client_name,client_version_from,client_version_to,release_order,num_commits,insertions,deletions,lines,files,self_driven_sdr
angular-mocks,1.2.18,1.2.19,1,28,966,507,1473,50,FALSE
angular-mocks,1.2.19,1.2.20,2,231,7438,2998,10436,459,FALSE
angular-mocks,1.2.20,1.2.21,3,1,15,10,25,1,TRUE
angular-mocks,1.2.21,1.2.22,4,1,15,10,25,1,TRUE
angular-mocks,1.2.22,1.2.25,5,437,63227,9484,72711,1581,FALSE
angular-mocks,1.2.25,1.2.27,6,356,15710,7879,23589,2441,FALSE
angular-mocks,1.2.27,1.2.28,7,155,9891,5783,15674,505,FALSE
angular-mocks,1.2.28,1.2.29,8,865,87771,42354,130125,3596,FALSE
angular-mocks,1.2.29,1.2.30,9,838,211864,61748,273612,3704,FALSE
angular-mocks,1.2.30,1.2.31,10,156,29113,24836,53949,903,FALSE
angular-mocks,1.2.31,1.2.32,11,2,44,37,81,6,TRUE
angular-mocks,1.3.0-rc.5,1.3.0,13,69,2762,717,3479,138,FALSE
angular-mocks,1.3.0,1.3.1,14,112,5523,4698,10221,1943,FALSE
angular-mocks,1.3.1,1.3.2,15,32,1013,160,1173,52,FALSE
angular-mocks,1.3.2,1.3.3,16,51,1815,800,2615,125,FALSE
angular-mocks,1.3.3,1.3.4-build.3588,17,14,336,61,397,18,FALSE
angular-mocks,1.3.4-build.3588,1.3.4,18,36,7044,4546,11590,316,FALSE
angular-mocks,1.3.4,1.3.5,19,29,444,146,590,39,FALSE
angular-mocks,1.3.5,1.3.6,20,53,1859,946,2805,97,FALSE
angular-mocks,1.3.6,1.3.7,21,37,523,146,669,53,FALSE
angular-mocks,1.3.7,1.3.8,22,26,281,118,399,30,FALSE
angular-mocks,1.3.8,1.3.9,23,69,11342,10014,21356,125,FALSE
angular-mocks,1.3.9,1.3.10,24,30,405,102,507,41,FALSE
angular-mocks,1.3.10,1.3.11,25,22,484,253,737,40,FALSE
angular-mocks,1.3.11,1.3.12,26,45,4716,1099,5815,119,FALSE
angular-mocks,1.3.12,1.3.13,27,11,309,29,338,19,FALSE
angular-mocks,1.3.13,1.3.14,28,51,15972,3957,19929,74,FALSE
angular-mocks,1.3.14,1.3.15,29,82,14992,3046,18038,1617,FALSE
angular-mocks,1.3.15,1.3.16,30,208,23892,13853,37745,436,FALSE
angular-mocks,1.3.16,1.3.17,31,66,2380,1433,3813,104,FALSE
angular-mocks,1.3.17,1.3.18,32,109,6276,5861,12137,694,FALSE
angular-mocks,1.3.18,1.3.19,33,82,2580,1130,3710,170,FALSE
angular-mocks,1.3.19,1.3.20,34,65,4164,1459,5623,128,FALSE
angular-mocks,1.4.0-beta.0,1.4.0-beta.1,36,30,405,102,507,41,FALSE
angular-mocks,1.4.0-beta.1,1.4.0-beta.2,37,22,484,253,737,40,FALSE
angular-mocks,1.4.0-beta.2,1.4.0-beta.3,38,45,4716,1099,5815,119,FALSE
angular-mocks,1.4.0-beta.3,1.4.0-beta.4,39,12,310,30,340,20,FALSE
angular-mocks,1.4.0-beta.4,1.4.0-beta.5,40,50,15971,3956,19927,73,FALSE
angular-mocks,1.4.0-beta.5,1.4.0-beta.6,41,78,14819,3025,17844,1611,FALSE
angular-mocks,1.4.0-beta.6,1.4.0-rc.0,42,61,17140,10853,27993,159,FALSE
angular-mocks,1.4.0-rc.0,1.4.0-rc.1,43,34,1986,484,2470,91,FALSE
angular-mocks,1.4.0-rc.1,1.4.0-rc.2,44,57,1524,379,1903,97,FALSE
angular-mocks,1.4.0-rc.2,1.4.0,45,21,2840,2065,4905,43,FALSE
angular-mocks,1.4.0,1.4.1,46,70,2123,903,3026,96,FALSE
angular-mocks,1.4.1,1.4.2,47,35,832,623,1455,60,FALSE
angular-mocks,1.4.2,1.4.3,48,15,271,22,293,20,FALSE
angular-mocks,1.4.3,1.4.4,49,86,5627,5745,11372,662,FALSE
angular-mocks,1.4.4,1.4.5,50,26,1300,683,1983,70,FALSE
angular-mocks,1.4.5,1.4.6,51,65,1660,543,2203,113,FALSE
angular-mocks,1.4.6,1.4.7,52,64,4162,1457,5619,127,FALSE
angular-mocks,1.4.7,1.4.8,53,117,13248,2110,15358,182,FALSE
angular-mocks,1.4.8,1.4.9,54,178,20362,4377,24739,1070,FALSE
angular-mocks,1.4.9,1.4.10,55,177,17239,15535,32774,1094,FALSE
angular-mocks,1.4.10,1.4.11,56,209,142640,26689,169329,1035,FALSE
angular-mocks,1.4.11,1.4.12,57,72,9239,6360,15599,116,FALSE
angular-mocks,1.4.12,1.4.13,58,240,38227,31513,69740,1109,FALSE
angular-mocks,1.4.13,1.4.14,59,3,66,37,103,7,TRUE
angular-mocks,1.5.0-beta.0,1.5.0-beta.2,61,174,16908,3305,20213,294,FALSE
angular-mocks,1.5.0-beta.2,1.5.0-rc.0,62,65,12306,845,13151,821,FALSE
angular-mocks,1.5.0-rc.0,1.5.0-rc.1,63,94,7439,3591,11030,227,FALSE
angular-mocks,1.5.0-rc.1,1.5.0-rc.2,64,61,3777,1638,5415,799,FALSE
angular-mocks,1.5.0-rc.2,1.5.0,65,32,1644,618,2262,48,FALSE
angular-mocks,1.5.0,1.5.1,66,100,12516,13406,25922,256,FALSE
angular-mocks,1.5.1,1.5.2,67,18,335,112,447,47,FALSE
angular-mocks,1.5.2,1.5.3,68,22,1421,533,1954,74,FALSE
angular-mocks,1.5.3,1.5.5,69,77,108456,8701,117157,257,FALSE
angular-mocks,1.5.5,1.5.6,70,103,32938,17423,50361,688,FALSE
angular-mocks,1.5.6,1.5.7,71,70,8974,6354,15328,112,FALSE
angular-mocks,1.5.7,1.5.8,72,85,9208,6676,15884,207,FALSE
angular-mocks,1.5.8,1.5.9,73,261,41999,30338,72337,1218,FALSE
angular-mocks,1.5.9,1.5.10,74,63,10646,27961,38607,162,FALSE
angular-mocks,1.5.10,1.5.11,75,33,1676,679,2355,67,FALSE
angular-mocks,1.6.0-rc.0,1.6.0-rc.1,77,56,7272,3792,11064,205,FALSE
angular-mocks,1.6.0-rc.1,1.6.0-rc.2,78,15,1520,1128,2648,43,FALSE
angular-mocks,1.6.0-rc.2,1.6.0,79,38,8867,27083,35950,129,FALSE
angular-mocks,1.6.0,1.6.1,80,33,2136,1031,3167,46,FALSE
angular-mocks,1.6.1,1.6.2,81,62,3555,2033,5588,313,FALSE
angular-mocks,1.6.2,1.6.3,82,40,1603,838,2441,95,FALSE
angular-mocks,1.6.3,1.6.4,83,41,6567,7520,14087,74,FALSE
angular-route,1.2.17-build.163.1,1.2.27,1,1327,136946,34542,171488,5423,FALSE
angular-route,1.2.27,1.2.28,2,155,9891,5783,15674,505,FALSE
angular-route,1.2.28,1.2.29,3,865,87771,42354,130125,3596,FALSE
angular-route,1.2.29,1.2.30,4,838,211864,61748,273612,3704,FALSE
angular-route,1.2.30,1.2.31,5,156,29113,24836,53949,903,FALSE
angular-route,1.2.31,1.2.32,6,2,44,37,81,6,TRUE
angular-route,1.3.0-rc.5,1.3.0,8,69,2762,717,3479,138,FALSE
angular-route,1.3.0,1.3.1,9,112,5523,4698,10221,1943,FALSE
angular-route,1.3.1,1.3.2,10,32,1013,160,1173,52,FALSE
angular-route,1.3.2,1.3.3,11,51,1815,800,2615,125,FALSE
angular-route,1.3.3,1.3.4-build.3588,12,14,336,61,397,18,FALSE
angular-route,1.3.4-build.3588,1.3.4,13,36,7044,4546,11590,316,FALSE
angular-route,1.3.4,1.3.5,14,29,444,146,590,39,FALSE
angular-route,1.3.5,1.3.6,15,53,1859,946,2805,97,FALSE
angular-route,1.3.6,1.3.7,16,37,523,146,669,53,FALSE
angular-route,1.3.7,1.3.8,17,26,281,118,399,30,FALSE
angular-route,1.3.8,1.3.9,18,69,11342,10014,21356,125,FALSE
angular-route,1.3.9,1.3.10,19,30,405,102,507,41,FALSE
angular-route,1.3.10,1.3.11,20,22,484,253,737,40,FALSE
angular-route,1.3.11,1.3.12,21,45,4716,1099,5815,119,FALSE
angular-route,1.3.12,1.3.13,22,11,309,29,338,19,FALSE
angular-route,1.3.13,1.3.14,23,51,15972,3957,19929,74,FALSE
angular-route,1.3.14,1.3.15,24,82,14992,3046,18038,1617,FALSE
angular-route,1.3.15,1.3.16,25,208,23892,13853,37745,436,FALSE
angular-route,1.3.16,1.3.17,26,66,2380,1433,3813,104,FALSE
angular-route,1.3.17,1.3.18,27,109,6276,5861,12137,694,FALSE
angular-route,1.3.18,1.3.19,28,82,2580,1130,3710,170,FALSE
angular-route,1.3.19,1.3.20,29,65,4164,1459,5623,128,FALSE
angular-route,1.4.0-beta.0,1.4.0-beta.1,31,30,405,102,507,41,FALSE
angular-route,1.4.0-beta.1,1.4.0-beta.2,32,22,484,253,737,40,FALSE
angular-route,1.4.0-beta.2,1.4.0-beta.3,33,45,4716,1099,5815,119,FALSE
angular-route,1.4.0-beta.3,1.4.0-beta.4,34,12,310,30,340,20,FALSE
angular-route,1.4.0-beta.4,1.4.0-beta.5,35,50,15971,3956,19927,73,FALSE
angular-route,1.4.0-beta.5,1.4.0-beta.6,36,78,14819,3025,17844,1611,FALSE
angular-route,1.4.0-beta.6,1.4.0-rc.0,37,61,17140,10853,27993,159,FALSE
angular-route,1.4.0-rc.0,1.4.0-rc.1,38,34,1986,484,2470,91,FALSE
angular-route,1.4.0-rc.1,1.4.0-rc.2,39,57,1524,379,1903,97,FALSE
angular-route,1.4.0-rc.2,1.4.0,40,21,2840,2065,4905,43,FALSE
angular-route,1.4.0,1.4.1,41,70,2123,903,3026,96,FALSE
angular-route,1.4.1,1.4.2,42,35,832,623,1455,60,FALSE
angular-route,1.4.2,1.4.3,43,15,271,22,293,20,FALSE
angular-route,1.4.3,1.4.4,44,86,5627,5745,11372,662,FALSE
angular-route,1.4.4,1.4.5,45,26,1300,683,1983,70,FALSE
angular-route,1.4.5,1.4.6,46,65,1660,543,2203,113,FALSE
angular-route,1.4.6,1.4.7,47,64,4162,1457,5619,127,FALSE
angular-route,1.4.7,1.4.8,48,117,13248,2110,15358,182,FALSE
angular-route,1.4.8,1.4.9,49,178,20362,4377,24739,1070,FALSE
angular-route,1.4.9,1.4.10,50,177,17239,15535,32774,1094,FALSE
angular-route,1.4.10,1.4.11,51,209,142640,26689,169329,1035,FALSE
angular-route,1.4.11,1.4.12,52,72,9239,6360,15599,116,FALSE
angular-route,1.4.12,1.4.13,53,240,38227,31513,69740,1109,FALSE
angular-route,1.4.13,1.4.14,54,3,66,37,103,7,TRUE
angular-route,1.5.0-beta.0,1.5.0-beta.2,56,174,16908,3305,20213,294,FALSE
angular-route,1.5.0-beta.2,1.5.0-rc.0,57,65,12306,845,13151,821,FALSE
angular-route,1.5.0-rc.0,1.5.0-rc.1,58,94,7439,3591,11030,227,FALSE
angular-route,1.5.0-rc.1,1.5.0-rc.2,59,61,3777,1638,5415,799,FALSE
angular-route,1.5.0-rc.2,1.5.0,60,32,1644,618,2262,48,FALSE
angular-route,1.5.0,1.5.1,61,100,12516,13406,25922,256,FALSE
angular-route,1.5.1,1.5.2,62,18,335,112,447,47,FALSE
angular-route,1.5.2,1.5.3,63,22,1421,533,1954,74,FALSE
angular-route,1.5.3,1.5.5,64,77,108456,8701,117157,257,FALSE
angular-route,1.5.5,1.5.6,65,103,32938,17423,50361,688,FALSE
angular-route,1.5.6,1.5.7,66,70,8974,6354,15328,112,FALSE
angular-route,1.5.7,1.5.8,67,85,9208,6676,15884,207,FALSE
angular-route,1.5.8,1.5.9,68,261,41999,30338,72337,1218,FALSE
angular-route,1.5.9,1.5.10,69,63,10646,27961,38607,162,FALSE
angular-route,1.5.10,1.5.11,70,33,1676,679,2355,67,FALSE
angular-route,1.6.0-rc.0,1.6.0-rc.1,72,56,7272,3792,11064,205,FALSE
angular-route,1.6.0-rc.1,1.6.0-rc.2,73,15,1520,1128,2648,43,FALSE
angular-route,1.6.0-rc.2,1.6.0,74,38,8867,27083,35950,129,FALSE
angular-route,1.6.0,1.6.1,75,33,2136,1031,3167,46,FALSE
angular-route,1.6.1,1.6.2,76,62,3555,2033,5588,313,FALSE
angular-route,1.6.2,1.6.3,77,40,1603,838,2441,95,FALSE
angular-route,1.6.3,1.6.4,78,41,6567,7520,14087,74,FALSE
angular-ui-router,0.2.7,0.2.8,1,42,144466,6534,151000,166,FALSE
angular-ui-router,0.2.8,0.2.10,2,43,17801,32420,50221,218,FALSE
angular-ui-router,0.2.10,0.2.11,3,203,45073,7881,52954,421,FALSE
angular-ui-router,0.2.11,0.2.13,4,88,64033,2631,66664,209,FALSE
angular-ui-router,0.2.13,0.2.14,5,47,1529,657,2186,89,FALSE
angular-ui-router,0.2.14,0.2.15,6,22,743,414,1157,54,FALSE
angular-ui-router,0.2.15,0.2.16,7,481,116102,153198,269300,2041,FALSE
angular-ui-router,0.2.16,0.2.17,8,2,49,12,61,9,FALSE
angular-ui-router,0.2.17,0.2.18,9,40,38589,480,39069,76,FALSE
angular-ui-router,0.2.18,0.3.0,10,119,46314,159358,205672,808,FALSE
angular-ui-router,0.3.0,0.3.1,11,5,409,287,696,13,FALSE
angular-ui-router,0.3.1,0.3.2,12,195,10453,29379,39832,1073,FALSE
angular-ui-router,0.3.2,0.4.0,13,72,48883,2252,51135,233,FALSE
angular-ui-router,0.4.0,0.4.1,14,1,12,12,24,1,TRUE
angular-ui-router,0.4.1,0.4.2,15,1,12,12,24,1,TRUE
angular-ui-router,1.0.0-alpha.1,1.0.0-alpha.2,17,17,1795,445,2240,88,FALSE
angular-ui-router,1.0.0-alpha.2,1.0.0-alpha.3,18,1,2,2,4,2,TRUE
angular-ui-router,1.0.0-alpha.3,1.0.0-alpha.4,19,5,136,60,196,16,FALSE
angular-ui-router,1.0.0-alpha.4,1.0.0-alpha.5,20,26,1443,1215,2658,103,FALSE
angular-ui-router,1.0.0-alpha.5,1.0.0-beta.1,21,47,4433,3426,7859,386,FALSE
angular-ui-router,1.0.0-beta.1,1.0.0-beta.2,22,77,3807,2240,6047,253,FALSE
angular-ui-router,1.0.0-beta.2,1.0.0-beta.3,23,30,1088,7100,8188,102,FALSE
angular-ui-router,1.0.0-beta.3,1.0.0-rc.1,24,110,50122,19002,69124,558,FALSE
angular-ui-router,1.0.0-rc.1,1.0.0,25,48,2598,1320,3918,139,FALSE
angular-ui-router,1.0.0,1.0.3,26,10,186,97,283,16,FALSE
ape-formatting,1.0.0,1.0.1,1,2,23,18,41,6,FALSE
ape-formatting,1.0.1,1.0.2,2,1,4,4,8,1,TRUE
archiver,0.1.0,0.1.1,1,6,350,295,645,13,FALSE
archiver,0.1.1,0.2.0,2,7,1073,291,1364,25,FALSE
archiver,0.2.0,0.2.1,3,8,276,154,430,24,FALSE
archiver,0.2.1,0.2.2,4,4,123,32,155,10,FALSE
archiver,0.2.2,0.3.0,5,21,671,529,1200,67,FALSE
archiver,0.3.0,0.4.0,6,45,1565,1402,2967,118,FALSE
archiver,0.4.0,0.4.1,7,4,28,16,44,8,FALSE
archiver,0.4.1,0.4.2,8,10,148,72,220,20,FALSE
archiver,0.4.2,0.4.3,9,11,56,31,87,15,FALSE
archiver,0.4.3,0.4.4,10,15,896,483,1379,34,FALSE
archiver,0.4.4,0.4.5,11,4,114,14,128,8,FALSE
archiver,0.4.5,0.4.6,12,8,856,495,1351,26,FALSE
archiver,0.4.6,0.4.7,13,11,94,78,172,17,FALSE
archiver,0.4.7,0.4.8,14,3,12,8,20,5,TRUE
archiver,0.4.8,0.4.9,15,15,203,214,417,23,FALSE
archiver,0.4.9,0.4.10,16,10,649,58,707,23,FALSE
archiver,0.4.10,0.5.0-alpha,17,46,1187,624,1811,99,FALSE
archiver,0.5.0-alpha,0.5.0,18,20,217,1678,1895,57,FALSE
archiver,0.5.0,0.5.1,19,2,12,11,23,4,FALSE
archiver,0.5.1,0.5.2,20,3,11,5,16,5,FALSE
archiver,0.5.2,0.6.0,21,15,111,142,253,27,FALSE
archiver,0.6.0,0.6.1,22,6,9,20,29,7,FALSE
archiver,0.6.1,0.7.0,23,7,51,14,65,12,FALSE
archiver,0.7.0,0.7.1,24,13,82,40,122,15,FALSE
archiver,0.7.1,0.8.0,25,9,194,209,403,28,FALSE
archiver,0.8.0,0.8.1,26,2,18,10,28,5,TRUE
archiver,0.8.1,0.9.0,27,21,204,1013,1217,51,FALSE
archiver,0.9.0,0.9.1,28,3,7,75,82,6,FALSE
archiver,0.9.1,0.10.0-alpha,29,16,159,226,385,19,FALSE
archiver,0.10.0-alpha,0.10.0,30,1,2,2,4,2,FALSE
archiver,0.10.0,0.10.1,31,3,5,5,10,5,FALSE
archiver,0.10.1,0.11.0-alpha,32,23,469,334,803,37,FALSE
archiver,0.11.0-alpha,0.11.0,33,8,15,8,23,8,FALSE
archiver,0.11.0,0.12.0,34,17,309,126,435,23,FALSE
archiver,0.12.0,0.13.0,35,14,152,67,219,19,FALSE
archiver,0.13.0,0.13.1,36,24,273,92,365,36,FALSE
archiver,0.13.1,0.14.0,37,11,159,26,185,16,FALSE
archiver,0.14.0,0.14.1,38,10,77,20,97,15,TRUE
archiver,0.14.1,0.14.2,39,2,12,18,30,4,TRUE
archiver,0.14.2,0.14.3,40,10,168,142,310,20,FALSE
archiver,0.14.3,0.14.4,41,6,13,22,35,9,FALSE
archiver,0.14.4,0.15.0-1,42,12,231,127,358,23,FALSE
archiver,0.15.0-1,0.15.0,43,5,45,34,79,9,FALSE
archiver,0.15.0,0.15.1,44,3,13,6,19,5,FALSE
archiver,0.15.1,0.16.0,45,2,6,6,12,3,FALSE
archiver,0.16.0,0.17.0,46,5,11,13,24,7,FALSE
archiver,0.17.0,0.18.0,47,5,148,14,162,10,FALSE
archiver,0.18.0,0.19.0,48,2,12,12,24,5,TRUE
archiver,0.19.0,0.20.0,49,11,30,509,539,23,FALSE
archiver,0.20.0,0.21.0,50,19,706,453,1159,41,FALSE
archiver,0.21.0,1.0.0,51,25,177,91,268,36,FALSE
archiver,1.0.0,1.0.1,52,4,14,4,18,6,FALSE
archiver,1.0.1,1.1.0,53,18,120,56,176,23,FALSE
archiver,1.1.0,1.2.0,54,2,18,2,20,4,FALSE
archiver,1.2.0,1.3.0,55,10,131,67,198,15,FALSE
babel-eslint,1.0.0,1.0.1,1,1,1,1,2,1,TRUE
babel-eslint,1.0.1,1.0.2,2,1,1,1,2,1,TRUE
babel-eslint,1.0.2,1.0.3,3,1,1,1,2,1,TRUE
babel-eslint,1.0.3,1.0.4,4,3,210,2,212,8,TRUE
babel-eslint,1.0.4,1.0.6,5,4,30,4,34,7,TRUE
babel-eslint,1.0.6,1.0.7,6,3,36,17,53,3,TRUE
babel-eslint,1.0.7,1.0.8,7,4,28,6,34,4,TRUE
babel-eslint,1.0.8,1.0.9,8,4,9,15,24,3,TRUE
babel-eslint,1.0.9,1.0.10,9,1,5,2,7,2,TRUE
babel-eslint,1.0.10,1.0.11,10,4,20,14,34,8,TRUE
babel-eslint,1.0.11,1.0.12,11,1,6,2,8,2,TRUE
babel-eslint,1.0.12,1.0.13,12,9,117,13,130,10,FALSE
babel-eslint,1.0.13,1.0.14,13,10,746,62,808,22,FALSE
babel-eslint,1.0.14,2.0.0,14,11,200,88,288,18,FALSE
babel-eslint,2.0.0,2.0.2,15,8,20,11,31,8,FALSE
babel-eslint,2.0.2,3.0.0,16,5,67,130,197,11,FALSE
babel-eslint,3.0.0,3.0.1,17,1,17,1,18,3,TRUE
babel-eslint,3.0.1,3.1.0,18,4,208,67,275,6,FALSE
babel-eslint,3.1.0,3.1.1,19,3,9,1,10,3,TRUE
babel-eslint,3.1.1,3.1.3,20,11,496,48,544,22,FALSE
babel-eslint,3.1.3,3.1.4,21,4,32,1,33,6,FALSE
babel-eslint,3.1.4,3.1.5,22,4,29,2,31,5,TRUE
babel-eslint,3.1.5,3.1.6,23,5,259,3,262,7,FALSE
babel-eslint,3.1.6,3.1.7,24,2,2,3,5,2,TRUE
babel-eslint,3.1.7,3.1.8,25,3,59,11,70,5,FALSE
babel-eslint,3.1.8,3.1.9,26,3,29,27,56,3,FALSE
babel-eslint,3.1.9,3.1.10,27,12,2123,269,2392,25,FALSE
babel-eslint,3.1.10,3.1.11,28,8,255,59,314,14,FALSE
babel-eslint,3.1.11,3.1.12,29,2,3,3,6,3,FALSE
babel-eslint,3.1.12,3.1.13,30,3,27,5,32,5,TRUE
babel-eslint,3.1.13,3.1.14,31,5,101,51,152,12,FALSE
babel-eslint,3.1.14,3.1.15,32,7,242,100,342,18,FALSE
babel-eslint,3.1.15,3.1.16,33,6,64,31,95,10,FALSE
babel-eslint,3.1.16,3.1.17,34,3,8,2,10,4,TRUE
babel-eslint,3.1.17,3.1.18,35,6,34,20,54,7,FALSE
babel-eslint,3.1.18,3.1.19,36,2,9,2,11,2,FALSE
babel-eslint,3.1.19,3.1.20,37,3,115,29,144,5,FALSE
babel-eslint,3.1.20,3.1.21,38,6,41,8,49,10,FALSE
babel-eslint,3.1.21,3.1.22,39,2,19,3,22,4,TRUE
babel-eslint,3.1.22,3.1.23,40,3,11,7,18,5,TRUE
babel-eslint,3.1.23,3.1.24,41,5,18,7,25,6,FALSE
babel-eslint,3.1.24,3.1.25,42,2,29,2,31,3,TRUE
babel-eslint,3.1.25,3.1.26,43,3,11,4,15,3,TRUE
babel-eslint,3.1.26,3.1.27,44,3,25,3,28,5,FALSE
babel-eslint,3.1.27,3.1.28,45,8,101,5,106,11,FALSE
babel-eslint,3.1.28,3.1.29,46,2,7,7,14,2,TRUE
babel-eslint,3.1.29,3.1.30,47,2,5,4,9,2,TRUE
babel-eslint,4.0.0,4.0.1,49,2,3,1,4,2,FALSE
babel-eslint,4.0.1,4.0.2,50,2,3,1,4,2,TRUE
babel-eslint,4.0.2,4.0.3,51,2,7,7,14,2,TRUE
babel-eslint,4.0.3,4.0.4,52,2,5,4,9,2,TRUE
babel-eslint,4.0.4,4.0.5,53,3,9,2,11,3,TRUE
babel-eslint,4.0.5,4.0.6,54,9,81,53,134,13,FALSE
babel-eslint,4.0.6,4.0.7,55,2,1,6,7,2,TRUE
babel-eslint,4.0.7,4.0.8,56,3,23,1,24,5,TRUE
babel-eslint,4.0.8,4.0.9,57,4,10,25,35,4,TRUE
babel-eslint,4.0.9,4.0.10,58,2,2,5,7,2,TRUE
babel-eslint,4.0.10,4.1.0,59,8,45,647,692,16,FALSE
babel-eslint,4.1.0,4.1.1,60,3,29,13,42,7,FALSE
babel-eslint,4.1.1,4.1.2,61,5,32,6,38,5,FALSE
babel-eslint,4.1.2,4.1.3,62,3,42,18,60,4,FALSE
babel-eslint,4.1.3,4.1.4,63,5,69,16,85,7,FALSE
babel-eslint,4.1.4,4.1.5,64,3,17,5,22,7,FALSE
babel-eslint,4.1.5,4.1.6,65,9,94,46,140,9,FALSE
babel-eslint,4.1.6,4.1.7,66,30,915,391,1306,56,FALSE
babel-eslint,4.1.7,4.1.8,67,6,69,9,78,8,TRUE
babel-eslint,5.0.0-beta1,5.0.0-beta10,69,32,745,111,856,54,FALSE
babel-eslint,5.0.0-beta2,5.0.0-beta3,71,2,81,65,146,4,FALSE
babel-eslint,5.0.0-beta3,5.0.0-beta4,72,2,2,2,4,2,TRUE
babel-eslint,5.0.0-beta4,5.0.0-beta5,73,4,68,7,75,8,FALSE
babel-eslint,5.0.0-beta5,5.0.0-beta6,74,1,1,1,2,1,TRUE
babel-eslint,5.0.0-beta6,5.0.0-beta7,75,8,462,12,474,20,FALSE
babel-eslint,5.0.0-beta7,5.0.0-beta8,76,2,11,3,14,2,TRUE
babel-eslint,5.0.0-beta8,5.0.0-beta9,77,3,13,1,14,3,FALSE
babel-eslint,5.0.0-beta9,5.0.0,78,13,82,17,99,16,FALSE
babel-eslint,5.0.0,5.0.1,79,32,1390,339,1729,70,FALSE
babel-eslint,5.0.1,5.0.2,80,5,53,23,76,5,FALSE
babel-eslint,5.0.2,5.0.3,81,1,50,20,70,2,FALSE
babel-eslint,5.0.3,5.0.4,82,3,41,101,142,5,TRUE
babel-eslint,6.0.0-beta.1,6.0.0-beta.2,84,7,55,76,131,12,FALSE
babel-eslint,6.0.0-beta.2,6.0.0-beta.3,85,4,36,19,55,5,TRUE
babel-eslint,6.0.0-beta.3,6.0.0-beta.4,86,2,5,3,8,3,TRUE
babel-eslint,6.0.0-beta.4,6.0.0-beta.5,87,2,5,5,10,2,TRUE
babel-eslint,6.0.0-beta.5,6.0.0-beta.6,88,3,7,9,16,5,FALSE
babel-eslint,6.0.0-beta.6,6.0.0,89,1,1,1,2,1,FALSE
babel-eslint,6.0.0,6.0.1,90,5,102,42,144,6,FALSE
babel-eslint,6.0.1,6.0.2,91,3,41,101,142,5,TRUE
babel-eslint,6.0.2,6.0.3,92,4,105,27,132,5,FALSE
babel-eslint,6.0.3,6.0.4,93,4,33,4,37,6,FALSE
babel-eslint,6.0.4,6.0.5,94,8,65,9,74,11,FALSE
babel-eslint,6.0.5,6.1.0,95,2,22,3,25,4,FALSE
babel-eslint,6.1.0,6.1.1,96,5,44,16,60,6,FALSE
babel-eslint,6.1.1,6.1.2,97,2,57,8,65,3,TRUE
babel-eslint,6.1.2,7.0.0,98,22,756,798,1554,51,FALSE
babel-eslint,7.0.0,7.1.0,99,6,808,718,1526,16,FALSE
babel-eslint,7.1.0,7.1.1,100,5,12,7,19,7,FALSE
babel-eslint,7.1.1,7.2.0,101,17,1746,676,2422,40,FALSE
babel-eslint,7.2.0,7.2.1,102,6,115,56,171,9,FALSE
babel-eslint,7.2.1,7.2.2,103,14,321,287,608,34,FALSE
babel-eslint,7.2.2,7.2.3,104,2,22,7,29,5,FALSE
babel-plugin-transform-builtin-extend,1.0.0,1.1.0,1,2,6,4,10,2,TRUE
babel-plugin-transform-builtin-extend,1.1.0,1.1.1,2,3,3,3,6,3,FALSE
babel-plugin-transform-builtin-extend,1.1.1,1.1.2,3,1,1,1,2,1,TRUE
babel-plugin-transform-react-remove-prop-types,0.1.0,0.2.0,1,6,529,26,555,18,FALSE
babel-plugin-transform-react-remove-prop-types,0.2.0,0.2.1,2,2,6,1,7,2,TRUE
babel-plugin-transform-react-remove-prop-types,0.2.1,0.2.2,3,4,104,20,124,14,FALSE
babel-plugin-transform-react-remove-prop-types,0.2.2,0.2.3,4,5,104,11,115,11,FALSE
babel-plugin-transform-react-remove-prop-types,0.2.3,0.2.4,5,5,169,11,180,13,FALSE
babel-plugin-transform-react-remove-prop-types,0.2.4,0.2.5,6,4,163,2,165,8,FALSE
babel-plugin-transform-react-remove-prop-types,0.2.5,0.2.6,7,11,393,92,485,26,FALSE
babel-plugin-transform-react-remove-prop-types,0.2.6,0.2.7,8,2,3,4,7,2,FALSE
babel-plugin-transform-react-remove-prop-types,0.2.7,0.2.8,9,12,1027,105,1132,73,FALSE
babel-plugin-transform-react-remove-prop-types,0.2.8,0.2.9,10,4,88,27,115,7,FALSE
babel-plugin-transform-react-remove-prop-types,0.2.9,0.2.10,11,16,863,348,1211,149,FALSE
babel-plugin-transform-react-remove-prop-types,0.2.10,0.2.11,12,11,185,258,443,25,FALSE
babel-plugin-transform-react-remove-prop-types,0.2.11,0.2.12,13,10,159,33,192,22,FALSE
babel-plugin-transform-react-remove-prop-types,0.2.12,0.3.0,14,3,277,105,382,19,FALSE
babel-plugin-transform-react-remove-prop-types,0.3.0,0.3.1,15,3,1,105,106,11,FALSE
babel-plugin-transform-react-remove-prop-types,0.3.1,0.3.2,16,3,371,239,610,17,FALSE
babel-plugin-transform-react-remove-prop-types,0.3.2,0.3.3,17,6,191,80,271,21,FALSE
babel-plugin-transform-react-remove-prop-types,0.3.3,0.4.0,18,7,5819,219,6038,95,FALSE
babel-plugin-transform-react-remove-prop-types,0.4.0,0.4.1,19,10,452,49,501,30,FALSE
babel-plugin-transform-react-remove-prop-types,0.4.1,0.4.2,20,3,587,317,904,91,FALSE
babel-plugin-transform-react-remove-prop-types,0.4.2,0.4.3,21,11,568,84,652,42,FALSE
babel-plugin-transform-react-remove-prop-types,0.4.3,0.4.4,22,3,235,11,246,13,FALSE
babel-plugin-transform-react-remove-prop-types,0.4.4,0.4.5,23,5,149,33,182,15,FALSE
bcrypt,0.1.2,0.1.3,1,21,817,307,1124,38,FALSE
bcrypt,0.2.0,0.2.1,3,2,28,4,32,2,FALSE
bcrypt,0.2.1,0.2.2,4,2,2,2,4,2,TRUE
bcrypt,0.2.2,0.2.3,5,1,82,21,103,5,FALSE
bcrypt,0.2.3,0.2.4,6,26,583,216,799,48,FALSE
bcrypt,0.2.4,0.3.0,7,21,279,328,607,32,FALSE
bcrypt,0.3.0,0.3.1,8,1,2,2,4,2,TRUE
bcrypt,0.3.1,0.3.2,9,7,56,70,126,10,FALSE
bcrypt,0.3.2,0.4.0,10,4,90,2,92,14,FALSE
bcrypt,0.4.0,0.4.1,11,12,813,519,1332,26,FALSE
bcrypt,0.4.1,0.5.0,12,22,279,215,494,39,FALSE
bcrypt,0.5.0,0.6.0,13,19,79,54,133,20,FALSE
bcrypt,0.6.0,0.7.0,14,7,63,31,94,13,FALSE
bcrypt,0.7.0,0.7.1,15,9,172,75,247,15,FALSE
bcrypt,0.7.1,0.7.2,16,9,35,17,52,9,FALSE
bcrypt,0.7.2,0.7.3,17,7,20,17,37,7,FALSE
bcrypt,0.7.3,0.7.4,18,4,5,9,14,4,FALSE
bcrypt,0.7.4,0.7.5,19,2,37,7,44,5,FALSE
bcrypt,0.7.5,0.7.6,20,9,108,79,187,11,FALSE
bcrypt,0.7.6,0.7.7,21,5,54,73,127,5,FALSE
bcrypt,0.7.7,0.7.8,22,25,208,523,731,37,FALSE
bcrypt,0.7.8,0.8.0,23,14,388,438,826,19,FALSE
bcrypt,0.8.0,0.8.1,24,15,79,70,149,17,FALSE
bcrypt,0.8.1,0.8.2,25,10,34,11,45,12,FALSE
bcrypt,0.8.2,0.8.3,26,11,33,10,43,12,FALSE
bcrypt,0.8.3,0.8.4,27,10,24,27,51,11,FALSE
bcrypt,0.8.4,0.8.5,28,4,247,223,470,9,FALSE
bcrypt,0.8.5,0.8.6,29,13,134,90,224,13,FALSE
bcrypt,0.8.6,0.8.7,30,5,23,2,25,5,FALSE
bcrypt,0.8.7,1.0.0,31,12,377,27,404,19,FALSE
bcrypt,1.0.0,1.0.1,32,3,16,12,28,4,FALSE
bcrypt,1.0.1,1.0.2,33,5,78,15,93,10,FALSE
benchmark,0.1.337,0.1.338,1,1,1967,763,2730,4,TRUE
benchmark,0.1.338,0.1.339,2,13,447,303,750,21,FALSE
benchmark,0.1.339,0.1.340,3,31,1586,1388,2974,67,FALSE
benchmark,0.1.340,0.1.341,4,19,1629,1008,2637,39,FALSE
benchmark,0.1.341,0.1.342,5,11,637,959,1596,31,FALSE
benchmark,0.1.342,0.1.343,6,25,1365,1278,2643,45,FALSE
benchmark,0.1.343,0.1.344,7,22,1390,1082,2472,38,FALSE
benchmark,0.1.344,0.1.345,8,6,294,290,584,13,FALSE
benchmark,0.1.345,0.1.346,9,9,356,298,654,19,FALSE
benchmark,0.1.346,0.1.347,10,9,539,425,964,18,FALSE
benchmark,0.1.347,0.1.348,11,5,20,11,31,7,FALSE
benchmark,0.1.348,0.1.349,12,7,240,182,422,13,FALSE
benchmark,0.1.349,0.2.0,13,7,566,246,812,15,FALSE
benchmark,0.2.0,0.2.1,14,6,70,46,116,9,FALSE
benchmark,0.2.1,0.2.2,15,45,6017,7167,13184,110,FALSE
benchmark,0.2.2,0.3.0,16,185,9434,6738,16172,355,FALSE
benchmark,0.3.0,1.0.0,17,138,23311,11490,34801,376,FALSE
benchmark,1.0.0,2.0.0,18,276,32269,43576,75845,567,FALSE
benchmark,2.0.0,2.1.0,19,13,807,1190,1997,27,FALSE
benchmark,2.1.0,2.1.1,20,17,47,69,116,18,FALSE
benchmark,2.1.1,2.1.2,21,24,1228,411,1639,34,FALSE
benchmark,2.1.2,2.1.3,22,11,353,318,671,15,FALSE
benchmark,2.1.3,2.1.4,23,5,204,237,441,9,FALSE
broccoli-static-compiler,0.1.4,0.2.0,1,8,64,27,91,15,FALSE
broccoli-static-compiler,0.2.0,0.2.1,2,4,337,1,338,21,FALSE
broccoli-static-compiler,0.2.1,0.2.2,3,4,11,1,12,5,FALSE
camelcase,1.0.0,1.0.1,1,2,9,2,11,3,TRUE
camelcase,1.0.1,1.0.2,2,3,9,5,14,5,FALSE
camelcase,1.0.2,1.1.0,3,4,17,2,19,5,FALSE
camelcase,1.1.0,1.2.0,4,3,27,5,32,7,FALSE
camelcase,1.2.0,1.2.1,5,2,12,1,13,3,FALSE
camelcase,1.2.1,2.0.0,6,8,103,122,225,15,FALSE
camelcase,2.0.0,2.0.1,7,3,17,7,24,5,FALSE
camelcase,2.0.1,2.1.0,8,5,32,5,37,6,FALSE
camelcase,2.1.0,2.1.1,9,2,10,2,12,4,FALSE
camelcase,2.1.1,3.0.0,10,3,4,4,8,4,FALSE
camelcase,3.0.0,4.0.0,11,3,82,88,170,10,FALSE
camelcase,4.0.0,4.1.0,12,4,27,12,39,4,FALSE
chai-immutable,0.2.0,0.2.1,1,4,16,6,22,4,FALSE
chai-immutable,0.2.1,0.3.0,2,12,381,157,538,18,FALSE
chai-immutable,0.3.0,1.0.2,3,26,312,70,382,47,FALSE
chai-immutable,1.0.2,1.1.1,4,7,136,7,143,9,FALSE
chai-immutable,1.1.1,1.2.0,5,6,31,12,43,8,FALSE
chai-immutable,1.2.0,1.3.0,6,16,658,593,1251,24,FALSE
chai-immutable,1.3.0,1.4.0,7,19,239,62,301,26,FALSE
chai-immutable,1.4.0,1.5.0,8,5,83,6,89,6,FALSE
chai-immutable,1.5.0,1.5.1,9,7,600,192,792,8,FALSE
chai-immutable,1.5.1,1.5.2,10,4,28,7,35,8,FALSE
chai-immutable,1.5.2,1.5.3,11,7,58,18,76,9,FALSE
chai-immutable,1.5.3,1.5.4,12,8,351,37,388,10,FALSE
chai-immutable,1.5.4,1.6.0,13,38,1272,327,1599,57,FALSE
chart.js,1.0.1-beta.2,1.0.1,1,90,2412,843,3255,155,FALSE
chart.js,1.0.1,1.0.2,2,45,414,156,570,70,FALSE
chart.js,1.0.2,1.1.0,3,1202,286049,197168,483217,3750,FALSE
chart.js,1.1.0,1.1.1,4,22,18352,17524,35876,46,FALSE
chart.js,1.1.1,2.0.0,5,1,17472,17472,34944,6,FALSE
chart.js,2.0.0,2.0.1,6,25,33854,33361,67215,42,FALSE
chart.js,2.0.1,2.0.2,7,3,3179,3466,6645,19,TRUE
chart.js,2.0.2,2.1.0,8,175,100588,63643,164231,538,FALSE
chart.js,2.1.0,2.1.1,9,24,35843,34160,70003,47,FALSE
chart.js,2.1.1,2.1.2,10,23,19661,18456,38117,53,FALSE
chart.js,2.1.2,2.1.3,11,33,65894,65592,131486,119,FALSE
chart.js,2.1.3,2.1.4,12,86,34762,33688,68450,260,FALSE
chart.js,2.1.4,2.1.5,13,97,49285,45159,94444,248,FALSE
chart.js,2.1.5,2.1.6,14,3,23,19,42,9,FALSE
chart.js,2.1.6,2.2.0-rc.1,15,86,2783,74634,77417,278,FALSE
chart.js,2.2.0-rc.1,2.2.0-rc.2,16,19,827,148,975,51,FALSE
chart.js,2.2.0-rc.2,2.2.0,17,19,2187,370,2557,29,FALSE
chart.js,2.2.0,2.2.1,18,13,613,18,631,17,FALSE
chart.js,2.2.1,2.2.2,19,40,2021,253,2274,90,FALSE
chart.js,2.2.2,2.3.0-rc.1,20,51,2626,2507,5133,250,FALSE
chart.js,2.3.0-rc.1,2.3.0,21,1,1,1,2,1,TRUE
chart.js,2.3.0,2.4.0,22,62,10701,6025,16726,327,FALSE
chart.js,2.4.0,2.5.0,23,61,4585,2159,6744,151,FALSE
chart.js,2.5.0,2.6.0,24,76,10715,6280,16995,449,FALSE
command-line-args,0.0.0,0.0.1,1,1,36,117,153,4,TRUE
command-line-args,0.0.1,0.0.2,2,7,116,63,179,14,TRUE
command-line-args,0.0.2,0.1.0,3,3,31,6,37,4,FALSE
command-line-args,0.1.0,0.2.0,4,9,374,207,581,36,FALSE
command-line-args,0.2.0,0.2.1,5,2,2,1,3,2,FALSE
command-line-args,0.2.1,0.2.2,6,4,59,31,90,6,FALSE
command-line-args,0.2.2,0.2.3,7,2,4,4,8,3,TRUE
command-line-args,0.2.3,0.2.4,8,2,5,5,10,3,FALSE
command-line-args,0.2.4,0.3.0,9,8,287,133,420,31,FALSE
command-line-args,0.3.0,0.3.1,10,2,14,2,16,3,TRUE
command-line-args,0.3.1,0.4.0,11,27,498,207,705,52,FALSE
command-line-args,0.4.0,0.5.0,12,5,23,21,44,6,FALSE
command-line-args,0.5.0,0.5.1,13,6,106,48,154,14,FALSE
command-line-args,0.5.1,0.5.2,14,4,21,7,28,7,FALSE
command-line-args,0.5.2,0.5.3,15,2,24,16,40,3,FALSE
command-line-args,0.5.3,0.5.4,16,5,73,75,148,10,FALSE
command-line-args,0.5.4,0.5.5,17,1,36,117,153,4,TRUE
command-line-args,0.5.5,0.5.6,18,2,105,53,158,18,FALSE
command-line-args,0.5.6,0.5.7,19,2,7,3,10,3,TRUE
command-line-args,0.5.7,0.5.8,20,2,3,2,5,2,FALSE
command-line-args,0.5.8,0.5.9,21,2,22,18,40,4,TRUE
command-line-args,0.5.9,1.0.0-0,22,25,1340,1385,2725,129,FALSE
command-line-args,1.0.0-0,1.0.0-1,23,2,223,79,302,12,FALSE
command-line-args,1.0.0-1,1.0.0-2,24,4,36,41,77,8,TRUE
command-line-args,1.0.0-2,1.0.0-3,25,5,85,202,287,13,FALSE
command-line-args,1.0.0-3,1.0.0,26,39,2120,1427,3547,131,FALSE
command-line-args,1.0.0,1.0.1,27,3,17,3,20,6,FALSE
command-line-args,1.0.1,1.0.2,28,4,1080,1081,2161,45,FALSE
command-line-args,1.1.0-0,1.1.0-1,30,6,429,475,904,17,FALSE
command-line-args,1.1.0-1,2.0.0,31,39,3436,2568,6004,168,FALSE
command-line-args,2.0.0,2.0.1,32,2,3,3,6,2,TRUE
command-line-args,2.0.1,2.0.2,33,2,8,7,15,4,TRUE
command-line-args,2.0.2,2.0.3,34,11,246,171,417,27,FALSE
command-line-args,2.0.3,2.0.4,35,2,3,4,7,4,TRUE
command-line-args,2.0.4,2.1.0,36,5,109,44,153,26,FALSE
command-line-args,2.1.0,2.1.1,37,4,21,9,30,9,FALSE
command-line-args,2.1.1,2.1.2,38,4,21,21,42,10,FALSE
command-line-args,2.1.2,2.1.3,39,2,3,3,6,3,FALSE
command-line-args,2.1.3,2.1.4,40,7,299,306,605,20,FALSE
command-line-args,2.1.4,2.1.5,41,12,363,277,640,42,FALSE
command-line-args,2.1.5,2.1.6,42,2,5,4,9,4,TRUE
command-line-args,2.1.6,3.0.0,43,16,616,855,1471,88,FALSE
command-line-args,3.0.0,3.0.1,44,8,352,312,664,57,FALSE
command-line-args,3.0.1,3.0.2,45,3,127,87,214,25,FALSE
command-line-args,3.0.2,3.0.3-0,46,2,18,4,22,5,FALSE
command-line-args,3.0.3-0,3.0.3,47,2,8,3,11,2,TRUE
command-line-args,3.0.3,3.0.4,48,6,1225,298,1523,74,FALSE
command-line-args,3.0.4,3.0.5,49,2,29,11,40,4,FALSE
command-line-args,3.0.5,4.0.0-0,50,8,753,1849,2602,140,FALSE
command-line-args,4.0.0-0,4.0.0-1,51,6,245,175,420,26,FALSE
command-line-args,4.0.0-1,4.0.0,52,1,1,1,2,1,TRUE
command-line-args,4.0.0,4.0.1,53,2,63,5,68,5,TRUE
command-line-args,4.0.1,4.0.2,54,2,72,12,84,4,FALSE
command-line-args,4.0.2,4.0.3,55,2,25,6,31,5,FALSE
command-line-args,4.0.3,4.0.4,56,7,957,551,1508,56,FALSE
command-line-args,4.0.4,4.0.5,57,3,46,20,66,8,FALSE
command-line-args,4.0.5,4.0.6,58,2,11,2,13,3,FALSE
commitizen,1.0.1,1.0.2,1,3,74,16,90,4,TRUE
commitizen,1.0.2,1.0.3,2,2,6,4,10,5,TRUE
commitizen,1.0.3,1.0.4,3,1,8,5,13,2,FALSE
commitizen,1.0.4,1.0.5,4,5,25,25,50,5,FALSE
commitizen,1.0.5,2.0.0,5,2,1455,216,1671,44,FALSE
commitizen,2.0.0,2.0.1,6,1,10,8,18,5,TRUE
commitizen,2.0.1,2.0.2,7,1,1,1,2,1,TRUE
commitizen,2.0.2,2.1.0,8,5,75,13,88,10,TRUE
commitizen,2.1.0,2.2.0,9,8,74,25,99,15,FALSE
commitizen,2.2.0,2.2.1,10,4,10,7,17,4,TRUE
commitizen,2.2.1,2.3.0,11,2,547,159,706,20,TRUE
commitizen,2.3.0,2.4.0,12,11,70,64,134,44,FALSE
commitizen,2.4.0,2.4.1,13,6,12,10,22,6,FALSE
commitizen,2.4.1,2.4.2,14,1,17,2,19,2,FALSE
commitizen,2.4.2,2.4.3,15,1,2,2,4,1,TRUE
commitizen,2.4.3,2.4.4,16,1,1,1,2,1,TRUE
commitizen,2.4.4,2.4.5,17,14,147,39,186,23,FALSE
commitizen,2.4.5,2.4.6,18,4,30,6,36,5,FALSE
commitizen,2.4.6,2.5.0,19,5,62,12,74,6,FALSE
commitizen,2.5.0,2.5.1,20,4,25,25,50,4,FALSE
commitizen,2.5.1,2.6.0,21,1,54,58,112,5,TRUE
commitizen,2.6.0,2.6.1,22,5,8,8,16,5,TRUE
commitizen,2.6.1,2.6.2,23,1,17,7,24,2,FALSE
commitizen,2.6.2,2.6.3,24,1,2,0,2,1,TRUE
commitizen,2.6.3,2.7.0,25,1,92,9,101,5,FALSE
commitizen,2.7.0,2.7.1,26,1,2,2,4,2,TRUE
commitizen,2.7.1,2.7.2,27,2,8,17,25,2,TRUE
commitizen,2.7.2,2.7.3,28,3,23,11,34,3,FALSE
commitizen,2.7.3,2.7.4,29,1,48,2,50,2,FALSE
commitizen,2.7.4,2.7.5,30,1,3,3,6,2,TRUE
commitizen,2.7.5,2.7.6,31,1,2,2,4,1,TRUE
commitizen,2.7.6,2.8.0,32,3,128,12,140,6,FALSE
commitizen,2.8.0,2.8.1,33,1,1,2,3,1,FALSE
commitizen,2.8.1,2.8.2,34,11,41,8,49,11,FALSE
commitizen,2.8.2,2.8.3,35,28,247,184,431,44,FALSE
commitizen,2.8.3,2.8.4,36,1,1,1,2,1,TRUE
commitizen,2.8.4,2.8.5,37,3,25,15,40,5,FALSE
commitizen,2.8.5,2.8.6,38,5,20,15,35,5,FALSE
commitizen,2.8.6,2.8.7,39,29,170,135,305,35,FALSE
commitizen,2.8.7,2.9.0,40,1,48,41,89,3,TRUE
commitizen,2.9.0,2.9.1,41,4,43,1,44,4,FALSE
commitizen,2.9.1,2.9.2,42,1,28,19,47,3,TRUE
commitizen,2.9.2,2.9.3,43,8,126,59,185,43,FALSE
commitizen,2.9.3,2.9.4,44,17,65,21,86,22,FALSE
commitizen,2.9.4,2.9.5,45,2,284,270,554,39,FALSE
commitizen,2.9.5,2.9.6,46,2,2,2,4,2,FALSE
compression,1.0.0,1.0.1,1,6,16,8,24,7,FALSE
compression,1.0.1,1.0.2,2,10,123,73,196,16,FALSE
compression,1.0.2,1.0.3,3,13,98,126,224,24,FALSE
compression,1.0.3,1.0.4,4,7,411,228,639,14,FALSE
compression,1.0.4,1.0.5,5,2,105,14,119,5,TRUE
compression,1.0.5,1.0.6,6,2,25,4,29,5,TRUE
compression,1.0.6,1.0.7,7,12,75,104,179,17,FALSE
compression,1.0.7,1.0.8,8,2,10,4,14,4,FALSE
compression,1.0.8,1.0.9,9,8,123,21,144,12,FALSE
compression,1.0.9,1.0.10,10,4,58,5,63,6,FALSE
compression,1.0.10,1.0.11,11,2,8,2,10,4,FALSE
compression,1.0.11,1.1.0,12,10,77,38,115,17,FALSE
compression,1.1.0,1.1.1,13,6,19,10,29,10,FALSE
compression,1.1.1,1.1.2,14,4,13,6,19,6,FALSE
compression,1.1.2,1.2.0,15,2,10,4,14,4,TRUE
compression,1.2.0,1.2.1,16,5,58,70,128,8,FALSE
compression,1.2.1,1.2.2,17,4,17,11,28,7,FALSE
compression,1.2.2,1.3.0,18,11,149,59,208,17,FALSE
compression,1.3.0,1.3.1,19,6,39,7,46,9,FALSE
compression,1.3.1,1.4.0,20,5,125,22,147,8,TRUE
compression,1.4.0,1.4.1,21,5,16,11,27,7,FALSE
compression,1.4.1,1.4.2,22,7,40,11,51,11,FALSE
compression,1.4.2,1.4.3,23,3,14,5,19,6,FALSE
compression,1.4.3,1.4.4,24,8,23,13,36,11,FALSE
compression,1.4.4,1.5.0,25,21,154,69,223,37,FALSE
compression,1.5.0,1.5.1,26,2,4,4,8,3,FALSE
compression,1.5.1,1.5.2,27,8,23,11,34,12,FALSE
compression,1.5.2,1.6.0,28,13,95,12,107,21,FALSE
compression,1.6.0,1.6.1,29,12,22,16,38,16,FALSE
compression,1.6.1,1.6.2,30,15,148,108,256,26,FALSE
condition-circle,1.0.0,1.0.1,1,1,2,2,4,1,TRUE
condition-circle,1.0.1,1.0.2,2,1,4,2,6,2,TRUE
condition-circle,1.0.2,1.1.0,3,1,18,5,23,3,TRUE
condition-circle,1.1.0,1.1.1,4,1,43,1,44,2,TRUE
condition-circle,1.1.1,1.2.0,5,6,106,9,115,8,TRUE
condition-circle,1.2.0,1.2.1,6,7,30,1,31,7,FALSE
condition-circle,1.2.1,1.3.0,7,3,18,3,21,4,TRUE
condition-circle,1.3.0,1.4.0,8,2,45,27,72,4,TRUE
condition-circle,1.4.0,1.5.0,9,2,22,4,26,4,TRUE
cross-env,1.0.0,1.0.1,1,1,1,0,1,1,TRUE
cross-env,1.0.1,1.0.2,2,1,7,6,13,3,FALSE
cross-env,1.0.2,1.0.3,3,1,11,11,22,3,TRUE
cross-env,1.0.3,1.0.4,4,4,17,15,32,7,TRUE
cross-env,1.0.4,1.0.5,5,1,6,4,10,3,FALSE
cross-env,1.0.5,1.0.6,6,2,78,20,98,4,FALSE
cross-env,1.0.6,1.0.7,7,5,37,8,45,7,FALSE
cross-env,1.0.7,1.0.8,8,2,13,9,22,4,FALSE
cross-env,1.0.8,2.0.0,9,3,16,5,21,5,FALSE
cross-env,2.0.0,2.0.1,10,3,29,8,37,5,FALSE
cross-env,2.0.1,3.0.0,11,1,2,4,6,2,FALSE
cross-env,3.0.0,3.1.0,12,1,74,5,79,5,FALSE
cross-env,3.1.0,3.1.1,13,1,2,2,4,2,TRUE
cross-env,3.1.1,3.1.2,14,1,10,1,11,2,FALSE
cross-env,3.1.2,3.1.3,15,1,1,1,2,1,FALSE
cross-env,3.1.3,3.1.4,16,2,8,0,8,3,FALSE
cross-env,3.1.4,3.2.0,17,4,6471,399,6870,36,FALSE
cross-env,3.2.0,3.2.1,18,1,2,2,4,1,TRUE
cross-env,3.2.1,3.2.2,19,2,14,4,18,3,TRUE
cross-env,3.2.2,3.2.3,20,2,4,2,6,2,TRUE
cross-env,3.2.3,3.2.4,21,8,109,24,133,15,FALSE
cross-env,3.2.4,4.0.0-beta.0,22,1,42,15,57,4,FALSE
cross-env,4.0.0-beta.0,4.0.0,23,7,267,68,335,23,FALSE
cross-env,4.0.0,5.0.0-beta.0,24,1,11,2,13,2,FALSE
cross-env,5.0.0-beta.0,5.0.0,25,3,77,26,103,10,FALSE
cuid,1.0.1,1.1.0,1,1,304,155,459,12,FALSE
cuid,1.1.0,1.1.1,2,4,55,28,83,12,TRUE
cuid,1.1.1,1.1.2,3,3,1062,21,1083,11,TRUE
cuid,1.1.2,1.1.3,4,2,4,4,8,2,TRUE
cuid,1.1.3,1.1.4,5,1,3,1,4,2,TRUE
cuid,1.1.4,1.1.5,6,16,121,45,166,16,FALSE
cuid,1.1.5,1.1.6,7,4,25,11,36,7,FALSE
cuid,1.1.6,1.1.7,8,6,31,28,59,11,FALSE
cuid,1.1.7,1.2.0,9,7,138,62,200,12,FALSE
cuid,1.2.0,1.2.1,10,1,2,1,3,1,TRUE
cuid,1.2.1,1.2.2,11,10,95,44,139,15,FALSE
cuid,1.2.2,1.2.3,12,5,38,5,43,7,TRUE
cuid,1.2.3,1.2.4,13,2,41,34,75,6,TRUE
cuid,1.2.4,1.2.5,14,14,18,18,36,14,FALSE
cuid,1.2.5,1.3.0,15,43,881,23134,24015,80,FALSE
cuid,1.3.0,1.3.1,16,2,10361,2122,12483,25,TRUE
cuid,1.3.1,1.3.3,17,4,5,10140,10145,5,TRUE
cuid,1.3.3,1.3.4,18,2,330,2,332,4,TRUE
cuid,1.3.4,1.3.5,19,2,3,3,6,2,TRUE
cuid,1.3.5,1.3.8,20,6,551,334,885,12,TRUE
ember-code-snippet,0.0.1,0.0.2,1,1,1,1,2,1,TRUE
ember-code-snippet,0.0.2,0.0.3,2,4,41,7,48,7,TRUE
ember-code-snippet,0.0.3,0.0.4,3,1,2,2,4,1,TRUE
ember-code-snippet,0.0.4,0.0.5,4,1,82,4,86,3,FALSE
ember-code-snippet,0.0.5,0.0.6,5,1,66,11,77,3,TRUE
ember-code-snippet,0.0.6,0.1.0,6,1,30,5,35,3,FALSE
ember-code-snippet,0.1.0,0.1.1,7,3,25,44,69,6,FALSE
ember-code-snippet,0.1.1,0.1.2,8,1,1,2,3,2,TRUE
ember-code-snippet,0.1.2,0.1.3,9,2,2,2,4,2,FALSE
ember-code-snippet,0.1.3,1.0.0,10,3,5,7,12,3,FALSE
ember-code-snippet,1.0.0,1.0.1,11,3,9,9,18,3,FALSE
ember-code-snippet,1.0.1,1.0.2,12,3,5,5,10,3,FALSE
ember-code-snippet,1.0.2,1.1.0,13,3,12,5,17,6,FALSE
ember-code-snippet,1.1.0,1.1.1,14,5,61,33,94,5,FALSE
ember-code-snippet,1.1.1,1.1.2,15,4,8,4,12,4,FALSE
ember-code-snippet,1.1.2,1.1.3,16,2,2,2,4,2,TRUE
ember-code-snippet,1.1.3,1.2.0,17,5,13,5,18,9,FALSE
ember-code-snippet,1.2.0,1.2.1,18,3,5,5,10,3,FALSE
ember-code-snippet,1.2.1,1.3.0,19,3,7,3,10,5,FALSE
ember-code-snippet,1.3.0,1.4.0,20,6,12,8,20,8,FALSE
ember-code-snippet,1.4.0,1.5.0,21,6,17,18,35,8,FALSE
ember-code-snippet,1.5.0,1.6.0,22,4,5,12,17,5,TRUE
ember-code-snippet,1.6.0,1.7.0,23,2,4,12,16,4,FALSE
ember-code-snippet,1.7.0,1.8.0,24,1,12,4,16,3,TRUE
ember-code-snippet,1.8.0,1.8.1,25,7,25,7,32,7,FALSE
ember-disable-prototype-extensions,1.0.0,1.0.1,1,3,3,3,6,3,TRUE
ember-disable-prototype-extensions,1.0.1,1.1.0,2,7,335,149,484,51,FALSE
eslint-config-hapi,1.0.0,1.0.1,1,3,16,7,23,4,TRUE
eslint-config-hapi,1.0.1,2.0.0,2,1,79,2,81,5,FALSE
eslint-config-hapi,2.0.0,2.0.1,3,2,32,4,36,8,TRUE
eslint-config-hapi,2.0.1,3.0.0,4,2,250,172,422,16,FALSE
eslint-config-hapi,3.0.0,3.0.1,5,1,5,3,8,3,TRUE
eslint-config-hapi,3.0.1,3.0.2,6,1,2,2,4,1,FALSE
eslint-config-hapi,3.0.2,4.0.0,7,5,154,78,232,11,FALSE
eslint-config-hapi,4.0.0,5.0.0,8,7,306,50,356,40,FALSE
eslint-config-hapi,5.0.0,6.0.0,9,6,105,10,115,14,FALSE
eslint-config-hapi,6.0.0,6.1.0,10,3,41,47,88,8,TRUE
eslint-config-hapi,6.1.0,6.1.1,11,2,52,3,55,4,FALSE
eslint-config-hapi,6.1.1,7.0.0,12,2,44,3,47,5,FALSE
eslint-config-hapi,7.0.0,8.0.0,13,2,65,4,69,6,FALSE
eslint-config-hapi,8.0.0,8.0.1,14,3,65,1,66,5,FALSE
eslint-config-hapi,8.0.1,9.0.0,15,2,15,16,31,7,FALSE
eslint-config-hapi,9.0.0,9.1.0,16,3,3,3,6,3,TRUE
eslint-config-hapi,9.1.0,10.0.0,17,6,348,260,608,24,FALSE
eslint-config-xo,0.1.0,0.2.0,1,5,11,9,20,5,FALSE
eslint-config-xo,0.2.0,0.2.1,2,2,3,2,5,2,TRUE
eslint-config-xo,0.2.1,0.3.0,3,2,4,3,7,3,TRUE
eslint-config-xo,0.3.0,0.3.1,4,2,2,2,4,2,FALSE
eslint-config-xo,0.3.1,0.4.0,5,7,14,11,25,9,FALSE
eslint-config-xo,0.4.0,0.5.0,6,6,66,25,91,10,FALSE
eslint-config-xo,0.5.0,0.6.0,7,7,32,49,81,13,FALSE
eslint-config-xo,0.6.0,0.7.0,8,14,30,24,54,15,FALSE
eslint-config-xo,0.7.0,0.7.1,9,2,1,11,12,2,FALSE
eslint-config-xo,0.7.1,0.8.0,10,3,7,5,12,5,FALSE
eslint-config-xo,0.8.0,0.9.0,11,5,25,33,58,6,FALSE
eslint-config-xo,0.9.0,0.9.1,12,2,1,2,3,2,FALSE
eslint-config-xo,0.9.1,0.9.2,13,4,5,4,9,4,FALSE
eslint-config-xo,0.9.2,0.10.0,14,3,35,19,54,7,FALSE
eslint-config-xo,0.10.0,0.10.1,15,1,0,1,1,1,TRUE
eslint-config-xo,0.10.1,0.11.0,16,5,48,50,98,9,FALSE
eslint-config-xo,0.11.0,0.12.0,17,3,7,5,12,4,FALSE
eslint-config-xo,0.12.0,0.13.0,18,7,10,12,22,9,FALSE
eslint-config-xo,0.13.0,0.14.0,19,10,15,34,49,14,FALSE
eslint-config-xo,0.14.0,0.14.1,20,2,3,2,5,2,FALSE
eslint-config-xo,0.14.1,0.15.0,21,14,85,24,109,16,FALSE
eslint-config-xo,0.15.0,0.15.1,22,1,187,187,374,2,FALSE
eslint-config-xo,0.15.1,0.15.2,23,2,3,2,5,2,TRUE
eslint-config-xo,0.15.2,0.15.3,24,4,17,13,30,10,FALSE
eslint-config-xo,0.15.3,0.15.4,25,7,11,10,21,9,FALSE
eslint-config-xo,0.15.4,0.16.0,26,8,38,46,84,13,FALSE
eslint-config-xo,0.16.0,0.17.0,27,2,2,2,4,2,FALSE
eslint-config-xo,0.17.0,0.18.0,28,20,76,44,120,29,FALSE
eslint-config-xo,0.18.0,0.18.1,29,2,5,4,9,2,TRUE
eslint-config-xo,0.18.1,0.18.2,30,2,1,2,3,2,FALSE
eslint-find-rules,1.0.0,1.1.0,1,2,13,1,14,3,TRUE
eslint-find-rules,1.1.0,1.2.0,2,4,201,38,239,20,TRUE
eslint-find-rules,1.2.0,1.3.0,3,4,32,7,39,7,FALSE
eslint-find-rules,1.3.0,1.4.0,4,4,93,4,97,6,FALSE
eslint-find-rules,1.4.0,1.5.0,5,3,188,72,260,7,TRUE
eslint-find-rules,1.5.0,1.6.0,6,1,12,4,16,2,TRUE
eslint-find-rules,1.6.0,1.7.0,7,2,174,10,184,7,FALSE
eslint-find-rules,1.7.0,1.8.0,8,3,25,2,27,4,FALSE
eslint-find-rules,1.8.0,1.9.0,9,3,31,3,34,6,FALSE
eslint-find-rules,1.9.0,1.9.1,10,1,2,3,5,1,TRUE
eslint-find-rules,1.9.1,1.9.2,11,1,1,1,2,1,TRUE
eslint-find-rules,1.9.2,1.10.0,12,11,117,51,168,17,FALSE
eslint-find-rules,1.10.0,1.11.0,13,12,12,12,24,12,FALSE
eslint-find-rules,1.11.0,1.11.1,14,6,14,10,24,7,FALSE
eslint-find-rules,1.11.1,1.12.0,15,1,42,11,53,3,FALSE
eslint-find-rules,1.12.0,1.13.0,16,4,21,6,27,6,TRUE
eslint-find-rules,1.13.0,1.13.1,17,3,40,25,65,5,FALSE
eslint-find-rules,1.13.1,1.13.2,18,7,29,7,36,9,FALSE
eslint-find-rules,1.13.2,1.14.0,19,1,1,1,2,1,FALSE
eslint-find-rules,1.14.0,1.14.1,20,1,15,4,19,2,FALSE
eslint-find-rules,1.14.1,1.14.2,21,3,45,12,57,3,TRUE
eslint-find-rules,1.14.2,1.14.3,22,2,4,2,6,2,FALSE
eslint-plugin-json,0.0.0,1.0.0,1,1,1,1,2,1,TRUE
eslint-plugin-json,1.0.0,1.0.1,2,2,9,2,11,2,TRUE
eslint-plugin-json,1.0.1,1.1.0,3,6,114,7,121,8,FALSE
eslint-plugin-json,1.1.0,1.2.0,4,4,6,3,9,4,FALSE
eslint-watch,0.0.0,1.0.0,1,4,345,34,379,21,FALSE
eslint-watch,1.0.0,1.0.2,2,4,3,3,6,4,TRUE
eslint-watch,1.0.2,1.0.3,3,3,121,108,229,11,TRUE
eslint-watch,1.0.3,1.0.4,4,2,23,16,39,6,TRUE
eslint-watch,1.0.4,1.0.5,5,6,112,34,146,19,FALSE
eslint-watch,1.0.5,1.1.0,6,10,295,99,394,43,TRUE
eslint-watch,1.1.0,1.1.1,7,2,66,32,98,11,TRUE
eslint-watch,1.1.1,1.2.0,8,11,416,170,586,42,FALSE
eslint-watch,1.2.0,1.2.1,9,2,4,4,8,2,TRUE
eslint-watch,1.2.1,1.2.2,10,5,33,25,58,9,FALSE
eslint-watch,1.2.2,1.2.3,11,6,20,9,29,6,FALSE
eslint-watch,1.2.3,1.2.4,12,4,19,21,40,9,FALSE
eslint-watch,1.2.4,1.2.5,13,19,505,326,831,55,FALSE
eslint-watch,1.2.5,1.2.6,14,50,1188,510,1698,103,FALSE
eslint-watch,1.2.6,2.0.0,15,13,767,273,1040,61,TRUE
eslint-watch,2.0.0,2.1.0,16,13,367,130,497,49,FALSE
eslint-watch,2.1.0,2.1.1,17,6,69,18,87,15,TRUE
eslint-watch,2.1.1,2.1.2,18,6,33,21,54,10,FALSE
eslint-watch,2.1.2,2.1.3,19,10,452,668,1120,46,FALSE
eslint-watch,2.1.3,2.1.4,20,9,176,89,265,18,FALSE
eslint-watch,2.1.4,2.1.5,21,14,486,240,726,40,FALSE
eslint-watch,2.1.5,2.1.6,22,10,208,141,349,30,FALSE
eslint-watch,2.1.6,2.1.7,23,3,39,5,44,5,FALSE
eslint-watch,2.1.7,2.1.8,24,16,696,136,832,40,FALSE
eslint-watch,2.1.8,2.1.9,25,3,89,31,120,11,FALSE
eslint-watch,2.1.9,2.1.10,26,6,69,19,88,12,FALSE
eslint-watch,2.1.10,2.1.11,27,3,54,12,66,6,FALSE
eslint-watch,2.1.11,2.1.12,28,2,130,80,210,16,FALSE
eslint-watch,2.1.12,2.1.13,29,2,4,3,7,3,FALSE
eslint-watch,2.1.13,2.1.14,30,3,6,6,12,4,FALSE
eslint-watch,2.1.14,3.0.0,31,17,626,628,1254,108,FALSE
eslint-watch,3.0.0,3.0.1,32,8,170,158,328,25,FALSE
eslint-watch,3.0.1,3.1.0,33,4,57,16,73,14,FALSE
esperanto,0.1.0,0.1.1,1,2,6,2,8,2,TRUE
esperanto,0.1.1,0.3.0,2,25,1283,420,1703,69,TRUE
esperanto,0.3.0,0.3.1,3,18,167476,177,167653,382,TRUE
esperanto,0.3.1,0.3.3,4,14,158,59,217,41,TRUE
esperanto,0.3.3,0.3.4,5,10,110,108,218,18,TRUE
esperanto,0.3.4,0.3.5,6,5,12,12,24,12,TRUE
esperanto,0.3.5,0.3.6,7,6,15,14,29,9,TRUE
esperanto,0.3.6,0.3.7,8,6,20,16,36,9,TRUE
esperanto,0.3.7,0.3.8,9,5,57,13,70,10,TRUE
esperanto,0.3.8,0.3.9,10,15,91,99,190,28,TRUE
esperanto,0.3.9,0.3.10,11,17,158,41,199,54,TRUE
esperanto,0.3.10,0.3.11,12,23,215060,24879,239939,409,FALSE
esperanto,0.3.11,0.3.12,13,5,24843,45,24888,13,FALSE
esperanto,0.3.12,0.4.0,14,8,13109,166601,179710,748,FALSE
esperanto,0.4.0,0.4.1,15,17,1109,586,1695,67,FALSE
esperanto,0.4.1,0.4.2,16,8,293,212,505,37,TRUE
esperanto,0.4.2,0.4.3,17,1,2,1,3,1,FALSE
esperanto,0.4.3,0.4.4,18,2,73,54,127,8,TRUE
esperanto,0.4.4,0.4.5,19,4,20,17,37,7,FALSE
esperanto,0.4.5,0.4.6,20,3,36,28,64,23,FALSE
esperanto,0.4.6,0.4.7,21,7,447,358,805,63,FALSE
esperanto,0.4.7,0.4.8,22,7,11830,11675,23505,305,FALSE
esperanto,0.4.8,0.4.9,23,3,545,110,655,47,FALSE
esperanto,0.4.9,0.4.10,24,8,52492,15842,68334,59,TRUE
esperanto,0.4.10,0.5.0,25,35,4556,3292,7848,413,FALSE
esperanto,0.5.0,0.5.1,26,2,64,8,72,9,TRUE
esperanto,0.5.1,0.5.2,27,6,417,87,504,44,TRUE
esperanto,0.5.2,0.5.3,28,5,750,57,807,80,TRUE
esperanto,0.5.3,0.5.5,29,5,4993,232811,237804,423,FALSE
esperanto,0.5.5,0.5.6,30,4,366,85,451,45,TRUE
esperanto,0.5.6,0.5.7,31,5,117,11,128,22,TRUE
esperanto,0.5.7,0.5.8,32,8,376,44,420,42,FALSE
esperanto,0.5.8,0.5.9,33,6,989,2927,3916,137,TRUE
esperanto,0.5.9,0.5.10,34,5,824,1372,2196,106,TRUE
esperanto,0.5.10,0.6.0,35,11,5130,6764,11894,927,FALSE
esperanto,0.6.0,0.6.1,36,15,4892,4437,9329,119,TRUE
esperanto,0.6.1,0.6.2,37,2,211,9,220,20,TRUE
esperanto,0.6.2,0.6.3,38,9,324,163,487,106,TRUE
esperanto,0.6.3,0.6.4,39,21,1896,2212,4108,662,FALSE
esperanto,0.6.4,0.6.5,40,14,2670,1462,4132,461,TRUE
esperanto,0.6.5,0.6.6,41,23,1081,265,1346,178,FALSE
esperanto,0.6.6,0.6.7,42,4,597,274,871,29,FALSE
esperanto,0.6.7,0.6.8,43,8,338,196,534,65,FALSE
esperanto,0.6.8,0.6.9,44,6,351,76,427,28,FALSE
esperanto,0.6.9,0.6.10,45,6,349,2617,2966,28,FALSE
esperanto,0.6.10,0.6.11,46,7,1259,139,1398,34,TRUE
esperanto,0.6.11,0.6.13,47,11,376,182,558,35,FALSE
esperanto,0.6.13,0.6.14,48,3,141,51,192,12,FALSE
esperanto,0.6.14,0.6.15,49,2,118,891,1009,14,FALSE
esperanto,0.6.15,0.6.16,50,10,1761,400,2161,89,FALSE
esperanto,0.6.16,0.6.17,51,3,377,260,637,25,FALSE
esperanto,0.6.17,0.6.18,52,6,275,161,436,30,FALSE
esperanto,0.6.18,0.6.20,53,2,450,311,761,15,TRUE
esperanto,0.6.20,0.6.21,54,9,1154,612,1766,55,TRUE
esperanto,0.6.21,0.6.22,55,2,36,5,41,8,TRUE
esperanto,0.6.22,0.6.23,56,12,893,431,1324,159,FALSE
esperanto,0.6.23,0.6.24,57,14,2040,2716,4756,179,FALSE
esperanto,0.6.24,0.6.25,58,7,614,51,665,49,FALSE
esperanto,0.6.25,0.6.26,59,2,55,3,58,13,TRUE
esperanto,0.6.26,0.6.27,60,7,2050,1442,3492,182,FALSE
esperanto,0.6.27,0.6.28,61,5,428,99,527,44,FALSE
esperanto,0.6.28,0.6.29,62,8,739,324,1063,27,FALSE
esperanto,0.6.29,0.6.30,63,2,501,35,536,21,FALSE
esperanto,0.6.30,0.6.31,64,20,748,281,1029,100,FALSE
esperanto,0.6.31,0.6.32,65,2,317,132,449,16,TRUE
esperanto,0.6.32,0.6.33,66,2,85,12,97,15,TRUE
esperanto,0.6.33,0.6.34,67,6,589,109,698,35,FALSE
esperanto,0.6.34,0.7.0,68,17,3090,2553,5643,127,FALSE
esperanto,0.7.0,0.7.1,69,7,276,176,452,22,FALSE
esperanto,0.7.1,0.7.2,70,7,130,20,150,28,FALSE
esperanto,0.7.2,0.7.3,71,3,5,23,28,12,FALSE
esperanto,0.7.3,0.7.4,72,5,162,153,315,27,FALSE
esperanto,0.7.4,0.7.5,73,15,723,17674,18397,92,FALSE
esperanto,0.7.5,0.7.6,74,1,8,4,12,3,FALSE
eventsource-polyfill,0.9.5,0.9.6,1,3,80,85,165,6,TRUE
figures,1.0.0,1.0.1,1,1,1,1,2,1,TRUE
figures,1.0.1,1.0.2,2,2,3,1,4,2,TRUE
figures,1.0.2,1.1.0,3,2,3,1,4,2,FALSE
figures,1.1.0,1.2.0,4,5,13,3,16,7,FALSE
figures,1.2.0,1.3.0,5,3,38,4,42,4,FALSE
figures,1.3.0,1.3.1,6,2,14,4,18,2,TRUE
figures,1.3.1,1.3.2,7,2,3,3,6,2,TRUE
figures,1.3.2,1.3.3,8,2,3,1,4,2,FALSE
figures,1.3.3,1.3.4,9,4,7,7,14,4,FALSE
figures,1.3.4,1.3.5,10,2,4,4,8,4,FALSE
figures,1.3.5,1.4.0,11,4,12,10,22,7,FALSE
figures,1.4.0,1.5.0,12,6,24,47,71,13,FALSE
figures,1.5.0,1.6.0,13,3,40,4,44,3,FALSE
figures,1.6.0,1.7.0,14,5,183,15,198,14,FALSE
figures,1.7.0,2.0.0,15,5,23,21,44,11,FALSE
flow-copy-source,1.0.0,1.0.1,1,2,7,3,10,3,TRUE
flow-copy-source,1.0.1,1.0.2,2,2,4,1,5,2,FALSE
flow-copy-source,1.0.2,1.1.0,3,3,17,9,26,7,FALSE
fs-promise,0.0.1,0.0.2,1,4,51,15,66,7,FALSE
fs-promise,0.0.2,0.1.0,2,1,2,2,4,1,FALSE
fs-promise,0.1.0,0.2.0,3,6,9,16,25,9,FALSE
fs-promise,0.2.0,0.3.0,4,2,42,12,54,5,FALSE
fs-promise,0.3.0,0.3.1,5,2,10,10,20,2,FALSE
fs-promise,0.3.1,0.4.0,6,2,35,15,50,3,FALSE
fs-promise,0.4.0,0.4.1,7,1,2,2,4,1,FALSE
fs-promise,0.4.1,0.5.0,8,6,668,284,952,24,FALSE
fs-promise,0.5.0,1.0.0,9,9,18,16,34,8,FALSE
fs-promise,1.0.0,2.0.0,10,9,131,98,229,15,FALSE
fs-promise,2.0.0,2.0.1,11,3,5,5,10,3,FALSE
fs-promise,2.0.1,2.0.2,12,3,27,3,30,5,FALSE
fs-promise,2.0.2,2.0.3,13,2,4,58,62,3,FALSE
graceful-fs,1.0.0,1.0.1,1,4,31,3,34,4,FALSE
graceful-fs,1.0.1,1.0.2,2,2,2,2,4,2,FALSE
graceful-fs,1.0.2,1.1.0,3,6,232,80,312,8,FALSE
graceful-fs,1.1.0,1.1.1,4,4,93,78,171,4,FALSE
graceful-fs,1.1.1,1.1.2,5,2,20,11,31,2,FALSE
graceful-fs,1.1.2,1.1.3,6,2,44,2,46,2,FALSE
graceful-fs,1.1.3,1.1.4,7,2,2,2,4,2,TRUE
graceful-fs,1.1.4,1.1.5,8,2,3,1,4,2,FALSE
graceful-fs,1.1.5,1.1.6,9,2,2,6,8,3,FALSE
graceful-fs,1.1.6,1.1.7,10,2,20,1,21,2,FALSE
graceful-fs,1.1.7,1.1.8,11,2,14,13,27,2,FALSE
graceful-fs,1.1.8,1.1.9,12,2,17,9,26,2,FALSE
graceful-fs,1.1.9,1.1.10,13,5,73,19,92,6,FALSE
graceful-fs,1.1.10,1.1.11,14,3,38,6,44,3,FALSE
graceful-fs,1.1.11,1.1.12,15,2,4,2,6,2,TRUE
graceful-fs,1.1.12,1.1.13,16,2,1,6,7,3,TRUE
graceful-fs,1.1.13,1.1.14,17,2,3,3,6,2,FALSE
graceful-fs,1.1.14,1.2.0,18,1,1,1,2,1,FALSE
graceful-fs,1.2.0,1.2.1,19,4,58,12,70,6,FALSE
graceful-fs,1.2.1,1.2.2,20,3,243,38,281,4,FALSE
graceful-fs,1.2.2,1.2.3,21,3,85,2,87,3,FALSE
graceful-fs,1.2.3,2.0.0,22,5,346,573,919,7,TRUE
graceful-fs,2.0.0,2.0.1,23,4,14,14,28,4,FALSE
graceful-fs,2.0.1,2.0.2,24,2,24,1,25,3,FALSE
graceful-fs,2.0.2,2.0.3,25,2,1,2,3,2,FALSE
graceful-fs,2.0.3,3.0.0,26,2,10,7,17,6,FALSE
graceful-fs,3.0.0,3.0.1,27,4,20,4,24,4,FALSE
graceful-fs,3.0.1,3.0.2,28,2,36,9,45,2,FALSE
graceful-fs,3.0.2,3.0.3,29,2,33,12,45,4,FALSE
graceful-fs,3.0.3,3.0.4,30,5,131,34,165,6,FALSE
graceful-fs,3.0.4,3.0.5,31,2,2,2,4,2,FALSE
graceful-fs,3.0.5,3.0.6,32,2,2,2,4,2,FALSE
graceful-fs,3.0.6,3.0.7,33,2,14,26,40,3,FALSE
graceful-fs,3.0.7,3.0.8,34,2,7,5,12,5,FALSE
graceful-fs,3.0.8,3.0.9,35,43,2104,1388,3492,89,FALSE
graceful-fs,3.0.9,3.0.10,36,2,5,5,10,2,FALSE
graceful-fs,3.0.10,3.0.11,37,1,1,1,2,1,FALSE
graceful-fs,4.1.0,4.1.1,39,5,158,45,203,7,TRUE
graceful-fs,4.1.1,4.1.2,40,2,8,2,10,2,TRUE
graceful-fs,4.1.2,4.1.3,41,5,34,5,39,6,FALSE
graceful-fs,4.1.3,4.1.4,42,3,86,7,93,3,FALSE
graceful-fs,4.1.4,4.1.5,43,5,95,19,114,5,FALSE
graceful-fs,4.1.5,4.1.6,44,2,5,5,10,2,FALSE
graceful-fs,4.1.6,4.1.7,45,2,64,1,65,3,FALSE
graceful-fs,4.1.7,4.1.8,46,2,10,1,11,3,TRUE
graceful-fs,4.1.8,4.1.9,47,6,141,18,159,7,FALSE
graceful-fs,4.1.9,4.1.10,48,2,16,4,20,2,FALSE
graceful-fs,4.1.10,4.1.11,49,2,46,3,49,3,FALSE
gray-matter,0.1.0,0.2.0,1,1,112,32,144,8,FALSE
gray-matter,0.2.0,0.2.1,2,1,63,30,93,8,TRUE
gray-matter,0.2.1,0.2.3,3,2,144,61,205,10,TRUE
gray-matter,0.2.3,0.2.4,4,1,32,3,35,4,FALSE
gray-matter,0.2.4,0.2.5,5,1,6,7,13,4,TRUE
gray-matter,0.2.5,0.2.6,6,1,145,22,167,5,TRUE
gray-matter,0.2.6,0.2.8,7,4,32,10,42,8,FALSE
gray-matter,0.2.8,0.3.1,8,15,408,142,550,37,FALSE
gray-matter,0.3.1,0.3.4,9,3,111,47,158,16,FALSE
gray-matter,0.3.4,0.3.5,10,1,2,2,4,1,FALSE
gray-matter,0.3.5,0.4.0,11,2,8,9,17,6,FALSE
gray-matter,0.4.0,0.4.1,12,1,53,48,101,10,FALSE
gray-matter,0.4.1,0.4.2,13,1,13,7,20,4,TRUE
gray-matter,0.4.2,0.5.0,14,2,916,778,1694,57,FALSE
gray-matter,0.5.0,0.5.1,15,2,523,259,782,18,FALSE
gray-matter,0.5.1,0.5.2,16,1,184,214,398,21,FALSE
gray-matter,0.5.2,0.5.3,17,1,2,2,4,1,TRUE
gray-matter,0.5.3,0.6.0,18,9,1832,1558,3390,83,FALSE
gray-matter,0.6.0,0.6.1,19,2,8,40,48,6,FALSE
gray-matter,0.6.1,0.6.2,20,1,51,0,51,2,FALSE
gray-matter,0.6.2,1.0.0,21,4,403,167,570,14,TRUE
gray-matter,1.0.0,1.0.1,22,1,2,2,4,2,TRUE
gray-matter,1.0.1,1.0.2,23,3,40,42,82,6,FALSE
gray-matter,1.0.2,1.1.0,24,14,387,618,1005,34,FALSE
gray-matter,1.1.0,1.1.1,25,3,25,6,31,4,TRUE
gray-matter,1.1.1,1.1.2,26,4,144,41,185,7,TRUE
gray-matter,1.1.2,1.2.0,27,14,1404,193,1597,34,FALSE
gray-matter,1.2.0,1.2.1,28,2,10,2,12,3,TRUE
gray-matter,1.2.1,1.2.2,29,3,63,32,95,13,TRUE
gray-matter,1.2.2,1.2.3,30,4,66,3,69,6,FALSE
gray-matter,1.2.3,1.2.4,31,2,19,3,22,4,FALSE
gray-matter,1.2.4,1.2.5,32,1,89,95,184,20,FALSE
gray-matter,1.2.5,1.2.6,33,3,48,49,97,20,FALSE
gray-matter,1.2.6,1.3.0,34,1,2,2,4,1,FALSE
gray-matter,1.3.0,2.0.0,35,9,63,40,103,18,FALSE
gray-matter,2.0.0,2.0.1,36,1,2,2,4,1,FALSE
gray-matter,2.0.1,2.0.2,37,13,457,270,727,32,FALSE
gray-matter,2.0.2,2.1.0,38,7,201,250,451,19,FALSE
gray-matter,2.1.0,2.1.1,39,6,62,18,80,8,FALSE
grunt-contrib-nodeunit,0.1.0,0.1.1,1,13,124,40,164,18,FALSE
grunt-contrib-nodeunit,0.1.1,0.1.2-rc5,2,31,479,145,624,74,FALSE
grunt-contrib-nodeunit,0.1.2,0.2.0,5,6,29,24,53,13,FALSE
grunt-contrib-nodeunit,0.2.0,0.2.1,6,3,43,14,57,8,FALSE
grunt-contrib-nodeunit,0.2.1,0.2.2,7,3,21,5,26,6,FALSE
grunt-contrib-nodeunit,0.2.2,0.3.0,8,11,239,55,294,24,FALSE
grunt-contrib-nodeunit,0.3.0,0.3.1,9,2,94,10,104,8,FALSE
grunt-contrib-nodeunit,0.3.1,0.3.2,10,3,105,5,110,8,FALSE
grunt-contrib-nodeunit,0.3.2,0.3.3,11,3,17,1,18,3,FALSE
grunt-contrib-nodeunit,0.3.3,0.4.0,12,7,52,14,66,13,FALSE
grunt-contrib-nodeunit,0.4.0,0.4.1,13,3,16,2,18,3,FALSE
grunt-contrib-nodeunit,0.4.1,1.0.0,14,35,321,210,531,66,FALSE
grunt-mocha-cov,0.0.1,0.0.2,1,4,919,30,949,30,TRUE
grunt-mocha-cov,0.0.2,0.0.3,2,1,15,2,17,2,TRUE
grunt-mocha-cov,0.0.3,0.0.4,3,4,94,8,102,8,FALSE
grunt-mocha-cov,0.0.4,0.0.5,4,3,40,19,59,5,FALSE
grunt-mocha-cov,0.0.5,0.0.6,5,2,58,4,62,6,TRUE
grunt-mocha-cov,0.0.6,0.0.7,6,2,320,197,517,11,FALSE
grunt-mocha-cov,0.0.7,0.1.0,7,10,267,261,528,14,FALSE
grunt-mocha-cov,0.1.0,0.1.1,8,2,40,5,45,5,FALSE
grunt-mocha-cov,0.1.1,0.2.0,9,6,753,357,1110,19,FALSE
grunt-mocha-cov,0.2.0,0.2.1,10,5,28,29,57,7,FALSE
grunt-mocha-cov,0.2.1,0.3.0,11,1,338,200,538,5,FALSE
grunt-mocha-cov,0.3.0,0.4.0,12,10,941,638,1579,30,FALSE
grunt,0.1.0,0.1.1,1,2,34,17,51,3,FALSE
grunt,0.1.1,0.1.2,2,2,10,5,15,3,TRUE
grunt,0.1.2,0.2.0,3,24,1389,409,1798,81,FALSE
grunt,0.2.0,0.2.1,4,3,132,87,219,16,TRUE
grunt,0.2.1,0.2.2,5,1,3,1,4,3,TRUE
grunt,0.2.2,0.2.3,6,4,49,37,86,16,TRUE
grunt,0.2.3,0.2.4,7,3,58,18,76,4,TRUE
grunt,0.2.4,0.2.5,8,16,11911,155,12066,36,FALSE
grunt,0.2.5,0.2.6,9,4,60,44,104,7,TRUE
grunt,0.2.6,0.2.7,10,2,5,9,14,2,TRUE
grunt,0.2.7,0.2.8,11,4,17,15,32,6,TRUE
grunt,0.2.8,0.2.9,12,5,32,13,45,6,TRUE
grunt,0.2.9,0.2.10,13,3,106,96,202,3,TRUE
grunt,0.2.10,0.2.11,14,3,22,16,38,6,TRUE
grunt,0.2.11,0.2.12,15,11,106,29,135,16,TRUE
grunt,0.2.12,0.2.13,16,4,94,2,96,4,TRUE
grunt,0.2.13,0.2.14,17,17,359,133,492,25,FALSE
grunt,0.2.14,0.2.15,18,62,1172,639,1811,97,FALSE
grunt,0.2.15,0.3.0,19,380,9273,5879,15152,770,FALSE
grunt,0.3.0,0.3.1,20,23,374,159,533,45,FALSE
grunt,0.3.1,0.3.2,21,6,688,523,1211,11,TRUE
grunt,0.3.2,0.3.3,22,8,183,21,204,9,TRUE
grunt,0.3.3,0.3.4,23,7,55,22,77,9,TRUE
grunt,0.3.4,0.3.5,24,18,121,77,198,29,FALSE
grunt,0.3.5,0.3.6,25,14,107,74,181,25,FALSE
grunt,0.3.6,0.3.7,26,8,179,27,206,17,FALSE
grunt,0.3.7,0.3.8,27,22,783,749,1532,77,FALSE
grunt,0.3.8,0.3.9,28,5,29,11,40,6,FALSE
grunt,0.3.9,0.3.10,29,1,4,3,7,2,FALSE
grunt,0.3.10,0.3.11,30,2,103,42,145,10,FALSE
grunt,0.3.11,0.3.12,31,159,4336,2150,6486,516,FALSE
grunt,0.3.12,0.3.13-a,32,34,1621,1156,2777,89,FALSE
grunt,0.3.13-a,0.3.13,33,1,3,3,6,1,TRUE
grunt,0.3.13,0.3.14,34,3,31,5,36,3,FALSE
grunt,0.3.14,0.3.15,35,9,374,877,1251,65,FALSE
grunt,0.3.15,0.3.16,36,42,1396,678,2074,187,FALSE
grunt,0.3.16,0.3.17,37,19,144,15293,15437,96,FALSE
grunt,0.3.17,0.4.0-a,38,60,1408,2000,3408,118,FALSE
grunt,0.4.0-a,0.4.0-rc1,39,6,120,599,719,14,FALSE
grunt,0.4.0-rc1,0.4.0-rc2,40,4,169,2437,2606,26,FALSE
grunt,0.4.0-rc2,0.4.0-rc3,41,10,43,241,284,19,FALSE
grunt,0.4.0-rc3,0.4.0-rc4,42,11,135,150,285,21,FALSE
grunt,0.4.0-rc4,0.4.0-rc5,43,23,854,504,1358,40,FALSE
grunt,0.4.0-rc5,0.4.0-rc6,44,2,4,4,8,2,FALSE
grunt,0.4.0-rc6,0.4.0-rc7,45,2,15,4,19,6,FALSE
grunt,0.4.0-rc7,0.4.0-rc8,46,3,5,7,12,5,FALSE
grunt,0.4.0-rc8,0.4.0,47,6,63,68,131,8,FALSE
grunt,0.4.0,0.4.1,48,17,369,118,487,41,FALSE
grunt,0.4.1,0.4.2,49,31,467,377,844,50,FALSE
grunt,0.4.2,0.4.3,50,25,413,659,1072,61,FALSE
grunt,0.4.3,0.4.4,51,2,23,8,31,4,FALSE
grunt,0.4.4,0.4.5,52,19,165,617,782,27,FALSE
grunt,0.4.5,1.0.0-rc1,53,87,620,399,1019,182,FALSE
grunt,1.0.0-rc1,1.0.0,54,23,162,498,660,63,FALSE
grunt,1.0.0,1.0.1,55,5,24,8,32,9,TRUE
gulp-cache,0.0.1,0.0.2,1,3,209,185,394,9,TRUE
gulp-cache,0.0.2,0.0.3,2,2,7,7,14,4,TRUE
gulp-cache,0.0.3,0.0.4,3,4,14,14,28,8,TRUE
gulp-cache,0.0.4,0.0.5,4,3,5,3,8,3,FALSE
gulp-cache,0.0.5,0.1.0,5,2,854,158,1012,12,TRUE
gulp-cache,0.1.0,0.1.1,6,2,3,3,6,2,TRUE
gulp-cache,0.1.1,0.1.2,7,5,187,21,208,11,FALSE
gulp-cache,0.1.2,0.1.3,8,3,145,35,180,5,FALSE
gulp-cache,0.1.3,0.1.4,9,6,53,24,77,7,FALSE
gulp-cache,0.1.4,0.1.5,10,1,11,5,16,1,TRUE
gulp-cache,0.1.5,0.1.6,11,3,23,3,26,3,TRUE
gulp-cache,0.1.6,0.1.8,12,4,146,38,184,6,FALSE
gulp-cache,0.1.8,0.1.9,13,4,66,119,185,8,TRUE
gulp-cache,0.1.9,0.1.10,14,3,33,20,53,4,FALSE
gulp-cache,0.1.10,0.1.11,15,1,14,4,18,3,TRUE
gulp-cache,0.1.11,0.2.0,16,4,7,7,14,5,FALSE
gulp-cache,0.2.0,0.2.1,17,1,3,3,6,1,FALSE
gulp-cache,0.2.1,0.2.2,18,3,57,14,71,4,FALSE
gulp-cache,0.2.2,0.2.3,19,4,16,2,18,8,FALSE
gulp-cache,0.2.3,0.2.4,20,1,1,1,2,1,TRUE
gulp-cache,0.2.4,0.2.5,21,12,89,67,156,18,FALSE
gulp-cache,0.2.5,0.2.6,22,9,408,672,1080,22,FALSE
gulp-cache,0.2.6,0.2.7,23,3,69,89,158,7,FALSE
gulp-cache,0.2.7,0.2.8,24,4,149,67,216,5,FALSE
gulp-cache,0.2.8,0.2.9,25,7,884,893,1777,16,FALSE
gulp-cache,0.2.9,0.2.10,26,3,15,43,58,4,FALSE
gulp-cache,0.2.10,0.3.0,27,4,61,56,117,5,FALSE
gulp-cache,0.3.0,0.4.0,28,6,24,24,48,8,FALSE
gulp-cache,0.4.0,0.4.1,29,3,31,32,63,3,FALSE
gulp-cache,0.4.1,0.4.2,30,3,9,10,19,4,FALSE
gulp-cache,0.4.2,0.4.3,31,5,23,19,42,9,FALSE
gulp-cache,0.4.3,0.4.4,32,3,125,7,132,7,FALSE
gulp-cache,0.4.4,0.4.5,33,4,152,10,162,7,FALSE
gulp-cache,0.4.5,0.4.6,34,2,2,2,4,2,FALSE
gulp-coffeelint,0.0.1,0.0.2,1,6,15,75,90,13,TRUE
gulp-coffeelint,0.0.2,0.1.0,2,13,242,63,305,24,FALSE
gulp-coffeelint,0.1.0,0.1.1,3,7,103,23,126,8,FALSE
gulp-coffeelint,0.1.1,0.1.2,4,5,37,20,57,7,FALSE
gulp-coffeelint,0.1.2,0.2.0,5,12,882,278,1160,27,FALSE
gulp-coffeelint,0.2.0,0.2.1,6,5,41,26,67,14,FALSE
gulp-coffeelint,0.2.1,0.2.2,7,3,20,15,35,4,FALSE
gulp-coffeelint,0.2.2,0.3.0,8,5,233,57,290,11,FALSE
gulp-coffeelint,0.3.0,0.3.1,9,2,11,1,12,3,TRUE
gulp-coffeelint,0.3.1,0.3.2,10,6,64,12,76,8,FALSE
gulp-coffeelint,0.3.2,0.3.3,11,4,35,12,47,6,FALSE
gulp-coffeelint,0.3.3,0.3.4,12,5,47,41,88,7,FALSE
gulp-coffeelint,0.3.4,0.4.0,13,8,485,57,542,17,FALSE
gulp-coffeelint,0.4.0,0.5.0,14,14,1407,236,1643,30,FALSE
gulp-coffeelint,0.5.0,0.6.0,15,24,38,38,76,26,FALSE
gulp-csso,0.1.0,0.1.1,1,4,6,4,10,4,FALSE
gulp-csso,0.1.1,0.1.2,2,4,39,6,45,5,FALSE
gulp-csso,0.1.2,0.1.3,3,2,43,23,66,3,FALSE
gulp-csso,0.1.3,0.1.4,4,2,3,3,6,3,TRUE
gulp-csso,0.1.4,0.1.5,5,2,35,10,45,4,FALSE
gulp-csso,0.1.5,0.1.6,6,4,37,8,45,5,TRUE
gulp-csso,0.1.6,0.1.7,7,2,3,4,7,4,FALSE
gulp-csso,0.1.7,0.1.8,8,2,2,2,4,2,FALSE
gulp-csso,0.1.8,0.2.0,9,2,116,10,126,4,FALSE
gulp-csso,0.2.0,0.2.1,10,2,1,13,14,2,TRUE
gulp-csso,0.2.1,0.2.2,11,2,8,9,17,3,FALSE
gulp-csso,0.2.2,0.2.3,12,4,16,6,22,4,FALSE
gulp-csso,0.2.3,0.2.4,13,3,3,3,6,3,FALSE
gulp-csso,0.2.4,0.2.5,14,2,2,2,4,2,FALSE
gulp-csso,0.2.5,0.2.6,15,2,7,7,14,2,FALSE
gulp-csso,0.2.6,0.2.7,16,2,2,2,4,2,FALSE
gulp-csso,0.2.7,0.2.8,17,2,5,9,14,3,FALSE
gulp-csso,0.2.8,0.2.9,18,2,2,2,4,2,FALSE
gulp-csso,0.2.9,1.0.0,19,6,43,82,125,10,FALSE
gulp-csso,1.0.0,1.0.1,20,5,100,119,219,16,FALSE
gulp-csso,1.0.1,1.1.0,21,6,388,37,425,15,FALSE
gulp-csso,1.1.0,2.0.0,22,3,15,13,28,6,FALSE
gulp-csso,2.0.0,3.0.0,23,5,9,5,14,6,FALSE
gulp-mocha,0.1.0,0.1.1,1,4,29,17,46,6,FALSE
gulp-mocha,0.1.1,0.1.2,2,2,6,1,7,2,FALSE
gulp-mocha,0.1.2,0.1.3,3,6,8,5,13,6,FALSE
gulp-mocha,0.1.3,0.2.0,4,4,30,23,53,7,TRUE
gulp-mocha,0.2.0,0.3.0,5,4,113,81,194,6,FALSE
gulp-mocha,0.3.0,0.4.0,6,3,100,96,196,9,FALSE
gulp-mocha,0.4.0,0.4.1,7,5,26,7,33,5,FALSE
gulp-mocha,0.4.1,0.5.0,8,12,151,39,190,15,FALSE
gulp-mocha,0.5.0,0.5.1,9,2,1,3,4,2,FALSE
gulp-mocha,0.5.1,0.5.2,10,2,1,3,4,2,FALSE
gulp-mocha,0.5.2,1.0.0,11,2,16,14,30,3,FALSE
gulp-mocha,1.0.0,1.1.0,12,8,126,135,261,19,FALSE
gulp-mocha,1.1.0,1.1.1,13,5,93,26,119,10,FALSE
gulp-mocha,1.1.1,1.1.2,14,7,7,7,14,7,FALSE
gulp-mocha,1.1.2,2.0.0,15,2,2,2,4,2,TRUE
gulp-mocha,2.0.0,2.0.1,16,14,73,54,127,15,FALSE
gulp-mocha,2.0.1,2.1.0,17,6,42,26,68,18,FALSE
gulp-mocha,2.1.0,2.1.1,18,2,2,2,4,2,FALSE
gulp-mocha,2.1.1,2.1.2,19,3,8,8,16,4,FALSE
gulp-mocha,2.1.2,2.1.3,20,6,105,36,141,8,FALSE
gulp-mocha,2.1.3,2.2.0,21,4,8,3,11,4,FALSE
gulp-mocha,2.2.0,3.0.0,22,9,62,68,130,16,FALSE
gulp-mocha,3.0.0,3.0.1,23,2,7,1,8,2,FALSE
gulp-mocha,3.0.1,4.0.0,24,3,263,406,669,23,FALSE
gulp-mocha,4.0.0,4.0.1,25,3,10,6,16,4,TRUE
gulp-mocha,4.0.1,4.1.0,26,5,34,21,55,7,FALSE
gulp-mocha,4.1.0,4.2.0,27,3,5,3,8,3,FALSE
gulp-mocha,4.2.0,4.3.0,28,2,7,2,9,2,FALSE
gulp-mocha,4.3.0,4.3.1,29,5,132,103,235,16,FALSE
gulp-postcss,0.0.1,0.0.2,1,3,198,29,227,10,TRUE
gulp-postcss,0.0.2,1.0.0,2,1,1,1,2,1,TRUE
gulp-postcss,1.0.0,1.0.1,3,1,21,4,25,4,TRUE
gulp-postcss,1.0.1,1.0.2,4,3,36,34,70,4,TRUE
gulp-postcss,1.0.2,2.0.0,5,9,87,24,111,16,FALSE
gulp-postcss,2.0.0,2.0.1,6,7,121,23,144,13,FALSE
gulp-postcss,2.0.1,3.0.0,7,2,8,5,13,4,TRUE
gulp-postcss,3.0.0,4.0.0,8,3,7,12,19,4,FALSE
gulp-postcss,4.0.0,4.0.1,9,1,8,2,10,2,FALSE
gulp-postcss,4.0.1,4.0.2,10,3,12,8,20,4,FALSE
gulp-postcss,4.0.2,4.0.3,11,3,75,5,80,7,FALSE
gulp-postcss,4.0.3,5.0.0,12,7,129,78,207,15,FALSE
gulp-postcss,5.0.0,5.0.1,13,3,28,6,34,8,FALSE
gulp-postcss,5.0.1,5.1.0,14,9,280,18,298,19,FALSE
gulp-postcss,5.1.0,5.1.1,15,4,70,13,83,7,FALSE
gulp-postcss,5.1.1,5.1.2,16,1,7,4,11,2,FALSE
gulp-postcss,5.1.2,5.1.3,17,1,5,4,9,2,TRUE
gulp-postcss,5.1.3,5.1.4,18,5,19,27,46,10,FALSE
gulp-postcss,5.1.4,5.1.5,19,1,2,2,4,1,FALSE
gulp-postcss,5.1.5,5.1.6,20,1,6,4,10,4,FALSE
gulp-postcss,5.1.6,5.1.7,21,2,8,5,13,3,FALSE
gulp-postcss,5.1.7,5.1.8,22,2,18,4,22,6,FALSE
gulp-postcss,5.1.8,5.1.9,23,5,16,5,21,6,FALSE
gulp-postcss,5.1.9,5.1.10,24,2,9,4,13,3,FALSE
gulp-postcss,5.1.10,6.0.0,25,2,12,6,18,6,FALSE
gulp-postcss,6.0.0,6.0.1,26,3,116,1,117,6,FALSE
gulp-postcss,6.0.1,6.1.0,27,6,53,9,62,8,FALSE
gulp-postcss,6.1.0,6.1.1,28,7,82,32,114,10,FALSE
gulp-postcss,6.1.1,6.2.0,29,3,10,7,17,8,FALSE
gulp-postcss,6.2.0,6.3.0,30,17,804,209,1013,36,FALSE
gulp-postcss,6.3.0,6.4.0,31,5,388,79,467,11,FALSE
gulp-postcss,6.4.0,7.0.0,32,9,130,55,185,18,FALSE
hiredis,0.1.6,0.1.8,7,7,29,15,44,8,FALSE
hiredis,0.1.8,0.1.9,8,2,9,3,12,3,FALSE
hiredis,0.1.9,0.1.10,9,5,84,75,159,7,FALSE
hiredis,0.1.10,0.1.12,10,5,18,27,45,9,FALSE
hiredis,0.1.12,0.1.13,11,2,8,3,11,2,FALSE
hiredis,0.1.13,0.1.14,12,3,29,2,31,3,FALSE
hiredis,0.1.14,0.1.15,13,32,354,165,519,52,FALSE
hiredis,0.1.15,0.1.16,14,14,147,83,230,20,FALSE
hiredis,0.1.16,0.1.17,15,17,119,88,207,25,FALSE
hiredis,0.1.17,0.2.0,16,13,105,41,146,17,FALSE
hiredis,0.2.0,0.3.0,17,9,78,20,98,18,FALSE
hiredis,0.3.0,0.4.0,18,7,14,20,34,8,FALSE
hiredis,0.4.0,0.4.1,19,5,147,141,288,14,FALSE
hiredis,0.4.1,0.5.0,20,28,79,57,136,31,FALSE
history,0.1.0,1.0.0,1,120,18734,15447,34181,577,FALSE
history,1.0.0,1.1.0,2,16,69,60,129,22,FALSE
history,1.1.0,1.2.0,3,18,747,458,1205,48,FALSE
history,1.2.0,1.2.1,4,4,23,25,48,8,TRUE
history,1.2.1,1.2.2,5,3,20,32,52,7,TRUE
history,1.2.2,1.3.0,6,3,919,151,1070,14,TRUE
history,1.3.0,1.3.1,7,3,8,5,13,5,TRUE
history,1.3.1,1.3.2,8,2,11,19,30,4,TRUE
history,1.3.2,1.3.3,9,2,7,1,8,2,TRUE
history,1.3.3,1.4.0,10,7,189,143,332,11,FALSE
history,1.4.0,1.4.1,11,25,410,323,733,49,FALSE
history,1.4.1,1.5.0,12,4,38,47,85,7,TRUE
history,1.5.0,1.6.0,13,5,153,79,232,12,TRUE
history,1.6.0,1.7.0,14,4,494,217,711,15,TRUE
history,1.7.0,1.8.0,15,2,243,145,388,13,TRUE
history,1.8.0,1.8.1,16,4,30,25,55,6,FALSE
history,1.8.1,1.8.2,17,3,149,10,159,10,FALSE
history,1.8.2,1.8.3,18,2,1,2,3,2,TRUE
history,1.8.3,1.8.4,19,2,9,9,18,7,TRUE
history,1.8.4,1.8.5,20,11,1030,997,2027,75,FALSE
history,1.8.5,1.9.0,21,9,64,2205,2269,17,FALSE
history,1.9.0,1.9.1,22,6,45,19,64,21,FALSE
history,1.9.1,1.10.0,23,7,149,8,157,12,FALSE
history,1.10.0,1.10.1,24,2,2,1,3,2,TRUE
history,1.10.1,1.10.2,25,5,36,26,62,8,FALSE
history,1.10.2,1.11.0,26,11,211,111,322,21,TRUE
history,1.11.0,1.11.1,27,12,64,63,127,15,FALSE
history,1.11.1,1.12.0,28,8,190,56,246,26,FALSE
history,1.12.0,1.12.1,29,11,126,156,282,20,TRUE
history,1.12.1,1.12.2,30,6,174,112,286,10,TRUE
history,1.12.2,1.12.3,31,12,343,40,383,27,FALSE
history,1.12.3,1.12.4,32,8,50,19,69,14,FALSE
history,1.12.4,1.12.5,33,8,206,146,352,17,FALSE
history,1.12.5,1.12.6,34,16,97,33,130,25,FALSE
history,1.12.6,1.13.0,35,16,91,59,150,20,FALSE
history,1.13.0,1.13.1,36,47,1861,838,2699,131,FALSE
history,1.13.1,1.14.0,37,34,1714,518,2232,136,FALSE
history,1.14.0,1.15.0,38,12,257,76,333,24,FALSE
history,1.15.0,1.16.0,39,7,108,37,145,15,FALSE
history,1.16.0,1.17.0,40,10,97,59,156,19,FALSE
history,1.17.0,2.0.0-rc1,41,5,38,8,46,6,FALSE
history,2.0.0-rc1,2.0.0-rc2,42,4,106,33,139,10,FALSE
history,2.0.0-rc2,2.0.0-rc3,43,21,332,71,403,35,FALSE
history,2.0.0-rc3,2.0.0,44,9,91,42,133,22,TRUE
history,2.0.0,2.0.1,45,17,311,318,629,43,FALSE
history,2.0.1,2.0.2,46,37,1744,2327,4071,174,FALSE
history,2.0.2,2.1.0,47,1,1237,1154,2391,50,FALSE
history,2.1.0,2.1.1,48,14,247,152,399,26,FALSE
history,2.1.1,2.1.2,49,20,120,91,211,31,FALSE
history,3.0.0-0,3.0.0-1,51,19,124,179,303,28,FALSE
history,3.0.0-1,3.0.0-2,52,3,11,3,14,3,TRUE
history,3.0.0-2,3.0.0,53,31,364,161,525,55,FALSE
history,3.0.0,3.1.0,54,61,1049,674,1723,99,FALSE
history,3.1.0,3.2.0,55,3,6,3,9,3,TRUE
history,3.2.0,3.2.1,56,3,71,57,128,3,TRUE
history,3.2.1,3.3.0,57,119,4711,5415,10126,365,FALSE
history,4.0.0-0,4.0.0-1,59,13,393,151,544,42,FALSE
history,4.0.0-1,4.0.0-2,60,16,437,349,786,51,FALSE
history,4.0.0-2,4.0.0,61,12,272,67,339,26,TRUE
history,4.0.0,4.0.1,62,4,4,4,8,4,FALSE
history,4.0.1,4.1.0,63,5,68,4,72,12,FALSE
history,4.1.0,4.2.0,64,4,38,17,55,8,TRUE
history,4.2.0,4.2.1,65,6,145,17,162,8,FALSE
history,4.2.1,4.3.0,66,6,106,24,130,21,TRUE
history,4.3.0,4.4.0,67,6,16,36,52,7,FALSE
history,4.4.0,4.4.1,68,4,25,7,32,6,FALSE
history,4.4.1,4.5.0,69,5,138,12,150,9,FALSE
history,4.5.0,4.5.1,70,4,19,9,28,5,FALSE
history,4.5.1,4.6.0,71,24,4548,184,4732,60,FALSE
history,4.6.0,4.6.1,72,3,86,28,114,8,FALSE
hubot,1.0.0,1.0.2,1,7,13,64,77,14,TRUE
hubot,1.0.2,1.0.3,2,23,338,83,421,41,TRUE
hubot,1.0.3,1.0.4,3,17,504,32,536,34,TRUE
hubot,1.0.4,1.0.5,4,1,9,7,16,4,TRUE
hubot,1.0.5,1.0.6,5,3,6,4,10,4,TRUE
hubot,1.0.6,1.1.0,6,81,2316,738,3054,222,FALSE
hubot,1.1.0,1.1.1,7,3,14,9,23,6,TRUE
hubot,1.1.1,1.1.2,8,1,7,2,9,3,TRUE
hubot,1.1.2,1.1.3,9,2,9,6,15,3,TRUE
hubot,1.1.3,1.1.4,10,9,2402,461,2863,80,TRUE
hubot,1.1.4,1.1.5,11,23,642,209,851,33,FALSE
hubot,1.1.5,1.1.6,12,2,5,5,10,4,TRUE
hubot,1.1.6,1.1.7,13,24,387,172,559,36,FALSE
hubot,1.1.7,1.1.8,14,8,117,84,201,12,TRUE
hubot,1.1.8,1.1.9,15,3,766,61,827,21,TRUE
hubot,1.1.9,1.1.10,16,17,160,165,325,19,FALSE
hubot,1.1.10,1.1.11,17,31,757,428,1185,73,FALSE
hubot,1.1.11,2.0.2,18,83,2571,1615,4186,278,FALSE
hubot,2.0.2,2.0.4,19,3,7,7,14,6,TRUE
hubot,2.0.4,2.0.5,20,10,58,439,497,17,FALSE
hubot,2.0.5,2.0.6,21,9,159,119,278,11,FALSE
hubot,2.0.6,2.0.7,22,6,56,13,69,8,FALSE
hubot,2.0.7,2.1.0,23,17,150,813,963,30,FALSE
hubot,2.1.0,2.1.1,24,1,11,8,19,4,TRUE
hubot,2.1.1,2.1.2,25,4,21,12,33,7,TRUE
hubot,2.1.2,2.1.3,26,31,485,141,626,63,FALSE
hubot,2.1.3,2.1.4,27,26,137,91,228,33,FALSE
hubot,2.1.4,2.2.0,28,30,101,88,189,39,FALSE
hubot,2.2.0,2.2.1,29,16,82,74,156,34,FALSE
hubot,2.2.1,2.3.0,30,33,959,798,1757,93,FALSE
hubot,2.3.0,2.3.2,31,10,177,21,198,15,FALSE
hubot,2.3.2,2.3.3,32,28,222,93,315,30,FALSE
hubot,2.3.3,2.3.4,33,4,14,5,19,5,FALSE
hubot,2.3.4,2.3.5,34,14,37,21,58,17,FALSE
hubot,2.3.5,2.4.0,35,3,19,11,30,6,TRUE
hubot,2.4.0,2.4.1,36,2,2,2,4,2,TRUE
hubot,2.4.1,2.4.2,37,53,719,791,1510,86,FALSE
hubot,2.4.2,2.4.4,38,10,26,29,55,13,FALSE
hubot,2.4.4,2.4.5,39,1,14,0,14,1,TRUE
hubot,2.4.5,2.4.6,40,16,180,104,284,37,FALSE
hubot,2.4.6,2.4.7,41,19,241,55,296,28,FALSE
hubot,2.4.7,2.4.8,42,35,1595,1370,2965,87,FALSE
hubot,2.4.8,2.5.0,43,77,1190,700,1890,101,FALSE
hubot,2.5.0,2.5.1,44,45,351,149,500,57,FALSE
hubot,2.5.1,2.5.2,45,10,31,14,45,14,FALSE
hubot,2.5.2,2.5.3,46,9,63,24,87,14,FALSE
hubot,2.5.3,2.5.4,47,6,89,15,104,8,FALSE
hubot,2.5.4,2.5.5,48,6,18,7,25,7,FALSE
hubot,2.5.5,2.6.0,49,39,1084,307,1391,64,FALSE
hubot,2.6.0,2.6.1,50,23,1199,433,1632,47,FALSE
hubot,2.6.1,2.6.2,51,18,124,29,153,24,FALSE
hubot,2.6.2,2.6.3,52,32,324,72,396,41,FALSE
hubot,2.6.3,2.6.4,53,24,171,54,225,24,FALSE
hubot,2.6.4,2.6.5,54,10,17,11,28,11,FALSE
hubot,2.6.5,2.7.0,55,13,211,69,280,16,FALSE
hubot,2.7.0,2.7.1,56,4,14,6,20,6,TRUE
hubot,2.7.1,2.7.2,57,34,107,44,151,44,FALSE
hubot,2.7.2,2.7.3,58,12,56,10,66,13,FALSE
hubot,2.7.3,2.7.4,59,12,34,10,44,12,FALSE
hubot,2.7.4,2.7.5,60,4,16,6,22,6,TRUE
hubot,2.7.5,2.8.0,61,26,287,100,387,38,FALSE
hubot,2.8.0,2.8.1,62,15,38,255,293,20,FALSE
hubot,2.8.1,2.8.2-beta1,63,26,126,985,1111,49,FALSE
hubot,2.8.2-beta1,2.8.2,64,1,1,3,4,2,TRUE
hubot,2.8.2,2.8.3-beta,65,8,228,174,402,35,FALSE
hubot,2.8.3-beta,2.8.3,66,5,28,7,35,8,TRUE
hubot,2.8.3,2.9.0,67,7,74,903,977,39,FALSE
hubot,2.9.0,2.9.3,68,34,378,173,551,44,FALSE
hubot,2.9.3,2.10.0,69,60,515,274,789,74,FALSE
hubot,2.10.0,2.11.0,70,24,791,1238,2029,84,FALSE
hubot,2.11.0,2.11.1,71,38,706,463,1169,56,FALSE
hubot,2.11.1,2.11.2,72,19,1504,632,2136,57,FALSE
hubot,2.11.2,2.11.3,73,41,607,263,870,96,FALSE
hubot,2.11.3,2.11.4,74,5,15,3,18,7,TRUE
hubot,2.11.4,2.12.0,75,46,1492,681,2173,81,FALSE
hubot,2.12.0,2.13.0,76,57,3894,1173,5067,127,FALSE
hubot,2.13.0,2.13.1,77,12,263,44,307,26,FALSE
hubot,2.13.1,2.13.2,78,14,269,225,494,20,FALSE
hubot,2.13.2,2.14.0-beta1,79,1,14,0,14,1,TRUE
hubot,2.14.0-beta1,2.14.0,80,47,1752,372,2124,81,FALSE
hubot,2.14.0,2.15.0,81,21,1549,197,1746,57,FALSE
hubot,2.15.0,2.16.0,82,21,3159,595,3754,83,FALSE
hubot,2.16.0,2.17.0,83,68,3992,775,4767,150,FALSE
hubot,2.17.0,2.18.0,84,42,2690,384,3074,79,FALSE
hubot,2.18.0,2.19.0,85,27,353,88,441,45,FALSE
imagemin,0.1.0,0.1.1,1,1,75,82,157,8,TRUE
imagemin,0.1.1,0.1.2,2,1,75,82,157,8,FALSE
imagemin,0.1.2,0.1.3,3,1,75,82,157,8,FALSE
imagemin,0.1.3,0.2.4,4,119,3124,1788,4912,228,FALSE
imagemin,0.4.5,0.4.6,6,2,30,18,48,4,FALSE
imagemin,0.4.6,0.4.7,7,9,247,14,261,11,FALSE
imagemin,0.4.7,0.4.8,8,2,1,5,6,2,FALSE
imagemin,0.4.8,0.4.9,9,3,28,18,46,5,TRUE
imagemin,0.4.9,1.0.0,10,3,11,15,26,5,FALSE
imagemin,1.0.0,1.0.1,11,6,125,103,228,9,FALSE
imagemin,1.0.1,1.0.2,12,4,49,17,66,5,TRUE
imagemin,1.0.2,1.0.3,13,6,454,344,798,16,FALSE
imagemin,1.0.3,1.0.4,14,7,16,16,32,9,FALSE
imagemin,1.0.4,1.0.5,15,4,13,10,23,4,FALSE
imagemin,1.0.5,2.0.0,16,5,131,270,401,14,FALSE
imagemin,2.0.0,2.0.1,17,12,104,66,170,13,FALSE
imagemin,2.0.1,2.1.0,18,7,60,81,141,8,FALSE
imagemin,2.1.0,2.1.1,19,3,10,7,17,4,TRUE
imagemin,2.1.1,2.1.2,20,1,75,82,157,8,TRUE
imagemin,2.1.2,2.2.0,21,6,38,19,57,8,FALSE
imagemin,2.2.0,2.2.1,22,2,10,1,11,2,FALSE
imagemin,2.2.1,3.0.0,23,6,23,22,45,6,FALSE
imagemin,3.0.0,3.1.0,24,4,37,3,40,6,FALSE
imagemin,3.1.0,3.2.0,25,23,224,317,541,46,FALSE
imagemin,3.2.0,3.2.1,26,13,51,193,244,20,FALSE
imagemin,3.2.1,3.2.2,27,1,3,3,6,2,FALSE
imagemin,3.2.2,4.0.0,28,2,2,2,4,2,FALSE
imagemin,4.0.0,5.0.0,29,9,231,756,987,26,FALSE
imagemin,5.0.0,5.0.1,30,2,36,1,37,3,FALSE
imagemin,5.0.1,5.0.2,31,2,4,20,24,2,TRUE
imagemin,5.0.2,5.1.0,32,3,14,13,27,6,FALSE
imagemin,5.1.0,5.1.1,33,2,4,2,6,2,FALSE
imagemin,5.1.1,5.1.2,34,2,2,2,4,2,FALSE
imagemin,5.1.2,5.1.3,35,2,23,2,25,4,FALSE
imagemin,5.1.3,5.2.0,36,3,20,6,26,5,FALSE
imagemin,5.2.0,5.2.1,37,2,3,3,6,2,FALSE
imagemin,5.2.1,5.2.2,38,4,6,5,11,4,FALSE
imagemin,5.2.2,5.3.0,39,5,43,40,83,10,FALSE
imagemin,5.3.0,5.3.1,40,2,22,7,29,4,TRUE
indent-string,0.1.0,0.1.1,1,3,3,3,6,3,TRUE
indent-string,0.1.1,0.1.2,2,3,6,2,8,3,TRUE
indent-string,0.1.2,0.1.3,3,3,4,4,8,4,TRUE
indent-string,0.1.3,1.0.0,4,2,6,1,7,2,FALSE
indent-string,1.0.0,1.1.0,5,3,28,23,51,6,FALSE
indent-string,1.1.0,1.2.0,6,4,10,6,16,6,FALSE
indent-string,1.2.0,1.2.1,7,3,5,2,7,3,FALSE
indent-string,1.2.1,1.2.2,8,4,20,5,25,6,FALSE
indent-string,1.2.2,2.0.0,9,2,15,92,107,7,FALSE
indent-string,2.0.0,2.1.0,10,2,2,2,4,2,FALSE
indent-string,2.1.0,3.0.0,11,4,79,68,147,14,FALSE
indent-string,3.0.0,3.1.0,12,2,3,12,15,4,FALSE
inversify,0.0.1,0.0.2,1,1,1720,1821,3541,82,TRUE
inversify,0.0.2,0.0.4,2,1,2,3,5,2,TRUE
inversify,0.0.4,0.0.5,3,1,2,11,13,2,TRUE
inversify,0.0.5,0.0.6,4,1,2,2,4,2,TRUE
inversify,0.0.6,0.0.7,5,2,162,89,251,9,TRUE
inversify,0.0.7,1.0.0,6,25,1100,284,1384,49,TRUE
inversify,1.0.0,1.0.1,7,20,1006,444,1450,61,FALSE
inversify,1.0.1,1.0.2,8,2,35,41,76,6,TRUE
inversify,1.0.2,1.0.3,9,1,34,9,43,3,TRUE
inversify,1.0.3,1.2.0,10,27,1057,363,1420,62,FALSE
inversify,1.2.0,1.2.1,11,133,1894,3618,5512,192,FALSE
inversify,1.2.1,1.2.2,12,5,311,183,494,19,TRUE
inversify,1.2.2,1.3.0,13,8,1267,2237,3504,79,FALSE
inversify,1.3.0,1.3.1,14,1,1,1,2,1,TRUE
inversify,1.3.1,2.0.0-alpha.0,15,9,6261,1769,8030,178,FALSE
inversify,2.0.0-alpha.0,2.0.0-alpha.1,16,7,1319,684,2003,92,FALSE
inversify,2.0.0-alpha.1,2.0.0-alpha.2,17,9,1640,258,1898,86,FALSE
inversify,2.0.0-alpha.2,2.0.0-alpha.3,18,16,15151,2205,17356,142,FALSE
inversify,2.0.0-alpha.3,2.0.0-alpha.4,19,42,2095,5585,7680,136,FALSE
inversify,2.0.0-alpha.4,2.0.0-alpha.5,20,6,183,152,335,37,TRUE
inversify,2.0.0-alpha.5,2.0.0-alpha.6,21,2,15,6,21,5,TRUE
inversify,2.0.0-alpha.6,2.0.0-alpha.8,22,34,6686,2210,8896,343,FALSE
inversify,2.0.0-alpha.8,2.0.0-beta.1,23,25,2850,653,3503,101,FALSE
inversify,2.0.0-beta.1,2.0.0-beta.2,24,21,1046,55,1101,48,FALSE
inversify,2.0.0-beta.2,2.0.0-beta.3,25,3,928,138,1066,33,FALSE
inversify,2.0.0-beta.3,2.0.0-beta.4,26,14,301,87,388,38,FALSE
inversify,2.0.0-beta.4,2.0.0-beta.5,27,6,41,1915,1956,13,FALSE
inversify,2.0.0-beta.5,2.0.0-beta.6,28,5,196,12,208,13,FALSE
inversify,2.0.0-beta.6,2.0.0-beta.7,29,15,758,324,1082,31,FALSE
inversify,2.0.0-beta.7,2.0.0-beta.8,30,6,7,13,20,6,TRUE
inversify,2.0.0-beta.8,2.0.0-beta.9,31,17,4891,4321,9212,206,FALSE
inversify,2.0.0-beta.9,2.0.0-beta.10,32,1,5,4,9,3,TRUE
inversify,2.0.0-beta.10,2.0.0-rc.1,33,13,71,29,100,21,FALSE
inversify,2.0.0-rc.1,2.0.0-rc.5,34,56,1655,1176,2831,92,FALSE
inversify,2.0.0-rc.5,2.0.0-rc.9,35,18,248,108,356,35,FALSE
inversify,2.0.0-rc.9,2.0.0-rc.10,36,6,140,629,769,15,FALSE
inversify,2.0.0-rc.10,2.0.0-rc.11,37,8,186,23,209,13,FALSE
inversify,2.0.0-rc.11,2.0.0-rc.12,38,3,723,90,813,21,FALSE
inversify,2.0.0-rc.12,2.0.0-rc.13,39,6,44,24,68,16,FALSE
inversify,2.0.0-rc.13,2.0.0-rc.14,40,25,491,410,901,63,FALSE
inversify,2.0.0-rc.14,2.0.0,41,5,10,7,17,6,FALSE
inversify,2.0.0,2.0.1,42,12,65,61,126,14,FALSE
inversify,2.0.1,3.0.0-beta.1,43,8,3023,2828,5851,128,FALSE
inversify,3.0.0-beta.1,3.0.0-beta.2,44,7,430,452,882,103,FALSE
inversify,3.0.0-beta.2,3.0.0-beta.3,45,6,1318,588,1906,81,FALSE
inversify,3.0.0-beta.3,3.0.0-rc.1,46,2,253,10,263,15,FALSE
inversify,3.0.0-rc.1,3.0.0-rc.2,47,2,33,3,36,4,FALSE
inversify,3.0.0-rc.2,3.0.0-rc.4,48,5,104,30,134,17,FALSE
inversify,3.0.0-rc.4,3.0.0,49,5,63,19,82,11,FALSE
inversify,3.0.0,3.1.0,50,8,229,86,315,25,FALSE
inversify,3.1.0,3.2.0,51,7,688,176,864,28,FALSE
inversify,3.2.0,3.3.0,52,2,81,5,86,8,FALSE
inversify,3.3.0,4.0.0,53,6,306,109,415,24,FALSE
inversify,4.0.0,4.1.0,54,1,107,2,109,3,FALSE
inversify,4.1.0,4.1.1,55,7,216,16,232,11,FALSE
is-plain-object,0.1.0,1.0.0,1,3,444,119,563,19,FALSE
is-plain-object,1.0.0,2.0.0,2,11,493,181,674,33,FALSE
is-plain-object,2.0.0,2.0.1,3,1,1,1,2,1,FALSE
is-plain-object,2.0.1,2.0.2,4,6,366,224,590,23,FALSE
is-plain-object,2.0.2,2.0.3,5,2,2,1,3,2,FALSE
is_js,0.1.1,0.1.2,1,3,7,5,12,4,TRUE
is_js,0.1.2,0.1.3,2,1,5,5,10,3,TRUE
is_js,0.1.3,0.2.0,3,9,227,87,314,15,TRUE
is_js,0.2.0,0.2.1,4,6,27,9,36,8,FALSE
is_js,0.2.1,0.2.2,5,6,54,40,94,8,TRUE
is_js,0.2.2,0.2.3,6,3,6,6,12,5,TRUE
is_js,0.2.3,0.3.0,7,8,141,15,156,11,FALSE
is_js,0.3.0,0.3.1,8,6,13,29,42,8,FALSE
is_js,0.3.1,0.4.0,9,9,227,16,243,12,TRUE
is_js,0.4.0,0.5.0,10,23,400,28,428,35,FALSE
is_js,0.5.0,0.5.1,11,4,19,7,26,10,TRUE
is_js,0.5.1,0.5.2,12,4,9,7,16,6,TRUE
is_js,0.5.2,0.6.0,13,13,165,15,180,19,FALSE
is_js,0.6.0,0.7.0,14,8,43,14,57,10,FALSE
is_js,0.7.0,0.7.1,15,7,31,14,45,11,FALSE
is_js,0.7.1,0.7.3,16,19,70,33412,33482,38,FALSE
is_js,0.7.3,0.7.4,17,16,75,19,94,18,FALSE
is_js,0.7.4,0.7.5,18,7,45,25,70,11,FALSE
is_js,0.7.5,0.7.6,19,2,14,8,22,6,FALSE
is_js,0.7.6,0.8.0,20,3,45,5,50,8,FALSE
is_js,0.8.0,0.9.0,21,89,3449,5406,8855,116,FALSE
jsdoc,0.0.0,3.2.0-dev,1,674,122435,57062,179497,3259,FALSE
jsdoc,3.2.0-dev,3.2.0,2,27,2095,1119,3214,95,FALSE
jsdoc,3.2.0,3.2.1,3,44,1549,439,1988,122,FALSE
jsdoc,3.2.1,3.2.2,4,27,7192,3804,10996,210,FALSE
jsdoc,3.2.2,3.3.0-alpha1,5,3,173,2054,2227,23,TRUE
jsdoc,3.3.0-alpha1,3.3.0-alpha10,6,344,143900,135147,279047,1213,FALSE
jsdoc,3.3.0-alpha10,3.3.0-alpha11,7,37,18941,1352,20293,232,FALSE
jsdoc,3.3.0-alpha11,3.3.0-alpha12,8,34,2397,1450,3847,91,FALSE
jsdoc,3.3.0-alpha12,3.3.0-alpha13,9,2,3,7,10,2,FALSE
jsdoc,3.3.0-alpha2,3.3.0-alpha3,11,60,66698,121733,188431,237,FALSE
jsdoc,3.3.0-alpha3,3.3.0-alpha4,12,21,525,288,813,42,FALSE
jsdoc,3.3.0-alpha4,3.3.0-alpha5,13,47,2061,1322,3383,245,FALSE
jsdoc,3.3.0-alpha5,3.3.0-alpha7,14,68,6475,2946,9421,220,FALSE
jsdoc,3.3.0-alpha7,3.3.0-alpha8,15,4,2982,141,3123,34,FALSE
jsdoc,3.3.0-alpha8,3.3.0-alpha9,16,21,325,751,1076,42,FALSE
jsdoc,3.3.0-alpha9,3.3.0-beta1,17,222,32930,7139,40069,728,FALSE
jsdoc,3.3.0-beta1,3.3.0-beta2,18,54,8769,6323,15092,197,FALSE
jsdoc,3.3.0-beta2,3.3.0-beta3,19,10,6045,351,6396,77,FALSE
jsdoc,3.3.0-beta3,3.3.0,20,17,799,158,957,57,FALSE
jsdoc,3.3.0,3.3.1,21,8,2584,2852,5436,21,FALSE
jsdoc,3.3.1,3.3.2,22,6,357,229,586,22,FALSE
jsdoc,3.3.2,3.3.3,23,24,2627,1402,4029,102,FALSE
jsdoc,3.3.3,3.4.0,24,14,406,76923,77329,378,FALSE
jsdoc,3.4.0,3.4.1,25,49,823,377,1200,135,FALSE
jsdoc,3.4.1,3.4.2,26,7,60,75,135,15,FALSE
jsdoc,3.4.2,3.4.3,27,2,8,203,211,2,FALSE
jsdom,0.0.1,0.1.2,1,1,154,122,276,3,TRUE
jsdom,0.1.2,0.1.4,2,1,154,122,276,3,TRUE
jsdom,0.1.4,0.1.5,3,1,154,122,276,3,TRUE
jsdom,0.1.5,0.1.6,4,1,154,122,276,3,TRUE
jsdom,0.1.6,0.1.7,5,1,154,122,276,3,TRUE
jsdom,0.1.7,0.1.8,6,1,154,122,276,3,TRUE
jsdom,0.1.8,0.1.9,7,1,154,122,276,3,TRUE
jsdom,0.1.9,0.1.10,8,1,154,122,276,3,TRUE
jsdom,0.1.10,0.1.11,9,1,154,122,276,3,TRUE
jsdom,0.1.11,0.1.12,10,1,154,122,276,3,TRUE
jsdom,0.1.12,0.1.13,11,1,154,122,276,3,TRUE
jsdom,0.1.13,0.1.15,12,1,154,122,276,3,TRUE
jsdom,0.1.15,0.1.16,13,1,154,122,276,3,TRUE
jsdom,0.1.16,0.1.17,14,1,154,122,276,3,TRUE
jsdom,0.1.17,0.1.18,15,1,154,122,276,3,TRUE
jsdom,0.1.18,0.1.19,16,1,154,122,276,3,TRUE
jsdom,0.1.19,0.1.20,17,1,154,122,276,3,TRUE
jsdom,0.1.20,0.1.21,18,1,154,122,276,3,TRUE
jsdom,0.1.21,0.1.22,19,1,154,122,276,3,TRUE
jsdom,0.1.22,0.1.23,20,1,154,122,276,3,TRUE
jsdom,0.1.23,0.2.0,21,1,154,122,276,3,TRUE
jsdom,0.2.0,0.2.1,22,1,154,122,276,3,TRUE
jsdom,0.2.1,0.2.2,23,1,154,122,276,3,TRUE
jsdom,0.2.2,0.2.3,24,1,154,122,276,3,TRUE
jsdom,0.2.3,0.2.4,25,1,154,122,276,3,TRUE
jsdom,0.2.4,0.2.5,26,1,154,122,276,3,TRUE
jsdom,0.2.5,0.2.6,27,1,154,122,276,3,TRUE
jsdom,0.2.6,0.2.7,28,1,154,122,276,3,TRUE
jsdom,0.2.7,0.2.8,29,1,154,122,276,3,TRUE
jsdom,0.2.8,0.2.9,30,1,154,122,276,3,TRUE
jsdom,0.2.9,0.2.10,31,1,154,122,276,3,TRUE
jsdom,0.2.10,0.2.11,32,43,2034,1277,3311,70,FALSE
jsdom,0.2.11,0.2.12,33,2,10,2,12,3,TRUE
jsdom,0.2.12,0.2.13,34,3,5,3,8,4,FALSE
jsdom,0.2.13,0.2.14,35,24,296,110,406,39,FALSE
jsdom,0.2.14,0.2.15,36,20,246,33,279,33,FALSE
jsdom,0.2.15,0.2.16,37,42,1875,1480,3355,62,FALSE
jsdom,0.2.16,0.2.17,38,3,28,29,57,9,TRUE
jsdom,0.2.17,0.2.18,39,4,36,13,49,9,TRUE
jsdom,0.2.18,0.2.19,40,11,270,97,367,27,FALSE
jsdom,0.2.19,0.3.0,41,21,13830,12254,26084,47,FALSE
jsdom,0.3.0,0.3.1,42,3,53,11,64,6,TRUE
jsdom,0.3.1,0.3.2,43,9,153,21,174,16,FALSE
jsdom,0.3.2,0.3.3,44,8,134,25,159,14,FALSE
jsdom,0.3.3,0.3.4,45,2,37,17,54,3,FALSE
jsdom,0.3.4,0.4.0,46,4,134,95,229,15,FALSE
jsdom,0.4.0,0.4.1,47,2,39,1,40,5,FALSE
jsdom,0.4.1,0.4.2,48,8,2017,1425,3442,13,FALSE
jsdom,0.4.2,0.5.0,49,3,55,29,84,5,TRUE
jsdom,0.5.0,0.5.1,50,6,347,9,356,13,FALSE
jsdom,0.5.1,0.5.2,51,4,103,33,136,9,FALSE
jsdom,0.5.2,0.5.3,52,3,20,9,29,9,FALSE
jsdom,0.5.3,0.5.4,53,11,107,203,310,20,FALSE
jsdom,0.5.4,0.5.5,54,8,67,13,80,10,FALSE
jsdom,0.5.5,0.5.6,55,9,141,43,184,11,FALSE
jsdom,0.5.6,0.5.7,56,4,74,25,99,7,FALSE
jsdom,0.5.7,0.6.0,57,13,133,55,188,23,TRUE
jsdom,0.6.0,0.6.1,58,4,38,23,61,7,FALSE
jsdom,0.6.1,0.6.2,59,9,198,65,263,16,FALSE
jsdom,0.6.2,0.6.3,60,2,40,25,65,5,FALSE
jsdom,0.6.3,0.6.4,61,3,54,22,76,6,FALSE
jsdom,0.6.4,0.6.5,62,2,25,10,35,5,TRUE
jsdom,0.6.5,0.7.0,63,9,666,346,1012,20,FALSE
jsdom,0.7.0,0.8.0,64,10,529,487,1016,26,FALSE
jsdom,0.8.0,0.8.1,65,7,47,21,68,10,TRUE
jsdom,0.8.1,0.8.2,66,10,465,188,653,17,FALSE
jsdom,0.8.2,0.8.3,67,2,6,2,8,3,FALSE
jsdom,0.8.3,0.8.4,68,4,34,21,55,6,FALSE
jsdom,0.8.4,0.8.5,69,2,6,1,7,3,FALSE
jsdom,0.8.5,0.8.6,70,3,20,5,25,4,FALSE
jsdom,0.8.6,0.8.7,71,2,40,3,43,6,FALSE
jsdom,0.8.7,0.8.8,72,2,13,8,21,4,FALSE
jsdom,0.8.8,0.8.9,73,3,24,7,31,7,FALSE
jsdom,0.8.9,0.8.10,74,4,60,14,74,8,FALSE
jsdom,0.8.10,0.8.11,75,16,565,190,755,37,FALSE
jsdom,0.8.11,0.9.0,76,11,937,251,1188,26,FALSE
jsdom,0.9.0,0.10.0,77,4,62,16,78,9,FALSE
jsdom,0.10.0,0.10.1,78,4,15,5,20,6,FALSE
jsdom,0.10.1,0.10.2,79,5,10426,79,10505,21,FALSE
jsdom,0.10.2,0.10.3,80,3,45,26,71,8,FALSE
jsdom,0.10.3,0.10.4,81,3,104,7,111,8,FALSE
jsdom,0.10.4,0.10.5,82,4,41,24,65,8,FALSE
jsdom,0.10.5,0.10.6,83,7,210,53,263,17,FALSE
jsdom,0.10.6,0.11.0,84,12,904,166,1070,30,FALSE
jsdom,0.11.0,0.11.1,85,8,307,104,411,12,FALSE
jsdom,0.11.1,1.0.0-pre.1,86,71,2481,3234,5715,143,FALSE
jsdom,1.0.0-pre.1,1.0.0-pre.3,87,6,70,4,74,8,FALSE
jsdom,1.0.0-pre.3,1.0.0-pre.4,88,5,175,64,239,12,FALSE
jsdom,1.0.0-pre.4,1.0.0-pre.5,89,2,6,2,8,3,FALSE
jsdom,1.0.0-pre.5,1.0.0-pre.6,90,4,44,4,48,7,FALSE
jsdom,1.0.0-pre.6,1.0.0-pre.7,91,9,385,121,506,23,FALSE
jsdom,1.0.0-pre.7,1.0.0,92,19,288,289,577,34,FALSE
jsdom,1.0.0,1.0.1,93,3,93,45,138,8,FALSE
jsdom,1.0.1,1.0.2,94,7,26,15,41,8,FALSE
jsdom,1.0.2,1.0.3,95,6,65,23,88,9,TRUE
jsdom,1.0.3,1.1.0,96,14,176,25,201,23,FALSE
jsdom,1.1.0,1.2.0,97,7,353,272,625,18,FALSE
jsdom,1.2.0,1.2.1,98,4,41,74,115,12,FALSE
jsdom,1.2.1,1.2.2,99,5,82,5,87,11,FALSE
jsdom,1.2.2,1.2.3,100,2,30,52,82,5,FALSE
jsdom,1.2.3,1.3.0,101,4,35,44,79,6,TRUE
jsdom,1.3.0,1.3.1,102,2,18,2,20,4,TRUE
jsdom,1.3.1,1.3.2,103,2,6,2,8,3,FALSE
jsdom,1.3.2,1.4.0,104,15,1031,476,1507,42,FALSE
jsdom,1.4.0,1.4.1,105,2,18,3,21,3,FALSE
jsdom,1.4.1,1.5.0,106,8,120,69,189,18,FALSE
jsdom,1.5.0,2.0.0,107,27,1386,29266,30652,112,FALSE
jsdom,2.0.0,3.0.0,108,9,3529,17407,20936,105,FALSE
jsdom,3.0.0,3.0.1,109,6,47,6,53,10,FALSE
jsdom,3.0.1,3.0.2,110,2,32,2,34,4,TRUE
jsdom,3.0.2,3.0.3,111,3,9,6,15,6,FALSE
jsdom,3.0.3,3.1.0,112,4,185,19,204,9,TRUE
jsdom,3.1.0,3.1.1,113,7,153,414,567,19,FALSE
jsdom,3.1.1,3.1.2,114,12,327,238,565,31,FALSE
jsdom,3.1.2,4.0.0,115,8,524,461,985,34,FALSE
jsdom,4.0.0,4.0.1,116,7,117,24,141,12,FALSE
jsdom,4.0.1,4.0.2,117,11,592,427,1019,30,FALSE
jsdom,4.0.2,4.0.3,118,10,194,128,322,19,FALSE
jsdom,4.0.3,4.0.4,119,3,22,2,24,4,FALSE
jsdom,4.0.4,4.0.5,120,5,333,99,432,12,FALSE
jsdom,4.0.5,4.1.0,121,2,95,9,104,4,FALSE
jsdom,4.1.0,4.2.0,122,3,63,57,120,5,FALSE
jsdom,4.2.0,4.3.0,123,3,88,33,121,8,FALSE
jsdom,4.3.0,4.4.0,124,2,51,54,105,5,FALSE
jsdom,4.4.0,4.5.0,125,7,359,254,613,40,FALSE
jsdom,4.5.0,4.5.1,126,3,186,42,228,6,TRUE
jsdom,4.5.1,4.5.2,127,8,862,401,1263,37,FALSE
jsdom,5.0.0,5.0.1,129,4,230,195,425,17,TRUE
jsdom,5.0.1,5.1.0,130,8,1160,88,1248,20,FALSE
jsdom,5.1.0,5.2.0,131,16,543,84,627,41,FALSE
jsdom,5.2.0,5.3.0,132,2,78,14,92,6,TRUE
jsdom,5.3.0,5.4.0,133,23,3179,1693,4872,75,FALSE
jsdom,5.4.0,5.4.1,134,2,22,22,44,6,TRUE
jsdom,5.4.1,5.4.2,135,3,10,33,43,6,FALSE
jsdom,5.4.2,5.4.3,136,4,184,140,324,8,FALSE
jsdom,5.4.3,5.5.0,137,21,1476,475,1951,79,FALSE
jsdom,5.5.0,5.6.0,138,2,15,10,25,4,FALSE
jsdom,5.6.0,5.6.1,139,5,28,8,36,8,FALSE
jsdom,5.6.1,6.0.0,140,46,2813,2105,4918,189,FALSE
jsdom,6.0.0,6.0.1,141,3,88,5,93,8,FALSE
jsdom,6.0.1,6.1.0,142,2,144,1,145,3,FALSE
jsdom,6.1.0,6.2.0,143,16,801,82,883,36,FALSE
jsdom,6.2.0,6.3.0,144,13,762,207,969,46,FALSE
jsdom,6.3.0,6.4.0,145,10,567,308,875,49,FALSE
jsdom,6.4.0,6.5.0,146,2,35,1,36,5,TRUE
jsdom,6.5.0,6.5.1,147,3,40,30,70,7,FALSE
jsdom,6.5.1,7.0.0,148,24,6118,3587,9705,241,FALSE
jsdom,7.0.0,7.0.1,149,2,221,22,243,8,TRUE
jsdom,7.0.1,7.0.2,150,7,12,12,24,9,FALSE
jsdom,7.0.2,7.1.0,151,19,1513,3945,5458,98,FALSE
jsdom,7.1.0,7.1.1,152,5,61,20,81,11,FALSE
jsdom,7.1.1,7.2.0,153,15,1409,525,1934,39,FALSE
jsdom,7.2.0,7.2.1,154,2,17,2,19,4,FALSE
jsdom,7.2.1,7.2.2,155,3,23,6,29,8,FALSE
jsdom,7.2.2,8.0.0-0,156,14,6919,12343,19262,243,FALSE
jsdom,8.0.0-0,8.0.0,157,29,2563,2281,4844,180,FALSE
jsdom,8.0.0,8.0.1,158,2,42,2,44,4,TRUE
jsdom,8.0.1,8.0.2,159,5,88,23,111,12,FALSE
jsdom,8.0.2,8.0.3,160,4,69,15,84,9,FALSE
jsdom,8.0.3,8.0.4,161,26,3705,3296,7001,83,TRUE
jsdom,8.0.4,8.1.0,162,18,448,202,650,39,FALSE
jsdom,8.1.0,8.2.0,163,12,1772,931,2703,64,FALSE
jsdom,8.2.0,8.3.0,164,8,892,608,1500,35,FALSE
jsdom,8.3.0,8.3.1,165,4,48,9,57,7,FALSE
jsdom,8.3.1,8.4.0,166,4,331,22,353,16,FALSE
jsdom,8.4.0,8.4.1,167,2,37,2,39,5,FALSE
jsdom,8.4.1,8.5.0,168,11,8454,8243,16697,118,FALSE
jsdom,8.5.0,9.0.0,169,7,234,378,612,45,FALSE
jsdom,9.0.0,9.1.0,170,10,449,259,708,49,FALSE
jsdom,9.1.0,9.2.0,171,4,224,16,240,17,FALSE
jsdom,9.2.0,9.2.1,172,17,511,411,922,77,FALSE
jsdom,9.2.1,9.3.0,173,12,648,484,1132,37,FALSE
jsdom,9.3.0,9.4.0,174,25,1352,345,1697,94,FALSE
jsdom,9.4.0,9.4.1,175,2,70,2,72,6,FALSE
jsdom,9.4.1,9.4.2,176,4,44,5,49,6,FALSE
jsdom,9.4.2,9.4.3,177,3,29,12,41,5,FALSE
jsdom,9.4.3,9.4.4,178,2,5,3,8,3,TRUE
jsdom,9.4.4,9.4.5,179,2,6,1,7,3,TRUE
jsdom,9.4.5,9.5.0,180,12,485,423,908,45,FALSE
jsdom,9.5.0,9.6.0,181,14,320,125,445,24,FALSE
jsdom,9.6.0,9.7.0,182,3,94,20,114,11,FALSE
jsdom,9.7.0,9.7.1,183,2,24,8,32,4,TRUE
jsdom,9.7.1,9.8.0,184,6,160,901,1061,30,FALSE
jsdom,9.8.0,9.8.1,185,2,36,2,38,5,FALSE
jsdom,9.8.1,9.8.2,186,2,58,4,62,6,TRUE
jsdom,9.8.2,9.8.3,187,2,11,5,16,5,TRUE
jsdom,9.8.3,9.9.0,188,13,620,66,686,46,FALSE
jsdom,9.9.0,9.9.1,189,2,7,3,10,4,TRUE
jsdom,9.9.1,9.10.0,190,28,2012,1615,3627,115,FALSE
jsdom,9.10.0,9.11.0,191,4,147,3,150,13,FALSE
jsdom,9.11.0,9.12.0,192,9,361,164,525,30,FALSE
jsdom,9.12.0,10.0.0,193,9,5715,32906,38621,400,FALSE
jsdom,10.0.0,10.1.0,194,15,472,109,581,53,FALSE
jsdom,10.1.0,11.0.0,195,40,1405,2165,3570,127,FALSE
jsondiffpatch,0.0.1,0.0.2,1,5,465,54,519,12,TRUE
jsondiffpatch,0.0.2,0.0.3,2,1,4,2,6,1,TRUE
jsondiffpatch,0.0.3,0.0.5,3,2,2,3,5,2,TRUE
jsondiffpatch,0.0.5,0.0.7,4,10,1076,423,1499,27,FALSE
jsondiffpatch,0.0.7,0.0.8,5,9,39,19,58,11,FALSE
jsondiffpatch,0.0.8,0.0.9,6,9,437,302,739,23,FALSE
jsondiffpatch,0.0.9,0.0.10,7,3,20,7,27,5,FALSE
jsondiffpatch,0.0.10,0.0.11,8,3,4,6,10,6,TRUE
jsondiffpatch,0.0.11,0.1.0,9,39,25450,7398,32848,232,FALSE
jsondiffpatch,0.1.0,0.1.1,10,7,71,71,142,28,TRUE
jsondiffpatch,0.1.1,0.1.2,11,9,7551,130,7681,22,TRUE
jsondiffpatch,0.1.2,0.1.3,12,10,105,71,176,17,TRUE
jsondiffpatch,0.1.3,0.1.4,13,4,33,11,44,9,TRUE
jsondiffpatch,0.1.4,0.1.5,14,4,22,16,38,8,FALSE
jsondiffpatch,0.1.5,0.1.6,15,3,1377,1250,2627,12,FALSE
jsondiffpatch,0.1.6,0.1.7,16,1,44,25,69,8,FALSE
jsondiffpatch,0.1.7,0.1.8,17,1,69,62,131,8,FALSE
jsondiffpatch,0.1.8,0.1.10,18,2,10381,11297,21678,57,FALSE
jsondiffpatch,0.1.10,0.1.12,19,3,14,13,27,14,TRUE
jsondiffpatch,0.1.12,0.1.14,20,5,17,15,32,15,TRUE
jsondiffpatch,0.1.14,0.1.15,21,4,12,11,23,9,TRUE
jsondiffpatch,0.1.15,0.1.16,22,2,10,8,18,8,TRUE
jsondiffpatch,0.1.16,0.1.17,23,2,9,9,18,9,TRUE
jsondiffpatch,0.1.17,0.1.18,24,4,6045,5154,11199,47,FALSE
jsondiffpatch,0.1.18,0.1.20,25,6,119,46,165,34,FALSE
jsondiffpatch,0.1.20,0.1.21,26,3,16,7,23,7,FALSE
jsondiffpatch,0.1.21,0.1.22,27,2,6,6,12,6,TRUE
jsondiffpatch,0.1.22,0.1.23,28,2,375,53,428,16,FALSE
jsondiffpatch,0.1.23,0.1.24,29,2,12,27,39,13,TRUE
jsondiffpatch,0.1.24,0.1.25,30,2,480,88,568,15,FALSE
jsondiffpatch,0.1.25,0.1.26,31,3,103,282,385,22,FALSE
jsondiffpatch,0.1.26,0.1.27,32,2,246,182,428,17,FALSE
jsondiffpatch,0.1.27,0.1.31,33,9,42,38,80,37,FALSE
jsondiffpatch,0.1.31,0.1.32,34,2,8,8,16,2,FALSE
jsondiffpatch,0.1.32,0.1.33,35,2,16,16,32,15,TRUE
jsondiffpatch,0.1.33,0.1.34,36,4,23,21,44,16,FALSE
jsondiffpatch,0.1.34,0.1.36,37,4,78,48,126,16,TRUE
jsondiffpatch,0.1.36,0.1.37,38,2,17,15,32,14,FALSE
jsondiffpatch,0.1.37,0.1.38,39,3,400,6349,6749,25,FALSE
jsondiffpatch,0.1.38,0.1.39,40,10,1213,370,1583,37,FALSE
jsondiffpatch,0.1.39,0.1.40,41,2,129,19,148,17,TRUE
jsondiffpatch,0.1.40,0.1.41,42,2,8,7,15,8,TRUE
jsondiffpatch,0.1.41,0.1.43,43,9,104,47,151,30,FALSE
jsondiffpatch,0.1.43,0.2.2,44,8,441,157,598,28,FALSE
jsondiffpatch,0.2.2,0.2.3,45,2,15,15,30,9,TRUE
jsondiffpatch,0.2.3,0.2.4,46,3,56,48,104,21,FALSE
jsonwebtoken,0.1.0,0.2.0,1,3,40,16,56,3,FALSE
jsonwebtoken,0.2.0,0.3.0,2,6,84,37,121,10,FALSE
jsonwebtoken,0.3.0,0.4.0,3,1,1,1,2,1,FALSE
jsonwebtoken,0.4.0,0.4.1,4,5,76,6,82,8,FALSE
jsonwebtoken,0.4.1,1.0.0,5,13,203,20,223,22,FALSE
jsonwebtoken,1.0.0,1.0.2,6,4,5,5,10,4,TRUE
jsonwebtoken,1.0.2,1.1.0,7,3,3,3,6,3,TRUE
jsonwebtoken,1.1.0,1.1.1,8,2,12,1,13,3,FALSE
jsonwebtoken,1.1.1,1.1.2,9,3,15,2,17,4,FALSE
jsonwebtoken,1.1.2,1.2.0,10,11,162,19,181,17,FALSE
jsonwebtoken,1.2.0,1.3.0,11,2,7,1,8,2,FALSE
jsonwebtoken,1.3.0,2.0.0,12,9,242,75,317,19,FALSE
jsonwebtoken,2.0.0,3.0.0,13,4,81,10,91,11,FALSE
jsonwebtoken,3.0.0,3.1.0,14,2,39,22,61,4,TRUE
jsonwebtoken,3.1.0,3.1.1,15,2,94,21,115,5,TRUE
jsonwebtoken,3.1.1,3.2.0,16,2,17,13,30,3,TRUE
jsonwebtoken,3.2.0,3.2.1,17,2,2,2,4,2,FALSE
jsonwebtoken,3.2.1,3.2.2,18,2,2,2,4,2,FALSE
jsonwebtoken,3.2.2,4.0.0,19,17,282,61,343,34,FALSE
jsonwebtoken,4.0.0,4.1.0,20,4,105,9,114,8,FALSE
jsonwebtoken,4.1.0,4.2.0,21,5,95,11,106,9,FALSE
jsonwebtoken,4.2.0,4.2.1,22,2,57,4,61,5,TRUE
jsonwebtoken,4.2.1,4.2.2,23,3,53,3,56,7,FALSE
jsonwebtoken,4.2.2,5.0.0,24,12,165,52,217,19,FALSE
jsonwebtoken,5.0.0,5.0.1,25,16,115,20,135,21,FALSE
jsonwebtoken,5.0.1,5.0.2,26,3,8,4,12,3,FALSE
jsonwebtoken,5.0.2,5.0.3,27,8,186,14,200,13,FALSE
jsonwebtoken,5.0.3,5.0.4,28,3,49,1,50,5,TRUE
jsonwebtoken,5.0.4,5.0.5,29,11,186,34,220,16,FALSE
jsonwebtoken,5.0.5,5.1.0,30,4,65,9,74,6,FALSE
jsonwebtoken,5.1.0,5.2.0,31,1,2,0,2,1,TRUE
jsonwebtoken,5.2.0,5.3.1,32,6,244,18,262,10,TRUE
jsonwebtoken,5.3.1,5.4.0,33,3,137,13,150,7,TRUE
jsonwebtoken,5.4.0,5.4.1,34,4,9,4,13,4,FALSE
jsonwebtoken,5.4.1,5.5.0,35,7,385,42,427,19,FALSE
jsonwebtoken,5.5.0,5.5.1,36,2,51,6,57,5,FALSE
jsonwebtoken,5.5.1,5.5.2,37,2,19,5,24,5,TRUE
jsonwebtoken,5.5.2,5.5.3,38,3,28,3,31,4,TRUE
jsonwebtoken,5.5.3,5.5.4,39,2,4,2,6,2,TRUE
jsonwebtoken,5.5.4,5.6.0,40,5,42,21,63,5,FALSE
jsonwebtoken,5.6.0,5.6.2,41,3,3,3,6,3,TRUE
jsonwebtoken,5.6.2,5.7.0,42,2,16,3,19,4,TRUE
jsonwebtoken,5.7.0,6.0.0,43,24,460,186,646,41,FALSE
jsonwebtoken,6.0.0,6.0.1,44,3,28,3,31,4,TRUE
jsonwebtoken,6.0.1,6.1.0,45,3,53,5,58,5,TRUE
jsonwebtoken,6.1.0,6.1.1,46,5,27,7,34,6,FALSE
jsonwebtoken,6.1.1,6.1.2,47,3,6,5,11,4,TRUE
jsonwebtoken,6.1.2,6.2.0,48,3,155,33,188,11,TRUE
jsonwebtoken,6.2.0,7.0.0,49,5,49,12,61,6,FALSE
jsonwebtoken,7.0.0,7.0.1,50,3,4,4,8,3,FALSE
jsonwebtoken,7.0.1,7.1.0,51,6,71,63,134,10,FALSE
jsonwebtoken,7.1.0,7.1.1,52,4,233,196,429,8,TRUE
jsonwebtoken,7.1.1,7.1.3,53,4,17,5,22,5,TRUE
jsonwebtoken,7.1.3,7.1.5,54,5,18,7,25,7,FALSE
jsonwebtoken,7.1.5,7.1.6,55,2,18,4,22,3,TRUE
jsonwebtoken,7.1.6,7.1.7,56,5,26,7,33,7,FALSE
jsonwebtoken,7.1.7,7.1.8,57,4,13,25,38,5,FALSE
jsonwebtoken,7.1.8,7.1.9,58,2,13,7,20,3,FALSE
jsonwebtoken,7.1.9,7.1.10,59,10,76,12,88,11,FALSE
jsonwebtoken,7.1.10,7.2.0,60,6,28,13,41,9,TRUE
jsonwebtoken,7.2.0,7.2.1,61,5,14,4,18,5,FALSE
jsonwebtoken,7.2.1,7.3.0,62,8,226,11,237,12,FALSE
jsonwebtoken,7.3.0,7.4.0,63,6,60,9,69,12,FALSE
jsonwebtoken,7.4.0,7.4.1,64,5,93,73,166,7,FALSE
less-plugin-autoprefix,0.0.1,1.0.0,1,6,149,49,198,13,FALSE
less-plugin-autoprefix,1.0.0,1.0.1,2,9,55,11,66,9,FALSE
less-plugin-autoprefix,1.0.1,1.1.0,3,3,3,3,6,3,FALSE
less-plugin-autoprefix,1.1.0,1.3.0,4,3,5,5,10,3,FALSE
less-plugin-autoprefix,1.3.0,1.4.0,5,3,4,4,8,3,FALSE
less-plugin-autoprefix,1.4.0,1.4.1,6,5,5,5,10,5,FALSE
less-plugin-autoprefix,1.4.1,1.4.2,7,3,9,5,14,5,FALSE
less-plugin-autoprefix,1.4.2,1.5.0,8,6,15,15,30,7,FALSE
less-plugin-autoprefix,1.5.0,1.5.1,9,4,9,3,12,4,FALSE
libxmljs,0.4.2,0.4.3,2,16,97,56,153,23,FALSE
libxmljs,0.4.3,0.5.0,3,33,7607,13094,20701,318,FALSE
libxmljs,0.5.0,0.5.1,4,1,3,3,6,2,FALSE
libxmljs,0.5.1,0.5.2,5,2,4,3,7,2,TRUE
libxmljs,0.5.2,0.5.3,6,1,3,2,5,2,FALSE
libxmljs,0.5.3,0.5.4,7,3,5,5,10,3,FALSE
libxmljs,0.5.4,0.6.0,8,40,1135,332,1467,125,FALSE
libxmljs,0.6.0,0.6.1,9,3,29,1,30,5,FALSE
libxmljs,0.6.1,0.7.0,10,28,823,647,1470,61,FALSE
libxmljs,0.7.0,0.7.1,11,7,92,15,107,11,FALSE
libxmljs,0.7.1,0.8.0,12,5,231871,50,231921,122,FALSE
libxmljs,0.8.0,0.8.1,13,2,2,2,4,2,FALSE
libxmljs,0.8.1,0.9.0,14,5,123,9,132,8,FALSE
libxmljs,0.9.0,0.10.0,15,4,1056,695,1751,38,FALSE
libxmljs,0.10.0,0.11.0,16,6,11,1038,1049,19,FALSE
libxmljs,0.11.0,0.11.1,17,2,4,2,6,3,FALSE
libxmljs,0.11.1,0.12.0,18,3,77,2,79,6,FALSE
libxmljs,0.12.0,0.13.0,19,12,342,38,380,29,FALSE
libxmljs,0.13.0,0.14.0,20,7,106,17,123,21,FALSE
libxmljs,0.14.0,0.14.1,21,2,2,2,4,2,FALSE
libxmljs,0.14.1,0.14.2,22,6,102,1,103,8,FALSE
libxmljs,0.14.2,0.14.3,23,14,1521,1269,2790,68,FALSE
libxmljs,0.14.3,0.15.0,24,9,270,27,297,22,FALSE
libxmljs,0.15.0,0.16.0,25,29,3320,648,3968,142,FALSE
libxmljs,0.16.0,0.16.1,26,3,5,5,10,3,FALSE
libxmljs,0.16.1,0.17.0,27,7,5595,2837,8432,131,FALSE
libxmljs,0.17.0,0.17.1,28,3,9,1,10,3,FALSE
libxmljs,0.17.1,0.18.0,29,8,245,29,274,21,FALSE
libxmljs,0.18.0,0.18.2,30,18,915,619,1534,72,FALSE
libxmljs,0.18.2,0.18.4,31,9,810,569,1379,74,FALSE
lie,0.5.0,0.5.1,1,2,26,8,34,7,FALSE
lie,0.5.1,0.6.0,2,1,395,19,414,8,TRUE
lie,0.6.0,0.6.1,3,1,4,4,8,4,TRUE
lie,0.6.1,0.6.2,4,3,14,14,28,10,TRUE
lie,0.6.2,1.0.0,5,7,37,45,82,14,FALSE
lie,1.0.0,1.0.3,6,2,25,21,46,13,FALSE
lie,1.0.3,1.1.0,7,2,819,707,1526,14,FALSE
lie,1.1.0,1.3.0,8,7,1587,1131,2718,36,FALSE
lie,1.3.0,1.4.0,9,6,1365,735,2100,22,FALSE
lie,1.4.0,2.0.0,10,10,430,544,974,31,FALSE
lie,2.0.0,2.0.1,11,1,6,6,12,6,TRUE
lie,2.0.1,2.0.3,12,9,193,197,390,15,FALSE
lie,2.0.3,2.0.5,13,3,39,12,51,11,FALSE
lie,2.0.5,2.0.6,14,3,165,137,302,9,FALSE
lie,2.0.6,2.0.7,15,3,69,66,135,12,FALSE
lie,2.0.7,2.1.0,16,2,394,884,1278,9,FALSE
lie,2.1.0,2.2.0,17,1,620,27,647,7,FALSE
lie,2.2.0,2.2.1,18,2,120,65,185,13,TRUE
lie,2.2.1,2.3.0,19,1,266,456,722,9,FALSE
lie,2.3.0,2.4.0,20,1,28,18,46,7,FALSE
lie,2.4.0,2.5.0,21,2,213,597,810,6,FALSE
lie,2.5.0,2.5.1,22,3,101,56,157,8,TRUE
lie,2.5.1,2.5.2,23,3,48,30,78,5,FALSE
lie,2.5.2,2.5.3,24,2,26,14,40,7,FALSE
lie,2.5.3,2.5.4,25,2,8,8,16,7,FALSE
lie,2.5.4,2.6.0,26,16,1641,1162,2803,59,FALSE
lie,2.6.0,2.7.0,27,4,646,576,1222,20,FALSE
lie,2.7.0,2.7.2,28,5,499,484,983,18,FALSE
lie,2.7.2,2.7.3,29,2,9,18,27,7,TRUE
lie,2.7.3,2.7.4,30,4,206,335,541,11,FALSE
lie,2.7.4,2.7.5,31,2,20,25,45,5,FALSE
lie,2.7.5,2.7.6,32,2,81,87,168,8,TRUE
lie,2.7.6,2.7.7,33,3,55,46,101,13,FALSE
lie,2.7.7,2.8.0,34,11,10343,63,10406,21,FALSE
lie,2.8.0,2.8.1,35,8,785,164,949,15,FALSE
lie,2.8.1,2.9.0,36,17,4735,2586,7321,40,FALSE
lie,2.9.0,2.9.1,37,1,10,4,14,4,TRUE
lie,2.9.1,3.0.0,38,10,1389,14269,15658,36,FALSE
lie,3.0.0,3.0.1,39,4,104,216,320,9,FALSE
lie,3.0.1,3.0.2,40,2,2,2,4,2,FALSE
lie,3.0.2,3.0.3,41,4,24,16,40,4,FALSE
lie,3.0.3,3.0.4,42,1,6,8,14,1,TRUE
lie,3.0.4,3.1.0,43,8,659,119,778,22,FALSE
lie,3.1.0,3.1.1,44,3,10,10,20,10,FALSE
lodash-es,3.0.0,3.0.1,1,1,1,1,2,1,FALSE
lodash-es,3.0.1,3.1.0,2,87,9862,3055,12917,111,FALSE
lodash-es,3.1.0,3.2.0,3,81,3340,1720,5060,120,FALSE
lodash-es,3.2.0,3.3.0,4,32,2470,1377,3847,42,FALSE
lodash-es,3.3.0,3.3.1,5,17,2940,1652,4592,42,FALSE
lodash-es,3.3.1,3.4.0,6,47,2267,1404,3671,64,FALSE
lodash-es,3.4.0,3.5.0,7,86,3905,2981,6886,115,FALSE
lodash-es,3.5.0,3.6.0,8,1,1,1,2,1,TRUE
lodash-es,3.6.0,3.7.0,9,136,4756,2812,7568,237,FALSE
lodash-es,3.7.0,3.8.0,10,43,1567,1107,2674,62,FALSE
lodash-es,3.8.0,3.9.0,11,72,3859,2421,6280,108,FALSE
lodash-es,3.9.0,3.9.2,12,19,521,453,974,25,FALSE
lodash-es,3.9.2,3.9.3,13,6,344,330,674,12,FALSE
lodash-es,3.9.3,3.10.0,14,105,2793,2596,5389,139,FALSE
lodash-es,3.10.0,3.10.1,15,151,8298,22078,30376,221,FALSE
lodash-es,3.10.1,4.0.0,16,808,64619,33343,97962,1106,FALSE
lodash-es,4.0.0,4.0.1,17,82,1842,1405,3247,133,FALSE
lodash-es,4.0.1,4.1.0,18,35,1453,971,2424,76,FALSE
lodash-es,4.1.0,4.2.0,19,34,3406,5581,8987,79,FALSE
lodash-es,4.2.0,4.2.1,20,13,548,437,985,26,FALSE
lodash-es,4.2.1,4.3.0,21,29,1899,792,2691,49,FALSE
lodash-es,4.3.0,4.4.0,22,78,5487,4544,10031,157,FALSE
lodash-es,4.4.0,4.5.0,23,15,182,136,318,16,FALSE
lodash-es,4.5.0,4.5.1,24,37,924,601,1525,63,FALSE
lodash-es,4.5.1,4.6.0,25,67,2825,2116,4941,98,FALSE
lodash-es,4.6.0,4.6.1,26,5,421,417,838,11,TRUE
lodash-es,4.6.1,4.7.0,27,172,8690,4662,13352,243,FALSE
lodash-es,4.7.0,4.8.0,28,42,1656,1157,2813,66,FALSE
lodash-es,4.8.0,4.8.2,29,9,708,696,1404,26,TRUE
lodash-es,4.8.2,4.9.0,30,28,1188,949,2137,46,FALSE
lodash-es,4.9.0,4.10.0,31,18,890,761,1651,32,FALSE
lodash-es,4.10.0,4.11.0,32,17,470,184,654,23,FALSE
lodash-es,4.11.0,4.11.1,33,9,925,856,1781,27,TRUE
lodash-es,4.11.1,4.11.2,34,82,2799,2079,4878,110,FALSE
lodash-es,4.11.2,4.12.0,35,25,1458,1286,2744,36,FALSE
lodash-es,4.12.0,4.13.0,36,84,4086,3028,7114,103,FALSE
lodash-es,4.13.0,4.13.1,37,8,592,488,1080,14,TRUE
lodash-es,4.13.1,4.14.0,38,150,2813,2363,5176,217,FALSE
lodash-es,4.14.0,4.14.1,39,23,2977,2456,5433,40,FALSE
lodash-es,4.14.1,4.14.2,40,38,1492,1503,2995,60,FALSE
lodash-es,4.14.2,4.15.0,41,26,1031,714,1745,33,FALSE
lodash-es,4.15.0,4.16.0,42,90,2346,1773,4119,126,FALSE
lodash-es,4.16.0,4.16.1,43,9,465,459,924,15,FALSE
lodash-es,4.16.1,4.16.2,44,17,698,582,1280,23,FALSE
lodash-es,4.16.2,4.16.3,45,17,621,536,1157,27,FALSE
lodash-es,4.16.3,4.16.4,46,33,807,772,1579,43,FALSE
lodash-es,4.16.4,4.16.5,47,62,4827,1479,6306,86,FALSE
lodash-es,4.16.5,4.16.6,48,6,385,379,764,14,TRUE
lodash-es,4.16.6,4.17.0,49,25,1235,1042,2277,42,FALSE
lodash-es,4.17.0,4.17.1,50,10,509,482,991,19,FALSE
lodash-es,4.17.1,4.17.2,51,9,208,171,379,14,TRUE
lodash-es,4.17.2,4.17.3,52,31,1111,678,1789,42,FALSE
lodash-es,4.17.3,4.17.4,53,8,1183,1121,2304,20,FALSE
lodash.debounce,2.0.0,2.1.0,1,1,1,1,2,1,TRUE
lodash.debounce,2.1.0,2.2.0,2,23,1563,1375,2938,62,FALSE
lodash.debounce,2.2.0,2.2.1,3,14,749,515,1264,43,FALSE
lodash.debounce,2.2.1,2.3.0,4,190,13784,8660,22444,462,FALSE
lodash.debounce,2.3.0,2.4.0,5,58,4562,3038,7600,180,FALSE
lodash.debounce,2.4.0,2.4.1,6,33,1941,1656,3597,101,FALSE
lodash.debounce,2.4.1,3.0.0,7,1547,121408,141532,262940,2857,FALSE
lodash.debounce,3.0.0,3.0.1,8,168,13202,4775,17977,231,FALSE
lodash.debounce,3.0.1,3.0.2,9,49,5410,3029,8439,84,FALSE
lodash.debounce,3.0.2,3.0.3,10,133,6172,4385,10557,179,FALSE
lodash.debounce,3.0.3,3.1.0,11,251,10182,6340,16522,407,FALSE
lodash.debounce,3.1.0,3.1.1,12,130,3658,3379,7037,176,FALSE
lodash.debounce,3.1.1,4.0.0,13,959,72917,55421,128338,1327,FALSE
lodash.debounce,4.0.0,4.0.1,14,151,6701,7957,14658,288,FALSE
lodash.debounce,4.0.1,4.0.2,15,117,6699,4780,11479,220,FALSE
lodash.debounce,4.0.2,4.0.3,16,6,1265,1022,2287,15,TRUE
lodash.debounce,4.0.3,4.0.4,17,324,13319,8085,21404,469,FALSE
lodash.debounce,4.0.4,4.0.5,18,66,4135,3381,7516,129,FALSE
lodash.debounce,4.0.5,4.0.6,19,26,1395,1040,2435,50,FALSE
lodash.debounce,4.0.6,4.0.7,20,349,11748,9244,20992,480,FALSE
lodash.debounce,4.0.7,4.0.8,21,87,5500,4673,10173,133,FALSE
lodash.find,2.0.0,2.1.0,1,1,1,1,2,1,TRUE
lodash.find,2.1.0,2.2.0,2,23,1563,1375,2938,62,FALSE
lodash.find,2.2.0,2.2.1,3,14,749,515,1264,43,FALSE
lodash.find,2.2.1,2.3.0,4,190,13784,8660,22444,462,FALSE
lodash.find,2.3.0,2.4.0,5,58,4562,3038,7600,180,FALSE
lodash.find,2.4.0,2.4.1,6,33,1941,1656,3597,101,FALSE
lodash.find,2.4.1,3.0.0,7,1547,121408,141532,262940,2857,FALSE
lodash.find,3.0.0,3.1.0,8,350,24784,12189,36973,494,FALSE
lodash.find,3.1.0,3.2.0,9,5,89,60,149,8,FALSE
lodash.find,3.2.0,3.2.1,10,265,10614,6733,17347,424,FALSE
lodash.find,3.2.1,4.0.0,11,1070,76054,58347,134401,1478,FALSE
lodash.find,4.0.0,4.0.1,12,89,2345,1616,3961,157,FALSE
lodash.find,4.0.1,4.0.2,13,62,4356,6341,10697,131,FALSE
lodash.find,4.0.2,4.1.0,14,14,549,438,987,27,FALSE
lodash.find,4.1.0,4.1.1,15,103,6150,4342,10492,193,FALSE
lodash.find,4.1.1,4.2.0,16,6,1265,1022,2287,15,TRUE
lodash.find,4.2.0,4.2.1,17,274,8728,5475,14203,398,FALSE
lodash.find,4.2.1,4.3.0,18,50,4591,2610,7201,71,FALSE
lodash.find,4.3.0,4.4.0,19,208,10264,8145,18409,336,FALSE
lodash.find,4.4.0,4.5.0,20,233,7014,5520,12534,323,FALSE
lodash.find,4.5.0,4.5.1,21,28,3009,2467,5476,45,FALSE
lodash.find,4.5.1,4.6.0,22,59,2491,2206,4697,88,FALSE
lodash.set,3.7.0,3.7.1,1,43,1567,1107,2674,62,FALSE
lodash.set,3.7.1,3.7.2,2,72,3859,2421,6280,108,FALSE
lodash.set,3.7.2,3.7.3,3,19,521,453,974,25,FALSE
lodash.set,3.7.3,3.7.4,4,6,344,330,674,12,FALSE
lodash.set,3.7.4,4.0.0,5,1064,75710,58017,133727,1466,FALSE
lodash.set,4.0.0,4.0.1,6,548,23393,19234,42627,921,FALSE
lodash.set,4.0.1,4.1.0,7,50,4591,2610,7201,71,FALSE
lodash.set,4.1.0,4.2.0,8,208,10264,8145,18409,336,FALSE
lodash.set,4.2.0,4.3.0,9,233,7014,5520,12534,323,FALSE
lodash.set,4.3.0,4.3.1,10,28,3009,2467,5476,45,FALSE
lodash.set,4.3.1,4.3.2,11,59,2491,2206,4697,88,FALSE
markdown-it,2.0.0,2.1.0,1,10,173,238,411,43,FALSE
markdown-it,2.1.0,2.1.1,2,4,105,42,147,11,TRUE
markdown-it,2.1.1,2.1.2,3,6,146,644,790,35,FALSE
markdown-it,2.1.2,2.1.3,4,10,200,195,395,15,FALSE
markdown-it,2.1.3,2.2.0,5,26,7514,5243,12757,85,FALSE
markdown-it,2.2.0,2.2.1,6,7,241,52,293,17,TRUE
markdown-it,2.2.1,3.0.0,7,42,11367,5128,16495,252,FALSE
markdown-it,3.0.0,3.0.1,8,9,180,41,221,17,FALSE
markdown-it,3.0.1,3.0.2,9,3,14,8,22,5,FALSE
markdown-it,3.0.2,3.0.3,10,4,172,66,238,9,FALSE
markdown-it,3.0.3,3.0.4,11,18,423,222,645,36,FALSE
markdown-it,3.0.4,3.0.5,12,13,145,125,270,25,FALSE
markdown-it,3.0.5,3.0.6,13,18,531,246,777,26,FALSE
markdown-it,3.0.6,3.0.7,14,12,225,131,356,19,FALSE
markdown-it,3.0.7,3.1.0,15,17,2419,3398,5817,41,FALSE
markdown-it,3.1.0,4.0.0,16,35,3645,6108,9753,132,FALSE
markdown-it,4.0.0,4.0.1,17,5,83,33,116,15,TRUE
markdown-it,4.0.1,4.0.2,18,9,351,6245,6596,14,FALSE
markdown-it,4.0.2,4.0.3,19,5,60,38,98,8,FALSE
markdown-it,4.0.3,4.1.0,20,6,86,37,123,10,FALSE
markdown-it,4.1.0,4.1.1,21,7,231,25,256,11,FALSE
markdown-it,4.1.1,4.1.2,22,6,73,21,94,10,FALSE
markdown-it,4.1.2,4.2.0,23,3,85,16,101,5,FALSE
markdown-it,4.2.0,4.2.1,24,13,1112,1048,2160,21,FALSE
markdown-it,4.2.1,4.2.2,25,13,1021,659,1680,27,FALSE
markdown-it,4.2.2,4.3.0,26,3,13,8,21,5,FALSE
markdown-it,4.3.0,4.3.1,27,4,63,13,76,9,FALSE
markdown-it,4.3.1,4.4.0,28,6,2211,881,3092,15,FALSE
markdown-it,4.4.0,5.0.0,29,19,1493,971,2464,70,FALSE
markdown-it,5.0.0,5.0.1,30,3,49,39,88,6,FALSE
markdown-it,5.0.1,5.0.2,31,5,22,8,30,8,FALSE
markdown-it,5.0.2,5.0.3,32,12,239,96,335,16,FALSE
markdown-it,5.0.3,5.1.0,33,7,264,70,334,20,FALSE
markdown-it,5.1.0,6.0.0,34,17,4044,3068,7112,45,FALSE
markdown-it,6.0.0,6.0.1,35,10,479,248,727,35,FALSE
markdown-it,6.0.1,6.0.2,36,9,107,78,185,14,FALSE
markdown-it,6.0.2,6.0.3,37,3,21,13,34,5,FALSE
markdown-it,6.0.3,6.0.4,38,5,81,7,88,9,TRUE
markdown-it,6.0.4,6.0.5,39,3,52,17,69,6,FALSE
markdown-it,6.0.5,6.1.0,40,4,73,20,93,7,FALSE
markdown-it,6.1.0,6.1.1,41,3,42,16,58,6,FALSE
markdown-it,6.1.1,7.0.0,42,3,158,125,283,5,FALSE
markdown-it,7.0.0,7.0.1,43,10,1366,1328,2694,14,FALSE
markdown-it,7.0.1,8.0.0,44,14,2091,9576,11667,105,FALSE
markdown-it,8.0.0,8.0.1,45,4,69,18,87,7,FALSE
markdown-it,8.0.1,8.1.0,46,3,38,48,86,8,FALSE
markdown-it,8.1.0,8.2.0,47,6,764,587,1351,12,FALSE
markdown-it,8.2.0,8.2.1,48,3,23,7,30,5,TRUE
markdown-it,8.2.1,8.2.2,49,4,71,5,76,7,FALSE
markdown-it,8.2.2,8.3.0,50,9,239,79,318,17,FALSE
markdown-it,8.3.0,8.3.1,51,3,159,24,183,14,FALSE
mversion,0.0.1,0.0.4,1,2,5,5,10,3,TRUE
mversion,0.0.4,0.0.5,2,3,8,6,14,4,TRUE
mversion,0.0.5,0.1.0,3,5,552,350,902,14,FALSE
mversion,0.1.0,0.1.1,4,3,12,8,20,3,TRUE
mversion,0.1.1,0.1.2,5,2,7,5,12,2,TRUE
mversion,0.1.2,0.1.3,6,2,5,4,9,2,FALSE
mversion,0.1.3,0.2.0,7,5,29,24,53,8,FALSE
mversion,0.2.0,0.2.1,8,2,47,35,82,2,FALSE
mversion,0.2.1,0.2.2,9,4,169,9,178,7,FALSE
mversion,0.2.2,0.2.3,10,1,52,9,61,3,FALSE
mversion,0.2.3,0.3.0,11,1,1,1,2,1,TRUE
mversion,0.3.0,0.3.1,12,4,286,3,289,8,FALSE
mversion,0.3.1,0.4.1,13,6,228,647,875,19,FALSE
mversion,0.4.1,0.4.2,14,5,101,13,114,6,FALSE
mversion,0.4.2,0.4.3,15,3,15,3,18,3,FALSE
mversion,0.4.3,0.5.0,16,5,446,189,635,16,FALSE
mversion,0.5.0,0.5.1,17,3,3,4,7,3,TRUE
mversion,0.5.1,1.0.0,18,4,129,22,151,8,TRUE
mversion,1.0.0,1.1.0,19,8,436,230,666,24,FALSE
mversion,1.1.0,1.2.0,20,10,524,207,731,25,TRUE
mversion,1.2.0,1.3.0,21,9,424,259,683,25,FALSE
mversion,1.3.0,1.4.0,22,4,69,13,82,7,FALSE
mversion,1.4.0,1.5.0,23,7,44,42,86,7,TRUE
mversion,1.5.0,1.6.0,24,2,12,2,14,3,TRUE
mversion,1.6.0,1.6.1,25,2,15,3,18,2,FALSE
mversion,1.6.1,1.7.0,26,4,76,15,91,5,FALSE
mversion,1.7.0,1.8.0,27,3,7,3,10,5,FALSE
mversion,1.8.0,1.9.0,28,5,181,5,186,9,FALSE
mversion,1.9.0,1.10.0,29,9,65,61,126,17,FALSE
mversion,1.10.0,1.10.1,30,3,5,2,7,3,FALSE
mysql2,0.0.1,0.0.2,1,14,100,52,152,17,TRUE
mysql2,0.0.2,0.0.3,2,2,26,10,36,5,TRUE
mysql2,0.0.3,0.1.0,3,4,111,14,125,8,FALSE
mysql2,0.1.0,0.1.1,4,6,80,98,178,9,TRUE
mysql2,0.1.1,0.1.2,5,7,109,133,242,11,TRUE
mysql2,0.1.2,0.2.0,6,12,339,22,361,15,FALSE
mysql2,0.2.0,0.2.1,7,4,113,13,126,7,TRUE
mysql2,0.2.1,0.2.2,8,5,123,5,128,6,TRUE
mysql2,0.2.2,0.2.3,9,18,363,44,407,19,FALSE
mysql2,0.2.3,0.2.4,10,13,1236,269,1505,32,TRUE
mysql2,0.2.4,0.3.0,11,34,456,134,590,38,TRUE
mysql2,0.3.0,0.4.0,12,4,126,23,149,13,TRUE
mysql2,0.4.0,0.5.0,13,8,331,56,387,21,FALSE
mysql2,0.5.0,0.6.0,14,5,148,12,160,8,FALSE
mysql2,0.6.0,0.7.0,15,37,1204,965,2169,41,FALSE
mysql2,0.7.0,0.8.0,16,5,826,157,983,26,FALSE
mysql2,0.8.0,0.8.1,17,2,1,6,7,3,TRUE
mysql2,0.8.1,0.8.2,18,11,618,10,628,15,FALSE
mysql2,0.8.2,0.8.3,19,5,30,19,49,5,FALSE
mysql2,0.8.3,0.8.4,20,1,21,2,23,2,FALSE
mysql2,0.8.4,0.8.5,21,2,22,2,24,3,FALSE
mysql2,0.8.5,0.8.6,22,1,12,7,19,4,FALSE
mysql2,0.8.6,0.8.7,23,3,62,11,73,6,FALSE
mysql2,0.8.7,0.8.8,24,1,14,1,15,2,FALSE
mysql2,0.8.8,0.8.9,25,1,21,2,23,2,TRUE
mysql2,0.8.9,0.8.10,26,4,102,24,126,8,FALSE
mysql2,0.8.10,0.8.11,27,1,1,1,2,1,FALSE
mysql2,0.8.11,0.8.12,28,1,3,3,6,2,FALSE
mysql2,0.8.12,0.8.13,29,10,246,30,276,16,FALSE
mysql2,0.8.13,0.8.14,30,3,31,1,32,4,TRUE
mysql2,0.8.14,0.8.15,31,2,4,4,8,2,TRUE
mysql2,0.8.15,0.8.16,32,3,35,3,38,5,TRUE
mysql2,0.8.16,0.8.17,33,4,26,8,34,5,TRUE
mysql2,0.8.17,0.8.18,34,4,104,21,125,9,TRUE
mysql2,0.8.18,0.8.19,35,5,219,72,291,10,FALSE
mysql2,0.8.19,0.8.20,36,7,100,13,113,12,FALSE
mysql2,0.8.20,0.8.21,37,4,14,7,21,5,FALSE
mysql2,0.8.21,0.9.1,38,7,294,31,325,8,FALSE
mysql2,0.9.1,0.9.2,39,4,44,8,52,7,TRUE
mysql2,0.9.2,0.10.1,40,5,58,8,66,9,FALSE
mysql2,0.10.1,0.10.2,41,2,27,2,29,4,FALSE
mysql2,0.10.2,0.10.3,42,4,54,40,94,7,TRUE
mysql2,0.10.3,0.10.4,43,13,55,31,86,13,FALSE
mysql2,0.10.4,0.10.5,44,6,51,15,66,7,FALSE
mysql2,0.10.5,0.10.6,45,11,150,11,161,15,FALSE
mysql2,0.10.6,0.10.7,46,22,1286,1022,2308,32,FALSE
mysql2,0.10.7,0.11.0,47,3,60,26,86,7,TRUE
mysql2,0.11.0,0.11.1,48,3,25,7,32,3,FALSE
mysql2,0.11.1,0.11.2,49,5,191,19,210,12,FALSE
mysql2,0.11.2,0.11.3,50,3,190,2,192,10,FALSE
mysql2,0.11.3,0.11.4,51,6,13,5,18,6,FALSE
mysql2,0.11.4,0.11.5,52,5,1523,439,1962,50,FALSE
mysql2,0.11.5,0.11.6,53,2,1,3,4,2,TRUE
mysql2,0.11.6,0.11.7,54,12,882,89,971,37,FALSE
mysql2,0.11.7,0.11.8,55,14,100,9,109,18,FALSE
mysql2,0.11.8,0.12.0,56,14,785,123,908,38,FALSE
mysql2,0.12.0,0.12.1,57,8,476,152,628,22,FALSE
mysql2,0.12.1,0.12.2,58,8,121,80,201,13,FALSE
mysql2,0.12.2,0.12.3,59,4,36,4,40,5,FALSE
mysql2,0.12.3,0.12.4,60,6,164,19,183,15,FALSE
mysql2,0.12.4,0.12.5,61,5,102,12,114,11,FALSE
mysql2,0.12.5,0.13.0,62,26,843,206,1049,53,FALSE
mysql2,0.13.0,0.14.0,63,4,31,1,32,4,FALSE
mysql2,0.14.0,0.14.1,64,32,748,292,1040,90,FALSE
mysql2,0.14.1,0.15.0,65,57,2817,675,3492,277,FALSE
mysql2,0.15.0,0.15.1,66,8,75,16,91,12,FALSE
mysql2,0.15.1,0.15.2,67,8,355,54,409,12,FALSE
mysql2,0.15.2,0.15.3,68,7,434,217,651,11,FALSE
mysql2,0.15.3,0.15.4,69,15,380,156,536,27,FALSE
mysql2,0.15.4,0.15.5,70,7,184,12,196,13,FALSE
mysql2,0.15.5,0.15.6,71,6,37,17,54,9,FALSE
mysql2,0.15.6,0.15.7,72,2,10,4,14,3,FALSE
mysql2,0.15.7,0.15.8,73,15,306,32,338,38,FALSE
mysql2,0.15.8,1.0.0-rc.1,74,127,5530,2244,7774,194,FALSE
mysql2,1.0.0-rc.1,1.0.0-rc.2,75,99,13121,11098,24219,831,FALSE
mysql2,1.0.0-rc.2,1.0.0-rc.3,76,22,827,210,1037,55,FALSE
mysql2,1.0.0-rc.3,1.0.0-rc.4,77,4,44,10,54,5,FALSE
mysql2,1.0.0-rc.4,1.0.0-rc.5,78,9,74,15,89,10,FALSE
mysql2,1.0.0-rc.5,1.0.0-rc.6,79,42,1581,497,2078,112,FALSE
mysql2,1.0.0-rc.6,1.0.0-rc.7,80,7,93,21,114,10,FALSE
mysql2,1.0.0-rc.7,1.0.0-rc.8,81,12,186,28,214,20,FALSE
mysql2,1.0.0-rc.8,1.0.0-rc.9,82,9,117,38,155,13,FALSE
mysql2,1.0.0-rc.9,1.0.0-rc.10,83,33,2023,1158,3181,85,FALSE
mysql2,1.0.0-rc.10,1.0.0-rc.11,84,16,203,57,260,22,FALSE
mysql2,1.0.0-rc.11,1.0.0-rc.12,85,50,1400,616,2016,249,FALSE
mysql2,1.0.0-rc.12,1.0.0-rc.13,86,13,218,58,276,25,FALSE
mysql2,1.0.0-rc.13,1.0.0,87,6,53684,1,53685,10,FALSE
mysql2,1.0.0,1.1.0,88,44,1509,1003,2512,155,FALSE
mysql2,1.1.0,1.1.1,89,26,502,243,745,54,FALSE
mysql2,1.1.1,1.1.2,90,107,2105,1179,3284,207,FALSE
mysql2,1.1.2,1.2.0,91,33,298,58,356,40,FALSE
mysql2,1.2.0,1.3.0,92,58,5300,3434,8734,225,FALSE
mysql2,1.3.0,1.3.1,93,7,6,6,12,6,FALSE
mysql2,1.3.1,1.3.2,94,4,120,7,127,6,TRUE
normalize-url,1.0.0,1.0.1,1,3,18,19,37,5,FALSE
normalize-url,1.0.1,1.0.2,2,2,20,10,30,4,TRUE
normalize-url,1.0.2,1.1.0,3,11,118,13,131,23,FALSE
normalize-url,1.1.0,1.2.0,4,4,41,7,48,8,FALSE
normalize-url,1.2.0,1.2.1,5,3,3,3,6,3,FALSE
normalize-url,1.2.1,1.3.0,6,3,61,17,78,7,FALSE
normalize-url,1.3.0,1.3.1,7,5,43,57,100,10,FALSE
normalize-url,1.3.1,1.4.0,8,2,2,2,4,2,FALSE
normalize-url,1.4.0,1.4.1,9,5,48,20,68,8,FALSE
normalize-url,1.4.1,1.5.0,10,4,114,73,187,11,FALSE
normalize-url,1.5.0,1.5.1,11,2,5,1,6,3,FALSE
normalize-url,1.5.1,1.5.2,12,1,1,1,2,1,TRUE
normalize-url,1.5.2,1.5.3,13,2,8,1,9,3,FALSE
normalize-url,1.5.3,1.6.0,14,2,34,3,37,4,FALSE
normalize-url,1.6.0,1.6.1,15,3,4,3,7,4,FALSE
normalize-url,1.6.1,1.7.0,16,3,73,14,87,8,FALSE
normalize-url,1.7.0,1.8.0,17,2,7,1,8,3,FALSE
normalize-url,1.8.0,1.9.0,18,2,30,1,31,4,FALSE
normalize-url,1.9.0,1.9.1,19,2,18,3,21,3,FALSE
npm-check,0.0.1,0.0.2,1,2,42,6,48,6,TRUE
npm-check,0.0.2,0.0.3,2,2,3,1,4,3,TRUE
npm-check,0.0.3,0.0.4,3,4,45,45,90,6,FALSE
npm-check,0.0.4,1.0.0,4,1,8,8,16,3,FALSE
npm-check,1.0.0,1.0.2,5,2,9,9,18,2,FALSE
npm-check,1.0.2,2.0.0,6,2,2,2,4,2,FALSE
npm-check,2.0.0,3.0.0,7,7,835,363,1198,40,FALSE
npm-check,3.0.0,3.2.1,8,7,57,63,120,13,FALSE
npm-check,3.2.1,3.2.2,9,1,1,1,2,1,TRUE
npm-check,3.2.2,3.2.3,10,9,74,60,134,11,FALSE
npm-check,3.2.3,3.2.4,11,2,10,6,16,3,TRUE
npm-check,3.2.4,3.2.5,12,2,4,2,6,2,TRUE
npm-check,3.2.5,3.2.6,13,2,2,5,7,3,TRUE
npm-check,3.2.6,3.2.7,14,8,35,18,53,11,FALSE
npm-check,3.2.7,3.2.9,15,2,25,22,47,5,FALSE
npm-check,3.2.9,3.2.10,16,2,2,2,4,2,TRUE
npm-check,3.2.10,4.0.0,17,14,551,1230,1781,54,FALSE
npm-check,4.0.0,4.0.1,18,8,69,23,92,14,TRUE
npm-check,4.0.1,4.0.2,19,5,42,30,72,10,FALSE
npm-check,4.0.2,4.0.3,20,4,26,22,48,10,TRUE
npm-check,4.0.3,4.0.4,21,4,9,10,19,6,FALSE
npm-check,4.0.4,4.1.0,22,4,27,17,44,6,FALSE
npm-check,4.1.0,4.1.1,23,3,3,3,6,3,FALSE
npm-check,4.1.1,4.1.2,24,2,5,5,10,2,TRUE
npm-check,4.1.2,4.1.3,25,7,40,21,61,11,FALSE
npm-check,4.1.3,4.1.4,26,2,3,269,272,4,FALSE
npm-check,4.1.4,5.0.1,27,12,1501,1075,2576,74,FALSE
npm-check,5.0.1,5.0.2,28,11,259,175,434,22,FALSE
npm-check,5.0.2,5.0.3,29,2,7,4,11,4,FALSE
npm-check,5.0.3,5.1.0,30,2,174,141,315,24,TRUE
npm-check,5.1.0,5.1.1,31,3,13,10,23,5,TRUE
npm-check,5.1.1,5.1.2,32,3,8,10,18,6,FALSE
npm-check,5.1.2,5.1.3,33,3,5,5,10,5,TRUE
npm-check,5.1.3,5.2.0,34,5,50,21,71,11,FALSE
npm-check,5.2.0,5.2.1,35,2,2,1,3,2,TRUE
npm-check,5.2.1,5.2.2,36,18,49,15,64,19,FALSE
npm-check,5.2.2,5.2.3,37,6,23,10,33,6,FALSE
npm-check,5.2.3,5.3.0,38,5,9,5,14,7,FALSE
npm-check,5.3.0,5.4.0,39,5,46,27,73,12,TRUE
npm-check,5.4.0,5.4.2,40,21,3870,333,4203,53,FALSE
npm-check,5.4.2,5.4.3,41,2,488,1073,1561,3,TRUE
npm-check,5.4.3,5.4.4,42,2,118,8,126,3,TRUE
npm-run-all,1.0.0,1.0.1,1,3,8,5,13,3,TRUE
npm-run-all,1.0.1,1.0.2,2,4,120,50,170,8,TRUE
npm-run-all,1.0.2,1.0.3,3,7,56,72,128,8,FALSE
npm-run-all,1.0.3,1.1.0,4,2,122,49,171,8,TRUE
npm-run-all,1.1.0,1.1.1,5,2,3,6,9,2,TRUE
npm-run-all,1.1.1,1.1.2,6,2,4,4,8,2,FALSE
npm-run-all,1.1.2,1.1.3,7,5,10,8,18,6,FALSE
npm-run-all,1.1.3,1.2.0,8,13,438,76,514,36,FALSE
npm-run-all,1.2.0,1.2.1,9,2,17,3,20,3,TRUE
npm-run-all,1.2.1,1.2.2,10,2,5,4,9,2,TRUE
npm-run-all,1.2.2,1.2.3,11,8,188,109,297,21,FALSE
npm-run-all,1.2.3,1.2.4,12,2,21,25,46,8,FALSE
npm-run-all,1.2.4,1.2.5,13,3,12,12,24,3,FALSE
npm-run-all,1.2.5,1.2.6,14,3,360,109,469,15,FALSE
npm-run-all,1.2.6,1.2.7,15,4,624,615,1239,20,FALSE
npm-run-all,1.2.7,1.2.8,16,1,1,1,2,1,TRUE
npm-run-all,1.2.8,1.2.9,17,5,50,18,68,13,FALSE
npm-run-all,1.2.9,1.2.10,18,2,1,9,10,2,TRUE
npm-run-all,1.2.10,1.2.11,19,1,1,1,2,1,TRUE
npm-run-all,1.2.11,1.2.12,20,6,70,40,110,12,FALSE
npm-run-all,1.2.12,1.2.13,21,4,125,54,179,9,FALSE
npm-run-all,1.2.13,1.2.14-beta,22,1,1153,780,1933,46,FALSE
npm-run-all,1.2.14-beta,1.3.0,23,3,150,24,174,11,TRUE
npm-run-all,1.3.0,1.3.1,24,1,10,1,11,2,TRUE
npm-run-all,1.3.1,1.3.2,25,2,83,85,168,9,FALSE
npm-run-all,1.3.2,1.3.3,26,6,100,53,153,21,FALSE
npm-run-all,1.3.3,1.3.4,27,4,7,5,12,4,FALSE
npm-run-all,1.3.4,1.4.0,28,3,90,46,136,10,FALSE
npm-run-all,1.4.0,1.5.0,29,5,131,64,195,19,FALSE
npm-run-all,1.5.0,1.5.1,30,5,38,19,57,11,FALSE
npm-run-all,1.5.1,1.5.2,31,7,100,97,197,21,FALSE
npm-run-all,1.5.2,1.5.3-0,32,1,12,5,17,2,FALSE
npm-run-all,1.5.3-0,1.5.3,33,2,4,7,11,2,TRUE
npm-run-all,1.5.3,1.6.0,34,4,41,25,66,15,FALSE
npm-run-all,1.6.0,1.7.0,35,3,343,45,388,17,FALSE
npm-run-all,1.7.0,1.8.0,36,3,654,123,777,24,FALSE
npm-run-all,1.8.0,2.0.0,37,13,5364,2260,7624,207,FALSE
npm-run-all,2.0.0,2.1.0,38,4,313,107,420,10,FALSE
npm-run-all,2.1.0,2.1.1,39,2,6,6,12,5,FALSE
npm-run-all,2.1.1,2.1.2,40,2,2,2,4,2,FALSE
npm-run-all,2.1.2,2.2.0,41,8,386,44,430,21,FALSE
npm-run-all,2.2.0,2.2.1,42,3,18,18,36,4,FALSE
npm-run-all,2.2.1,2.2.2,43,2,2,2,4,2,TRUE
npm-run-all,2.2.2,2.3.0,44,3,1126,1028,2154,63,FALSE
npm-run-all,2.3.0,3.0.0,45,10,216,111,327,25,FALSE
npm-run-all,3.0.0,3.1.0,46,4,353,53,406,28,FALSE
npm-run-all,3.1.0,3.1.1,47,5,11,11,22,11,FALSE
npm-run-all,3.1.1,3.1.2,48,6,208,157,365,24,FALSE
npm-run-all,3.1.2,4.0.0,49,15,678,556,1234,149,FALSE
npm-run-all,4.0.0,4.0.1,50,11,36,40,76,30,FALSE
npm-run-all,4.0.1,4.0.2,51,2,12,3,15,3,FALSE
postcss-mixins,0.1.0,0.1.1,1,5,14,28,42,6,FALSE
postcss-mixins,0.1.1,0.2.0,2,18,161,70,231,27,FALSE
postcss-mixins,0.2.0,0.3.0,3,13,237,151,388,21,FALSE
postcss-mixins,0.3.0,0.4.0,4,9,224,108,332,19,FALSE
postcss-mixins,0.4.0,1.0.0,5,9,193,70,263,12,FALSE
postcss-mixins,1.0.0,1.0.1,6,8,55,18,73,11,FALSE
postcss-mixins,1.0.1,1.0.2,7,7,122,115,237,16,FALSE
postcss-mixins,1.0.2,2.0.0,8,5,94,75,169,8,FALSE
postcss-mixins,2.0.0,2.1.0,9,3,86,33,119,8,TRUE
postcss-mixins,2.1.0,2.1.1,10,5,42,28,70,6,FALSE
postcss-mixins,2.1.1,3.0.0,11,10,218,222,440,20,FALSE
postcss-mixins,3.0.0,3.0.1,12,5,51,22,73,8,FALSE
postcss-mixins,3.0.1,3.0.2,13,3,17,3,20,5,FALSE
postcss-mixins,3.0.2,4.0.0,14,5,18,45,63,7,FALSE
postcss-mixins,4.0.0,4.0.1,15,8,31,143,174,11,FALSE
postcss-mixins,4.0.1,4.0.2,16,9,64,46,110,12,FALSE
postcss-mixins,4.0.2,5.0.0,17,4,10,9,19,5,FALSE
postcss-mixins,5.0.0,5.0.1,18,3,25,19,44,5,FALSE
postcss-mixins,5.0.1,5.1.0,19,4,33,19,52,10,FALSE
postcss-mixins,5.1.0,5.2.0,20,2,21,8,29,6,TRUE
postcss-mixins,5.2.0,5.3.0,21,4,34,13,47,7,FALSE
postcss-mixins,5.3.0,5.4.0,22,3,32,3,35,6,FALSE
postcss-mixins,5.4.0,5.4.1,23,13,4607,1691,6298,27,FALSE
postcss-mixins,5.4.1,6.0.0,24,6,844,866,1710,10,FALSE
preact,1.2.0,1.3.0,1,4,1269,128,1397,17,FALSE
preact,1.3.0,1.3.1,2,4,60,5,65,6,TRUE
preact,1.3.1,1.3.2,3,5,185,5,190,9,FALSE
preact,1.3.2,1.4.0,4,11,223,65,288,14,FALSE
preact,1.4.0,1.5.0,5,14,352,62,414,19,FALSE
preact,1.5.0,1.5.1,6,5,12,8,20,7,FALSE
preact,1.5.1,1.5.2,7,3,4,3,7,4,FALSE
preact,1.5.2,2.0.0,8,8,527,176,703,9,FALSE
preact,2.0.0,2.0.1,9,2,8,3,11,4,FALSE
preact,2.0.1,2.1.0,10,2,7,3,10,4,TRUE
preact,2.1.0,2.2.0,11,2,17,14,31,4,FALSE
preact,2.2.0,2.3.0,12,3,71,24,95,5,FALSE
preact,2.3.0,2.4.0,13,7,160,69,229,31,FALSE
preact,2.4.0,2.4.1,14,2,1,2,3,2,TRUE
preact,2.4.1,2.5.0,15,4,23,11,34,5,TRUE
preact,2.5.0,2.5.1,16,2,4,4,8,2,FALSE
preact,2.5.1,2.6.0,17,3,11,6,17,3,FALSE
preact,2.6.0,2.6.1,18,3,4,3,7,3,TRUE
preact,2.6.1,2.7.0,19,2,4,1,5,2,FALSE
preact,2.7.0,2.7.1,20,2,5,7,12,3,TRUE
preact,2.7.1,2.7.2,21,2,9,4,13,2,TRUE
preact,2.7.2,2.7.3,22,3,6,14,20,3,FALSE
preact,2.7.3,2.8.0,23,16,177,52,229,17,FALSE
preact,2.8.0,2.8.1,24,2,2,2,4,2,TRUE
preact,2.8.1,2.8.2,25,2,6,4,10,2,TRUE
preact,2.8.2,2.8.3,26,15,329,173,502,26,FALSE
preact,3.0.0-beta1,3.0.0-beta2,28,6,9,8,17,6,TRUE
preact,3.0.0-beta2,3.0.0-beta3,29,7,124,45,169,7,FALSE
preact,3.0.0-beta3,3.0.0-beta4,30,3,1151,1110,2261,20,TRUE
preact,3.0.0-beta4,3.0.0,31,1,1,1,2,1,TRUE
preact,3.0.0,3.0.1,32,6,26,16,42,12,TRUE
preact,3.0.1,3.0.2,33,2,4,3,7,2,FALSE
preact,3.0.2,3.1.0,34,5,55,40,95,13,TRUE
preact,3.1.0,3.2.0,35,3,14,10,24,4,TRUE
preact,3.2.0,3.3.0,36,13,278,216,494,21,FALSE
preact,3.3.0,3.4.0,37,3,35,23,58,4,FALSE
preact,3.4.0,4.0.0,38,45,1285,444,1729,59,FALSE
preact,4.0.0,4.0.1,39,6,115,23,138,7,TRUE
preact,4.0.1,4.1.0,40,6,9,8,17,7,FALSE
preact,4.1.0,4.1.1,41,2,2,2,4,2,FALSE
preact,4.1.1,4.1.2,42,13,103,32,135,17,FALSE
preact,4.1.2,4.1.3,43,2,19,5,24,4,TRUE
preact,4.1.3,4.2.0,44,3,47,4,51,6,FALSE
preact,4.2.0,4.3.0,45,4,127,21,148,5,FALSE
preact,4.3.0,4.3.1,46,2,3,4,7,2,TRUE
preact,4.3.1,4.3.2,47,4,13,5,18,5,TRUE
preact,4.3.2,4.4.0,48,6,161,22,183,8,FALSE
preact,4.4.0,4.5.0,49,5,62,19,81,9,FALSE
preact,4.5.0,4.5.1,50,10,19,22,41,11,FALSE
preact,4.5.1,4.6.0,51,13,36,26,62,16,FALSE
preact,4.6.0,4.6.1,52,3,3,3,6,3,TRUE
preact,4.6.1,4.6.2,53,3,13,13,26,3,FALSE
preact,4.6.2,4.6.3,54,2,2,2,4,2,FALSE
preact,4.6.3,4.7.0,55,10,41,42,83,15,FALSE
preact,4.7.0,4.7.1,56,4,47,20,67,6,TRUE
preact,4.7.1,4.7.2,57,2,2,3,5,2,TRUE
preact,4.7.2,4.8.0,58,19,318,93,411,27,FALSE
preact,4.8.0,5.0.0-beta1,59,28,1832,1124,2956,63,FALSE
preact,5.0.0-beta1,5.0.0-beta10,60,66,870,677,1547,100,FALSE
preact,5.0.0-beta10,5.0.0-beta11,61,4,10,6,16,5,FALSE
preact,5.0.0-beta2,5.0.0-beta3,63,4,35,12,47,5,TRUE
preact,5.0.0-beta3,5.0.0-beta4,64,3,19,8,27,3,TRUE
preact,5.0.0-beta4,5.0.0-beta5,65,7,44,56,100,7,FALSE
preact,5.0.0-beta5,5.0.0-beta6,66,13,347,325,672,21,FALSE
preact,5.0.0-beta6,5.0.0-beta7,67,7,54,56,110,14,FALSE
preact,5.0.0-beta7,5.0.0-beta8,68,8,101,29,130,14,FALSE
preact,5.0.0-beta8,5.0.0-beta9,69,2,3,3,6,2,TRUE
preact,5.0.0-beta9,5.0.1-beta.12,70,14,26,24,50,14,FALSE
preact,5.0.1-beta.12,5.0.1-beta.14,71,12,99,92,191,17,FALSE
preact,5.0.1-beta.14,5.0.1-beta.15,72,9,90,40,130,12,FALSE
preact,5.0.1-beta.15,5.1.0-beta.16,73,3,111,49,160,7,TRUE
preact,5.1.0-beta.16,5.1.0-beta.17,74,4,43,17,60,7,TRUE
preact,5.1.0-beta.17,5.1.0-beta.18,75,5,8,6,14,5,FALSE
preact,5.1.0-beta.18,5.1.0-beta.19,76,3,45,10,55,4,TRUE
preact,5.1.0-beta.19,5.1.0-beta.20,77,6,24,12,36,6,FALSE
preact,5.1.0-beta.20,5.1.0-beta.21,78,2,24,2,26,3,FALSE
preact,5.1.0-beta.21,5.1.0-beta.22,79,2,12,2,14,3,TRUE
preact,5.1.0-beta.22,5.1.0-beta.23,80,15,201,191,392,27,FALSE
preact,5.1.0-beta.23,5.1.0-beta.24,81,4,5,5,10,4,FALSE
preact,5.1.0-beta.24,5.1.0-beta.25,82,1,1,1,2,1,TRUE
preact,5.1.0-beta.25,5.1.0-beta.26,83,2,7,3,10,2,TRUE
preact,5.1.0-beta.26,5.2.0-beta.0,84,15,405,126,531,25,FALSE
preact,5.2.0-beta.0,5.3.0,85,15,267,221,488,22,FALSE
preact,5.3.0,5.3.1,86,2,6,4,10,2,TRUE
preact,5.3.1,5.3.2,87,4,44,4,48,4,FALSE
preact,5.3.2,5.4.0,88,6,88,114,202,19,TRUE
preact,5.4.0,5.4.1,89,2,24,2,26,3,FALSE
preact,5.4.1,5.5.0,90,3,61,14,75,4,TRUE
preact,5.5.0,5.6.0,91,17,189,78,267,29,FALSE
preact,5.6.0,5.7.0,92,20,609,36,645,27,FALSE
preact,5.7.0,6.0.0,93,24,145,93,238,33,FALSE
preact,6.0.0,6.0.1,94,3,3,2,5,3,FALSE
preact,6.0.1,6.0.2,95,4,24,7,31,5,FALSE
preact,6.0.2,6.1.0,96,21,218,217,435,34,FALSE
preact,6.1.0,6.2.0,97,24,208,178,386,33,FALSE
preact,6.2.0,6.2.1,98,2,2,2,4,2,TRUE
preact,6.2.1,6.3.0,99,3,78,76,154,12,FALSE
preact,6.3.0,6.4.0,100,15,836,67,903,29,FALSE
preact,6.4.0,7.0.1,101,13,194,71,265,18,FALSE
preact,7.0.1,7.0.2,102,7,22,32,54,6,FALSE
preact,7.0.2,7.0.3,103,3,5,5,10,3,FALSE
preact,7.0.3,7.1.0,104,19,377,141,518,37,FALSE
preact,7.1.0,7.2.0,105,61,1357,434,1791,137,FALSE
preact,7.2.0,7.2.1,106,38,251,104,355,57,FALSE
preact,7.2.1,8.0.0,107,60,2613,876,3489,144,FALSE
preact,8.0.0,8.0.1,108,5,407,71,478,19,TRUE
preact,8.0.1,8.1.0,109,16,1249,1511,2760,103,FALSE
prettier,0.0.1,0.0.2,1,4,210,240,450,18,TRUE
prettier,0.0.2,0.0.3,2,14,354,417,771,33,TRUE
prettier,0.0.3,0.0.4,3,31,15900,15515,31415,390,TRUE
prettier,0.0.4,0.0.5,4,26,6529,1188,7717,424,TRUE
prettier,0.0.5,0.0.6,5,61,4475,2072,6547,141,FALSE
prettier,0.0.6,0.0.7,6,11,226,146,372,36,TRUE
prettier,0.0.7,0.0.8,7,29,1461,882,2343,186,FALSE
prettier,0.0.8,0.0.9,8,27,1935,328,2263,194,FALSE
prettier,0.0.9,0.0.10,9,26,1727,688,2415,89,FALSE
prettier,0.0.10,0.11.0,10,46,1556,437,1993,146,FALSE
prettier,0.11.0,0.13.1,11,48,11361,10531,21892,2317,FALSE
prettier,0.13.1,0.14.0,12,9,5378,1335,6713,113,FALSE
prettier,0.14.0,0.14.1,13,2,145,352,497,38,TRUE
prettier,0.14.1,0.15.0,14,19,1616,369,1985,161,FALSE
prettier,0.15.0,0.16.0,15,19,1077,355,1432,110,FALSE
prettier,0.16.0,0.17.0,16,31,7838,6456,14294,127,FALSE
prettier,0.17.0,0.17.1,17,3,46,3,49,5,TRUE
prettier,0.17.1,0.18.0,18,15,699,273,972,65,FALSE
prettier,0.18.0,0.19.0,19,30,12387,10482,22869,528,FALSE
prettier,0.19.0,0.20.0,20,20,29926,216,30142,77,FALSE
prettier,0.20.0,0.21.0,21,19,1051,188,1239,56,FALSE
prettier,0.21.0,0.22.0,22,32,6301,930,7231,208,FALSE
prettier,0.22.0,1.0.0,23,123,36799,24623,61422,2229,FALSE
prettier,1.0.0,1.0.1,24,1,3,1,4,1,TRUE
prettier,1.0.1,1.0.2,25,1,2,2,4,2,TRUE
prettier,1.0.2,1.1.0,26,12,331,162,493,25,TRUE
prettier,1.1.0,1.2.0,27,26,1002,222,1224,55,FALSE
prettier,1.2.0,1.2.1,28,2,35,12,47,6,TRUE
prettier,1.2.1,1.2.2,29,2,21,4,25,6,TRUE
prettier,1.2.2,1.3.0,30,48,11600,4851,16451,286,FALSE
prettier,1.3.0,1.3.1,31,7,1249,195,1444,42,TRUE
protobufjs,0.0.0,0.9.1,1,1,18,13,31,8,FALSE
protobufjs,0.9.1,0.9.3,2,1,18,13,31,8,TRUE
protobufjs,0.9.3,0.9.4,3,1,18,13,31,8,TRUE
protobufjs,0.9.4,0.9.5,4,1,18,13,31,8,FALSE
protobufjs,0.9.5,0.9.6,5,1,18,13,31,8,TRUE
protobufjs,0.9.6,0.9.7,6,1,18,13,31,8,FALSE
protobufjs,0.9.7,0.9.8,7,1,18,13,31,8,FALSE
protobufjs,0.9.8,0.9.9,8,1,18,13,31,8,FALSE
protobufjs,0.9.9,0.9.10,9,1,18,13,31,8,TRUE
protobufjs,0.9.10,0.9.11,10,1,18,13,31,8,TRUE
protobufjs,0.9.11,0.9.12,11,1,18,13,31,8,TRUE
protobufjs,0.9.12,0.9.13,12,1,18,13,31,8,TRUE
protobufjs,0.9.13,0.10.0,13,1,18,13,31,8,TRUE
protobufjs,0.10.0,0.11.0,14,1,18,13,31,8,TRUE
protobufjs,0.11.0,0.11.1,15,1,18,13,31,8,TRUE
protobufjs,0.11.1,0.11.2,16,1,18,13,31,8,TRUE
protobufjs,0.11.2,0.12.0,17,1,18,13,31,8,TRUE
protobufjs,0.12.0,0.12.1,18,1,18,13,31,8,TRUE
protobufjs,0.12.1,0.12.2,19,1,18,13,31,8,FALSE
protobufjs,0.12.2,0.12.3,20,1,18,13,31,8,FALSE
protobufjs,0.12.3,0.12.4,21,1,18,13,31,8,FALSE
protobufjs,0.12.4,0.12.5,22,1,18,13,31,8,TRUE
protobufjs,0.12.5,0.12.6,23,1,18,13,31,8,TRUE
protobufjs,0.12.6,0.12.7,24,1,18,13,31,8,TRUE
protobufjs,0.12.7,0.12.8,25,1,18,13,31,8,FALSE
protobufjs,0.12.8,0.12.9,26,1,18,13,31,8,FALSE
protobufjs,0.12.9,0.12.10,27,1,18,13,31,8,FALSE
protobufjs,0.12.10,0.12.11,28,1,18,13,31,8,TRUE
protobufjs,0.12.11,0.12.12,29,1,18,13,31,8,TRUE
protobufjs,0.12.12,0.12.13,30,1,18,13,31,8,TRUE
protobufjs,0.12.13,1.0.0-b1,31,1,18,13,31,8,FALSE
protobufjs,1.0.0-b1,1.0.0-b2,32,1,18,13,31,8,TRUE
protobufjs,1.0.0-b2,1.0.0-b4,33,1,18,13,31,8,FALSE
protobufjs,1.0.0-b4,1.0.0-b5,34,1,18,13,31,8,FALSE
protobufjs,1.0.0-b5,1.0.0-b6,35,1,18,13,31,8,FALSE
protobufjs,1.0.0-b6,1.0.0,36,1,18,13,31,8,TRUE
protobufjs,1.0.0,1.0.1,37,1,18,13,31,8,FALSE
protobufjs,1.0.1,1.0.2,38,1,18,13,31,8,TRUE
protobufjs,1.0.2,1.0.3,39,1,18,13,31,8,TRUE
protobufjs,1.0.3,1.0.4,40,1,18,13,31,8,FALSE
protobufjs,1.0.4,1.1.0,41,1,18,13,31,8,TRUE
protobufjs,1.1.0,1.1.1,42,1,18,13,31,8,FALSE
protobufjs,1.1.1,1.1.2,43,1,18,13,31,8,TRUE
protobufjs,1.1.2,1.1.3,44,1,18,13,31,8,TRUE
protobufjs,1.1.3,1.1.4,45,1,18,13,31,8,FALSE
protobufjs,1.1.4,1.1.6,46,1,18,13,31,8,FALSE
protobufjs,1.1.6,1.1.7,47,1,18,13,31,8,FALSE
protobufjs,1.1.7,1.1.8,48,1,18,13,31,8,FALSE
protobufjs,1.1.8,1.1.9,49,1,18,13,31,8,FALSE
protobufjs,1.1.9,1.3.0,50,1,18,13,31,8,FALSE
protobufjs,1.3.0,1.3.1,51,1,18,13,31,8,FALSE
protobufjs,1.3.1,1.3.2,52,1,18,13,31,8,TRUE
protobufjs,1.3.2,1.5.0,53,1,18,13,31,8,FALSE
protobufjs,1.5.0,1.5.1,54,1,18,13,31,8,TRUE
protobufjs,1.5.1,2.0.0-rc1,55,1,18,13,31,8,FALSE
protobufjs,2.0.0-rc1,2.0.0-rc2,56,1,18,13,31,8,TRUE
protobufjs,2.0.0-rc2,2.0.0-rc4,57,1,18,13,31,8,FALSE
protobufjs,2.0.0-rc4,2.0.0,58,1,18,13,31,8,FALSE
protobufjs,2.0.0,2.0.1,59,1,18,13,31,8,FALSE
protobufjs,2.0.1,2.0.2,60,1,18,13,31,8,FALSE
protobufjs,2.0.2,2.0.3,61,1,18,13,31,8,FALSE
protobufjs,2.0.3,2.0.4,62,1,18,13,31,8,FALSE
protobufjs,2.0.4,2.0.5,63,1,18,13,31,8,FALSE
protobufjs,2.0.5,2.2.1,64,1,18,13,31,8,FALSE
protobufjs,2.2.1,3.0.0,65,1,18,13,31,8,FALSE
protobufjs,3.0.0,3.2.0,66,1,18,13,31,8,FALSE
protobufjs,3.2.0,3.2.1,67,1,18,13,31,8,FALSE
protobufjs,3.2.1,3.2.2,68,1,18,13,31,8,FALSE
protobufjs,3.2.2,3.2.4,69,1,18,13,31,8,FALSE
protobufjs,3.2.4,3.3.0,70,1,18,13,31,8,FALSE
protobufjs,3.3.0,3.3.1,71,1,18,13,31,8,FALSE
protobufjs,3.3.1,3.4.0,72,1,18,13,31,8,TRUE
protobufjs,3.4.0,3.4.1,73,1,18,13,31,8,FALSE
protobufjs,3.4.1,3.5.1,74,1,18,13,31,8,FALSE
protobufjs,3.5.1,3.5.2,75,1,18,13,31,8,TRUE
protobufjs,3.5.2,3.5.4,76,1,18,13,31,8,FALSE
protobufjs,3.5.4,3.5.5,77,1,18,13,31,8,TRUE
protobufjs,3.5.5,3.6.0,78,1,18,13,31,8,TRUE
protobufjs,3.6.0,3.7.0,79,1,18,13,31,8,FALSE
protobufjs,3.7.0,3.8.0,80,1,18,13,31,8,FALSE
protobufjs,3.8.0,3.8.1,81,1,18,13,31,8,FALSE
protobufjs,3.8.1,3.8.2,82,1,18,13,31,8,FALSE
protobufjs,3.8.2,4.0.0-b2,83,1,18,13,31,8,FALSE
protobufjs,4.0.0-b2,4.0.0-b3,84,1,18,13,31,8,FALSE
protobufjs,4.0.0-b3,4.0.0-b4,85,1,18,13,31,8,FALSE
protobufjs,4.0.0-b4,4.0.0-b5,86,1,18,13,31,8,FALSE
protobufjs,4.0.0-b5,4.0.0,87,1,18,13,31,8,FALSE
protobufjs,4.0.0,4.1.0,88,1,18,13,31,8,FALSE
protobufjs,4.1.0,4.1.1,89,1,18,13,31,8,TRUE
protobufjs,4.1.1,4.1.2,90,1,18,13,31,8,FALSE
protobufjs,4.1.2,4.1.3,91,1,18,13,31,8,FALSE
protobufjs,5.0.0,5.0.1,93,1,18,13,31,8,FALSE
protobufjs,5.0.1,5.0.2,94,370,142580,83734,226314,4349,FALSE
protobufjs,6.0.0,6.0.1,96,17,1119,958,2077,123,FALSE
protobufjs,6.0.1,6.0.2,97,23,3596,1679,5275,189,FALSE
protobufjs,6.0.2,6.1.0,98,54,10865,7388,18253,481,FALSE
protobufjs,6.1.0,6.1.1,99,21,4739,1418,6157,179,FALSE
protobufjs,6.1.1,6.2.0,100,22,6513,4783,11296,223,FALSE
protobufjs,6.2.0,6.2.1,101,12,2431,1009,3440,149,TRUE
protobufjs,6.2.1,6.3.0,102,52,16408,8911,25319,676,FALSE
protobufjs,6.3.0,6.3.1,103,6,567,476,1043,80,FALSE
protobufjs,6.3.1,6.4.0,104,36,41378,27574,68952,384,FALSE
protobufjs,6.4.0,6.4.1,105,13,936,743,1679,100,TRUE
protobufjs,6.4.1,6.4.3,106,11,546,426,972,105,FALSE
protobufjs,6.4.3,6.4.4,107,4,29,19,48,14,TRUE
protobufjs,6.4.4,6.4.5,108,5,523,459,982,34,FALSE
protobufjs,6.4.5,6.4.6,109,5,647,546,1193,59,FALSE
protobufjs,6.4.6,6.5.0,110,30,21942,19693,41635,556,FALSE
protobufjs,6.5.0,6.5.1,111,4,567,130,697,43,TRUE
protobufjs,6.5.1,6.5.2,112,8,1536,548,2084,156,FALSE
protobufjs,6.5.2,6.5.3,113,1,194,47,241,24,TRUE
protobufjs,6.5.3,6.6.0,114,24,8004,5653,13657,449,FALSE
protobufjs,6.6.0,6.6.1,115,3,154,177,331,29,TRUE
protobufjs,6.6.1,6.6.2,116,13,1559,789,2348,193,FALSE
protobufjs,6.6.2,6.6.3,117,10,1056,462,1518,79,FALSE
protobufjs,6.6.3,6.6.4,118,15,1784,846,2630,168,FALSE
protobufjs,6.6.4,6.6.5,119,7,247,135,382,43,FALSE
protobufjs,6.6.5,6.7.0,120,87,16772,12090,28862,706,FALSE
protobufjs,6.7.0,6.7.1,121,11,1464,1345,2809,64,FALSE
protobufjs,6.7.1,6.7.2,122,12,2281,1562,3843,59,FALSE
protobufjs,6.7.2,6.7.3,123,1,9,49,58,4,TRUE
protype,0.0.0,0.1.0,1,1,39,24,63,4,FALSE
protype,0.1.0,0.2.0,2,1,17,17,34,4,TRUE
protype,0.2.0,0.3.0,3,1,17,29,46,4,FALSE
protype,0.3.0,0.4.0,4,1,8,8,16,3,TRUE
protype,0.4.0,0.5.0,5,4,623,165,788,25,FALSE
protype,0.5.0,0.6.0,6,2,6,6,12,6,TRUE
protype,0.6.0,0.7.0,7,1,3,3,6,3,TRUE
protype,0.7.0,0.8.0,8,1,228,19,247,8,FALSE
protype,0.8.0,0.9.0,9,3,2087,101,2188,7,FALSE
protype,0.9.0,0.10.0,10,1,44,9,53,7,FALSE
protype,0.10.0,0.11.0,11,1,17,17,34,4,TRUE
protype,0.11.0,0.12.0,12,1,612,310,922,8,FALSE
protype,0.12.0,0.13.0,13,1,19,8,27,6,TRUE
protype,0.13.0,0.14.0,14,1,12,12,24,6,TRUE
protype,0.14.0,0.15.0,15,5,2552,2542,5094,20,FALSE
protype,0.15.0,0.16.0,16,4,502,504,1006,20,FALSE
protype,0.16.0,0.17.0,17,2,157,144,301,9,TRUE
protype,0.17.0,0.18.0,18,2,73,59,132,5,FALSE
protype,0.18.0,0.19.0,19,2,57,74,131,6,FALSE
protype,0.19.0,0.20.0,20,2,87,80,167,5,FALSE
protype,0.20.0,0.21.0,21,2,36,35,71,5,FALSE
react-redux,0.1.0,0.2.0,1,4,6,4,10,4,FALSE
react-redux,0.2.0,0.2.1,2,1,1,1,2,1,TRUE
react-redux,0.2.1,0.2.2,3,3,6,11,17,4,TRUE
react-redux,0.2.2,0.3.0,4,30,1869,1684,3553,98,FALSE
react-redux,0.3.0,0.4.0,5,2,29,152,181,10,TRUE
react-redux,0.4.0,0.5.0,6,25,1936,1423,3359,66,TRUE
react-redux,0.5.0,0.5.1,7,13,128,115,243,14,TRUE
react-redux,0.5.1,0.5.2,8,5,129,39,168,7,TRUE
react-redux,0.5.2,0.5.3,9,2,56,10,66,3,TRUE
react-redux,0.5.3,0.6.0,10,3,447,371,818,9,TRUE
react-redux,0.6.0,0.7.0,11,6,139,131,270,7,FALSE
react-redux,0.7.0,0.8.0,12,9,199,39,238,13,TRUE
react-redux,0.8.0,0.8.1,13,8,115,15,130,10,FALSE
react-redux,0.8.1,0.8.2,14,5,153,65,218,6,TRUE
react-redux,0.8.2,0.9.0,15,10,522,69,591,15,FALSE
react-redux,1.0.0-alpha,1.0.0,17,141,6438,4486,10924,291,FALSE
react-redux,1.0.0,1.0.1,18,4,4,4,8,4,FALSE
react-redux,1.0.1,2.0.0,19,10,155,119,274,16,FALSE
react-redux,2.0.0,2.1.0,20,15,195,44,239,18,FALSE
react-redux,2.1.0,2.1.1,21,5,110,27,137,9,FALSE
react-redux,2.1.1,2.1.2,22,2,3,3,6,2,FALSE
react-redux,2.1.2,3.0.0-alpha,23,10,1093,1005,2098,16,FALSE
react-redux,3.0.0-alpha,3.0.0,24,5,135,34,169,6,FALSE
react-redux,3.0.0,3.0.1,25,4,123,1,124,5,FALSE
react-redux,3.0.1,3.1.0,26,10,107,63,170,19,FALSE
react-redux,3.1.0,3.1.1,27,43,2730,2842,5572,134,FALSE
react-redux,3.1.1,3.1.2,28,4,107,8,115,6,TRUE
react-redux,4.0.0,4.0.1,30,37,1871,1759,3630,93,FALSE
react-redux,4.0.1,4.0.2,31,7,193,21,214,9,FALSE
react-redux,4.0.2,4.0.3,32,5,287,137,424,7,FALSE
react-redux,4.0.3,4.0.4,33,3,6,4,10,3,TRUE
react-redux,4.0.4,4.0.5,34,2,2,2,4,2,FALSE
react-redux,4.0.5,4.0.6,35,4,69,45,114,17,FALSE
react-redux,4.0.6,4.1.0,36,5,44,27,71,6,FALSE
react-redux,4.1.0,4.1.1,37,2,3,2,5,2,TRUE
react-redux,4.1.1,4.1.2,38,2,30,20,50,2,TRUE
react-redux,4.1.2,4.2.0,39,3,38,88,126,10,FALSE
react-redux,4.2.0,4.2.1,40,5,115,62,177,13,TRUE
react-redux,4.2.1,4.3.0,41,9,436,243,679,12,FALSE
react-redux,4.3.0,4.4.0,42,2,1,2,3,2,FALSE
react-redux,4.4.0,4.4.1,43,12,34,32,66,19,FALSE
react-redux,4.4.1,4.4.2,44,11,164,46,210,22,FALSE
react-redux,4.4.2,4.4.3,45,6,239,163,402,10,FALSE
react-redux,4.4.3,4.4.4,46,3,127,13,140,5,TRUE
react-redux,4.4.4,4.4.5,47,5,152,24,176,6,FALSE
react-redux,4.4.5,4.4.6,48,121,5222,3736,8958,312,FALSE
react-redux,4.4.6,4.4.7,49,45,5125,1232,6357,66,FALSE
react-redux,4.4.7,4.4.8,50,7,549,502,1051,14,FALSE
react-redux,5.0.0-alpha.1,5.0.0-beta.1,52,12,1314,493,1807,46,FALSE
react-redux,5.0.0-beta.1,5.0.0-beta.2,53,9,243,108,351,20,FALSE
react-redux,5.0.0-beta.2,5.0.0-beta.3,54,2,2,44,46,3,TRUE
react-redux,5.0.0-beta.3,5.0.0-rc.1,55,9,4015,314,4329,19,FALSE
react-redux,5.0.0-rc.1,5.0.0-rc.2,56,3,200,208,408,6,FALSE
react-redux,5.0.0-rc.2,5.0.0,57,1,1,1,2,1,TRUE
react-redux,5.0.0,5.0.1,58,4,39,12,51,4,TRUE
react-redux,5.0.1,5.0.2,59,10,203,155,358,12,FALSE
react-redux,5.0.2,5.0.3,60,18,718,544,1262,25,FALSE
react-redux,5.0.3,5.0.4,61,9,551,503,1054,16,FALSE
react-redux,5.0.4,5.0.5,62,9,278,487,765,16,FALSE
react-router,0.0.0,0.0.1,1,296,202475,198777,401252,792,FALSE
react-router,0.0.1,0.4.0,2,65,9993,6908,16901,157,FALSE
react-router,0.4.0,0.4.1,3,7,35,10,45,9,TRUE
react-router,0.4.1,0.4.2,4,8,158,34,192,20,FALSE
react-router,0.4.2,0.5.0,5,2,16,9,25,6,TRUE
react-router,0.5.0,0.5.1,6,50,2521,1274,3795,175,FALSE
react-router,0.5.1,0.5.2,7,14,607,144,751,62,FALSE
react-router,0.5.2,0.5.3,8,55,2526,1725,4251,149,FALSE
react-router,0.5.3,0.6.0,9,32,2792,1346,4138,120,FALSE
react-router,0.6.0,0.6.1,10,8,1634,953,2587,16,FALSE
react-router,0.6.1,0.7.0,11,17,1368,1042,2410,109,FALSE
react-router,0.7.0,0.8.0,12,64,8997,6825,15822,269,FALSE
react-router,0.8.0,0.9.0,13,29,3164,3340,6504,107,FALSE
react-router,0.9.0,0.9.1,14,5,43,24,67,10,TRUE
react-router,0.9.1,0.9.2,15,18,645,800,1445,59,FALSE
react-router,0.9.2,0.9.3,16,3,30,12,42,9,TRUE
react-router,0.9.3,0.9.4,17,59,5564,1221,6785,125,FALSE
react-router,0.9.4,0.9.5,18,10,209,91,300,21,FALSE
react-router,0.9.5,0.10.0,19,2,1080,1054,2134,8,TRUE
react-router,0.10.0,0.10.1,20,4,51,48,99,8,FALSE
react-router,0.10.1,0.10.2,21,4,99,183,282,17,TRUE
react-router,0.10.2,0.11.0,22,122,8393,13035,21428,478,FALSE
react-router,0.11.0,0.11.1,23,4,106,28,134,11,TRUE
react-router,0.11.1,0.11.2,24,24,359,87,446,38,FALSE
react-router,0.11.2,0.11.3,25,19,1892,385,2277,42,FALSE
react-router,0.11.3,0.11.4,26,9,166,75,241,18,FALSE
react-router,0.11.4,0.11.5,27,32,755,321,1076,83,FALSE
react-router,0.11.5,0.11.6,28,8,128,93,221,17,FALSE
react-router,0.11.6,0.12.0,29,122,11960,11445,23405,312,FALSE
react-router,0.12.0,0.12.1,30,46,5398,1766,7164,150,FALSE
react-router,0.12.1,0.12.2,31,2,296,433,729,13,TRUE
react-router,0.12.2,0.12.3,32,11,1632,1589,3221,52,TRUE
react-router,0.12.3,0.12.4,33,3,118,84,202,16,TRUE
react-router,0.12.4,0.13.0,34,49,2173,2158,4331,122,FALSE
react-router,0.13.0,0.13.1,35,2,91,85,176,8,TRUE
react-router,0.13.1,0.13.2,36,33,711,426,1137,74,FALSE
react-router,0.13.2,0.13.3,37,29,4243,2498,6741,152,FALSE
react-router,0.13.3,0.13.4,38,794,55492,63487,118979,2767,FALSE
react-router,0.13.4,0.13.5,39,208,5289,1728,7017,529,FALSE
react-router,0.13.5,0.13.6,40,801,28163,20782,48945,2207,FALSE
react-router,1.0.0-alpha1,1.0.0-alpha2,42,9,22,1241,1263,10,TRUE
react-router,1.0.0-alpha2,1.0.0-beta1,43,33,1175,962,2137,61,FALSE
react-router,1.0.0-beta1,1.0.0-beta2,44,30,1268,817,2085,49,FALSE
react-router,1.0.0-beta2,1.0.0-beta3,45,78,1437,755,2192,190,FALSE
react-router,1.0.0-beta3,1.0.0-beta4,46,101,9312,5456,14768,323,FALSE
react-router,1.0.0-beta4,1.0.0-rc1,47,122,7032,12903,19935,498,FALSE
react-router,1.0.0-rc1,1.0.0-rc2,48,174,7068,5788,12856,542,FALSE
react-router,1.0.0-rc2,1.0.0-rc3,49,9,142,34,176,17,TRUE
react-router,1.0.0-rc3,1.0.0-rc4,50,174,4663,1383,6046,451,FALSE
react-router,1.0.0-rc4,1.0.0,51,33,1136,2279,3415,56,FALSE
react-router,1.0.0,1.0.1,52,73,1311,1059,2370,153,FALSE
react-router,1.0.1,1.0.2,53,36,1671,752,2423,88,FALSE
react-router,1.0.2,1.0.3,54,62,5163,2122,7285,265,FALSE
react-router,1.0.3,2.0.0-rc1,55,8,784,963,1747,19,FALSE
react-router,2.0.0-rc1,2.0.0-rc2,56,8,135,38,173,23,TRUE
react-router,2.0.0-rc2,2.0.0-rc3,57,18,137,97,234,18,TRUE
react-router,2.0.0-rc3,2.0.0-rc4,58,3,13,2,15,3,TRUE
react-router,2.0.0-rc4,2.0.0-rc5,59,78,738,374,1112,128,FALSE
react-router,2.0.0-rc5,2.0.0-rc6,60,60,1136,560,1696,117,FALSE
react-router,2.0.0-rc6,2.0.0,61,7,44,14,58,20,FALSE
react-router,2.0.0,2.0.1,62,54,901,454,1355,92,FALSE
react-router,2.0.1,2.1.0,63,55,1174,621,1795,138,FALSE
react-router,2.1.0,2.1.1,64,3,49,144,193,7,TRUE
react-router,2.1.1,2.2.0,65,16,719,207,926,65,FALSE
react-router,2.2.0,2.2.1,66,4,22,8,30,6,TRUE
react-router,2.2.1,2.2.2,67,4,30,13,43,5,TRUE
react-router,2.2.2,2.2.4,68,9,107,77,184,10,FALSE
react-router,2.2.4,2.3.0,69,13,445,116,561,40,FALSE
react-router,2.3.0,2.4.0,70,40,1043,3773,4816,137,FALSE
react-router,2.4.0,2.4.1,71,49,1441,1205,2646,132,FALSE
react-router,2.4.1,2.5.0,72,85,6856,3823,10679,312,FALSE
react-router,2.5.0,2.5.1,73,8,183,26,209,17,FALSE
react-router,2.5.1,2.5.2,74,22,1006,349,1355,70,FALSE
react-router,2.5.2,2.6.0,75,52,1876,1705,3581,284,FALSE
react-router,2.6.0,2.6.1,76,41,936,793,1729,107,FALSE
react-router,2.6.1,2.7.0,77,89,3355,2909,6264,323,FALSE
react-router,2.7.0,2.8.0,78,61,7406,17307,24713,494,FALSE
react-router,2.8.0,2.8.1,79,36,680,657,1337,78,FALSE
react-router,3.0.0-alpha.1,3.0.0-alpha.2,81,173,10143,6103,16246,701,FALSE
react-router,3.0.0-alpha.2,3.0.0-alpha.3,82,41,932,772,1704,122,FALSE
react-router,3.0.0-alpha.3,3.0.0-beta.1,83,236,12047,21098,33145,985,FALSE
react-router,3.0.0-beta.1,3.0.0,84,68,2556,917,3473,168,FALSE
react-router,3.0.0,3.0.1,85,103,11692,7753,19445,425,FALSE
react-router,3.0.1,3.0.2,86,24,930,687,1617,61,FALSE
react-router,3.0.2,3.0.3,87,335,69794,39586,109380,1886,FALSE
react-router,3.0.3,3.0.4,88,9,124,80,204,58,FALSE
react-router,3.0.4,3.0.5,89,1,1,1,2,1,FALSE
react-router,4.0.0-0,4.0.0-1,91,3,21,17,38,4,TRUE
react-router,4.0.0-1,4.0.0-2,92,3,14,7,21,4,TRUE
react-router,4.0.0-2,4.0.0-alpha.3,93,68,1030,421,1451,145,FALSE
react-router,4.0.0-alpha.3,4.0.0-alpha.4,94,24,766,553,1319,77,FALSE
react-router,4.0.0-alpha.4,4.0.0-alpha.5,95,27,943,144,1087,59,FALSE
react-router,4.0.0-alpha.5,4.0.0-alpha.6,96,34,1249,646,1895,61,FALSE
react-router,4.0.0-alpha.6,4.0.0-beta.1,97,193,25029,12152,37181,1017,FALSE
react-router,4.0.0-beta.1,4.0.0-beta.2,98,4,34,109,143,13,TRUE
react-router,4.0.0-beta.2,4.0.0-beta.3,99,9,73,46,119,14,TRUE
react-router,4.0.0-beta.3,4.0.0-beta.4,100,22,281,55,336,37,FALSE
react-router,4.0.0-beta.4,4.0.0-beta.5,101,20,450,114,564,55,FALSE
react-router,4.0.0-beta.5,4.0.0-beta.6,102,17,163,95,258,37,FALSE
react-router,4.0.0-beta.6,4.0.0-beta.7,103,53,2444,859,3303,188,FALSE
react-router,4.0.0-beta.7,4.0.0-beta.8,104,42,12636,2035,14671,272,FALSE
react-router,4.0.0-beta.8,4.0.0,105,26,38817,31357,70174,612,FALSE
react-router,4.0.0,4.1.0,106,69,2275,884,3159,162,FALSE
react-router,4.1.0,4.1.1,107,4,749,51,800,7,FALSE
redux-saga,0.1.0,0.1.1,1,1,2,1,3,1,TRUE
redux-saga,0.1.1,0.2.0,2,14,4555,3552,8107,78,FALSE
redux-saga,0.2.0,0.2.2,3,19,53574,820,54394,51,FALSE
redux-saga,0.2.2,0.3.0,4,14,3138,2266,5404,40,FALSE
redux-saga,0.3.0,0.3.1,5,13,1965,1660,3625,16,TRUE
redux-saga,0.3.1,0.3.2,6,11,1237,77933,79170,47,FALSE
redux-saga,0.3.2,0.3.3,7,10,25954,38,25992,13,FALSE
redux-saga,0.3.3,0.4.0,8,36,2639,1222,3861,102,FALSE
redux-saga,0.4.0,0.4.1,9,5,88,19,107,5,TRUE
redux-saga,0.4.1,0.5.0,10,28,2083,26058,28141,49,FALSE
redux-saga,0.5.0,0.6.0,11,32,3674,917,4591,91,FALSE
redux-saga,0.6.0,0.6.1,12,13,241,186,427,15,FALSE
redux-saga,0.6.1,0.7.0,13,26,2514,1080,3594,114,FALSE
redux-saga,0.7.0,0.8.0,14,69,4722,1392,6114,200,FALSE
redux-saga,0.8.0,0.8.1,15,6,133,8,141,7,TRUE
redux-saga,0.8.1,0.8.2,16,17,394,118,512,22,FALSE
redux-saga,0.8.2,0.9.0,17,63,916,384,1300,106,FALSE
redux-saga,0.9.0,0.9.1,18,9,155,78,233,20,TRUE
redux-saga,0.9.1,0.9.2,19,14,69,58,127,19,FALSE
redux-saga,0.9.2,0.9.3,20,14,619,85,704,27,FALSE
redux-saga,0.9.3,0.9.4,21,7,57,23,80,8,FALSE
redux-saga,0.9.4,0.9.5,22,30,179,84,263,36,FALSE
redux-saga,0.9.5,0.10.0,23,139,6122,3764,9886,321,FALSE
redux-saga,0.10.0,0.10.1,24,18,1225,799,2024,27,FALSE
redux-saga,0.10.1,0.10.2,25,10,977,1702,2679,63,FALSE
redux-saga,0.10.2,0.10.3,26,29,685,463,1148,59,FALSE
redux-saga,0.10.3,0.10.4,27,9,170,187,357,14,TRUE
redux-saga,0.10.4,0.10.5,28,52,1733,302,2035,94,FALSE
redux-saga,0.10.5,0.11.0,29,36,328,110,438,50,FALSE
redux-saga,0.11.0,0.11.1,30,79,1037,370,1407,99,FALSE
redux-saga,0.11.1,0.12.0,31,44,2185,1322,3507,154,FALSE
redux-saga,0.12.0,0.12.1,32,42,465,193,658,54,FALSE
redux-saga,0.12.1,0.13.0,33,10,839,345,1184,30,FALSE
redux-saga,0.13.0,0.14.0,34,64,2581,1971,4552,167,FALSE
redux-saga,0.14.0,0.14.1,35,24,411,233,644,49,FALSE
redux-saga,0.14.1,0.14.2,36,17,2174,520,2694,58,FALSE
redux-saga,0.14.2,0.14.3,37,13,233,176,409,18,FALSE
redux-saga,0.14.3,0.14.4,38,80,4186,878,5064,206,FALSE
redux-saga,0.14.4,0.14.5,39,4,32,39,71,8,FALSE
redux-saga,0.14.5,0.14.6,40,3,1849,335,2184,48,FALSE
redux-saga,0.14.6,0.14.7,41,15,2362,2541,4903,36,FALSE
redux-saga,0.14.7,0.14.8,42,6,319,83,402,35,FALSE
redux-saga,0.14.8,0.15.0,43,10,2976,897,3873,71,FALSE
redux-saga,0.15.0,0.15.1,44,7,76,143,219,13,FALSE
redux-saga,0.15.1,0.15.2,45,8,78,332,410,10,FALSE
redux-saga,0.15.2,0.15.3,46,8,19,14,33,10,TRUE
requirejs,0.26.0,0.27.0,1,31,79239,44276,123515,93,FALSE
requirejs,0.27.0,0.27.1,2,13,27042,35126,62168,48,FALSE
requirejs,0.27.1,1.0.0,3,2,9049,7,9056,5,FALSE
requirejs,1.0.0,1.0.1,4,5,534,43323,43857,19,FALSE
requirejs,1.0.1,1.0.2,5,11,27497,18204,45701,38,FALSE
requirejs,1.0.2,1.0.3,6,34,1857,9494,11351,122,FALSE
requirejs,1.0.3,1.0.4,7,8,614,72,686,25,FALSE
requirejs,1.0.4,1.0.5,8,29,1516,9707,11223,80,FALSE
requirejs,1.0.5,1.0.6,9,22,1097,261,1358,55,FALSE
requirejs,1.0.6,1.0.7,10,25,685,160,845,84,FALSE
requirejs,1.0.7,1.0.8,11,24,9652,1534,11186,98,FALSE
requirejs,1.0.8,2.0.0,12,90,19548,4103,23651,300,FALSE
requirejs,2.0.0,2.0.1,13,12,360,61,421,38,FALSE
requirejs,2.0.1,2.0.2,14,30,1865,3371,5236,86,FALSE
requirejs,2.0.2,2.0.3,15,27,560,182,742,57,FALSE
requirejs,2.0.3,2.0.4,16,16,1105,1351,2456,31,FALSE
requirejs,2.0.4,2.0.5,17,16,16406,16442,32848,41,FALSE
requirejs,2.0.5,2.0.6,18,22,742,398,1140,50,FALSE
requirejs,2.0.6,2.1.0,19,47,14629,1365,15994,153,FALSE
requirejs,2.1.0,2.1.1,20,8,418,200,618,26,FALSE
requirejs,2.1.1,2.1.2,21,56,27125,9497,36622,228,FALSE
requirejs,2.1.2,2.1.3,22,53,3088,678,3766,180,FALSE
requirejs,2.1.3,2.1.4,23,3,82,22,104,12,FALSE
requirejs,2.1.4,2.1.5,24,45,2534,590,3124,123,FALSE
requirejs,2.1.5,2.1.6,25,61,11661,3137,14798,228,FALSE
requirejs,2.1.6,2.1.7,26,31,2393,1237,3630,79,FALSE
requirejs,2.1.7,2.1.8,27,4,22,16,38,8,FALSE
requirejs,2.1.8,2.1.9,28,59,4475,780,5255,158,FALSE
requirejs,2.1.9,2.1.10,29,53,15911,11957,27868,212,FALSE
requirejs,2.1.10,2.1.11,30,21,931,228,1159,64,FALSE
requirejs,2.1.11,2.1.12,31,51,6381,4346,10727,120,FALSE
requirejs,2.1.12,2.1.13,32,1,75,20,95,7,TRUE
requirejs,2.1.13,2.1.14,33,6,372,79,451,23,FALSE
requirejs,2.1.14,2.1.15,34,10,227,61,288,19,FALSE
requirejs,2.1.15,2.1.16,35,31,38297,1779,40076,61,FALSE
requirejs,2.1.16,2.1.17,36,18,1861,1087,2948,58,FALSE
requirejs,2.1.17,2.1.18,37,15,8945,477,9422,38,FALSE
requirejs,2.1.18,2.1.19,38,14,1888,538,2426,41,FALSE
requirejs,2.1.19,2.1.20,39,7,4030,39,4069,25,FALSE
requirejs,2.1.20,2.1.21,40,18,5303,3077,8380,74,FALSE
requirejs,2.1.21,2.1.22,41,2,3588,2229,5817,4,FALSE
requirejs,2.1.22,2.2.0,42,37,3094,10948,14042,154,FALSE
requirejs,2.2.0,2.3.0,43,14,7210,5648,12858,39,FALSE
requirejs,2.3.0,2.3.1,44,2,15,10,25,5,TRUE
requirejs,2.3.1,2.3.2,45,3,18,18,36,6,FALSE
requirejs,2.3.2,2.3.3,46,20,14268,11762,26030,58,FALSE
restler,0.2.2,0.2.3,3,6,13,9,22,7,FALSE
restler,0.2.3,0.2.4,4,9,72,37,109,11,FALSE
restler,0.2.4,0.2.5,5,22,6073,924,6997,63,FALSE
restler,0.2.5,2.0.0,6,9,398,4454,4852,31,FALSE
restler,2.0.0,2.0.1,7,9,40,11,51,13,FALSE
restler,2.0.1,3.0.0,8,39,409,311,720,53,FALSE
restler,3.0.0,3.1.0,9,11,205,156,361,16,FALSE
restler,3.1.0,3.2.0,10,13,63,9,72,15,FALSE
restler,3.2.0,3.2.1,11,9,35,11,46,15,FALSE
restler,3.2.1,3.2.2,12,4,355,215,570,8,FALSE
restler,3.2.2,3.3.0,13,15,77,22,99,22,FALSE
restler,3.3.0,3.4.0,14,9,38,11,49,12,FALSE
rollup-plugin-istanbul,1.0.0,1.1.0,1,15,212,102,314,26,FALSE
rollup-plugin-json,1.0.0,2.0.0,1,9,290,105,395,22,FALSE
rollup-plugin-json,2.0.0,2.0.1,2,9,75,9,84,17,FALSE
rollup-plugin-json,2.0.1,2.0.2,3,2,280,51,331,8,FALSE
rollup-plugin-json,2.0.2,2.1.0,4,11,456,28,484,20,FALSE
rollup-plugin-json,2.1.0,2.1.1,5,3,9,2,11,4,FALSE
sauce-connect-launcher,0.0.1,0.1.0,1,2,31,14,45,3,FALSE
sauce-connect-launcher,0.1.0,0.1.1,2,5,39,26,65,7,FALSE
sauce-connect-launcher,0.1.1,0.1.2,3,2,12,5,17,2,TRUE
sauce-connect-launcher,0.1.2,0.1.3,4,6,39,13,52,9,FALSE
sauce-connect-launcher,0.1.3,0.1.4,5,4,12,2,14,6,FALSE
sauce-connect-launcher,0.1.4,0.1.5,6,3,11,1,12,5,FALSE
sauce-connect-launcher,0.1.5,0.1.6,7,8,413,225,638,25,FALSE
sauce-connect-launcher,0.1.6,0.1.7,8,15,168,126,294,25,FALSE
sauce-connect-launcher,0.1.7,0.1.8,9,2,3,3,6,3,TRUE
sauce-connect-launcher,0.1.8,0.1.9,10,3,17,12,29,5,TRUE
sauce-connect-launcher,0.1.9,0.1.10,11,4,49,8,57,6,FALSE
sauce-connect-launcher,0.1.10,0.1.11,12,3,11,1,12,3,FALSE
sauce-connect-launcher,0.1.11,0.2.0,13,2,13,3,16,4,FALSE
sauce-connect-launcher,0.2.0,0.2.1,14,2,3,3,6,2,FALSE
sauce-connect-launcher,0.2.1,0.2.2,15,2,8,3,11,4,FALSE
sauce-connect-launcher,0.2.2,0.3.0,16,6,186,126,312,13,FALSE
sauce-connect-launcher,0.3.0,0.3.1,17,4,29,7,36,6,FALSE
sauce-connect-launcher,0.3.1,0.3.2,18,2,10,5,15,2,FALSE
sauce-connect-launcher,0.3.2,0.3.3,19,3,5,3,8,3,FALSE
sauce-connect-launcher,0.3.3,0.3.5,20,2,15,11,26,3,FALSE
sauce-connect-launcher,0.4.0,0.4.1,22,2,2,2,4,2,TRUE
sauce-connect-launcher,0.4.1,0.4.2,23,2,6,2,8,2,TRUE
sauce-connect-launcher,0.4.2,0.5.0,24,12,87,40,127,13,FALSE
sauce-connect-launcher,0.5.0,0.5.1,25,5,104,46,150,6,FALSE
sauce-connect-launcher,0.5.1,0.5.2,26,3,5,2,7,3,FALSE
sauce-connect-launcher,0.5.2,0.6.0,27,5,47,3,50,6,FALSE
sauce-connect-launcher,0.6.0,0.6.1,28,5,13,3,16,6,FALSE
sauce-connect-launcher,0.6.1,0.7.0,29,7,122,96,218,15,FALSE
sauce-connect-launcher,0.7.0,0.7.1,30,4,18,6,24,5,FALSE
sauce-connect-launcher,0.7.1,0.8.0,31,4,25,6,31,5,TRUE
sauce-connect-launcher,0.8.0,0.8.1,32,2,2,2,4,2,FALSE
sauce-connect-launcher,0.8.1,0.8.2,33,3,9,2,11,3,TRUE
sauce-connect-launcher,0.8.2,0.9.0,34,2,2,2,4,2,TRUE
sauce-connect-launcher,0.9.0,0.9.1,35,6,77,20,97,7,FALSE
sauce-connect-launcher,0.9.1,0.9.2,36,3,15,11,26,3,TRUE
sauce-connect-launcher,0.9.2,0.9.3,37,5,29,98,127,5,FALSE
sauce-connect-launcher,0.9.3,0.10.0,38,6,92,59,151,9,FALSE
sauce-connect-launcher,0.10.0,0.10.1,39,4,52,3,55,5,TRUE
sauce-connect-launcher,0.10.1,0.10.2,40,5,6,4,10,5,FALSE
sauce-connect-launcher,0.10.2,0.10.3,41,4,13,2,15,4,TRUE
sauce-connect-launcher,0.10.3,0.11.0,42,6,767,672,1439,25,FALSE
sauce-connect-launcher,0.11.0,0.11.1,43,4,9,3,12,4,TRUE
sauce-connect-launcher,0.11.1,0.12.0,44,7,33,25,58,9,FALSE
sauce-connect-launcher,0.12.0,0.13.0,45,6,25,15,40,8,FALSE
sauce-connect-launcher,0.13.0,0.14.0,46,5,5,5,10,5,FALSE
sauce-connect-launcher,0.14.0,0.15.0,47,13,52,29,81,15,FALSE
sauce-connect-launcher,0.15.0,0.15.1,48,3,3,3,6,3,TRUE
sauce-connect-launcher,0.15.1,0.16.0,49,5,13,3,16,5,FALSE
sauce-connect-launcher,0.16.0,0.17.0,50,3,3,3,6,3,FALSE
sauce-connect-launcher,0.17.0,1.0.0,51,30,845,119,964,66,FALSE
sauce-connect-launcher,1.0.0,1.1.0,52,3,587,297,884,18,FALSE
sauce-connect-launcher,1.1.0,1.1.1,53,4,31,23,54,9,TRUE
sauce-connect-launcher,1.1.1,1.2.0,54,9,516,175,691,57,FALSE
sauce-connect-launcher,1.2.0,1.2.1,55,6,22,3,25,6,FALSE
sauce-connect-launcher,1.2.1,1.2.2,56,5,123,49,172,10,FALSE
seamless-immutable,0.1.0,0.2.0,1,23,511,356,867,36,TRUE
seamless-immutable,0.2.0,0.2.1,2,1,17,13,30,2,TRUE
seamless-immutable,0.2.1,0.3.0,3,26,587,221,808,34,FALSE
seamless-immutable,0.3.0,0.3.1,4,4,103,51,154,6,TRUE
seamless-immutable,0.3.1,0.3.2,5,5,288,269,557,7,FALSE
seamless-immutable,0.3.2,0.4.0,6,3,14,9,23,4,TRUE
seamless-immutable,0.4.0,0.4.1,7,6,22,14,36,7,FALSE
seamless-immutable,0.4.1,0.5.0,8,3,108,8,116,5,TRUE
seamless-immutable,0.5.0,1.0.0,9,18,333,241,574,29,TRUE
seamless-immutable,1.0.0,1.0.1,10,13,93,29,122,20,FALSE
seamless-immutable,1.0.1,1.1.0,11,14,417,145,562,36,FALSE
seamless-immutable,1.1.0,1.1.2,12,8,54,33,87,20,TRUE
seamless-immutable,1.1.2,1.2.0,13,6,26,35,61,7,TRUE
seamless-immutable,1.2.0,1.3.0,14,7,95,33,128,8,TRUE
seamless-immutable,1.3.0,2.0.0,15,8,391,321,712,15,FALSE
seamless-immutable,2.0.0,2.0.1,16,3,9,5,14,6,TRUE
seamless-immutable,2.0.1,2.0.2,17,5,46,12,58,9,FALSE
seamless-immutable,2.0.2,2.1.0,18,4,84,6,90,8,FALSE
seamless-immutable,2.1.0,2.2.0,19,10,1098,430,1528,57,FALSE
seamless-immutable,2.2.0,2.3.0,20,7,161,83,244,23,FALSE
seamless-immutable,2.3.0,2.3.1,21,6,14,10,24,9,FALSE
seamless-immutable,2.3.1,2.3.2,22,12,76,35,111,25,FALSE
seamless-immutable,2.3.2,2.4.0,23,5,41,4,45,10,FALSE
seamless-immutable,2.4.0,2.4.1,24,8,97,37,134,18,FALSE
seamless-immutable,2.4.1,2.4.2,25,5,29,11,40,14,FALSE
seamless-immutable,2.4.2,3.0.0,26,5,364,123,487,30,FALSE
seamless-immutable,3.0.0,4.0.0,27,9,60,234,294,14,FALSE
seamless-immutable,4.0.0,4.0.1,28,10,98,17,115,15,FALSE
seamless-immutable,4.0.1,4.0.2,29,10,277,94,371,19,FALSE
seamless-immutable,4.0.2,4.1.0,30,14,867,131,998,48,FALSE
seamless-immutable,4.1.0,4.1.1,31,9,134,96,230,24,TRUE
seamless-immutable,4.1.1,5.0.0,32,11,237,20,257,23,FALSE
seamless-immutable,5.0.0,5.0.1,33,2,28,7,35,5,FALSE
seamless-immutable,5.0.1,5.1.0,34,35,398,249,647,70,FALSE
seamless-immutable,5.1.0,5.1.1,35,9,144,103,247,34,FALSE
seamless-immutable,5.1.1,5.2.0,36,11,526,30,556,35,FALSE
seamless-immutable,5.2.0,6.0.0,37,14,168,31,199,22,TRUE
seamless-immutable,6.0.0,6.0.1,38,7,485,60,545,34,FALSE
seamless-immutable,6.0.1,6.1.0,39,6,50,6,56,15,FALSE
seamless-immutable,6.1.0,6.1.1,40,3,74,18,92,15,FALSE
seamless-immutable,6.1.1,6.1.2,41,4,49,28,77,14,FALSE
seamless-immutable,6.1.2,6.1.3,42,4,53,26,79,15,TRUE
seamless-immutable,6.1.3,6.1.4,43,3,45,11,56,14,FALSE
seamless-immutable,6.1.4,6.2.0,44,4,204,63,267,21,FALSE
seamless-immutable,6.2.0,6.3.0,45,6,1132,152,1284,36,TRUE
seamless-immutable,6.3.0,7.0.0,46,22,1311,368,1679,82,FALSE
seamless-immutable,7.0.0,7.0.1,47,11,61,46,107,19,FALSE
seamless-immutable,7.0.1,7.1.0,48,19,603,78,681,73,FALSE
seamless-immutable,7.1.0,7.1.1,49,3,6,8,14,5,TRUE
seamless-immutable,7.1.1,7.1.2,50,6,41,13,54,14,FALSE
seneca,0.0.1,0.4.1,1,50,10669,5384,16053,255,FALSE
seneca,0.4.1,0.4.2,2,33,7357,3069,10426,146,FALSE
seneca,0.4.2,0.4.3,3,7,330,1043,1373,20,FALSE
seneca,0.4.3,0.4.4,4,1,1,1,2,1,TRUE
seneca,0.4.4,0.5.0,5,26,5447,5106,10553,205,FALSE
seneca,0.5.0,0.5.1,6,8,521,152,673,26,FALSE
seneca,0.5.1,0.5.2,7,1,3,3,6,3,TRUE
seneca,0.5.2,0.5.3,8,12,1002,235,1237,45,FALSE
seneca,0.5.3,0.5.4,9,4,65,15,80,14,FALSE
seneca,0.5.4,0.5.5,10,5,92,70,162,8,FALSE
seneca,0.5.5,0.5.6,11,10,409,156,565,33,FALSE
seneca,0.5.6,0.5.7,12,3,92,32,124,8,FALSE
seneca,0.5.7,0.5.8,13,4,101,34,135,16,FALSE
seneca,0.5.8,0.5.9,14,17,1291,611,1902,57,FALSE
seneca,0.5.9,0.5.10,15,10,372,65,437,31,FALSE
seneca,0.5.10,0.5.11,16,4,73,27,100,11,FALSE
seneca,0.5.11,0.5.12,17,3,225,577,802,16,FALSE
seneca,0.5.12,0.5.13,18,7,735,771,1506,38,FALSE
seneca,0.5.13,0.5.14,19,12,541,2397,2938,54,FALSE
seneca,0.5.14,0.5.15,20,17,2437,2135,4572,105,FALSE
seneca,0.5.15,0.5.16,21,33,8077,4995,13072,122,FALSE
seneca,0.5.16,0.5.17,22,2,94,476,570,16,FALSE
seneca,0.5.17,0.5.18,23,46,5082,5899,10981,173,FALSE
seneca,0.5.18,0.5.19,24,6,498,937,1435,26,FALSE
seneca,0.5.19,0.5.20,25,47,1698,1124,2822,133,FALSE
seneca,0.5.20,0.5.21,26,17,1474,924,2398,37,FALSE
seneca,0.5.21,0.6.0-rc2,27,68,5466,4219,9685,199,FALSE
seneca,0.6.0,0.6.1-rc0,29,20,205,178,383,33,FALSE
seneca,0.6.1-rc0,0.6.1-rc1,30,3,145,39,184,8,TRUE
seneca,0.6.1-rc1,0.6.1-rc2,31,8,609,393,1002,19,FALSE
seneca,0.6.1-rc2,0.6.1,32,8,181,129,310,29,FALSE
seneca,0.6.1,0.6.2,33,44,4633,2679,7312,116,FALSE
seneca,0.6.2,0.6.3,34,23,9343,2100,11443,182,FALSE
seneca,0.6.3,0.6.4,35,11,466,253,719,25,FALSE
seneca,0.6.4,0.6.5,36,4,820,105,925,22,FALSE
seneca,0.6.5,0.7.0,37,41,16379,57969,74348,608,FALSE
seneca,0.7.0,0.7.1,38,5,26,9,35,9,TRUE
seneca,0.7.1,0.7.2,39,36,10516,26176,36692,362,FALSE
seneca,0.7.2,0.8.0,40,60,6031,4913,10944,283,FALSE
seneca,0.8.0,0.9.0,41,81,6185,4787,10972,214,FALSE
seneca,0.9.0,0.9.1,42,5,83,6,89,7,FALSE
seneca,0.9.1,0.9.2,43,11,79,30,109,20,FALSE
seneca,0.9.2,0.9.3,44,15,324,41,365,26,FALSE
seneca,0.9.3,1.0.0,45,34,1197,1097,2294,106,FALSE
seneca,1.0.0,1.1.0,46,45,2452,1254,3706,225,FALSE
seneca,1.1.0,1.2.0,47,10,69,1031,1100,20,FALSE
seneca,1.2.0,1.3.0,48,18,484,100,584,33,FALSE
seneca,1.3.0,1.4.0,49,20,666,395,1061,49,FALSE
seneca,1.4.0,2.0.0,50,8,45,11,56,18,FALSE
seneca,2.0.0,2.0.1,51,6,32,13,45,6,FALSE
seneca,2.0.1,2.1.0,52,21,842,1177,2019,41,FALSE
seneca,2.1.0,3.0.0,53,151,7375,23945,31320,719,FALSE
seneca,3.0.0,3.1.0,54,36,1586,699,2285,84,FALSE
seneca,3.1.0,3.2.0,55,17,2223,1394,3617,55,FALSE
seneca,3.2.0,3.2.1,56,3,3,3,6,3,TRUE
seneca,3.2.1,3.2.2,57,14,2456,1436,3892,82,FALSE
seneca,3.2.2,3.3.0,58,16,1468,1180,2648,48,FALSE
serve-index,1.0.0,1.0.1,1,3,5,2,7,3,TRUE
serve-index,1.0.1,1.0.2,2,9,41,13,54,11,FALSE
serve-index,1.0.2,1.0.3,3,6,71,38,109,9,FALSE
serve-index,1.0.3,1.1.0,4,15,525,227,752,34,FALSE
serve-index,1.1.0,1.1.1,5,4,13,14,27,6,FALSE
serve-index,1.1.1,1.1.2,6,2,9,4,13,4,FALSE
serve-index,1.1.2,1.1.3,7,2,10,4,14,4,FALSE
serve-index,1.1.3,1.1.4,8,2,9,4,13,4,TRUE
serve-index,1.1.4,1.1.5,9,7,45,27,72,12,FALSE
serve-index,1.1.5,1.1.6,10,2,17,8,25,5,FALSE
serve-index,1.1.6,1.2.0,11,10,157,72,229,18,FALSE
serve-index,1.2.0,1.2.1,12,3,9,3,12,5,FALSE
serve-index,1.2.1,1.3.0,13,5,218,150,368,19,FALSE
serve-index,1.3.0,1.3.1,14,5,24,12,36,8,FALSE
serve-index,1.3.1,1.4.0,15,3,54,9,63,10,FALSE
serve-index,1.4.0,1.4.1,16,3,12,5,17,5,FALSE
serve-index,1.4.1,1.5.0,17,5,20,27,47,10,FALSE
serve-index,1.5.0,1.5.1,18,6,58,55,113,10,FALSE
serve-index,1.5.1,1.5.2,19,3,10,5,15,5,FALSE
serve-index,1.5.2,1.5.3,20,5,18,7,25,9,FALSE
serve-index,1.5.3,1.6.0,21,7,29,12,41,15,FALSE
serve-index,1.6.0,1.6.1,22,4,41,11,52,10,FALSE
serve-index,1.6.1,1.6.2,23,8,30,23,53,13,FALSE
serve-index,1.6.2,1.6.3,24,8,88,33,121,19,FALSE
serve-index,1.6.3,1.6.4,25,8,23,10,33,14,FALSE
serve-index,1.6.4,1.7.0,26,13,382,167,549,28,FALSE
serve-index,1.7.0,1.7.1,27,4,15,7,22,8,FALSE
serve-index,1.7.1,1.7.2,28,3,13,5,18,6,FALSE
serve-index,1.7.2,1.7.3,29,17,51,23,74,30,FALSE
serve-index,1.7.3,1.8.0,30,14,53,22,75,25,FALSE
serve-index,1.8.0,1.9.0,31,35,141,100,241,64,FALSE
showdown,0.0.1,0.1.0,1,32,2220,1955,4175,130,FALSE
showdown,0.1.0,0.2.0,2,6,17,17,34,6,TRUE
showdown,0.2.0,0.3.0,3,46,1733,369,2102,103,FALSE
showdown,0.3.0,0.3.1,4,21,383,206,589,52,FALSE
showdown,0.3.1,0.3.4,5,68,14199,17187,31386,463,FALSE
showdown,0.3.4,0.4.0,6,1,10,8,18,8,TRUE
showdown,0.4.0,0.5.0,7,11,3371,3261,6632,60,FALSE
showdown,0.5.0,0.5.2,8,43,3453,6992,10445,237,FALSE
showdown,0.5.2,0.5.3,9,1,0,1,1,1,TRUE
showdown,0.5.3,0.5.4,10,1,0,1,1,1,TRUE
showdown,1.0.0-alpha1,1.0.0,13,24,296,80,376,40,FALSE
showdown,1.0.0,1.0.1,14,6,60,185,245,9,TRUE
showdown,1.0.1,1.0.2,15,8,55,7,62,18,TRUE
showdown,1.0.2,1.1.0,16,42,2904,912,3816,583,FALSE
showdown,1.1.0,1.2.0,17,35,1886,438,2324,218,FALSE
showdown,1.2.0,1.2.1,18,26,1061,108,1169,104,FALSE
showdown,1.2.1,1.2.2,19,4,445,177,622,48,FALSE
showdown,1.2.2,1.2.3,20,12,272,27,299,80,FALSE
showdown,1.2.3,1.3.0,21,13,664,99,763,148,FALSE
showdown,1.3.0,1.4.0,22,24,987,687,1674,186,FALSE
showdown,1.4.0,1.4.1,23,3,51,6,57,11,FALSE
showdown,1.4.1,1.4.2,24,8,398,9,407,51,FALSE
showdown,1.4.2,1.4.3,25,14,197,169,366,46,FALSE
showdown,1.4.3,1.4.4,26,10,161,498,659,170,FALSE
showdown,1.4.4,1.5.0,27,5,361,64,425,38,FALSE
showdown,1.5.0,1.5.1,28,8,159,54,213,33,FALSE
showdown,1.5.1,1.5.2,29,6,119,7,126,39,FALSE
showdown,1.5.2,1.5.3,30,4,32,16,48,19,FALSE
showdown,1.5.3,1.5.4,31,5,448,42,490,42,FALSE
showdown,1.5.4,1.5.5,32,6,306,99,405,31,FALSE
showdown,1.5.5,1.6.0,33,15,563,169,732,86,FALSE
showdown,1.6.0,1.6.1,34,12,2965,592,3557,221,FALSE
showdown,1.6.1,1.6.2,35,8,165,71,236,53,TRUE
showdown,1.6.2,1.6.3,36,14,302,132,434,91,FALSE
showdown,1.6.3,1.6.4,37,14,537,361,898,110,FALSE
showdown,1.6.4,1.7.0,38,34,1274,487,1761,193,FALSE
standard-version,1.1.0,2.1.1,1,8,119,48,167,16,FALSE
standard-version,2.1.1,2.1.2,2,3,14,4,18,4,FALSE
standard-version,2.1.2,2.2.0,3,7,172,36,208,13,FALSE
standard-version,2.2.0,2.2.1,4,4,16,6,22,4,TRUE
standard-version,2.2.1,2.3.0,5,10,160,65,225,16,FALSE
standard-version,2.3.0,2.3.1,6,4,54,20,74,6,FALSE
standard-version,2.3.1,2.4.0,7,8,47,15,62,9,FALSE
standard-version,2.4.0,3.0.0,8,25,443,187,630,44,FALSE
standard-version,3.0.0,4.0.0-0,9,10,377,45,422,18,FALSE
standard-version,4.0.0-0,4.0.0-1,10,8,154,90,244,15,TRUE
standard-version,4.0.0-1,4.0.0,11,2,6,6,12,3,FALSE
stream-buffers,0.1.0,0.2.0,1,1,43,66,109,5,TRUE
stream-buffers,0.2.0,0.2.1,2,1,12,0,12,1,FALSE
stream-buffers,0.2.1,0.2.2,3,6,19,6,25,7,FALSE
stream-buffers,0.2.2,0.2.3,4,4,20,7,27,7,FALSE
stream-buffers,0.2.3,0.2.4,5,8,49,7,56,10,FALSE
stream-buffers,0.2.4,0.2.5,6,3,121,97,218,11,FALSE
stream-buffers,0.2.5,0.2.6,7,6,110,71,181,10,FALSE
stream-buffers,0.2.6,1.0.0,8,5,16,5,21,5,TRUE
stream-buffers,1.0.0,1.0.1,9,6,10,10,20,6,FALSE
stream-buffers,1.0.1,1.1.0,10,9,119,40,159,11,FALSE
stream-buffers,1.1.0,2.0.0,11,12,188,105,293,14,FALSE
stream-buffers,2.0.0,2.1.0,12,1,1,1,2,1,TRUE
stream-buffers,2.1.0,2.2.0,13,5,15,1,16,7,FALSE
stream-buffers,2.2.0,3.0.0,14,15,1634,1891,3525,38,FALSE
stream-buffers,3.0.0,3.0.1,15,5,9,3,12,5,FALSE
tcomb,0.0.1,0.0.2,1,3,611,716,1327,12,FALSE
tcomb,0.0.2,0.0.3,2,1,10,21,31,3,TRUE
tcomb,0.0.3,0.0.4,3,2,211,96,307,9,FALSE
tcomb,0.0.4,0.0.5,4,15,482,413,895,17,FALSE
tcomb,0.0.5,0.0.6,5,9,168,51,219,12,FALSE
tcomb,0.0.6,0.0.7,6,4,139,84,223,6,TRUE
tcomb,0.0.7,0.0.8,7,19,145,26,171,26,FALSE
tcomb,0.0.8,0.0.9,8,17,1854,1161,3015,66,TRUE
tcomb,0.0.9,0.0.10,9,21,1009,627,1636,79,FALSE
tcomb,0.0.10,0.0.11,10,13,2016,862,2878,118,TRUE
tcomb,0.0.11,0.0.12,11,14,1441,1210,2651,57,FALSE
tcomb,0.0.12,0.1.0,12,17,339,1316,1655,56,FALSE
tcomb,0.1.0,0.2.0,13,5,34,15,49,10,FALSE
tcomb,0.2.0,0.2.1,14,15,528,797,1325,36,FALSE
tcomb,0.2.1,0.3.0,15,31,32210,1325,33535,86,FALSE
tcomb,0.3.0,0.3.1,16,6,35,134,169,14,FALSE
tcomb,0.3.1,0.3.2,17,4,29,50,79,13,FALSE
tcomb,0.3.2,0.3.3,18,3,175,151,326,8,FALSE
tcomb,0.3.3,0.3.4,19,4,294,189,483,13,FALSE
tcomb,0.3.4,0.3.5,20,3,39,8,47,12,FALSE
tcomb,0.3.5,0.3.6,21,1,44,24,68,7,FALSE
tcomb,0.3.6,0.4.0,22,7,2952,32421,35373,44,FALSE
tcomb,0.4.0,1.0.0,23,15,295,522,817,41,FALSE
tcomb,1.0.0,1.0.1,24,1,10,6,16,6,FALSE
tcomb,1.0.1,1.0.2,25,1,22,153,175,6,FALSE
tcomb,1.0.2,1.0.3,26,1,23,14,37,6,FALSE
tcomb,1.0.3,1.1.0,27,23,3714,3621,7335,82,FALSE
tcomb,2.0.0-beta,2.0.0,29,7,168,129,297,11,FALSE
tcomb,2.0.0,2.0.1,30,1,17,3,20,3,FALSE
tcomb,2.0.1,2.1.0,31,5,1176,996,2172,22,FALSE
tcomb,2.1.0,2.2.0,32,11,920,636,1556,25,FALSE
tcomb,2.2.0,2.2.1,33,8,375,172,547,18,FALSE
tcomb,2.2.1,2.3.0,34,4,4332,4098,8430,49,FALSE
tcomb,2.3.0,2.4.0,35,16,290,170,460,29,FALSE
tcomb,2.4.0,2.4.1,36,8,199,99,298,18,FALSE
tcomb,2.4.1,2.5.0,37,14,1261,883,2144,46,FALSE
tcomb,2.5.0,2.5.1,38,5,100,19,119,16,FALSE
tcomb,2.5.1,2.5.2,39,4,23,13,36,7,FALSE
tcomb,2.5.2,2.6.0,40,50,8329,4616,12945,237,FALSE
tcomb,2.6.0,2.7.0,41,20,803,109,912,57,FALSE
tcomb,2.7.0,3.0.0,42,14,62,20,82,17,FALSE
tcomb,3.0.0,3.1.0,43,33,3627,948,4575,128,FALSE
tcomb,3.1.0,3.2.0,44,18,2176,170,2346,39,FALSE
tcomb,3.2.0,3.2.1,45,4,68,16,84,12,FALSE
tcomb,3.2.1,3.2.2,46,2,46,30,76,8,FALSE
tcomb,3.2.2,3.2.3,47,5,32,8,40,10,FALSE
tcomb,3.2.3,3.2.4,48,2,16,10,26,8,FALSE
tcomb,3.2.4,3.2.5,49,3,76,22,98,18,TRUE
tcomb,3.2.5,3.2.6,50,2,26,4,30,8,FALSE
tcomb,3.2.6,3.2.7,51,4,65,23,88,15,FALSE
tcomb,3.2.7,3.2.8,52,1,15,3,18,4,FALSE
tcomb,3.2.8,3.2.9,53,2,75,75,150,8,FALSE
tcomb,3.2.9,3.2.10,54,1,11,1,12,4,FALSE
tcomb,3.2.10,3.2.11,55,1,44,2,46,5,FALSE
tcomb,3.2.11,3.2.12,56,1,34,12,46,6,TRUE
tcomb,3.2.12,3.2.13,57,2,37,3,40,5,FALSE
tcomb,3.2.13,3.2.14,58,2,15,2,17,4,FALSE
tcomb,3.2.14,3.2.15,59,2,80,3,83,5,FALSE
tcomb,3.2.15,3.2.16,60,2,26,5,31,5,FALSE
tcomb,3.2.16,3.2.17,61,1,8,2,10,3,FALSE
tcomb,3.2.17,3.2.18,62,1,7,2,9,3,FALSE
tcomb,3.2.18,3.2.19,63,1,8,1,9,3,FALSE
tcomb,3.2.19,3.2.20,64,1,14,4,18,3,TRUE
thenify,1.0.0,2.0.0,1,2,212,2,214,9,FALSE
thenify,2.0.0,3.0.0,2,3,82,21,103,6,FALSE
thenify,3.0.0,3.1.0,3,2,160,13,173,4,FALSE
thenify,3.1.0,3.1.1,4,10,19,14,33,10,FALSE
thenify,3.1.1,3.2.0,5,7,14,13,27,9,FALSE
thenify,3.2.0,3.2.1,6,3,8,5,13,4,FALSE
thenify,3.2.1,3.3.0,7,4,153,18,171,7,FALSE
three,0.54.0-dev,0.54.0,1,371,692076,572819,1264895,2360,FALSE
three,0.54.1-dev,0.54.2-dev,3,60,326870,242638,569508,923,FALSE
three,0.54.2-dev,0.54.3-dev,4,1,111,38,149,1,TRUE
three,0.54.3-dev,0.54.4-dev,5,2,47,21,68,3,TRUE
three,0.54.4-dev,0.54.5-dev,6,30,76659,72108,148767,140,FALSE
three,0.54.5-dev,0.54.6-dev,7,31,10495,1203,11698,129,FALSE
three,0.54.6-dev,0.54.7-dev,8,3,95,99,194,11,TRUE
three,0.54.7-dev,0.54.8-dev,9,31,85437,80118,165555,154,FALSE
three,0.54.8-dev,0.54.9-dev,10,26,39153,37270,76423,96,FALSE
three,0.54.9-dev,0.54.10-dev,11,11,9060,636,9696,66,FALSE
three,0.54.10-dev,0.54.11-dev,12,49,116181,121216,237397,304,FALSE
three,0.54.11-dev,0.54.12-dev,13,82,14334,12160,26494,413,FALSE
three,0.54.12-dev,0.55.0,14,81,24472,15921,40393,262,FALSE
three,0.55.0,0.56.0,15,179,82819,48444,131263,616,FALSE
three,0.56.0,0.56.1,16,1,111,38,149,1,TRUE
three,0.56.1,0.56.2,17,1,111,38,149,1,TRUE
three,0.56.2,0.56.3,18,1,111,38,149,1,TRUE
three,0.56.3,0.56.4,19,1,1,0,1,1,TRUE
three,0.56.4,0.56.7,20,491,110398,72844,183242,1897,FALSE
three,0.58.1,0.58.2,22,94,12942,7417,20359,535,FALSE
three,0.58.2,0.58.3,23,1,111,38,149,1,TRUE
three,0.58.3,0.58.4,24,1,111,38,149,1,TRUE
three,0.58.4,0.58.5,25,1,111,38,149,1,TRUE
three,0.58.5,0.58.6,26,1,111,38,149,1,TRUE
three,0.58.6,0.58.7,27,3,8,8,16,6,TRUE
three,0.58.7,0.58.8,28,1,3,1,4,1,TRUE
three,0.58.8,0.58.9,29,14,588,443,1031,35,TRUE
three,0.58.9,0.58.10,30,639,168829,58819,227648,1783,FALSE
three,0.58.10,0.66.0,31,1208,484475,268175,752650,3712,FALSE
three,0.66.0,0.66.1,32,4,413,8,421,10,TRUE
three,0.66.1,0.66.2,33,1,111,38,149,1,TRUE
three,0.66.2,0.66.6,34,1540,264005,157211,421216,6228,FALSE
three,0.66.6,0.66.7,35,57,54723,32606,87329,942,FALSE
three,0.66.7,0.66.8,36,16,8880,4179,13059,137,FALSE
three,0.66.8,0.66.9,37,1,111,38,149,1,TRUE
three,0.66.9,0.66.10,38,8,377,412,789,44,FALSE
three,0.66.10,0.66.11,39,1,111,38,149,1,TRUE
three,0.66.11,0.66.12,40,7,285,86,371,10,TRUE
three,0.66.12,0.66.13,41,1,111,38,149,1,TRUE
three,0.66.13,0.66.14,42,1,111,38,149,1,TRUE
three,0.66.14,0.66.15,43,22,520,381,901,28,FALSE
three,0.66.15,0.66.16,44,1,111,38,149,1,TRUE
three,0.66.16,0.66.17,45,1,111,38,149,1,TRUE
three,0.66.17,0.66.18,46,10,123392,63671,187063,1435,FALSE
three,0.66.18,0.66.19,47,1,111,38,149,1,TRUE
three,0.66.19,0.66.20,48,1,111,38,149,1,TRUE
three,0.66.20,0.66.21,49,1,111,38,149,1,TRUE
three,0.66.21,0.66.22,50,1,111,38,149,1,TRUE
three,0.66.22,0.66.23,51,28,178972,243588,422560,626,FALSE
three,0.66.23,0.66.24,52,17,42632,36826,79458,223,TRUE
three,0.66.24,0.66.25,53,1,111,38,149,1,TRUE
three,0.66.25,0.66.26,54,15,78637,1229,79866,234,FALSE
three,0.66.26,0.66.27,55,34,2655,1120,3775,119,FALSE
three,0.66.27,0.66.28,56,9,197,156,353,13,FALSE
three,0.66.28,0.66.29,57,1,6,6,12,1,TRUE
three,0.66.29,0.66.30,58,1,50,68,118,2,TRUE
three,0.66.30,0.66.31,59,10,456,784,1240,20,TRUE
three,0.66.31,0.66.32-dev,60,35,1648,1043,2691,58,FALSE
three,0.66.32-dev,0.66.35,61,191,13816,12886,26702,925,FALSE
three,0.66.35,0.66.36,62,1,111,38,149,1,TRUE
three,0.66.36,0.66.37,63,30,1429,1300,2729,91,FALSE
three,0.66.37,0.66.38,64,37,49082,49771,98853,946,FALSE
three,0.66.38,0.66.39,65,1,111,38,149,1,TRUE
three,0.66.39,0.66.40,66,6,12,4,16,9,TRUE
three,0.66.40,0.66.41,67,346,99261,55888,155149,2985,FALSE
three,0.66.41,0.66.42,68,4,21,17,38,5,FALSE
three,0.66.42,0.66.43,69,194,38746,19301,58047,1221,FALSE
three,0.66.43,0.66.45,70,27,4675,2864,7539,259,FALSE
three,0.66.45,0.66.46,71,2,1,0,1,3,TRUE
three,0.66.46,0.66.47,72,55,8536,7935,16471,78,FALSE
three,0.66.47,0.66.48,73,8,2417,518,2935,43,FALSE
three,0.66.48,0.66.49,74,39,7337,6632,13969,386,FALSE
three,0.66.49,0.66.50,75,39,989,3226,4215,158,FALSE
three,0.66.50,0.66.51,76,20,1173,354,1527,74,FALSE
three,0.66.51,0.66.52,77,1,111,38,149,1,TRUE
three,0.66.52,0.66.53,78,27,15206,12822,28028,355,FALSE
three,0.66.53,0.66.54,79,1,111,38,149,1,TRUE
three,0.66.54,0.66.55,80,1,111,38,149,1,TRUE
three,0.66.55,0.66.56,81,1,111,38,149,1,TRUE
three,0.66.56,0.66.57,82,1,111,38,149,1,TRUE
three,0.66.57,0.66.58,83,1,36,0,36,2,TRUE
three,0.66.58,0.66.59,84,1,111,38,149,1,TRUE
three,0.66.59,0.66.60,85,1,111,38,149,1,TRUE
three,0.66.60,0.66.61,86,1,111,38,149,1,TRUE
three,0.66.61,0.66.62,87,8,702,610,1312,42,FALSE
three,0.66.62,0.66.63,88,4,8,6,14,4,FALSE
three,0.66.63,0.66.64,89,1,111,38,149,1,TRUE
three,0.66.64,0.66.65,90,48,2848,791,3639,64,FALSE
three,0.66.65,0.66.66,91,7,465,175,640,47,TRUE
three,0.66.66,0.66.67,92,1,111,38,149,1,TRUE
three,0.66.67,0.66.68,93,5,256,178,434,43,TRUE
three,0.66.68,0.66.69,94,1,111,38,149,1,TRUE
three,0.66.69,0.66.70,95,30,1011,1054,2065,103,FALSE
three,0.66.70,0.66.71,96,1,111,38,149,1,TRUE
three,0.66.71,0.66.72,97,1,111,38,149,1,FALSE
three,0.66.72,0.66.73,98,1,111,38,149,1,TRUE
three,0.66.73,0.66.74,99,2,198,51,249,5,TRUE
three,0.66.74,0.66.75,100,4,200,290,490,11,TRUE
three,0.66.75,0.66.76,101,8,480,462,942,34,FALSE
three,0.66.76,0.66.77,102,143,11097,8501,19598,407,FALSE
three,0.66.77,0.66.78,103,1,111,38,149,1,TRUE
three,0.66.78,0.66.79,104,5,486,197,683,14,FALSE
three,0.66.79,0.66.80,105,38,1582,492,2074,52,FALSE
three,0.66.80,0.66.81,106,22,34031,1712,35743,73,FALSE
three,0.66.81,0.66.82,107,2011,815225,572284,1387509,13085,FALSE
three,0.66.83,0.66.84,109,31,42398,19811,62209,514,FALSE
three,0.66.84,0.66.85,110,51,7831,4711,12542,223,FALSE
three,0.66.85,0.66.86,111,313,101894,74806,176700,1382,FALSE
three,0.66.86,0.66.87,112,1037,323388,266266,589654,6093,FALSE
three,0.66.87,0.66.88,113,537,320335,204860,525195,4720,FALSE
three,0.66.88,0.66.89,114,6,550,535,1085,94,TRUE
three,0.66.89,0.66.90,115,1,111,38,149,1,TRUE
three,0.66.90,0.66.91,116,1,111,38,149,1,TRUE
three,0.66.91,0.66.92,117,6,66,45,111,8,TRUE
three,0.66.92,0.66.93,118,1,111,38,149,1,TRUE
three,0.66.93,0.66.94,119,26,6532,2960,9492,133,TRUE
three,0.66.94,0.66.95,120,1,111,38,149,1,TRUE
three,0.66.95,0.66.96,121,1,734,0,734,3,TRUE
three,0.66.96,0.66.97,122,256,420736,180281,601017,2872,FALSE
three,0.67.0,0.68.0,124,249,34444,24538,58982,916,FALSE
three,0.68.0,0.68.86,125,2647,1087988,743891,1831879,17496,FALSE
three,0.68.86,0.68.87,126,1036,323391,266271,589662,6092,FALSE
three,0.69.0,0.70.0,128,726,452409,397496,849905,5992,FALSE
three,0.70.0,0.70.1,129,462,96291,61458,157749,2890,FALSE
three,0.71.0,0.71.1,131,1295,376966,234087,611053,6561,FALSE
three,0.71.1,0.72.0,132,324,71882,73386,145268,1846,FALSE
three,0.72.0,0.73.0,133,704,419031,278714,697745,5531,FALSE
three,0.73.0,0.73.1,134,1138,804457,310621,1115078,7646,FALSE
three,0.73.1,0.73.2,135,7,171,108,279,58,FALSE
three,0.73.2,0.74.0,136,228,216945,19456,236401,1329,FALSE
three,0.74.0,0.75.0,137,582,127253,57040,184293,2525,FALSE
three,0.75.0,0.76.1,138,319,1020021,28999,1049020,2072,FALSE
three,0.76.1,0.77.0,139,172,24383,23645,48028,617,FALSE
three,0.77.0,0.77.1,140,1,2,2,4,1,TRUE
three,0.77.1,0.78.0,141,131,51803,13586,65389,512,FALSE
three,0.78.0,0.79.0,142,168,135606,83988,219594,342,FALSE
three,0.79.0,0.80.0,143,161,68098,65675,133773,1175,FALSE
three,0.80.0,0.80.1,144,4,617,589,1206,5,FALSE
three,0.80.1,0.81.0,145,119,53484,50902,104386,396,FALSE
three,0.81.0,0.81.1,146,19,27004,27054,54058,27,FALSE
three,0.81.1,0.81.2,147,4,6,6,12,4,TRUE
three,0.81.2,0.82.0,148,137,57918,9313,67231,331,FALSE
three,0.82.0,0.82.1,149,12,306,229,535,21,FALSE
three,0.82.1,0.83.0,150,985,542683,266504,809187,6983,FALSE
three,0.83.0,0.84.0,151,404,1136897,231387,1368284,3814,FALSE
three,0.84.0,0.85.0,152,1150,1821894,519065,2340959,9333,FALSE
three,0.85.0,0.85.1,153,38,8004,5240,13244,222,FALSE
three,0.85.1,0.85.2,154,25,8029,1031,9060,41,FALSE
through,0.0.1,0.0.2,1,2,21,1,22,2,TRUE
through,0.0.2,0.0.3,2,4,9,64,73,5,TRUE
through,0.0.3,0.0.4,3,4,75,22,97,6,FALSE
through,0.0.4,0.1.0,4,2,2,1,3,2,FALSE
through,0.1.0,0.1.1,5,2,2,2,4,2,TRUE
through,0.1.1,0.1.2,6,2,2,1,3,2,TRUE
through,0.1.2,0.1.3,7,3,8,3,11,3,FALSE
through,0.1.3,0.1.4,8,1,1,1,2,1,TRUE
through,0.1.4,1.0.0,9,2,2,2,4,2,FALSE
through,1.0.0,1.1.0,10,5,122,7,129,5,FALSE
through,1.1.0,1.1.1,11,2,1,3,4,2,FALSE
through,1.1.1,1.1.2,12,1,38,4,42,2,FALSE
through,1.1.2,2.0.0,13,3,6,6,12,3,FALSE
through,2.0.0,2.1.0,14,2,11,14,25,2,FALSE
through,2.1.0,2.2.0,15,4,8,3,11,4,FALSE
through,2.2.0,2.2.1,16,4,12,8,20,4,FALSE
through,2.2.1,2.2.2,17,4,59,51,110,7,FALSE
through,2.2.2,2.2.4,18,4,4,4,8,4,FALSE
through,2.2.4,2.2.5,19,3,6,6,12,5,TRUE
through,2.2.5,2.2.6,20,2,2,2,4,2,TRUE
through,2.2.6,2.2.7,21,4,6,6,12,4,FALSE
through,2.2.7,2.3.1,22,6,62,10,72,6,FALSE
through,2.3.1,2.3.2,23,3,24,2,26,3,FALSE
through,2.3.2,2.3.3,24,3,3,1,4,3,TRUE
through,2.3.3,2.3.4,25,4,4,4,8,4,FALSE
through,2.3.4,2.3.6,26,10,61,28,89,11,FALSE
through,2.3.6,2.3.7,27,3,19,3,22,4,FALSE
through,2.3.7,2.3.8,28,3,3,3,6,3,FALSE
through2,0.0.0,0.0.1,1,1,1,1,2,1,TRUE
through2,0.0.1,0.0.2,2,1,1,1,2,1,TRUE
through2,0.0.2,0.0.3,3,1,1,1,2,1,TRUE
through2,0.0.3,0.0.4,4,6,349,3,352,12,TRUE
through2,0.0.4,0.0.5,5,4,6,4,10,4,TRUE
through2,0.0.5,0.1.0,6,6,265,21,286,11,FALSE
through2,0.1.0,0.2.0,7,1,12,2,14,3,FALSE
through2,0.2.0,0.2.1,8,1,2,3,5,2,FALSE
through2,0.2.1,0.2.2,9,1,2,2,4,1,FALSE
through2,0.2.2,0.2.3,10,3,10,7,17,4,FALSE
through2,0.2.3,0.3.0,11,10,181,35,216,18,FALSE
through2,0.3.0,0.4.0,12,8,102,39,141,13,FALSE
through2,0.4.0,0.4.1,13,1,3,3,6,1,FALSE
through2,0.4.1,0.4.2,14,5,28,9,37,5,FALSE
through2,0.4.2,0.5.0,15,4,6,3,9,4,FALSE
through2,0.5.0,0.5.1,16,2,2,2,4,2,TRUE
through2,0.5.1,0.6.0,17,12,62,23,85,12,FALSE
through2,0.6.0,0.6.1,18,4,57,3,60,5,FALSE
through2,0.6.1,0.6.2,19,2,2,2,4,2,FALSE
through2,0.6.2,0.6.3,20,9,59,40,99,10,FALSE
through2,0.6.3,0.6.4,21,3,13,8,21,3,FALSE
through2,0.6.4,0.6.5,22,2,1,18,19,2,TRUE
through2,1.0.0,1.1.0,24,23,98,37,135,23,FALSE
through2,1.1.0,1.1.1,25,3,56,2,58,4,FALSE
through2,1.1.1,2.0.0,26,18,83,75,158,19,FALSE
through2,2.0.0,2.0.1,27,8,8,6,14,8,FALSE
through2,2.0.1,2.0.2,28,4,10,7,17,4,FALSE
through2,2.0.2,2.0.3,29,2,10,40,50,3,TRUE
tildify,0.1.0,0.2.0,1,5,22,10,32,5,FALSE
tildify,0.2.0,1.0.0,2,2,6,4,10,3,FALSE
tildify,1.0.0,1.1.0,3,6,69,40,109,16,FALSE
tildify,1.1.0,1.1.1,4,6,32,11,43,8,FALSE
tildify,1.1.1,1.1.2,5,2,8,2,10,3,FALSE
tildify,1.1.2,1.2.0,6,4,50,60,110,11,FALSE
to-string-loader,1.0.0,1.1.0,1,2,1,2,3,2,TRUE
to-string-loader,1.1.0,1.1.1,2,2,2,2,4,2,TRUE
to-string-loader,1.1.1,1.1.2,3,2,6,3,9,2,TRUE
to-string-loader,1.1.2,1.1.3,4,1,1,1,2,1,TRUE
to-string-loader,1.1.3,1.1.4,5,5,6,4,10,5,FALSE
to-string-loader,1.1.4,1.1.5,6,2,52,10,62,4,FALSE
ts-jest,0.0.1,0.1.0,1,1,6,6,12,3,TRUE
ts-jest,0.1.0,0.1.1,2,2,17,18,35,2,TRUE
ts-jest,0.1.1,0.1.2,3,1,4,22,26,3,TRUE
ts-jest,0.1.2,0.1.3,4,1,2,2,4,2,TRUE
ts-jest,0.1.3,0.1.4,5,2,188,8,196,16,FALSE
ts-jest,0.1.4,0.1.5,6,4,30,10,40,7,FALSE
ts-jest,0.1.5,0.1.6,7,11,696,126,822,49,FALSE
ts-jest,0.1.6,0.1.7,8,3,97,63,160,7,FALSE
ts-jest,0.1.7,0.1.8,9,11,1680,1428,3108,92,FALSE
ts-jest,0.1.8,0.1.9,10,20,1593,1577,3170,101,FALSE
ts-jest,0.1.9,0.1.10,11,18,62,30,92,27,FALSE
ts-jest,0.1.10,0.1.11,12,2,8,5,13,3,FALSE
ts-jest,0.1.11,0.1.13,13,20,521,321,842,79,FALSE
ts-jest,0.1.13,17.0.0,14,3,154,19,173,16,FALSE
ts-jest,17.0.0,17.0.1,15,9,12,9,21,9,FALSE
ts-jest,17.0.1,17.0.2,16,4,260,68,328,20,TRUE
ts-jest,17.0.2,17.0.3,17,2,6,6,12,6,TRUE
ts-jest,17.0.3,18.0.0,18,24,475,94,569,56,FALSE
ts-jest,18.0.0,18.0.1,19,6,6,4,10,6,FALSE
ts-jest,18.0.1,18.0.2,20,11,258,90,348,25,FALSE
ts-jest,18.0.2,18.0.3,21,13,21,13,34,13,FALSE
ts-jest,18.0.3,19.0.0,22,4,92,56,148,28,FALSE
ts-jest,19.0.0,19.0.1,23,22,484,416,900,76,FALSE
ts-jest,19.0.1,19.0.2,24,23,431,203,634,48,FALSE
ts-jest,19.0.2,19.0.3,25,7,81,13,94,14,FALSE
ts-jest,19.0.3,19.0.4,26,4,17,3,20,7,TRUE
ts-jest,19.0.4,19.0.5,27,10,105,34,139,13,TRUE
ts-jest,19.0.5,19.0.6,28,8,185,67,252,21,FALSE
ts-jest,19.0.6,19.0.7,29,11,106,22,128,16,FALSE
ts-jest,19.0.7,19.0.8,30,6,56,34,90,12,FALSE
ts-jest,19.0.8,19.0.9,31,16,231,43,274,44,FALSE
ts-jest,19.0.9,19.0.10,32,5,72,6,78,10,FALSE
ts-jest,19.0.10,19.0.11,33,10,257,28,285,31,FALSE
ts-jest,19.0.11,19.0.12,34,6,81,7,88,11,FALSE
ts-jest,19.0.12,19.0.13,35,3,6,4,10,5,TRUE
ts-jest,19.0.13,19.0.14,36,4,21,20,41,9,FALSE
ts-jest,19.0.14,20.0.0,37,21,6773,791,7564,75,FALSE
ts-jest,20.0.0,20.0.1,38,5,23,15,38,9,FALSE
ts-jest,20.0.1,20.0.2,39,2,8,6,14,4,TRUE
ts-jest,20.0.2,20.0.3,40,3,12,10,22,5,FALSE
ts-jest,20.0.3,20.0.4,41,6,123,24,147,11,FALSE
ts-jest,20.0.4,20.0.5,42,23,920,1247,2167,76,FALSE
tslint-eslint-rules,0.1.5,0.1.6,1,1,63,2,65,2,TRUE
tslint-eslint-rules,0.1.6,0.1.7,2,1,63,2,65,2,TRUE
tslint-eslint-rules,0.1.7,0.2.0,3,3,245,37,282,22,TRUE
tslint-eslint-rules,0.2.0,0.2.1,4,1,63,2,65,2,TRUE
tslint-eslint-rules,0.2.1,0.2.3,5,5,2986,2780,5766,27,TRUE
tslint-eslint-rules,0.2.3,0.2.4,6,4,254,18,272,13,FALSE
tslint-eslint-rules,0.2.4,0.2.5,7,5,303,27,330,13,TRUE
tslint-eslint-rules,0.2.5,0.2.6,8,4,382,18,400,28,TRUE
tslint-eslint-rules,0.2.6,0.2.7,9,3,331,6,337,11,TRUE
tslint-eslint-rules,0.2.7,0.3.0,10,10,2250,294,2544,64,FALSE
tslint-eslint-rules,0.3.0,1.0.0,11,11,1200,1425,2625,36,FALSE
tslint-eslint-rules,1.0.0,1.0.1,12,1,1,1,2,1,TRUE
tslint-eslint-rules,1.0.1,1.1.0,13,3,48,32,80,12,FALSE
tslint-eslint-rules,1.1.0,1.1.1,14,4,10,1,11,4,FALSE
tslint-eslint-rules,1.1.1,1.2.0,15,12,1870,303,2173,20,FALSE
tslint-eslint-rules,1.2.0,1.3.0,16,13,1519,94,1613,30,FALSE
tslint-eslint-rules,1.3.0,1.4.0,17,31,1352,183,1535,72,FALSE
tslint-eslint-rules,1.4.0,1.5.0,18,8,1294,405,1699,116,TRUE
tslint-eslint-rules,1.5.0,1.6.0,19,54,22941,12964,35905,350,FALSE
tslint-eslint-rules,1.6.0,1.6.1,20,3,38,14,52,9,FALSE
tslint-eslint-rules,1.6.1,2.0.0,21,3,31,24,55,10,TRUE
tslint-eslint-rules,2.0.0,2.0.1,22,2,36,24,60,4,TRUE
tslint-eslint-rules,2.0.1,2.1.0,23,14,261,151,412,46,FALSE
tslint-eslint-rules,2.1.0,2.2.0,24,23,11082,579,11661,59,FALSE
tslint-eslint-rules,2.2.0,2.2.1,25,4,30,23,53,7,TRUE
tslint-eslint-rules,2.2.1,3.0.0,26,17,2117,1706,3823,101,FALSE
tslint-eslint-rules,3.0.0,3.1.0,27,29,8853,5424,14277,85,FALSE
tslint-eslint-rules,3.1.0,3.2.0,28,28,9217,1042,10259,239,FALSE
tslint-eslint-rules,3.2.0,3.2.1,29,5,111,2,113,9,FALSE
tslint-eslint-rules,3.2.1,3.2.2,30,9,390,61,451,19,FALSE
tslint-eslint-rules,3.2.2,3.2.3,31,6,98,18,116,11,TRUE
tslint-eslint-rules,3.2.3,3.3.0,32,30,25436,13308,38744,442,FALSE
tslint-eslint-rules,3.3.0,3.4.0,33,29,4600,1460,6060,79,FALSE
tslint-eslint-rules,3.4.0,3.5.0,34,48,6754,2958,9712,100,FALSE
tslint-eslint-rules,3.5.0,3.5.1,35,3,49,3,52,6,FALSE
tslint-eslint-rules,3.5.1,4.0.0,36,17,465,5125,5590,61,FALSE
tslint-eslint-rules,4.0.0,4.1.0,37,39,5576,4237,9813,243,FALSE
tslint-eslint-rules,4.1.0,4.1.1,38,4,60,6,66,7,FALSE
twilio,0.3.0,0.3.3,6,10,232,163,395,16,FALSE
twilio,0.4.0,0.4.1,8,9,231,162,393,15,FALSE
twilio,0.4.1,0.5.0,9,20,1880,2599,4479,111,FALSE
twilio,0.5.0,0.6.0,10,5,266,13,279,7,TRUE
twilio,0.6.0,0.6.1,11,6,85,67,152,18,FALSE
twilio,0.6.1,0.6.2,12,4,68,12,80,17,FALSE
twilio,0.6.2,0.7.0,13,4,358,116,474,16,FALSE
twilio,0.7.0,0.7.1,14,4,78,281,359,20,FALSE
twilio,0.7.1,0.8.0,15,15,469,61,530,30,FALSE
twilio,0.8.0,0.8.1,16,4,70,15,85,7,TRUE
twilio,0.8.1,1.0.0,17,3,14,13,27,7,FALSE
twilio,1.0.0,1.0.1,18,2,2,14,16,3,FALSE
twilio,1.0.1,1.1.0,19,6,171,6,177,8,FALSE
twilio,1.1.0,1.1.1,20,2,55,145,200,5,FALSE
twilio,1.1.1,1.1.2,21,1,38,4,42,3,FALSE
twilio,1.1.2,1.1.3,22,3,15,9,24,3,FALSE
twilio,1.1.3,1.1.4,23,2,28,6,34,3,FALSE
twilio,1.1.4,1.2.0,24,11,611,134,745,31,FALSE
twilio,1.2.0,1.3.0,25,5,59,8,67,10,FALSE
twilio,1.3.0,1.4.0,26,9,904,892,1796,30,FALSE
twilio,1.4.0,1.5.0,27,12,521,28,549,19,FALSE
twilio,1.5.0,1.6.0,28,20,426,262,688,28,FALSE
twilio,1.6.0,1.7.0,29,14,170,88,258,28,FALSE
twilio,1.7.0,1.8.0,30,14,1189,238,1427,38,FALSE
twilio,1.8.0,1.9.0,31,7,138,14,152,13,FALSE
twilio,1.9.0,1.10.0,32,2,108,2,110,4,FALSE
twilio,1.10.0,1.11.0,33,33,3452,902,4354,126,FALSE
twilio,1.11.0,1.11.1,34,4,6,5,11,4,FALSE
twilio,1.11.1,2.0.0,35,9,233,23,256,21,FALSE
twilio,2.0.0,2.1.0,36,7,343,16,359,20,FALSE
twilio,2.1.0,2.1.1,37,5,162,6,168,12,FALSE
twilio,2.1.1,2.2.0,38,3,303,1,304,13,TRUE
twilio,2.2.0,2.2.1,39,5,9,7,16,5,FALSE
twilio,2.2.1,2.3.0,40,29,2843,867,3710,93,FALSE
twilio,2.3.0,2.4.0,41,20,2418,644,3062,60,FALSE
twilio,2.4.0,2.5.1-edge,42,7,353,3,356,10,FALSE
twilio,2.5.1,2.5.2-edge,44,4,128,46,174,8,FALSE
twilio,2.5.2-edge,2.5.2,45,1,68,3,71,3,TRUE
twilio,2.5.2,2.6.0,46,19,20573,3505,24078,461,FALSE
twilio,2.6.0,2.7.0,47,10,22618,26980,49598,477,FALSE
twilio,2.7.0,2.8.0,48,1,2540,1365,3905,1251,FALSE
twilio,2.8.0,2.9.0,49,45,68206,26172,94378,2097,FALSE
twilio,2.9.0,2.9.1,50,22,570913,41746,612659,1829,FALSE
twilio,2.9.1,2.9.2,51,36,114072,10474,124546,3721,FALSE
twilio,2.9.2,2.9.3,52,8,13134,2406,15540,179,FALSE
twilio,2.10.0,2.11.0,54,6,13062,2399,15461,175,FALSE
twilio,2.11.0,2.11.1,55,3,76,19,95,16,FALSE
twilio,2.11.1,3.0.0-alpha-1,56,63,550891,1089577,1640468,4263,FALSE
twilio,3.0.0-edge,3.0.0-rc.2,58,90,678007,96348,774355,4781,FALSE
twilio,3.0.0-rc.2,3.0.0-rc.3,59,1,3578,201,3779,24,FALSE
twilio,3.0.0-rc.3,3.0.0-rc.4,60,6,49998,2324,52322,1094,FALSE
twilio,3.0.0-rc.4,3.0.0-rc.5,61,3,26,19,45,4,TRUE
twilio,3.0.0-rc.5,3.0.0-rc.6,62,7,33375,2966,36341,1162,FALSE
twilio,3.0.0-rc.6,3.0.0-rc.7,63,2,4370,1126,5496,561,FALSE
twilio,3.0.0-rc.7,3.0.0-rc.8,64,3,44,8,52,8,FALSE
twilio,3.0.0-rc.8,3.0.0-rc.9,65,1,3,1,4,2,FALSE
twilio,3.0.0-rc.9,3.0.0-rc.10,66,2,23897,2703,26600,703,FALSE
twilio,3.0.0-rc.10,3.0.0-rc.11,67,12,2359,1327,3686,187,FALSE
twilio,3.0.0-rc.11,3.0.0-rc.12,68,2,72,7,79,4,FALSE
twilio,3.0.0-rc.12,3.0.0-rc.13,69,6,13062,2399,15461,175,FALSE
twilio,3.0.0-rc.13,3.0.0-rc.14,70,3,76,19,95,16,FALSE
twilio,3.0.0-rc.14,3.0.0-rc.15,71,26,47841,4162,52003,483,FALSE
twilio,3.0.0-rc.15,3.0.0-rc.16,72,20,30741,26271,57012,1345,FALSE
twilio,3.0.0-rc.16,3.0.0-rc.17,73,12,472140,1029450,1501590,2240,FALSE
twilio,3.0.0-rc16,3.0.0,75,6,170,29695,29865,196,FALSE
twilio,3.0.0,3.1.0-alpha-1,76,12,2901,132,3033,29,FALSE
twilio,3.1.0-edge,3.1.0,78,189,1320193,1170526,2490719,12134,FALSE
twilio,3.1.0,3.2.0-alpha-1,79,4,611,74,685,11,FALSE
twilio,3.2.0-edge,3.2.0,81,193,1320804,1170600,2491404,12145,FALSE
twilio,3.2.0,3.3.0-alpha-1,82,3,7,2,9,3,TRUE
twilio,3.3.0-edge,3.3.0,84,151,1252605,1144430,2397035,10051,FALSE
twilio,3.3.1-edge,5.0.0-rc16,86,66,117260,37162,154422,2391,FALSE
update-notifier,0.1.0,0.1.1,1,4,58,16,74,8,FALSE
update-notifier,0.1.1,0.1.2,2,5,37,21,58,5,FALSE
update-notifier,0.1.2,0.1.3,3,3,10,5,15,4,FALSE
update-notifier,0.1.3,0.1.4,4,13,104,28,132,18,FALSE
update-notifier,0.1.4,0.1.5,5,3,29,29,58,5,FALSE
update-notifier,0.1.5,0.1.6,6,3,20,4,24,5,FALSE
update-notifier,0.1.6,0.1.7,7,5,14,9,23,6,FALSE
update-notifier,0.1.7,0.1.8,8,7,57,58,115,7,FALSE
update-notifier,0.1.8,0.1.9,9,16,223,253,476,31,FALSE
update-notifier,0.1.9,0.1.10,10,1,12,1,13,4,FALSE
update-notifier,0.1.10,0.2.0,11,14,135,108,243,25,FALSE
update-notifier,0.2.0,0.2.1,12,4,9,7,16,4,FALSE
update-notifier,0.2.1,0.2.2,13,5,8,5,13,6,FALSE
update-notifier,0.2.2,0.3.0,14,3,32,28,60,5,FALSE
update-notifier,0.3.0,0.3.1,15,3,5,2,7,3,FALSE
update-notifier,0.3.1,0.3.2,16,3,3,3,6,3,FALSE
update-notifier,0.3.2,0.4.0,17,3,10,20,30,5,FALSE
update-notifier,0.4.0,0.5.0,18,4,4,4,8,4,FALSE
update-notifier,0.5.0,0.6.0,19,6,54,89,143,15,FALSE
update-notifier,0.6.0,0.6.1,20,2,25,25,50,6,FALSE
update-notifier,0.6.1,0.6.2,21,3,3,3,6,3,FALSE
update-notifier,0.6.2,0.6.3,22,6,7,6,13,6,FALSE
update-notifier,0.6.3,0.7.0,23,4,84,16,100,9,FALSE
update-notifier,0.7.0,1.0.0,24,3,104,17,121,6,FALSE
update-notifier,1.0.0,1.0.1,25,5,10,8,18,6,FALSE
update-notifier,1.0.1,1.0.2,26,2,24,22,46,3,FALSE
update-notifier,1.0.2,1.0.3,27,3,6,4,10,4,FALSE
update-notifier,1.0.3,2.0.0,28,5,227,217,444,14,FALSE
update-notifier,2.0.0,2.1.0,29,2,26,11,37,4,FALSE
vorpal,1.0.0,1.0.1,1,7,50,47,97,8,FALSE
vorpal,1.0.1,1.0.2,2,2,24,0,24,2,FALSE
vorpal,1.0.2,1.0.3,3,2,3,3,6,2,TRUE
vorpal,1.0.3,1.0.4,4,2,66,22,88,5,TRUE
vorpal,1.0.4,1.0.5,5,2,39,20,59,4,TRUE
vorpal,1.0.5,1.0.7,6,2,56,16,72,5,TRUE
vorpal,1.0.7,1.0.8,7,6,14,6,20,6,FALSE
vorpal,1.0.8,1.0.9,8,3,63,17,80,5,TRUE
vorpal,1.0.9,1.1.0,9,4,2441,2190,4631,15,FALSE
vorpal,1.1.0,1.1.1,10,5,1812,1854,3666,22,TRUE
vorpal,1.1.1,1.1.2,11,4,275,164,439,5,TRUE
vorpal,1.1.2,1.1.3,12,2,16,1,17,3,TRUE
vorpal,1.1.3,1.1.4,13,2,9,1,10,2,TRUE
vorpal,1.1.4,1.1.5,14,2,6,8,14,4,TRUE
vorpal,1.1.5,1.1.6,15,4,569,15,584,9,FALSE
vorpal,1.1.6,1.1.7,16,2,68,83,151,3,TRUE
vorpal,1.1.7,1.1.8,17,1,278,3,281,7,TRUE
vorpal,1.1.8,1.1.9,18,4,21,6,27,5,TRUE
vorpal,1.1.9,1.1.10,19,2,105,452,557,9,TRUE
vorpal,1.1.10,1.2.0,20,2,14,2,16,5,TRUE
vorpal,1.2.0,1.2.1,21,2,89,9,98,8,TRUE
vorpal,1.2.1,1.2.3,22,2,33,34,67,6,TRUE
vorpal,1.2.3,1.2.4,23,3,29,2,31,3,TRUE
vorpal,1.2.4,1.2.5,24,2,43,27,70,4,FALSE
vorpal,1.2.5,1.2.6,25,2,55,21,76,6,TRUE
vorpal,1.2.6,1.3.0,26,3,68,13,81,4,FALSE
vorpal,1.3.0,1.3.1,27,2,200,86,286,3,TRUE
vorpal,1.3.1,1.3.2,28,3,15,47,62,5,TRUE
vorpal,1.3.2,1.3.3,29,2,2,2,4,2,TRUE
vorpal,1.3.3,1.3.4,30,2,5,3,8,3,FALSE
vorpal,1.3.4,1.3.5,31,2,33,9,42,5,TRUE
vorpal,1.3.5,1.3.6,32,3,6,4,10,4,FALSE
vorpal,1.3.6,1.3.7,33,2,38,17,55,4,TRUE
vorpal,1.3.7,1.3.8,34,2,14,8,22,5,TRUE
vorpal,1.3.8,1.3.9,35,2,11,3,14,2,TRUE
vorpal,1.3.9,1.3.10,36,12,73,346,419,21,FALSE
vorpal,1.3.10,1.3.11,37,3,96,845,941,3,TRUE
vorpal,1.3.11,1.3.12,38,2,3,2,5,2,TRUE
vorpal,1.3.12,1.3.13,39,2,21,2,23,3,TRUE
vorpal,1.3.13,1.3.14,40,3,17,2,19,3,TRUE
vorpal,1.3.14,1.3.15,41,2,19,13,32,4,TRUE
vorpal,1.3.15,1.3.16,42,2,9,3,12,4,TRUE
vorpal,1.3.16,1.3.17,43,2,44,34,78,6,TRUE
vorpal,1.3.17,1.3.18,44,2,6,2,8,2,TRUE
vorpal,1.3.18,1.3.19,45,2,106,19,125,4,TRUE
vorpal,1.3.19,1.3.20,46,2,17,5,22,3,TRUE
vorpal,1.3.20,1.3.21,47,2,63,6,69,3,TRUE
vorpal,1.3.21,1.3.22,48,14,130,166,296,21,FALSE
vorpal,1.3.22,1.3.23,49,2,5,6,11,2,TRUE
vorpal,1.3.23,1.3.24,50,2,3,2,5,2,FALSE
vorpal,1.3.24,1.3.25,51,3,84,9,93,5,TRUE
vorpal,1.3.25,1.3.26,52,7,43,42,85,8,FALSE
vorpal,1.3.26,1.3.27,53,5,35,23,58,5,FALSE
vorpal,1.3.27,1.3.29,54,3,3,3,6,3,FALSE
vorpal,1.3.29,1.3.30,55,2,13,29,42,4,TRUE
vorpal,1.3.30,1.3.31,56,3,45,23,68,5,TRUE
vorpal,1.3.31,1.3.32,57,1,1,1,2,1,TRUE
vorpal,1.3.32,1.3.33,58,2,13,5,18,4,TRUE
vorpal,1.3.33,1.3.34,59,2,30,7,37,2,TRUE
vorpal,1.3.34,1.4.0,60,9,90,20,110,12,FALSE
vorpal,1.4.0,1.4.1,61,13,285,11,296,29,FALSE
vorpal,1.4.1,1.5.0,62,19,1104,121,1225,58,FALSE
vorpal,1.5.0,1.5.1,63,3,3,3,6,3,TRUE
vorpal,1.5.1,1.5.2,64,4,46,7,53,7,TRUE
vorpal,1.5.2,1.5.3,65,2,1,18,19,2,TRUE
vorpal,1.5.3,1.5.4,66,2,9,2,11,3,TRUE
vorpal,1.5.4,1.5.5,67,3,40,151,191,5,FALSE
vorpal,1.5.5,1.5.6,68,12,171,60,231,23,FALSE
vorpal,1.5.6,1.5.7,69,1,1,1,2,1,TRUE
vorpal,1.5.7,1.5.8,70,4,16,16,32,11,TRUE
vorpal,1.5.8,1.6.0,71,2,106,20,126,5,FALSE
vorpal,1.6.0,1.6.1,72,3,10,9,19,4,TRUE
vorpal,1.6.1,1.6.2,73,2,4,4,8,3,TRUE
vorpal,1.6.2,1.6.3,74,1,278,3,281,7,TRUE
vorpal,1.6.3,1.7.0,75,4,8,7,15,5,FALSE
vorpal,1.7.0,1.7.1,76,3,494,97,591,9,FALSE
vorpal,1.7.1,1.7.2,77,1,1,1,2,1,TRUE
vorpal,1.7.2,1.7.3,78,3,10,8,18,3,TRUE
vorpal,1.7.3,1.7.4,79,3,64,44,108,3,TRUE
vorpal,1.7.4,1.7.5,80,2,4,3,7,2,TRUE
vorpal,1.7.5,1.7.6,81,7,243,74,317,15,TRUE
vorpal,1.7.6,1.7.7,82,1,1,1,2,1,TRUE
vorpal,1.7.7,1.8.0,83,22,587,562,1149,45,FALSE
vorpal,1.8.0,1.8.1,84,2,9,3,12,3,TRUE
vorpal,1.8.1,1.8.2,85,2,4,2,6,3,TRUE
vorpal,1.8.2,1.8.3,86,1,1,1,2,1,TRUE
vorpal,1.8.3,1.8.4,87,3,7,3,10,3,TRUE
vorpal,1.8.4,1.8.5,88,6,30,24,54,10,TRUE
vorpal,1.8.5,1.8.6,89,4,16,17,33,6,TRUE
vorpal,1.8.6,1.8.8,90,4,4542,4,4546,17,TRUE
vorpal,1.8.8,1.8.9,91,2,10,4,14,2,TRUE
vorpal,1.8.9,1.9.0,92,3,144,8,152,9,FALSE
vorpal,1.9.0,1.9.1,93,7,44,19,63,7,FALSE
vorpal,1.9.1,1.9.2,94,2,17,1,18,3,TRUE
vorpal,1.9.2,1.9.3,95,12,124,172,296,26,FALSE
vorpal,1.9.3,1.9.4,96,3,49,76,125,29,TRUE
vorpal,1.9.4,1.9.5,97,1,278,3,281,7,TRUE
vorpal,1.9.5,1.9.6,98,5,5,4,9,5,FALSE
vorpal,1.9.6,1.9.7,99,2,2,2,4,2,TRUE
vorpal,1.9.7,1.10.0,100,5,66,30,96,34,FALSE
vorpal,1.10.0,1.10.1,101,2,312,24,336,7,TRUE
vorpal,1.10.1,1.10.2,102,2,147,42,189,6,TRUE
vorpal,1.10.2,1.10.3,103,2,17,1,18,4,TRUE
vorpal,1.10.3,1.10.4,104,2,7,7,14,5,TRUE
vorpal,1.10.4,1.10.5,105,5,93,24,117,8,TRUE
vorpal,1.10.5,1.10.6,106,4,35,5,40,7,TRUE
vorpal,1.10.6,1.10.7,107,2,2,2,4,2,TRUE
vorpal,1.10.7,1.10.8,108,2,15,5,20,5,TRUE
vorpal,1.10.8,1.10.9,109,10,212,328,540,31,FALSE
vorpal,1.10.9,1.10.10,110,2,145,7,152,4,FALSE
vorpal,1.10.10,1.11.0,111,7,199,88,287,13,FALSE
vorpal,1.11.0,1.11.1,112,1,278,3,281,7,TRUE
vorpal,1.11.1,1.11.2,113,5,64,41,105,10,FALSE
vorpal,1.11.2,1.11.3,114,10,332,40,372,25,FALSE
vorpal,1.11.3,1.11.4,115,5,39,37,76,16,FALSE
vorpal,1.11.4,1.12.0,116,21,299,181,480,47,FALSE
vue-template-compiler,0.1.0,2.0.0-alpha.1,1,11,336,174,510,37,TRUE
vue-template-compiler,2.0.0-alpha.1,2.0.0-alpha.2,2,18,706,472,1178,50,FALSE
vue-template-compiler,2.0.0-alpha.2,2.0.0-alpha.3,3,10,485,275,760,44,FALSE
vue-template-compiler,2.0.0-alpha.3,2.0.0-alpha.4,4,4,230,130,360,12,TRUE
vue-template-compiler,2.0.0-alpha.4,2.0.0-alpha.5,5,10,204,407,611,40,FALSE
vue-template-compiler,2.0.0-alpha.5,2.0.0-alpha.6,6,23,545,554,1099,58,FALSE
vue-template-compiler,2.0.0-alpha.6,2.0.0-alpha.7,7,36,7761,7131,14892,126,FALSE
vue-template-compiler,2.0.0-alpha.7,2.0.0-alpha.8,8,10,1215,843,2058,28,TRUE
vue-template-compiler,2.0.0-alpha.8,2.0.0-beta.1,9,41,887,451,1338,104,FALSE
vue-template-compiler,2.0.0-beta.1,2.0.0-beta.2,10,65,5913,3319,9232,137,FALSE
vue-template-compiler,2.0.0-beta.2,2.0.0-beta.3,11,22,1643,1078,2721,59,FALSE
vue-template-compiler,2.0.0-beta.3,2.0.0-beta.4,12,10,707,742,1449,35,FALSE
vue-template-compiler,2.0.0-beta.4,2.0.0-beta.5,13,8,9640,9500,19140,34,FALSE
vue-template-compiler,2.0.0-beta.5,2.0.0-beta.6,14,28,1113,261,1374,66,FALSE
vue-template-compiler,2.0.0-beta.6,2.0.0-beta.7,15,21,693,478,1171,72,FALSE
vue-template-compiler,2.0.0-beta.7,2.0.0-beta.8,16,13,687,494,1181,42,FALSE
vue-template-compiler,2.0.0-beta.8,2.0.0-rc.1,17,5,436,275,711,16,FALSE
vue-template-compiler,2.0.0-rc.1,2.0.0-rc.2,18,29,754,288,1042,54,FALSE
vue-template-compiler,2.0.0-rc.2,2.0.0-rc.3,19,20,544,290,834,54,FALSE
vue-template-compiler,2.0.0-rc.3,2.0.0-rc.4,20,29,1288,871,2159,79,FALSE
vue-template-compiler,2.0.0-rc.4,2.0.0-rc.5,21,21,16278,12997,29275,64,FALSE
vue-template-compiler,2.0.0-rc.5,2.0.0-rc.6,22,12,433,276,709,29,FALSE
vue-template-compiler,2.0.0-rc.6,2.0.0-rc.7,23,28,711,1792,2503,79,FALSE
vue-template-compiler,2.0.0-rc.7,2.0.0-rc.8,24,7,701,666,1367,16,FALSE
vue-template-compiler,2.0.0-rc.8,2.0.0,25,24,756,434,1190,47,FALSE
vue-template-compiler,2.0.0,2.0.1,26,3,350,297,647,10,TRUE
vue-template-compiler,2.0.1,2.0.2,27,36,625,233,858,81,FALSE
vue-template-compiler,2.0.2,2.0.3,28,17,6992,6626,13618,55,FALSE
vue-template-compiler,2.0.3,2.0.4,29,41,1777,874,2651,127,FALSE
vue-template-compiler,2.0.4,2.0.5,30,8,8733,1648,10381,21,TRUE
vue-template-compiler,2.0.5,2.0.6,31,36,14706,620,15326,151,FALSE
vue-template-compiler,2.0.6,2.0.7,32,8,7629,2907,10536,26,TRUE
vue-template-compiler,2.0.7,2.0.8,33,17,8546,2684,11230,49,FALSE
vue-template-compiler,2.0.8,2.1.0,34,35,1912,487,2399,123,FALSE
vue-template-compiler,2.1.0,2.1.1,35,6,12289,9261,21550,21,FALSE
vue-template-compiler,2.1.1,2.1.2,36,5,327,189,516,18,TRUE
vue-template-compiler,2.1.2,2.1.3,37,2,89,59,148,11,TRUE
vue-template-compiler,2.1.3,2.1.4,38,39,1536,593,2129,127,FALSE
vue-template-compiler,2.1.4,2.1.5,39,38,10965,10299,21264,97,FALSE
vue-template-compiler,2.1.5,2.1.6,40,6,2160,1668,3828,17,TRUE
vue-template-compiler,2.1.6,2.1.7,41,35,938,367,1305,82,FALSE
vue-template-compiler,2.1.7,2.1.8,42,22,3487,2661,6148,60,FALSE
vue-template-compiler,2.1.8,2.1.9,43,46,2536,4672,7208,102,FALSE
vue-template-compiler,2.1.9,2.1.10,44,4,11733,11489,23222,16,TRUE
vue-template-compiler,2.1.10,2.2.0-beta.1,45,117,6953,3626,10579,361,FALSE
vue-template-compiler,2.2.0-beta.1,2.2.0-beta.2,46,12,26429,17808,44237,34,TRUE
vue-template-compiler,2.2.0-beta.2,2.2.0,47,12,9002,13047,22049,35,FALSE
vue-template-compiler,2.2.0,2.2.1,48,3,16147,299,16446,14,TRUE
vue-template-compiler,2.2.1,2.2.2,49,44,488,338,826,100,FALSE
vue-template-compiler,2.2.2,2.2.3,50,15,1381,1053,2434,44,FALSE
vue-template-compiler,2.2.3,2.2.4,51,3,1484,1127,2611,15,TRUE
vue-template-compiler,2.2.4,2.2.5,52,19,1295,834,2129,56,FALSE
vue-template-compiler,2.2.5,2.2.6,53,6,1059,527,1586,19,FALSE
vue-template-compiler,2.2.6,2.3.0-beta.1,54,123,4709,2165,6874,355,FALSE
vue-template-compiler,2.3.0-beta.1,2.3.0,55,3,11979,14068,26047,18,TRUE
vue-template-compiler,2.3.0,2.3.1,56,11,1683,1627,3310,50,FALSE
vue-template-compiler,2.3.1,2.3.2,57,4,397,327,724,18,TRUE
vue-template-compiler,2.3.2,2.3.3,58,19,446,143,589,58,FALSE
vue,0.0.0,0.6.0,1,1,1,1,2,1,TRUE
vue,0.6.0,0.7.0,2,1,1,1,2,1,FALSE
vue,0.7.0,0.7.1,3,1,1,1,2,1,TRUE
vue,0.7.1,0.7.3,4,1,1,1,2,1,FALSE
vue,0.7.3,0.7.4,5,1,1,1,2,1,FALSE
vue,0.7.4,0.7.5,6,1,1,1,2,1,FALSE
vue,0.7.5,0.7.6,7,1,1,1,2,1,FALSE
vue,0.7.6,0.8.0,8,1,1,1,2,1,FALSE
vue,0.8.0,0.8.1,9,1,1,1,2,1,FALSE
vue,0.8.1,0.8.2,10,1,1,1,2,1,FALSE
vue,0.8.2,0.8.3,11,1,1,1,2,1,FALSE
vue,0.8.3,0.8.4,12,1,1,1,2,1,FALSE
vue,0.8.4,0.8.6,13,1,1,1,2,1,FALSE
vue,0.8.6,0.8.7,14,1,1,1,2,1,FALSE
vue,0.8.7,0.8.8,15,1,1,1,2,1,TRUE
vue,0.8.8,0.9.0,16,1,1,1,2,1,FALSE
vue,0.9.0,0.9.1,17,1,1,1,2,1,TRUE
vue,0.9.1,0.9.2,18,1,1,1,2,1,TRUE
vue,0.9.2,0.9.3,19,1,1,1,2,1,FALSE
vue,0.9.3,0.10.0,20,1,1,1,2,1,FALSE
vue,0.10.0,0.10.1,21,1,1,1,2,1,TRUE
vue,0.10.1,0.10.2,22,1,1,1,2,1,TRUE
vue,0.10.2,0.10.3,23,1,1,1,2,1,FALSE
vue,0.10.3,0.10.4,24,1,1,1,2,1,FALSE
vue,0.10.4,0.10.5,25,1,1,1,2,1,FALSE
vue,0.10.5,0.10.6,26,1,1,1,2,1,FALSE
vue,0.10.6,0.11.0-rc,27,1,1,1,2,1,FALSE
vue,0.11.0-rc,0.11.0-rc2,28,1,1,1,2,1,FALSE
vue,0.11.0-rc2,0.11.0-rc3,29,1,1,1,2,1,FALSE
vue,0.11.0-rc3,0.11.0,30,1,1,1,2,1,FALSE
vue,0.11.0,0.11.1,31,1,1,1,2,1,FALSE
vue,0.11.1,0.11.2,32,1,1,1,2,1,FALSE
vue,0.11.2,0.11.3,33,1,1,1,2,1,TRUE
vue,0.11.3,0.11.4,34,1,1,1,2,1,FALSE
vue,0.11.4,0.11.5,35,1,1,1,2,1,FALSE
vue,0.11.5,0.11.6,36,1,1,1,2,1,FALSE
vue,0.11.6,0.11.7,37,1,1,1,2,1,FALSE
vue,0.11.7,0.11.8,38,1,1,1,2,1,TRUE
vue,0.11.8,0.11.9,39,1,1,1,2,1,FALSE
vue,0.11.9,0.11.10,40,1,1,1,2,1,TRUE
vue,0.11.10,0.12.0-beta1,41,1,1,1,2,1,FALSE
vue,0.12.0-beta1,0.12.0-beta2,42,1,1,1,2,1,TRUE
vue,0.12.0-beta2,0.12.0-beta3,43,1,1,1,2,1,FALSE
vue,0.12.0-beta3,0.12.0-beta4,44,1,1,1,2,1,FALSE
vue,0.12.0-beta4,0.12.0-beta5,45,1,1,1,2,1,FALSE
vue,0.12.0-beta5,0.12.0-csp,46,1,1,1,2,1,FALSE
vue,0.12.0-rc,0.12.0-rc2,48,1,1,1,2,1,FALSE
vue,0.12.0-rc2,0.12.0,49,1,1,1,2,1,FALSE
vue,0.12.0,0.12.1-csp,50,1,1,1,2,1,FALSE
vue,0.12.1-csp,0.12.1-csp.1,51,1,1,1,2,1,FALSE
vue,0.12.1-csp.1,0.12.1-csp.2,52,1,1,1,2,1,TRUE
vue,0.12.1,0.12.2,54,1,1,1,2,1,FALSE
vue,0.12.2,0.12.3,55,1,1,1,2,1,TRUE
vue,0.12.3,0.12.4,56,1,1,1,2,1,TRUE
vue,0.12.4,0.12.5-csp,57,1,1,1,2,1,FALSE
vue,0.12.5,0.12.6-csp,59,1,1,1,2,1,FALSE
vue,0.12.6,0.12.7-csp,61,1,1,1,2,1,FALSE
vue,0.12.7,0.12.8-csp,63,1,1,1,2,1,FALSE
vue,0.12.8,0.12.9-csp,65,1,1,1,2,1,FALSE
vue,0.12.9,0.12.10-csp,67,1,1,1,2,1,FALSE
vue,0.12.10,0.12.11-csp,69,1,1,1,2,1,FALSE
vue,0.12.11,0.12.12-csp,71,1,1,1,2,1,TRUE
vue,0.12.12,0.12.13-csp,73,1,1,1,2,1,FALSE
vue,0.12.13,0.12.14-csp,75,1,1,1,2,1,FALSE
vue,0.12.14,0.12.15-csp,77,1,1,1,2,1,FALSE
vue,0.12.15,0.12.16-csp,79,1,1,1,2,1,FALSE
vue,1.0.0-alpha.1,1.0.0-alpha.2,82,1,1,1,2,1,TRUE
vue,1.0.0-alpha.2,1.0.0-alpha.3,83,1,1,1,2,1,FALSE
vue,1.0.0-alpha.3,1.0.0-alpha.4,84,1,1,1,2,1,FALSE
vue,1.0.0-alpha.4,1.0.0-alpha.5,85,1,1,1,2,1,FALSE
vue,1.0.0-alpha.5,1.0.0-alpha.6,86,1,1,1,2,1,FALSE
vue,1.0.0-alpha.6,1.0.0-alpha.7,87,1,1,1,2,1,FALSE
vue,1.0.0-alpha.7,1.0.0-alpha.8,88,1,1,1,2,1,FALSE
vue,1.0.0-beta.1,1.0.0-beta.2,90,1,1,1,2,1,FALSE
vue,1.0.0-beta.2,1.0.0-beta.3,91,1,1,1,2,1,FALSE
vue,1.0.0-beta.3,1.0.0-beta.4,92,1,1,1,2,1,FALSE
vue,1.0.0-beta.4,1.0.0-csp,93,1,1,1,2,1,FALSE
vue,1.0.0-csp,1.0.0-migration,94,1,1,1,2,1,TRUE
vue,1.0.0-rc.1,1.0.0-rc.2,96,1,1,1,2,1,FALSE
vue,1.0.0-rc.2-migration,1.0.0,98,1,1,1,2,1,FALSE
vue,1.0.0,1.0.1,99,1,1,1,2,1,TRUE
vue,1.0.1,1.0.2,100,1,1,1,2,1,FALSE
vue,1.0.2,1.0.3,101,1,1,1,2,1,TRUE
vue,1.0.3,1.0.4,102,1,1,1,2,1,FALSE
vue,1.0.4,1.0.5,103,1,1,1,2,1,FALSE
vue,1.0.5,1.0.6,104,1,1,1,2,1,TRUE
vue,1.0.6,1.0.7,105,1,1,1,2,1,TRUE
vue,1.0.7,1.0.8,106,1,1,1,2,1,FALSE
vue,1.0.8,1.0.9,107,1,1,1,2,1,FALSE
vue,1.0.9,1.0.10-csp,108,1,1,1,2,1,TRUE
vue,1.0.10,1.0.11-csp,110,1,1,1,2,1,FALSE
vue,1.0.11,1.0.12-csp,112,1,1,1,2,1,FALSE
vue,1.0.12-csp,1.0.12-csp-1,113,1,1,1,2,1,TRUE
vue,1.0.12,1.0.13-csp,115,1,1,1,2,1,FALSE
vue,1.0.13,1.0.14-csp,117,1,1,1,2,1,FALSE
vue,1.0.14,1.0.15-csp,119,1,1,1,2,1,FALSE
vue,1.0.15,1.0.16-csp,121,1,1,1,2,1,FALSE
vue,1.0.16,1.0.17-csp,123,1,1,1,2,1,FALSE
vue,1.0.17,1.0.18-csp,125,1,1,1,2,1,FALSE
vue,1.0.18,1.0.19-csp,127,1,1,1,2,1,FALSE
vue,1.0.19,1.0.20-csp,129,1,1,1,2,1,FALSE
vue,1.0.20,1.0.21-csp,131,1,1,1,2,1,FALSE
vue,1.0.21,1.0.22-csp,133,394,37687,8437,46124,1387,FALSE
vue,1.0.22,1.0.23-csp,135,25,1061,804,1865,121,FALSE
vue,1.0.23,1.0.24-csp,137,2,97,129,226,15,TRUE
vue,1.0.24,1.0.25-csp,139,271,26135,12593,38728,940,FALSE
vue,1.0.25,1.0.26-csp,141,78,9714,8909,18623,248,FALSE
vue,1.0.26,1.0.27-csp,143,344,41647,33021,74668,897,FALSE
vue,1.0.27,1.0.28-csp,145,12,724,687,1411,33,FALSE
vue,2.0.0-alpha.1,2.0.0-alpha.2,148,16,475,421,896,46,FALSE
vue,2.0.0-alpha.2,2.0.0-alpha.3,149,10,545,219,764,44,FALSE
vue,2.0.0-alpha.3,2.0.0-alpha.4,150,2,18,6,24,3,TRUE
vue,2.0.0-alpha.4,2.0.0-alpha.5,151,10,204,407,611,40,FALSE
vue,2.0.0-alpha.5,2.0.0-alpha.6,152,23,545,554,1099,58,FALSE
vue,2.0.0-alpha.6,2.0.0-alpha.7,153,36,7761,7131,14892,126,FALSE
vue,2.0.0-alpha.7,2.0.0-alpha.8,154,10,1215,843,2058,28,TRUE
vue,2.0.0-alpha.8,2.0.0-beta.1,155,41,887,451,1338,104,FALSE
vue,2.0.0-beta.1,2.0.0-beta.2,156,65,5913,3319,9232,137,FALSE
vue,2.0.0-beta.2,2.0.0-beta.3,157,22,1643,1078,2721,59,FALSE
vue,2.0.0-beta.3,2.0.0-beta.4,158,10,707,742,1449,35,FALSE
vue,2.0.0-beta.4,2.0.0-beta.5,159,10,9906,9586,19492,43,FALSE
vue,2.0.0-beta.5,2.0.0-beta.6,160,26,847,175,1022,57,FALSE
vue,2.0.0-beta.6,2.0.0-beta.7,161,21,693,478,1171,72,FALSE
vue,2.0.0-beta.7,2.0.0-beta.8,162,15,998,693,1691,52,FALSE
vue,2.0.0-beta.8,2.0.0-rc.1,163,5,240,166,406,15,FALSE
vue,2.0.0-rc.1,2.0.0-rc.2,164,29,894,331,1225,54,FALSE
vue,2.0.0-rc.2,2.0.0-rc.3,165,20,810,595,1405,54,FALSE
vue,2.0.0-rc.3,2.0.0-rc.4,166,29,16266,13289,29555,79,FALSE
vue,2.0.0-rc.4,2.0.0-rc.5,167,21,1104,364,1468,64,FALSE
vue,2.0.0-rc.5,2.0.0-rc.6,168,12,279,203,482,29,FALSE
vue,2.0.0-rc.6,2.0.0-rc.7,169,28,1168,2286,3454,79,FALSE
vue,2.0.0-rc.7,2.0.0-rc.8,170,7,288,100,388,16,FALSE
vue,2.0.0-rc.8,2.0.0,171,24,890,652,1542,47,FALSE
vue,2.0.0,2.0.1,172,3,10,10,20,8,TRUE
vue,2.0.1,2.0.2,173,36,7324,6604,13928,83,FALSE
vue,2.0.2,2.0.3,174,17,720,649,1369,55,FALSE
vue,2.0.3,2.0.4,175,41,9975,2088,12063,129,FALSE
vue,2.0.4,2.0.5,176,8,300,189,489,21,TRUE
vue,2.0.5,2.0.6,177,36,21302,2458,23760,152,FALSE
vue,2.0.6,2.0.7,178,8,9136,3475,12611,28,TRUE
vue,2.0.7,2.0.8,179,17,521,201,722,47,FALSE
vue,2.0.8,2.1.0,180,35,13774,9657,23431,123,FALSE
vue,2.1.0,2.1.1,181,6,439,181,620,22,FALSE
vue,2.1.1,2.1.2,182,5,125,77,202,16,TRUE
vue,2.1.2,2.1.3,183,2,16,16,32,10,TRUE
vue,2.1.3,2.1.4,184,39,11850,10465,22315,129,FALSE
vue,2.1.4,2.1.5,185,38,2754,2072,4826,96,FALSE
vue,2.1.5,2.1.6,186,6,96,46,142,18,TRUE
vue,2.1.6,2.1.7,187,35,3918,2641,6559,82,FALSE
vue,2.1.7,2.1.8,188,22,752,466,1218,59,FALSE
vue,2.1.8,2.1.9,189,46,12345,14451,26796,102,FALSE
vue,2.1.9,2.1.10,190,4,1652,1612,3264,14,TRUE
vue,2.1.10,2.2.0-beta.1,191,117,33032,20990,54022,364,FALSE
vue,2.2.0-beta.1,2.2.0-beta.2,192,12,9086,13389,22475,36,TRUE
vue,2.2.0-beta.2,2.2.0,193,12,16383,381,16764,34,FALSE
vue,2.2.0,2.2.1,194,3,21,19,40,12,TRUE
vue,2.2.1,2.2.2,195,45,1555,1242,2797,108,FALSE
vue,2.2.2,2.2.3,196,14,1773,1252,3025,38,FALSE
vue,2.2.3,2.2.4,197,3,290,225,515,17,TRUE
vue,2.2.4,2.2.5,198,19,2006,1125,3131,54,FALSE
vue,2.2.5,2.2.6,199,6,204,60,264,19,FALSE
vue,2.2.6,2.3.0-beta.1,200,123,16534,16187,32721,357,FALSE
vue,2.3.0-beta.1,2.3.0,201,3,1562,1082,2644,18,TRUE
vue,2.3.0,2.3.1,202,11,506,864,1370,50,FALSE
vue,2.3.1,2.3.2,203,4,110,43,153,15,TRUE
vue,2.3.2,2.3.3,204,19,1014,416,1430,59,FALSE
vuex,0.1.0,0.2.0,1,29,2405,394,2799,113,FALSE
vuex,0.2.0,0.3.0,2,57,2888,648,3536,149,FALSE
vuex,0.3.0,0.4.0,3,26,1027,1113,2140,101,FALSE
vuex,0.4.0,0.4.1,4,3,601,11,612,8,TRUE
vuex,0.4.1,0.4.2,5,7,41,26,67,10,TRUE
vuex,0.4.2,0.5.0,6,5,88,128,216,13,FALSE
vuex,0.5.0,0.5.1,7,3,23,6,29,5,TRUE
vuex,0.5.1,0.6.1,8,19,922,143,1065,50,FALSE
vuex,0.6.1,0.6.2,9,8,118,30,148,12,FALSE
vuex,0.6.2,0.6.3,10,62,6018,616,6634,135,FALSE
vuex,0.6.3,0.7.0,11,38,2437,421,2858,102,FALSE
vuex,0.7.0,0.7.1,12,1,1,4,5,1,FALSE
vuex,0.7.1,0.8.0,13,4,24,19,43,5,TRUE
vuex,0.8.0,0.8.1,14,3,26,13,39,4,FALSE
vuex,0.8.1,0.8.2,15,2,5,6,11,3,TRUE
vuex,0.8.2,1.0.0-rc,16,11,1010,591,1601,71,FALSE
vuex,1.0.0-rc,1.0.0-rc.2,17,21,1688,1541,3229,92,FALSE
vuex,1.0.0-rc.2,1.0.0,18,77,8623,14892,23515,330,FALSE
vuex,1.0.0,1.0.1,19,91,11443,2143,13586,300,FALSE
vuex,2.0.0-rc.1,2.0.0-rc.3,21,13,715,610,1325,25,FALSE
vuex,2.0.0-rc.3,2.0.0-rc.4,22,18,1048,1019,2067,69,FALSE
vuex,2.0.0-rc.4,2.0.0-rc.5,23,7,469,535,1004,13,FALSE
vuex,2.0.0-rc.5,2.0.0-rc.6,24,23,6195,12660,18855,194,FALSE
vuex,2.0.0-rc.6,2.0.0,25,16,196,68,264,29,FALSE
vuex,2.0.0,2.1.0,26,64,11070,2016,13086,258,FALSE
vuex,2.1.0,2.1.1,27,5,10,9,19,6,TRUE
vuex,2.1.1,2.1.2,28,39,865,484,1349,78,FALSE
vuex,2.1.2,2.1.3,29,13,5071,29,5100,29,FALSE
vuex,2.1.3,2.2.0,30,3,971,161,1132,9,FALSE
vuex,2.2.0,2.2.1,31,3,693,673,1366,10,TRUE
vuex,2.2.1,2.3.0,32,23,226,67,293,44,FALSE
vuex,2.3.0,2.3.1,33,5,123,32,155,15,FALSE
walk-sync,0.0.1,0.1.0,1,1,5,1,6,2,FALSE
walk-sync,0.1.0,0.1.1,2,2,31,3,34,12,FALSE
walk-sync,0.1.1,0.1.2,3,5,32,7,39,10,FALSE
walk-sync,0.1.2,0.1.3,4,5,71,24,95,17,FALSE
walk-sync,0.1.3,0.2.0,5,27,683,277,960,52,FALSE
walk-sync,0.2.0,0.2.1,6,9,191,59,250,18,FALSE
walk-sync,0.2.1,0.2.2,7,9,256,138,394,19,FALSE
walk-sync,0.2.2,0.2.3,8,4,8,85,93,8,TRUE
walk-sync,0.2.3,0.2.4,9,6,78,64,142,12,FALSE
walk-sync,0.2.4,0.2.5,10,2,10,1,11,4,FALSE
walk-sync,0.2.5,0.2.6,11,9,82,12,94,19,FALSE
walk-sync,0.2.6,0.2.7,12,7,251,41,292,16,FALSE
walk-sync,0.2.7,0.3.0,13,7,144,20,164,10,FALSE
walk-sync,0.3.0,0.3.1,14,3,12,2,14,4,FALSE
walk-sync,0.3.1,0.3.2,15,5,1195,8,1203,7,FALSE
whatwg-fetch,0.5.0,0.6.0,1,5,81,65,146,9,TRUE
whatwg-fetch,0.6.0,0.6.1,2,21,451,89,540,29,FALSE
whatwg-fetch,0.6.1,0.7.0,3,18,208,82,290,21,FALSE
whatwg-fetch,0.7.0,0.8.0,4,58,1128,669,1797,101,FALSE
whatwg-fetch,0.8.0,0.8.1,5,1,1,0,1,1,TRUE
whatwg-fetch,0.8.1,0.8.2,6,5,17,13,30,6,FALSE
whatwg-fetch,0.8.2,0.9.0,7,8,79,30,109,11,FALSE
whatwg-fetch,0.9.0,0.10.0,8,44,742,199,941,63,FALSE
whatwg-fetch,0.10.0,0.10.1,9,5,135,61,196,14,FALSE
whatwg-fetch,0.10.1,0.11.0,10,21,568,252,820,50,FALSE
whatwg-fetch,0.11.0,0.11.1,11,27,523,261,784,54,FALSE
whatwg-fetch,1.0.0,1.1.0,13,51,1308,996,2304,84,FALSE
whatwg-fetch,1.1.0,1.1.1,14,9,45,21,66,10,FALSE
whatwg-fetch,2.0.0,2.0.1,16,8,44,20,64,9,FALSE
whatwg-fetch,2.0.1,2.0.2,17,8,66,16,82,10,FALSE
whatwg-fetch,2.0.2,2.0.3,18,11,52,29,81,14,FALSE
wiredep,0.1.0,0.1.1,1,5,142,106,248,11,FALSE
wiredep,0.1.1,0.1.2,2,1,194,0,194,16,TRUE
wiredep,0.1.2,0.1.4,3,5,86,31,117,7,TRUE
wiredep,0.1.4,0.1.5,4,3,52,9,61,3,FALSE
wiredep,0.1.5,0.1.6,5,4,10547,22,10569,17,FALSE
wiredep,0.1.6,0.1.7,6,4,8837,23,8860,10,FALSE
wiredep,0.1.7,0.1.8,7,2,10,9,19,2,TRUE
wiredep,0.1.8,0.2.0,8,2,60,12,72,7,FALSE
wiredep,0.2.0,0.3.0,9,2,87,23,110,9,FALSE
wiredep,0.3.0,0.3.1,10,2,8,18,26,2,FALSE
wiredep,0.3.1,0.4.0,11,7,186,29,215,17,FALSE
wiredep,0.4.0,0.4.1,12,2,149,15,164,13,FALSE
wiredep,0.4.1,0.4.2,13,4,80,19,99,4,FALSE
wiredep,0.4.2,0.5.0,14,5,11,3,14,5,FALSE
wiredep,0.5.0,0.5.1,15,3,314,152,466,25,FALSE
wiredep,0.5.1,0.5.2,16,6,302,137,439,22,FALSE
wiredep,0.5.2,1.0.0,17,6,1530,55,1585,34,FALSE
wiredep,1.0.0,1.1.0,18,2,71,10,81,4,FALSE
wiredep,1.1.0,1.1.1,19,5,83,9,92,14,FALSE
wiredep,1.1.1,1.2.0,20,5,55,14,69,12,FALSE
wiredep,1.2.0,1.2.1,21,2,174,130,304,39,FALSE
wiredep,1.2.1,1.2.2,22,3,11,11,22,3,TRUE
wiredep,1.2.2,1.3.0,23,6,1571,103,1674,14,FALSE
wiredep,1.3.0,1.3.1,24,2,9,11,20,2,FALSE
wiredep,1.3.1,1.3.2,25,2,5,3,8,2,FALSE
wiredep,1.3.2,1.3.3,26,1,0,2,2,1,FALSE
wiredep,1.3.3,1.4.0,27,4,36,13,49,5,FALSE
wiredep,1.4.0,1.4.1,28,1,1,1,2,1,TRUE
wiredep,1.4.1,1.4.2,29,1,194,0,194,16,TRUE
wiredep,1.4.2,1.4.3,30,11,131,59,190,14,FALSE
wiredep,1.4.3,1.4.4,31,6,69,8,77,9,FALSE
wiredep,1.4.4,1.5.0,32,6,138,7,145,8,FALSE
wiredep,1.5.0,1.6.0,33,3,91,4,95,4,FALSE
wiredep,1.6.0,1.6.1,34,5,40,4,44,5,TRUE
wiredep,1.6.1,1.6.2,35,4,170,24,194,16,FALSE
wiredep,1.6.2,1.7.0,36,3,2967,9,2976,21,FALSE
wiredep,1.7.0,1.7.1,37,2,2,2,4,2,FALSE
wiredep,1.7.1,1.7.2,38,3,521,403,924,29,FALSE
wiredep,1.7.2,1.7.3,39,6,26,43,69,8,FALSE
wiredep,1.7.3,1.8.0,40,6,724,752,1476,38,FALSE
wiredep,1.8.0,1.8.1,41,2,2,2,4,2,TRUE
wiredep,1.8.1,1.8.2,42,3,219,5,224,29,FALSE
wiredep,1.8.2,1.8.3,43,4,36,40,76,4,FALSE
wiredep,1.8.3,1.8.4,44,4,14,14,28,4,FALSE
wiredep,1.8.4,1.8.5,45,1,1,1,2,1,TRUE
wiredep,1.8.5,1.8.6,46,7,52,36,88,10,FALSE
wiredep,1.8.6,2.0.0,47,7,731,152,883,43,FALSE
wiredep,2.0.0,2.0.1,48,5,186,5,191,19,FALSE
wiredep,2.0.1,2.1.0,49,3,138,8,146,14,FALSE
wiredep,2.1.0,2.2.0,50,18,784,33,817,68,FALSE
wiredep,2.2.0,2.2.1,51,3,53,1,54,7,FALSE
wiredep,2.2.1,2.2.2,52,2,27,11,38,4,TRUE
wiredep,2.2.2,3.0.0-beta,53,24,632,3499,4131,186,FALSE
wiredep,3.0.0-beta,3.0.0,54,6,93,1,94,8,FALSE
wiredep,3.0.0,3.0.1,55,16,331,182,513,23,FALSE
wiredep,3.0.1,4.0.0,56,4,40,285,325,9,TRUE