client_name,client_version_from,client_version_to,release_order,num_commits,insertions,deletions,lines,files,scenario
nestedreact,0.3.0,0.4.0,1,22,2647,1655,4302,67,FALSE
nestedreact,1.0.1-rc9,1.0.1-rc91,53,8,465,144,609,28,FALSE
nestedreact,1.0.1-rc8,1.0.1-rc9,52,1,24,4,28,4,FALSE
nestedreact,1.0.1-rc5,1.0.1-rc7,50,11,7567,911,8478,151,FALSE
nestedreact,1.0.1-rc4,1.0.1-rc5,49,1,18,6,24,4,FALSE
nestedreact,1.0.1-rc7,1.0.1-rc8,51,1,19,2,21,3,FALSE
nestedreact,1.0.1-rc1,1.0.1-rc2,46,1,1937,1800,3737,7,FALSE
nestedreact,1.0.1-rc3,1.0.1-rc4,48,1,4,4,8,4,FALSE
nestedreact,1.0.1-rc2,1.0.1-rc3,47,1,44,53,97,7,FALSE
nestedreact,1.0.1-alpha1,1.0.1-alpha2,36,4,5328,5200,10528,20,FALSE
nestedreact,1.0.1-alpha3,1.0.1-b01,38,3,13983,13937,27920,15,FALSE
nestedreact,1.0.1-alpha2,1.0.1-alpha3,37,2,2329,2045,4374,20,FALSE
nestedreact,1.0.0-rc0,1.0.0-rc1,29,3,2397,883,3280,19,FALSE
nestedreact,1.0.0-rc1,1.0.0-rc2,30,1,6,2,8,4,FALSE
nestedreact,1.0.0-rc2,1.0.0-rc3,31,1,4,4,8,4,FALSE
nestedreact,1.0.0-rc3,1.0.0-rc4,32,2,5,5,10,3,FALSE
nestedreact,1.0.0-rc4,1.0.0-rc6,33,8,15886,15047,30933,27,FALSE
nestedreact,1.0.0-rc6,1.0.1-a04,34,24,138099,43262,181361,133,FALSE
nestedreact,1.0.1-b04,1.0.1-b05,42,11,40362,218,40580,40,FALSE
nestedreact,1.0.1-b05,1.0.1-b06,43,1,4,4,8,4,FALSE
nestedreact,1.0.1-b06,1.0.1-b07,44,2,60,30,90,5,FALSE
nestedreact,1.0.1-b07,1.0.1-rc1,45,1,2,2,4,1,FALSE
nestedreact,1.0.1-b01,1.0.1-b02,39,1,6059,5692,11751,12,FALSE
nestedreact,1.0.1-b02,1.0.1-b03,40,1,6,6,12,4,FALSE
nestedreact,1.0.1-b03,1.0.1-b04,41,1,7,5,12,4,FALSE
nestedreact,0.6.0-rc7,0.6.0-rc8,24,2,11,3,14,5,FALSE
nestedreact,0.6.0,1.0.0-alpha1,27,6,9979,13838,23817,37,FALSE
nestedreact,0.6.0-rc5,0.6.0-rc6,22,1,10,12,22,4,TRUE
nestedreact,0.4.0,0.5.0-rc1,2,5,359,164,523,21,FALSE
nestedreact,1.0.1-rc92,1.0.1-rc93,55,36,34886,34511,69397,444,FALSE
nestedreact,0.5.0,0.5.1,15,2,13,3,16,2,FALSE
nestedreact,0.5.1,0.5.2,16,27,38505,186,38691,60,FALSE
nestedreact,0.5.2,0.6.0-rc1,17,2,465,144,609,4,FALSE
nestedreact,0.6.0-rc9,0.6.0,26,28,165862,38363,204225,144,FALSE
nestedreact,0.6.0-rc8,0.6.0-rc9,25,1,4,4,8,4,FALSE
nestedreact,0.6.0-rc3,0.6.0-rc4,20,1,4,4,8,4,FALSE
nestedreact,0.6.0-rc2,0.6.0-rc3,19,2,7,6,13,6,FALSE
nestedreact,0.6.0-rc1,0.6.0-rc2,18,2,1020,559,1579,14,FALSE
nestedreact,1.0.1-rc91,1.0.1-rc92,54,1,4,4,8,4,FALSE
nestedreact,0.6.0-rc6,0.6.0-rc7,23,1,1587,53,1640,5,FALSE
nestedreact,0.6.0-rc4,0.6.0-rc5,21,1,4,4,8,4,FALSE
nestedreact,0.5.0-rc92,0.5.0,14,17,1566,775,2341,34,FALSE
nestedreact,0.5.0-rc90,0.5.0-rc91,12,3,39,5,44,7,FALSE
nestedreact,0.5.0-rc91,0.5.0-rc92,13,2,10,10,20,4,FALSE
nestedreact,0.5.0-rc1,0.5.0-rc2,3,2,2,2,4,2,FALSE
nestedreact,0.5.0-rc2,0.5.0-rc3,4,3,27,9,36,6,FALSE
nestedreact,0.5.0-rc3,0.5.0-rc4,5,2,112,52,164,5,FALSE
nestedreact,0.5.0-rc4,0.5.0-rc5,6,1,16,16,32,4,FALSE
nestedreact,0.5.0-rc5,0.5.0-rc6,7,3,377,521,898,19,FALSE
nestedreact,0.5.0-rc6,0.5.0-rc7,8,6,89,135,224,9,FALSE
nestedreact,0.5.0-rc7,0.5.0-rc8,9,6,598,112,710,17,FALSE
nestedreact,0.5.0-rc8,0.5.0-rc9,10,1,1,1,2,1,FALSE
nestedreact,0.5.0-rc9,0.5.0-rc90,11,3,31,33,64,8,FALSE
nestedreact,0.6.0-rc7,0.6.0-rc8,24,2,11,3,14,5,TRUE
nestedreact,0.6.0-rc5,0.6.0-rc6,22,1,10,12,22,4,FALSE
node-instagram-analytics,0.4.1,0.4.2,2,5,34,22,56,5,FALSE
node-instagram-analytics,0.4.0,0.4.1,1,3,59,23,82,4,FALSE
node-instagram-analytics,0.4.3,0.5.0,4,5,12,39,51,5,FALSE
node-instagram-analytics,0.4.2,0.4.3,3,6,71,117,188,6,FALSE
node-instagram-analytics,0.4.1,0.4.2,2,5,34,22,56,5,TRUE
limdu,0.9.1,0.9.2,8,2,25,23,48,3,FALSE
limdu,0.9.2,0.9.3,9,4,20,8,28,5,FALSE
limdu,0.3.0,0.4.0,3,62,3702,617,4319,129,FALSE
limdu,0.6.0,0.8.0,6,47,1638,1421,3059,55,FALSE
limdu,0.8.0,0.9.1,7,23,2021,660,2681,28,FALSE
limdu,0.2.0,0.3.0,2,4,221,1611,1832,33,FALSE
limdu,0.1.0,0.2.0,1,12,719,499,1218,77,FALSE
limdu,0.4.0,0.5.0,4,25,1207,308,1515,47,FALSE
limdu,0.5.0,0.6.0,5,141,7818,7186,15004,279,FALSE
limdu,0.3.0,0.4.0,3,62,3702,617,4319,129,TRUE
reforms,0.7.2,0.7.3,14,6,131,37,168,22,FALSE
reforms,0.7.3,0.8.1,15,3,166,34,200,14,FALSE
reforms,0.7.1,0.7.2,13,6,120,35,155,17,FALSE
reforms,0.3.2,0.4.1,6,4,5,3,8,5,FALSE
reforms,0.3.1,0.3.2,5,5,83,2073,2156,70,FALSE
reforms,0.4.1,0.4.2,7,5,55,19,74,11,FALSE
reforms,0.4.3,0.5.1,9,5,15,15,30,9,FALSE
reforms,0.4.2,0.4.3,8,4,17,9,26,7,FALSE
reforms,0.5.1,0.5.2,10,4,17,17,34,10,FALSE
reforms,0.5.2,0.6.1,11,5,126,36,162,10,FALSE
reforms,0.6.1,0.7.1,12,11,1041,299,1340,41,FALSE
reforms,0.2.7,0.3.1,4,5,2045,17,2062,41,FALSE
reforms,0.2.6,0.2.7,3,4,5,5,10,5,FALSE
reforms,0.2.5,0.2.6,2,4,15,11,26,7,FALSE
reforms,0.2.4,0.2.5,1,13,3468,1178,4646,47,FALSE
reforms,0.7.3,0.8.1,15,3,166,34,200,14,TRUE
reforms,0.6.1,0.7.1,12,11,1041,299,1340,41,TRUE
reforms,0.4.3,0.5.1,9,5,15,15,30,9,TRUE
tify,1.0.0,1.0.1,15,1,17,14,31,5,FALSE
tify,1.0.1,1.0.2,16,1,17,14,31,5,FALSE
tify,1.0.2,1.0.3,17,1,17,14,31,5,FALSE
tify,0.3.3,0.4.0,6,5,56,39,95,13,FALSE
tify,0.3.0,0.3.2,4,5,103,38,141,22,FALSE
tify,0.6.0,0.6.1,11,4,14,9,23,6,FALSE
tify,0.3.2,0.3.3,5,2,5,10,15,4,FALSE
tify,0.2.3,0.3.0,3,5,165,36,201,25,FALSE
tify,0.2.2,0.2.3,2,2,8,7,15,3,FALSE
tify,0.2.0,0.2.2,1,5,14,8,22,8,FALSE
tify,0.4.1,0.4.2,8,2,4,5,9,4,FALSE
tify,0.4.0,0.4.1,7,3,70,45,115,8,FALSE
tify,0.6.2,0.6.3,13,7,85,45,130,14,FALSE
tify,0.4.2,0.5.0,9,11,392,213,605,32,FALSE
tify,0.5.0,0.6.0,10,21,673,337,1010,51,FALSE
tify,0.6.1,0.6.2,12,2,39,41,80,11,FALSE
tify,0.6.0,0.6.1,11,4,14,9,23,6,TRUE
tify,0.3.0,0.3.2,4,5,103,38,141,22,TRUE
tify,1.0.0,1.0.1,15,1,17,14,31,5,TRUE
tify,0.5.0,0.6.0,10,21,673,337,1010,51,TRUE
tify,0.6.1,0.6.2,12,2,39,41,80,11,TRUE
react-formio,1.1.1,1.1.2,104,2,5,5,10,3,FALSE
react-formio,1.1.0,1.1.1,103,2,19,3,22,3,FALSE
react-formio,1.1.2,1.2.0,105,2,104,29,133,5,FALSE
react-formio,1.0.0,1.0.1,100,2,3,1,4,3,FALSE
react-formio,1.0.1,1.0.2,101,4,80,66,146,15,FALSE
react-formio,1.0.2,1.1.0,102,3,255,113,368,7,FALSE
react-formio,1.3.4,1.3.5,116,2,191,111,302,4,FALSE
react-formio,1.3.9,1.3.10,121,2,6,17,23,4,FALSE
react-formio,1.0.0-alpha14,1.0.0-alpha15,75,3,39,31,70,5,FALSE
react-formio,1.0.0-alpha15,1.0.0-alpha16,76,8,312,159,471,26,FALSE
react-formio,1.0.0-alpha16,1.0.0-alpha17,77,2,5,1,6,4,FALSE
react-formio,1.0.0-alpha17,1.0.0-alpha18,78,2,1,2,3,2,FALSE
react-formio,1.0.0-alpha10,1.0.0-alpha11,71,2,5,3,8,3,FALSE
react-formio,1.0.0-alpha11,1.0.0-alpha12,72,2,11,10,21,9,FALSE
react-formio,1.0.0-alpha12,1.0.0-alpha13,73,2,160,57,217,7,FALSE
react-formio,1.0.0-alpha13,1.0.0-alpha14,74,4,35,23,58,13,FALSE
react-formio,1.0.0-alpha18,1.0.0-alpha19,79,2,24,19,43,4,FALSE
react-formio,1.0.0-alpha26,1.0.0-alpha27,88,3,948,29,977,16,FALSE
react-formio,1.0.0-alpha8,1.0.0-alpha9,98,2,108,41,149,10,FALSE
react-formio,1.0.0-alpha9,1.0.0,99,57,3039,549,3588,143,FALSE
react-formio,1.0.0-alpha6,1.0.0-alpha7,96,2,17,14,31,9,FALSE
react-formio,1.0.0-alpha7,1.0.0-alpha8,97,3,118,44,162,17,FALSE
react-formio,1.0.0-alpha4,1.0.0-alpha5,94,2,42,63,105,5,FALSE
react-formio,1.0.0-alpha5,1.0.0-alpha6,95,4,46,24,70,12,FALSE
react-formio,1.0.0-alpha2,1.0.0-alpha20,81,53,1076,568,1644,156,FALSE
react-formio,1.0.0-alpha3,1.0.0-alpha30,92,73,3422,739,4161,204,FALSE
react-formio,1.0.0-alpha1,1.0.0-alpha10,70,27,495,271,766,85,FALSE
react-formio,1.3.5,1.3.6,117,2,33,17,50,5,FALSE
react-formio,1.2.5,1.3.0,111,4,255,223,478,24,FALSE
react-formio,1.3.3,1.3.4,115,2,44,18,62,4,FALSE
react-formio,1.3.2,1.3.3,114,2,75,6,81,7,FALSE
react-formio,1.3.1,1.3.2,113,4,142,49,191,10,FALSE
react-formio,1.3.0,1.3.1,112,5,106,90,196,7,FALSE
react-formio,1.3.7,1.3.8,119,2,73,15,88,4,FALSE
react-formio,1.2.3,1.2.4,109,2,5,5,10,3,FALSE
react-formio,1.2.0,1.2.1,106,2,3,3,6,3,FALSE
react-formio,1.2.1,1.2.2,107,3,24,18,42,7,FALSE
react-formio,1.0.0-alpha25,1.0.0-alpha26,87,2,624,5,629,7,FALSE
react-formio,1.0.0-alpha24,1.0.0-alpha25,86,2,3,3,6,3,FALSE
react-formio,1.0.0-alpha27,1.0.0-alpha28,89,2,7,5,12,3,FALSE
react-formio,1.3.8,1.3.9,120,6,936,497,1433,51,FALSE
react-formio,1.0.0-alpha21,1.0.0-alpha22,83,2,10,5,15,3,FALSE
react-formio,1.0.0-alpha20,1.0.0-alpha21,82,4,33,50,83,8,FALSE
react-formio,1.0.0-alpha23,1.0.0-alpha24,85,1,1,1,2,1,FALSE
react-formio,1.0.0-alpha22,1.0.0-alpha23,84,2,602,14,616,5,FALSE
react-formio,1.2.4,1.2.5,110,2,3,3,6,3,FALSE
react-formio,1.3.13,1.3.14,125,2,3,3,6,3,FALSE
react-formio,1.3.12,1.3.13,124,3,32,23,55,7,FALSE
react-formio,1.3.11,1.3.12,123,3,55,11,66,13,FALSE
react-formio,1.3.10,1.3.11,122,3,41,8,49,7,FALSE
react-formio,1.3.6,1.3.7,118,2,33,8,41,4,FALSE
react-formio,1.2.2,1.2.3,108,2,3,3,6,3,FALSE
react-formio,1.0.0-alpha28,1.0.0-alpha29,90,2,3,3,6,3,FALSE
react-formio,0.10.11,0.11.0,40,3,753,47,800,26,FALSE
react-formio,0.10.10,0.10.11,39,8,2465,259,2724,104,FALSE
react-formio,0.14.11,1.0.0-alpha1,69,4,1889,722,2611,213,FALSE
react-formio,0.14.10,0.14.11,68,2,17,1,18,3,FALSE
react-formio,0.11.4,0.11.5,45,3,38,13,51,5,FALSE
react-formio,0.11.5,0.11.6,46,13,459,1700,2159,158,FALSE
react-formio,0.11.6,0.12.0,47,5,956,51,1007,22,FALSE
react-formio,0.11.0,0.11.1,41,2,2,2,4,2,FALSE
react-formio,0.11.1,0.11.2,42,2,82,23,105,15,FALSE
react-formio,0.11.2,0.11.3,43,2,2,2,4,2,FALSE
react-formio,0.11.3,0.11.4,44,2,5,5,10,3,FALSE
react-formio,0.13.0,0.13.1,56,2,7,3,10,3,FALSE
react-formio,0.13.1,0.14.0,57,2,280,98,378,59,FALSE
react-formio,0.14.5,0.14.6,63,2,21,19,40,3,FALSE
react-formio,0.14.4,0.14.5,62,3,72,18,90,7,FALSE
react-formio,0.14.7,0.14.8,65,2,3,3,6,3,FALSE
react-formio,0.14.6,0.14.7,64,5,41,11,52,9,FALSE
react-formio,0.14.1,0.14.2,59,4,30,8,38,7,FALSE
react-formio,0.14.0,0.14.1,58,8,70,31,101,16,FALSE
react-formio,0.14.3,0.14.4,61,3,82,11,93,7,FALSE
react-formio,0.14.2,0.14.3,60,5,72,38,110,10,FALSE
react-formio,0.14.9,0.14.10,67,2,21,5,26,3,FALSE
react-formio,0.14.8,0.14.9,66,2,5,11,16,3,FALSE
react-formio,0.10.1,0.10.3,31,2,18,3,21,5,FALSE
react-formio,0.10.0,0.10.1,30,2,25,9,34,8,FALSE
react-formio,0.10.3,0.10.4,32,2,12,3,15,3,FALSE
react-formio,0.10.5,0.10.6,34,3,158,19,177,12,FALSE
react-formio,0.10.4,0.10.5,33,18,12416,9470,21886,550,FALSE
react-formio,0.10.7,0.10.8,36,2,2,2,4,2,FALSE
react-formio,0.10.6,0.10.7,35,8,1942,1242,3184,88,FALSE
react-formio,0.10.8,0.10.9,37,5,559,116,675,48,FALSE
react-formio,0.12.3,0.12.4,51,4,229,54,283,25,FALSE
react-formio,0.12.2,0.12.3,50,4,39,66,105,16,FALSE
react-formio,0.12.1,0.12.2,49,3,74,44,118,9,FALSE
react-formio,0.12.0,0.12.1,48,1,1,1,2,1,FALSE
react-formio,0.12.7,0.13.0,55,2,31,10,41,5,FALSE
react-formio,0.12.6,0.12.7,54,2,5,5,10,3,FALSE
react-formio,0.12.5,0.12.6,53,2,7,7,14,3,FALSE
react-formio,0.12.4,0.12.5,52,5,82,51,133,9,FALSE
react-formio,1.2.4,1.2.5,110,2,3,3,6,3,TRUE
react-formio,0.10.9,0.10.10,38,3,19,22,41,16,FALSE
react-formio,0.0.5,0.0.6,4,5,1959,1950,3909,10,FALSE
react-formio,0.0.4,0.0.5,3,4,172327,1142,173469,14,FALSE
react-formio,0.0.6,0.1.0,5,2,290,4,294,4,FALSE
react-formio,0.0.1,0.0.2,1,2,329,262,591,3,FALSE
react-formio,0.0.2,0.0.4,2,12,1470,1020,2490,48,TRUE
react-formio,0.1.0,0.1.1,6,2,976,2,978,29,FALSE
react-formio,1.3.14,2.0.0-alpha1,126,6,160,22514,22674,247,FALSE
react-formio,0.0.2,0.0.4,2,12,1470,1020,2490,48,FALSE
react-formio,0.1.1,0.2.0,7,2,172216,203053,375269,44,FALSE
react-formio,0.3.0,0.3.1,9,6,112117,341081,453198,35,FALSE
react-formio,0.3.1,0.4.0,10,13,68656,253246,321902,197,FALSE
react-formio,0.10.11,0.11.0,40,3,753,47,800,26,TRUE
react-formio,0.6.1,0.7.0,19,11,2459,1427,3886,59,FALSE
react-formio,0.11.5,0.11.6,46,13,459,1700,2159,158,TRUE
react-formio,0.6.0,0.6.1,18,3,191,149,340,11,FALSE
react-formio,0.4.1,0.4.2,12,4,103,47,150,5,FALSE
react-formio,0.4.0,0.4.1,11,29,103516,290636,394152,244,FALSE
react-formio,0.4.3,0.5.0,14,6,118,165,283,19,FALSE
react-formio,0.4.2,0.4.3,13,17,1119,28221,29340,58,FALSE
react-formio,0.8.4,0.9.1,25,6,364,179,543,27,FALSE
react-formio,0.8.3,0.8.4,24,2,19,7,26,6,FALSE
react-formio,0.8.2,0.8.3,23,2,19,9,28,7,FALSE
react-formio,0.2.0,0.3.0,8,16,534,95,629,35,FALSE
react-formio,0.7.0,0.8.0,20,7,107,87,194,27,TRUE
react-formio,0.12.3,0.12.4,51,4,229,54,283,25,TRUE
react-formio,0.5.0,0.5.1,15,66,17964,1065,19029,324,FALSE
react-formio,0.5.1,0.5.2,16,13,770,84,854,24,FALSE
react-formio,0.5.2,0.6.0,17,26,4142,182,4324,90,FALSE
react-formio,0.9.1,0.9.2,26,4,623,517,1140,19,FALSE
react-formio,0.9.2,0.9.3,27,2,5,5,10,3,FALSE
react-formio,0.9.3,0.9.4,28,2,29,7,36,3,FALSE
react-formio,0.9.4,0.10.0,29,18,3774,1747,5521,283,FALSE
react-formio,0.8.1,0.8.2,22,1,1,1,2,1,FALSE
react-formio,0.8.0,0.8.1,21,1,1,1,2,1,FALSE
react-formio,0.11.6,0.12.0,47,5,956,51,1007,22,TRUE
react-formio,0.11.4,0.11.5,45,3,38,13,51,5,TRUE
react-formio,0.7.0,0.8.0,20,7,107,87,194,27,FALSE
react-formio,0.9.1,0.9.2,26,4,623,517,1140,19,TRUE
react-formio,0.10.8,0.10.9,37,5,559,116,675,48,TRUE
react-formio,0.10.0,0.10.1,30,2,25,9,34,8,TRUE
react-formio,1.0.0-alpha6,1.0.0-alpha7,96,2,17,14,31,9,TRUE
react-formio,1.2.5,1.3.0,111,4,255,223,478,24,TRUE
react-formio,0.10.1,0.10.3,31,2,18,3,21,5,TRUE
react-formio,1.0.0-alpha2,1.0.0-alpha20,81,53,1076,568,1644,156,TRUE
react-formio,1.0.0-alpha21,1.0.0-alpha22,83,2,10,5,15,3,TRUE
react-formio,0.11.3,0.11.4,44,2,5,5,10,3,TRUE
react-formio,0.14.0,0.14.1,58,8,70,31,101,16,TRUE
react-formio,1.2.0,1.2.1,106,2,3,3,6,3,TRUE
react-formio,1.3.2,1.3.3,114,2,75,6,81,7,TRUE
react-formio,0.10.5,0.10.6,34,3,158,19,177,12,TRUE
react-formio,0.11.2,0.11.3,43,2,2,2,4,2,TRUE
react-formio,0.4.0,0.4.1,11,29,103516,290636,394152,244,TRUE
react-formio,0.5.1,0.5.2,16,13,770,84,854,24,TRUE
react-formio,0.8.4,0.9.1,25,6,364,179,543,27,TRUE
react-formio,0.10.4,0.10.5,33,18,12416,9470,21886,550,TRUE
react-formio,0.12.4,0.12.5,52,5,82,51,133,9,TRUE
react-formio,1.3.1,1.3.2,113,4,142,49,191,10,TRUE
react-formio,0.11.0,0.11.1,41,2,2,2,4,2,TRUE
react-formio,1.0.0-alpha22,1.0.0-alpha23,84,2,602,14,616,5,TRUE
react-formio,0.4.2,0.4.3,13,17,1119,28221,29340,58,TRUE
react-formio,0.14.1,0.14.2,59,4,30,8,38,7,TRUE
react-formio,1.0.0-alpha11,1.0.0-alpha12,72,2,11,10,21,9,TRUE
react-formio,0.12.5,0.12.6,53,2,7,7,14,3,TRUE
rn-packager,0.0.1,0.0.2,1,2,23409,2,23411,200,FALSE
rn-packager,0.0.2,0.1.0,2,1,10811,7114,17925,301,FALSE
rn-packager,0.2.4,0.2.5,13,6,3817,4161,7978,98,FALSE
rn-packager,0.2.3,0.2.4,12,2,6,4,10,3,TRUE
rn-packager,0.2.2,0.2.3,11,5,41,62246,62287,507,FALSE
rn-packager,0.2.1,0.2.2,10,1,1,1,2,1,FALSE
rn-packager,0.2.0,0.2.1,9,1,64983,967,65950,594,FALSE
rn-packager,0.1.0,0.1.1,3,2,17,9,26,10,FALSE
rn-packager,0.1.1,0.1.2,4,1,10811,7114,17925,301,FALSE
rn-packager,0.1.2,0.1.3,5,2,10,6,16,3,FALSE
rn-packager,0.1.3,0.1.4,6,2,8,4,12,4,FALSE
rn-packager,0.1.4,0.1.5,7,1,10811,7114,17925,301,FALSE
rn-packager,0.1.5,0.2.0,8,3,23,4,27,5,TRUE
rn-packager,0.3.1,0.3.2,16,1,1,1,2,1,FALSE
rn-packager,0.3.6,0.3.7,21,1,2,12,14,2,FALSE
rn-packager,0.3.7,0.3.8,22,2,33,16,49,7,FALSE
rn-packager,0.2.3,0.2.4,12,2,6,4,10,3,FALSE
rn-packager,0.1.5,0.2.0,8,3,23,4,27,5,FALSE
rn-packager,0.10.1,0.11.0,61,4,167,50,217,17,FALSE
rn-packager,0.10.0,0.10.1,60,5,21,28,49,10,FALSE
rn-packager,0.3.8,0.3.9,23,1,27,9,36,3,FALSE
rn-packager,0.3.9,0.3.10,24,2,23,15,38,3,FALSE
rn-packager,0.3.2,0.3.3,17,1,20,17,37,2,FALSE
rn-packager,0.3.3,0.3.4,18,1,40,24,64,3,FALSE
rn-packager,0.3.0,0.3.1,15,1,10,3,13,1,FALSE
rn-packager,0.6.0,0.7.0,44,3,269,100,369,39,FALSE
rn-packager,0.7.2,0.8.0,47,2,13201,7330,20531,235,FALSE
rn-packager,0.3.4,0.3.5,19,1,2,2,4,2,FALSE
rn-packager,0.3.5,0.3.6,20,8,7050,13827,20877,231,FALSE
rn-packager,0.3.14,0.3.15,29,19,28879,20196,49075,920,FALSE
rn-packager,0.4.0,0.4.1,34,1,3058,12036,15094,134,FALSE
rn-packager,0.4.3,0.5.0,37,16,10727,5617,16344,397,FALSE
rn-packager,0.4.2,0.4.3,36,1,12,24,36,3,FALSE
rn-packager,0.3.10,0.3.11,25,1,81,49,130,2,FALSE
rn-packager,0.3.11,0.3.12,26,3,7,7,14,3,FALSE
rn-packager,0.3.12,0.3.13,27,2,25,9,34,4,FALSE
rn-packager,0.3.13,0.3.14,28,1,3,5,8,2,FALSE
rn-packager,0.9.0,0.9.1,50,1,11,9,20,2,FALSE
rn-packager,0.9.1,0.9.2,51,1,1,1,2,1,FALSE
rn-packager,0.9.2,0.9.3,52,4,18375,8136,26511,338,FALSE
rn-packager,0.9.3,0.9.4,53,1,16,14,30,4,FALSE
rn-packager,0.9.4,0.9.5,54,4,682,11,693,8,FALSE
rn-packager,0.9.5,0.9.6,55,2,694,23,717,8,FALSE
rn-packager,0.9.6,0.9.7,56,2,14,13,27,3,FALSE
rn-packager,0.9.7,0.9.8,57,2,405,223,628,18,FALSE
rn-packager,0.9.8,0.9.9,58,1,10811,7114,17925,301,FALSE
rn-packager,0.9.9,0.10.0,59,3,9931,7431,17362,250,FALSE
rn-packager,0.8.1,0.9.0,49,2,4653,626,5279,191,FALSE
rn-packager,0.8.0,0.8.1,48,1,0,1,1,1,TRUE
rn-packager,0.5.4,0.5.5,42,5,17563,13785,31348,446,FALSE
rn-packager,0.4.1,0.4.2,35,4,3967,1756,5723,90,FALSE
rn-packager,0.5.5,0.6.0,43,1,387,232,619,43,FALSE
rn-packager,0.11.0,0.11.1,62,2,4,4,8,4,FALSE
rn-packager,0.3.16,0.3.17,31,22,30116,15877,45993,638,FALSE
rn-packager,0.3.17,0.3.18,32,6,171,54,225,21,FALSE
rn-packager,0.3.15,0.3.16,30,7,17864,7950,25814,425,FALSE
rn-packager,0.5.0,0.5.1,38,1,2,549,551,2,FALSE
rn-packager,0.5.1,0.5.2,39,1,98,8,106,6,FALSE
rn-packager,0.5.2,0.5.3,40,1,4,4,8,2,FALSE
rn-packager,0.7.0,0.7.1,45,2,5,5,10,2,FALSE
rn-packager,0.7.1,0.7.2,46,1,3,1,4,2,FALSE
rn-packager,0.5.3,0.5.4,41,1,7,4,11,3,FALSE
rn-packager,0.8.0,0.8.1,48,1,0,1,1,1,FALSE
rn-packager,0.9.4,0.9.5,54,4,682,11,693,8,TRUE
rn-packager,0.9.5,0.9.6,55,2,694,23,717,8,TRUE
rn-packager,0.3.3,0.3.4,18,1,40,24,64,3,TRUE
rn-packager,0.10.1,0.11.0,61,4,167,50,217,17,TRUE
rn-packager,0.7.2,0.8.0,47,2,13201,7330,20531,235,TRUE
rn-packager,0.8.1,0.9.0,49,2,4653,626,5279,191,TRUE
rn-packager,0.3.2,0.3.3,17,1,20,17,37,2,TRUE
rn-packager,0.11.0,0.11.1,62,2,4,4,8,4,TRUE
rn-packager,0.3.16,0.3.17,31,22,30116,15877,45993,638,TRUE
rn-packager,0.4.3,0.5.0,37,16,10727,5617,16344,397,TRUE
rn-packager,0.5.5,0.6.0,43,1,387,232,619,43,TRUE
rn-packager,0.10.0,0.10.1,60,5,21,28,49,10,TRUE
npm-profile-downloads,1.1.1,2.0.0,3,8,43,49,92,15,FALSE
npm-profile-downloads,1.1.0,1.1.1,2,2,5,1,6,2,FALSE
npm-profile-downloads,1.0.0,1.1.0,1,2,11,10,21,2,FALSE
npm-profile-downloads,1.1.0,1.1.1,2,2,5,1,6,2,TRUE
newsql,0.0.5,0.0.6,5,1,151,29,180,5,FALSE
newsql,0.0.4,0.0.5,4,2,539,159,698,16,FALSE
newsql,0.0.7,0.0.8,7,1,92,32,124,8,FALSE
newsql,0.0.6,0.0.7,6,1,42,15,57,3,FALSE
newsql,0.0.3,0.0.4,3,9,580,177,757,15,FALSE
newsql,0.0.2,0.0.3,2,3,923,220,1143,13,FALSE
newsql,0.0.8,0.1.0,8,5,897,606,1503,15,FALSE
newsql,0.1.0,0.1.1,9,1,215,59,274,6,FALSE
newsql,0.1.1,0.1.2,10,1,147,93,240,6,FALSE
newsql,0.0.5,0.0.6,5,1,151,29,180,5,TRUE
newsql,0.1.0,0.1.1,9,1,215,59,274,6,TRUE
nativefier,6.1.0,6.2.0,13,8,72,37,109,18,FALSE
nativefier,7.1.0,7.2.0,44,13,137,71,208,24,FALSE
nativefier,6.7.0,6.8.0,31,30,738,551,1289,65,FALSE
nativefier,6.8.0,6.9.0,32,59,768,335,1103,106,FALSE
nativefier,6.5.2-0,6.5.3,23,2,2,2,4,2,FALSE
nativefier,6.2.1,6.3.0,15,6,252,91,343,16,FALSE
nativefier,7.0.0,7.0.1,42,4,76,66,142,11,FALSE
nativefier,7.0.1,7.1.0,43,24,183,104,287,41,FALSE
nativefier,6.14.0,7.0.0,41,29,222,104,326,46,FALSE
nativefier,6.9.0,6.9.1,33,2,6,0,6,2,FALSE
nativefier,6.9.1,6.10.0,34,10,170,35,205,26,FALSE
nativefier,6.5.3,6.5.4,24,9,85,287,372,20,FALSE
nativefier,6.5.0,6.5.1,21,4,247,525,772,9,FALSE
nativefier,6.5.1,6.5.2-0,22,1,1,1,2,1,FALSE
nativefier,6.5.6,6.6.0,27,58,1494,689,2183,153,FALSE
nativefier,6.5.4,6.5.5,25,7,57,262,319,23,FALSE
nativefier,6.5.5,6.5.6,26,5,33,6,39,12,FALSE
nativefier,6.13.0,6.14.0,40,23,171,48,219,57,FALSE
nativefier,6.12.1,6.13.0,39,19,369,96,465,38,FALSE
nativefier,6.12.0,6.12.1,38,5,39,35,74,7,FALSE
nativefier,6.4.0,6.5.0,20,10,684,192,876,24,FALSE
nativefier,6.2.0,6.2.1,14,8,32,20,52,10,FALSE
nativefier,6.3.0,6.3.1,16,3,99,15,114,5,FALSE
nativefier,6.3.1,6.3.2,17,3,9,2,11,3,FALSE
nativefier,6.3.2,6.3.3,18,3,19,5,24,4,FALSE
nativefier,6.3.3,6.4.0,19,21,158,61,219,26,FALSE
nativefier,6.11.0,6.12.0,37,21,840,459,1299,45,FALSE
nativefier,6.10.0,6.10.1,35,4,18,3,21,4,FALSE
nativefier,6.6.1,6.6.2,29,11,155,22,177,22,FALSE
nativefier,6.6.0,6.6.1,28,7,93,28,121,7,FALSE
nativefier,6.10.1,6.11.0,36,29,747,512,1259,64,FALSE
nativefier,6.6.2,6.7.0,30,16,448,54,502,38,TRUE
nativefier,1.0.4,1.0.5,3,1,9,3,12,1,FALSE
nativefier,1.0.5,1.0.6,4,2,2,2,4,2,FALSE
nativefier,1.0.6,1.0.7,5,2,75,22,97,7,FALSE
nativefier,1.0.7,1.0.8,6,2,4,5,9,2,FALSE
nativefier,1.0.2,1.0.3,1,2,1,73,74,2,FALSE
nativefier,1.0.3,1.0.4,2,2,77,2,79,3,FALSE
nativefier,5.1.1,5.1.2,10,2,10,8,18,2,FALSE
nativefier,1.0.8,1.0.9,7,4,59,13,72,9,FALSE
nativefier,1.0.9,5.1.0,8,8,100,51,151,19,FALSE
nativefier,5.1.0,5.1.1,9,3,17,9,26,3,FALSE
nativefier,7.3.1,7.4.0,46,10,540,111,651,38,FALSE
nativefier,7.2.0,7.3.1,45,10,2005,1959,3964,71,FALSE
nativefier,6.6.2,6.7.0,30,16,448,54,502,38,FALSE
nativefier,6.0.0,6.1.0,12,6,216,100,316,9,FALSE
nativefier,5.1.1,5.1.2,10,2,10,8,18,2,TRUE
nativefier,5.1.2,6.0.0,11,10,520,1587,2107,44,FALSE
nativefier,6.7.0,6.8.0,31,30,738,551,1289,65,TRUE
nativefier,6.6.1,6.6.2,29,11,155,22,177,22,TRUE
cellpack-swig,1.0.0-alpha.9,1.0.0-alpha.10,5,1,18,2,20,3,FALSE
cellpack-swig,1.0.0-alpha.8,1.0.0-alpha.9,4,1,43,3,46,4,FALSE
cellpack-swig,1.0.0-alpha.5,1.0.0-alpha.6,2,1,3,1,4,3,FALSE
cellpack-swig,1.0.0-alpha.4,1.0.0-alpha.5,1,1,38,4,42,4,FALSE
cellpack-swig,1.0.0-alpha.6,1.0.0-alpha.8,3,2,59,11,70,5,FALSE
cellpack-swig,1.0.0-alpha.10,1.0.0-alpha.11,6,1,3,1,4,3,FALSE
cellpack-swig,1.0.0-alpha.9,1.0.0-alpha.10,5,1,18,2,20,3,TRUE
cellpack-swig,1.0.0-alpha.8,1.0.0-alpha.9,4,1,43,3,46,4,TRUE
cellpack-swig,1.0.0-alpha.5,1.0.0-alpha.6,2,1,3,1,4,3,TRUE
cellpack-swig,1.0.0-alpha.4,1.0.0-alpha.5,1,1,38,4,42,4,TRUE
cellpack-swig,1.0.0-alpha.6,1.0.0-alpha.8,3,2,59,11,70,5,TRUE
cellpack-swig,1.0.0-alpha.10,1.0.0-alpha.11,6,1,3,1,4,3,TRUE
ol3-tilecache,1.1.1,1.1.2,4,1,21,14,35,4,FALSE
ol3-tilecache,1.1.0,1.1.1,3,1,17,10,27,4,FALSE
ol3-tilecache,1.1.2,1.2.0,5,6,718,173,891,35,FALSE
ol3-tilecache,1.2.2,1.2.3,8,4,58,14,72,12,FALSE
ol3-tilecache,1.2.0,1.2.1,6,1,72,68,140,6,FALSE
ol3-tilecache,1.2.1,1.2.2,7,2,2,3,5,2,FALSE
ol3-tilecache,1.0.2,1.0.3,1,2,38,18,56,9,FALSE
ol3-tilecache,1.2.2,1.2.3,8,4,58,14,72,12,TRUE
linked-data-reactor,0.9.0,0.9.1,46,3,45,62,107,19,FALSE
linked-data-reactor,0.3.16,0.3.17,32,7,8,8,16,7,FALSE
linked-data-reactor,0.5.3,0.9.0,45,160,15668,6979,22647,599,FALSE
linked-data-reactor,0.9.1,0.9.7,47,272,11123,5604,16727,736,FALSE
linked-data-reactor,0.9.75,0.9.78,66,10,86,52,138,15,FALSE
linked-data-reactor,0.9.47,0.9.48,54,8,90,36,126,10,FALSE
linked-data-reactor,0.2.7,0.2.8,18,2,47,22,69,13,FALSE
linked-data-reactor,0.2.5,0.2.7,17,5,177,24,201,10,FALSE
linked-data-reactor,0.9.85,0.9.88,68,13,393,191,584,53,FALSE
linked-data-reactor,0.2.2,0.2.5,16,15,438,207,645,50,FALSE
linked-data-reactor,0.2.1,0.2.2,15,1,4,4,8,2,FALSE
linked-data-reactor,0.1.1,0.1.3,2,29,1836,415,2251,123,FALSE
linked-data-reactor,0.1.0,0.1.1,1,4,282,34,316,21,FALSE
linked-data-reactor,0.9.88,0.9.89,69,3,20,19,39,4,FALSE
linked-data-reactor,0.1.3,0.1.4,3,12,214,62,276,30,FALSE
linked-data-reactor,0.1.4,0.1.5,4,35,2078,927,3005,124,FALSE
linked-data-reactor,0.1.5,0.1.6,5,2,9,9,18,6,FALSE
linked-data-reactor,0.2.9,0.3.0,20,30,2270,1794,4064,179,FALSE
linked-data-reactor,0.2.8,0.2.9,19,5,45,599,644,17,FALSE
linked-data-reactor,0.1.67,0.1.68,11,2,128,92,220,8,FALSE
linked-data-reactor,0.1.66,0.1.67,10,2,13,13,26,5,FALSE
linked-data-reactor,0.1.65,0.1.66,9,12,53,42,95,19,FALSE
linked-data-reactor,0.3.9,0.3.10,25,4,65,56,121,10,FALSE
linked-data-reactor,0.3.2,0.3.5,22,40,626,522,1148,73,FALSE
linked-data-reactor,0.3.0,0.3.2,21,1,4,0,4,1,FALSE
linked-data-reactor,0.3.7,0.3.9,24,12,242,123,365,19,FALSE
linked-data-reactor,0.1.69,0.1.70,13,4,482,12,494,8,FALSE
linked-data-reactor,0.1.68,0.1.69,12,1,25,23,48,17,FALSE
linked-data-reactor,0.9.45,0.9.46,52,8,337,80,417,20,FALSE
linked-data-reactor,0.3.30,0.3.35,36,1,3,3,6,1,FALSE
linked-data-reactor,0.9.46,0.9.47,53,1,12,5,17,2,FALSE
linked-data-reactor,0.1.6,0.1.8,6,29,1124,230,1354,73,FALSE
linked-data-reactor,0.3.35,0.4.5,37,9,189,206,395,27,FALSE
linked-data-reactor,0.3.14,0.3.15,30,5,84,32,116,8,FALSE
linked-data-reactor,0.3.15,0.3.16,31,3,81,70,151,5,FALSE
linked-data-reactor,0.9.65,0.9.66,62,8,530,163,693,37,FALSE
linked-data-reactor,0.3.17,0.3.19,33,13,164,105,269,22,FALSE
linked-data-reactor,0.3.10,0.3.11,26,2,4,1,5,2,FALSE
linked-data-reactor,0.9.48,0.9.55,55,22,390,165,555,33,FALSE
linked-data-reactor,0.9.61,0.9.63,60,16,2779,2364,5143,60,FALSE
linked-data-reactor,0.3.13,0.3.14,29,3,19,20,39,5,FALSE
linked-data-reactor,0.4.11,0.5.0,42,17,905,172,1077,46,FALSE
linked-data-reactor,0.4.10,0.4.11,41,1,13,13,26,6,FALSE
linked-data-reactor,0.9.42,0.9.45,51,47,1603,532,2135,145,FALSE
linked-data-reactor,0.9.67,0.9.72,64,10,127,94,221,11,FALSE
linked-data-reactor,0.9.63,0.9.65,61,4,28,25,53,4,FALSE
linked-data-reactor,0.9.56,0.9.57,57,1,2,1,3,2,FALSE
linked-data-reactor,0.5.2,0.5.3,44,4,68,23,91,9,FALSE
linked-data-reactor,0.3.5,0.3.7,23,6,42,14,56,8,FALSE
linked-data-reactor,0.9.66,0.9.67,63,3,64,122,186,7,FALSE
linked-data-reactor,0.1.8,0.1.9,7,2,10,7,17,3,FALSE
linked-data-reactor,0.9.36,0.9.40,49,24,600,268,868,53,FALSE
linked-data-reactor,0.9.78,0.9.85,67,13,524,323,847,41,FALSE
linked-data-reactor,0.5.0,0.5.2,43,4,60,40,100,7,FALSE
linked-data-reactor,0.3.19,0.3.21,34,6,135,87,222,25,FALSE
linked-data-reactor,0.3.11,0.3.12,27,7,118,133,251,24,FALSE
linked-data-reactor,0.3.21,0.3.30,35,2,2,2,4,2,FALSE
linked-data-reactor,0.9.57,0.9.58,58,1,3,3,6,2,FALSE
linked-data-reactor,0.9.72,0.9.75,65,2,329,122,451,43,FALSE
linked-data-reactor,0.9.55,0.9.56,56,3,129,30,159,16,FALSE
linked-data-reactor,0.3.12,0.3.13,28,7,126,115,241,15,FALSE
linked-data-reactor,0.4.5,0.4.6,38,3,47,9,56,6,FALSE
linked-data-reactor,0.1.70,0.2.1,14,11,247,41,288,24,FALSE
linked-data-reactor,0.9.40,0.9.42,50,10,174,42,216,24,FALSE
linked-data-reactor,0.4.6,0.4.8,39,6,666,40,706,21,FALSE
linked-data-reactor,0.9.58,0.9.61,59,3,24,23,47,7,FALSE
linked-data-reactor,0.1.66,0.1.67,10,2,13,13,26,5,TRUE
linked-data-reactor,0.9.78,0.9.85,67,13,524,323,847,41,TRUE
linked-data-reactor,0.3.19,0.3.21,34,6,135,87,222,25,TRUE
linked-data-reactor,0.1.65,0.1.66,9,12,53,42,95,19,TRUE
linked-data-reactor,0.1.6,0.1.8,6,29,1124,230,1354,73,TRUE
linked-data-reactor,0.3.13,0.3.14,29,3,19,20,39,5,TRUE
linked-data-reactor,0.3.35,0.4.5,37,9,189,206,395,27,TRUE
linked-data-reactor,0.2.2,0.2.5,16,15,438,207,645,50,TRUE
linked-data-reactor,0.1.4,0.1.5,4,35,2078,927,3005,124,TRUE
linked-data-reactor,0.1.5,0.1.6,5,2,9,9,18,6,TRUE
linked-data-reactor,0.3.2,0.3.5,22,40,626,522,1148,73,TRUE
linked-data-reactor,0.1.8,0.1.9,7,2,10,7,17,3,TRUE
linked-data-reactor,0.1.70,0.2.1,14,11,247,41,288,24,TRUE
linked-data-reactor,0.9.36,0.9.40,49,24,600,268,868,53,TRUE
linked-data-reactor,0.9.85,0.9.88,68,13,393,191,584,53,TRUE
linked-data-reactor,0.9.61,0.9.63,60,16,2779,2364,5143,60,TRUE
linked-data-reactor,0.9.66,0.9.67,63,3,64,122,186,7,TRUE
linked-data-reactor,0.9.72,0.9.75,65,2,329,122,451,43,TRUE
linked-data-reactor,0.1.1,0.1.3,2,29,1836,415,2251,123,TRUE
linked-data-reactor,0.1.3,0.1.4,3,12,214,62,276,30,TRUE
linked-data-reactor,0.1.67,0.1.68,11,2,128,92,220,8,TRUE
linked-data-reactor,0.5.2,0.5.3,44,4,68,23,91,9,TRUE
linked-data-reactor,0.4.6,0.4.8,39,6,666,40,706,21,TRUE
linked-data-reactor,0.5.0,0.5.2,43,4,60,40,100,7,TRUE
linked-data-reactor,0.3.16,0.3.17,32,7,8,8,16,7,TRUE
linked-data-reactor,0.9.65,0.9.66,62,8,530,163,693,37,TRUE
linked-data-reactor,0.5.3,0.9.0,45,160,15668,6979,22647,599,TRUE
linked-data-reactor,0.3.30,0.3.35,36,1,3,3,6,1,TRUE
linked-data-reactor,0.9.67,0.9.72,64,10,127,94,221,11,TRUE
seed-packer,0.0.5,0.0.6,5,2,4,4,8,2,FALSE
seed-packer,0.0.4,0.0.5,4,3,4,7,11,5,FALSE
seed-packer,0.0.7,0.0.8,7,2,3,2,5,2,FALSE
seed-packer,0.0.6,0.0.7,6,3,57,11,68,7,FALSE
seed-packer,0.0.1,0.0.2,1,5,87,14,101,6,FALSE
seed-packer,0.0.3,0.0.4,3,7,20,11,31,7,FALSE
seed-packer,0.0.2,0.0.3,2,2,1,3,4,2,FALSE
seed-packer,0.0.9,0.0.10,9,2,4,4,8,2,FALSE
seed-packer,0.0.8,0.0.9,8,2,5,3,8,4,FALSE
seed-packer,0.0.3,0.0.4,3,7,20,11,31,7,TRUE
generator-nitro,1.1.1,1.1.2,47,3,7,7,14,4,FALSE
generator-nitro,1.1.0,1.1.1,46,5,96,63,159,7,FALSE
generator-nitro,1.1.3,1.2.0,49,14,376,81,457,52,FALSE
generator-nitro,1.1.2,1.1.3,48,7,30,19,49,10,FALSE
generator-nitro,1.0.0,1.0.1,42,5,24,14,38,6,FALSE
generator-nitro,1.0.1,1.0.2,43,3,42,37,79,5,FALSE
generator-nitro,1.0.2,1.0.3,44,5,105,8,113,10,FALSE
generator-nitro,1.0.3,1.1.0,45,4,117,13,130,13,FALSE
generator-nitro,0.2.7,0.2.8,11,5,16,35,51,9,FALSE
generator-nitro,0.2.6,0.2.7,10,6,39,21,60,11,FALSE
generator-nitro,0.2.5,0.2.6,9,6,58,37,95,12,FALSE
generator-nitro,0.2.4,0.2.5,8,22,895,447,1342,84,FALSE
generator-nitro,0.2.3,0.2.4,7,8,273,40,313,18,FALSE
generator-nitro,0.2.2,0.2.3,6,15,506,440,946,36,FALSE
generator-nitro,0.2.1,0.2.2,5,8,33,28,61,15,FALSE
generator-nitro,0.2.0,0.2.1,4,7,62,62,124,11,FALSE
generator-nitro,0.1.0,0.1.1,1,7,72,68,140,9,FALSE
generator-nitro,0.1.1,0.1.2,2,17,315,297,612,40,FALSE
generator-nitro,0.1.2,0.2.0,3,28,417,250,667,42,FALSE
generator-nitro,0.2.9,0.2.10,13,2,57,3,60,6,FALSE
generator-nitro,0.2.8,0.2.9,12,8,107,103,210,19,FALSE
generator-nitro,0.3.8,0.3.9,23,10,434,409,843,86,FALSE
generator-nitro,0.3.9,0.3.10,24,10,150,45,195,25,FALSE
generator-nitro,0.3.2,0.3.3,17,6,92,79,171,9,FALSE
generator-nitro,0.3.3,0.3.4,18,13,92,69,161,20,TRUE
generator-nitro,0.3.0,0.3.1,15,6,17,17,34,8,TRUE
generator-nitro,0.3.1,0.3.2,16,10,49,32,81,13,FALSE
generator-nitro,0.3.6,0.3.7,21,4,83,37,120,13,FALSE
generator-nitro,0.3.7,0.3.8,22,21,1131,364,1495,53,FALSE
generator-nitro,0.3.4,0.3.5,19,4,26,11,37,9,FALSE
generator-nitro,0.3.5,0.3.6,20,5,329,186,515,14,FALSE
generator-nitro,0.4.9,0.4.10,36,5,16,16,32,6,FALSE
generator-nitro,0.4.8,0.4.9,35,2,2,1,3,2,FALSE
generator-nitro,0.4.1,0.4.2,29,8,383,291,674,54,FALSE
generator-nitro,0.4.0,0.4.1,28,7,454,187,641,22,FALSE
generator-nitro,0.4.3,0.4.4,31,11,291,233,524,54,TRUE
generator-nitro,0.4.2,0.4.3,30,7,760,694,1454,96,FALSE
generator-nitro,0.3.10,0.3.11,25,12,544,615,1159,74,FALSE
generator-nitro,0.3.11,0.3.12,26,18,4914,5107,10021,177,FALSE
generator-nitro,0.3.12,0.4.0,27,5,267,20,287,12,FALSE
generator-nitro,0.4.6,0.4.8,34,7,128,116,244,11,TRUE
generator-nitro,0.4.11,0.4.12,38,6,120,135,255,12,FALSE
generator-nitro,0.4.10,0.4.11,37,2,6,6,12,3,FALSE
generator-nitro,0.4.13,0.4.14,40,14,127,78,205,45,FALSE
generator-nitro,0.4.12,0.4.13,39,26,1118,959,2077,200,FALSE
generator-nitro,0.4.14,1.0.0,41,11,3391,2909,6300,202,FALSE
generator-nitro,0.2.10,0.3.0,14,6,45,38,83,7,FALSE
generator-nitro,1.3.0,1.3.1,54,10,73,55,128,18,FALSE
generator-nitro,1.2.2,1.2.3,52,2,15,15,30,3,FALSE
generator-nitro,1.2.3,1.3.0,53,10,169,73,242,17,FALSE
generator-nitro,1.2.0,1.2.1,50,8,379,38,417,21,FALSE
generator-nitro,1.2.1,1.2.2,51,7,57,24,81,8,FALSE
generator-nitro,0.4.5,0.4.6,33,6,39,38,77,14,FALSE
generator-nitro,0.4.4,0.4.5,32,2,4,4,8,3,TRUE
generator-nitro,0.3.3,0.3.4,18,13,92,69,161,20,FALSE
generator-nitro,0.3.0,0.3.1,15,6,17,17,34,8,FALSE
generator-nitro,0.4.3,0.4.4,31,11,291,233,524,54,FALSE
generator-nitro,0.4.6,0.4.8,34,7,128,116,244,11,FALSE
generator-nitro,0.4.4,0.4.5,32,2,4,4,8,3,FALSE
generator-nitro,0.4.0,0.4.1,28,7,454,187,641,22,TRUE
generator-nitro,1.1.2,1.1.3,48,7,30,19,49,10,TRUE
generator-nitro,0.1.0,0.1.1,1,7,72,68,140,9,TRUE
generator-nitro,0.3.9,0.3.10,24,10,150,45,195,25,TRUE
generator-nitro,0.4.12,0.4.13,39,26,1118,959,2077,200,TRUE
generator-nitro,1.2.2,1.2.3,52,2,15,15,30,3,TRUE
generator-nitro,1.1.3,1.2.0,49,14,376,81,457,52,TRUE
generator-nitro,1.0.0,1.0.1,42,5,24,14,38,6,TRUE
generator-nitro,0.4.2,0.4.3,30,7,760,694,1454,96,TRUE
generator-nitro,0.3.10,0.3.11,25,12,544,615,1159,74,TRUE
o2-payment-stripe,0.1.1,0.1.3,1,1,3,3,6,2,FALSE
o2-payment-stripe,0.1.1,0.1.3,1,1,3,3,6,2,TRUE
neato,0.7.2,0.7.3,21,2,2,2,4,2,FALSE
neato,0.7.3,0.8.1,22,14,120,270,390,99,FALSE
neato,0.7.1,0.7.2,20,2,34,16,50,10,FALSE
neato,1.1.1,1.1.3,46,4,2,6,8,4,FALSE
neato,1.0.0-alpha.8,1.0.0-beta.1,34,5,22,70,92,8,FALSE
neato,1.1.3,1.1.4-experimental,47,2,7,1,8,2,FALSE
neato,1.0.0,1.0.1,41,2,5,4,9,2,FALSE
neato,1.0.1,1.0.2,42,2,28,26,54,2,FALSE
neato,1.0.2,1.0.3,43,2,4,4,8,2,FALSE
neato,1.0.3,1.1.0,44,2,25,1,26,4,FALSE
neato,1.0.0-alpha.1,1.0.0-alpha.2,27,12,45,43,88,19,FALSE
neato,1.0.0-alpha.3,1.0.0-alpha.4,29,2,50,8,58,4,FALSE
neato,1.0.0-alpha.2,1.0.0-alpha.3,28,5,63,10,73,10,FALSE
neato,1.0.0-alpha.5,1.0.0-alpha.6,31,5,42,46,88,7,FALSE
neato,1.0.0-alpha.4,1.0.0-alpha.5,30,2,30,19,49,5,FALSE
neato,1.0.0-alpha.7,1.0.0-alpha.8,33,2,5,17,22,3,FALSE
neato,1.0.0-alpha.6,1.0.0-alpha.7,32,2,3,2,5,2,FALSE
neato,2.0.0-alpha.6,2.0.0-alpha.7,70,2,42,21,63,7,FALSE
neato,2.0.0-alpha.7,2.0.0-alpha.8,71,2,3,6,9,2,FALSE
neato,2.0.0-alpha.4,2.0.0-alpha.5,68,2,2,2,4,2,FALSE
neato,2.0.0-alpha.5,2.0.0-alpha.6,69,2,641,407,1048,3,FALSE
neato,2.0.0-alpha.2,2.0.0-alpha.3,66,2,5,5,10,2,FALSE
neato,2.0.0-alpha.3,2.0.0-alpha.4,67,3,5474,9,5483,5,FALSE
neato,2.0.0-alpha.0,2.0.0-alpha.1,64,2,4,3,7,2,FALSE
neato,2.0.0-alpha.1,2.0.0-alpha.2,65,2,6,4,10,2,FALSE
neato,1.0.0-beta.6,1.0.0,40,2,6,2,8,2,FALSE
neato,1.0.0-beta.4,1.0.0-beta.5,38,4,17,11,28,4,FALSE
neato,1.0.0-beta.5,1.0.0-beta.6,39,1,1,1,2,1,FALSE
neato,1.0.0-beta.2,1.0.0-beta.3,36,11,375,19,394,21,FALSE
neato,1.0.0-beta.3,1.0.0-beta.4,37,6,5,5,10,5,FALSE
neato,2.0.0-alpha.8,2.0.0-alpha.9,72,2,4,6,10,4,FALSE
neato,1.0.0-beta.1,1.0.0-beta.2,35,3,9,6,15,4,FALSE
neato,0.10.0,1.0.0-alpha.1,26,2,12,1,13,2,FALSE
neato,2.0.0-alpha.9,2.0.0-alpha.10,73,2,12,16,28,3,FALSE
neato,0.9.0,0.10.0,25,9,35,396,431,37,FALSE
neato,1.2.6,1.2.7,56,2,3,2,5,2,FALSE
neato,1.2.7,1.2.8,57,2,2,3,5,2,FALSE
neato,1.2.4,1.2.5,54,2,2,2,4,2,FALSE
neato,1.2.5,1.2.6,55,2,2,1,3,2,FALSE
neato,1.2.2,1.2.3,52,2,33,24,57,2,FALSE
neato,1.2.3,1.2.4,53,2,2,1,3,2,TRUE
neato,1.2.0,1.2.1,50,3,8,3,11,3,FALSE
neato,1.2.1,1.2.2,51,2,83,1,84,2,FALSE
neato,1.1.4,1.2.0,49,2,23,2,25,3,FALSE
neato,1.2.8,1.2.9,58,2,1,2,3,2,FALSE
neato,1.2.9,1.3.0,59,2,22,3,25,3,FALSE
neato,1.1.0,1.1.1,45,2,2,2,4,2,FALSE
neato,1.3.3,2.0.0-alpha.0,63,2,5,4,9,2,FALSE
neato,1.3.1,1.3.2,61,2,2,2,4,2,FALSE
neato,1.3.0,1.3.1,60,2,9,3,12,3,FALSE
neato,1.3.2,1.3.3,62,2,2,2,4,2,FALSE
neato,0.3.0-0,0.4.0-0,15,2,3,2,5,2,FALSE
neato,0.2.0-0,0.3.0-0,14,1,1,1,2,1,FALSE
neato,0.4.1-0,0.4.3-0,17,4,4,4,8,4,FALSE
neato,0.4.0-0,0.4.1-0,16,2,5,2,7,2,FALSE
neato,0.4.3-0,0.4.4-0,18,7,109,47,156,19,FALSE
neato,0.8.1,0.8.2,23,20,131,4480,4611,55,FALSE
neato,0.8.2,0.9.0,24,17,616,193,809,86,FALSE
neato,1.2.3,1.2.4,53,2,2,1,3,2,FALSE
neato,0.4.4-0,0.7.1,19,13,2380,1621,4001,248,FALSE
neato,1.2.5,1.2.6,55,2,2,1,3,2,TRUE
neato,1.0.0-alpha.6,1.0.0-alpha.7,32,2,3,2,5,2,TRUE
neato,1.1.4,1.2.0,49,2,23,2,25,3,TRUE
neato,0.1.0-pre-alpha.9,0.1.0-pre-alpha.10,8,2,4076,2,4078,15,FALSE
neato,0.1.0-pre-alpha.8,0.1.0-pre-alpha.9,7,2,2,2,4,2,FALSE
neato,0.1.0-pre-alpha.1,0.1.0-pre-alpha.2,1,5,9,3,12,5,FALSE
neato,0.1.0-pre-alpha.3,0.1.0-pre-alpha.5,3,3,3,3,6,3,FALSE
neato,0.1.0-pre-alpha.2,0.1.0-pre-alpha.3,2,15,25,17,42,16,FALSE
neato,0.1.0-pre-alpha.5,0.1.0-pre-alpha.6,4,7,136,9,145,10,FALSE
neato,0.1.0-pre-alpha.7,0.1.0-pre-alpha.8,6,2,11,1,12,2,FALSE
neato,0.1.0-pre-alpha.6,0.1.0-pre-alpha.7,5,2,28,41,69,9,FALSE
neato,0.1.0,0.1.3,10,4,4,4,8,4,FALSE
neato,0.1.3,0.1.4,11,2,2,2,4,2,FALSE
neato,0.1.4,0.1.5-1,12,2,2,2,4,2,FALSE
neato,0.1.0-pre-alpha.10,0.1.0,9,2,1,6,7,2,FALSE
neato,0.1.5-1,0.2.0-0,13,4,460,14,474,31,FALSE
neato,2.0.0-alpha.9,2.0.0-alpha.10,73,2,12,16,28,3,TRUE
neato,1.2.7,1.2.8,57,2,2,3,5,2,TRUE
neato,0.8.2,0.9.0,24,17,616,193,809,86,TRUE
neato,2.0.0-alpha.5,2.0.0-alpha.6,69,2,641,407,1048,3,TRUE
neato,1.2.6,1.2.7,56,2,3,2,5,2,TRUE
neato,1.0.0,1.0.1,41,2,5,4,9,2,TRUE
neato,0.10.0,1.0.0-alpha.1,26,2,12,1,13,2,TRUE
neato,1.1.3,1.1.4-experimental,47,2,7,1,8,2,TRUE
neato,1.0.3,1.1.0,44,2,25,1,26,4,TRUE
neato,1.0.0-alpha.3,1.0.0-alpha.4,29,2,50,8,58,4,TRUE
neato,1.0.0-alpha.5,1.0.0-alpha.6,31,5,42,46,88,7,TRUE
neato,1.0.0-alpha.4,1.0.0-alpha.5,30,2,30,19,49,5,TRUE
neato,1.0.0-alpha.7,1.0.0-alpha.8,33,2,5,17,22,3,TRUE
neato,2.0.0-alpha.7,2.0.0-alpha.8,71,2,3,6,9,2,TRUE
neato,2.0.0-alpha.3,2.0.0-alpha.4,67,3,5474,9,5483,5,TRUE
neato,1.0.0-beta.6,1.0.0,40,2,6,2,8,2,TRUE
neato,1.0.0-beta.4,1.0.0-beta.5,38,4,17,11,28,4,TRUE
neato,1.0.0-beta.2,1.0.0-beta.3,36,11,375,19,394,21,TRUE
neato,1.0.0-beta.3,1.0.0-beta.4,37,6,5,5,10,5,TRUE
neato,1.0.0-beta.1,1.0.0-beta.2,35,3,9,6,15,4,TRUE
neato,1.3.1,1.3.2,61,2,2,2,4,2,TRUE
neato,1.2.0,1.2.1,50,3,8,3,11,3,TRUE
neato,1.2.9,1.3.0,59,2,22,3,25,3,TRUE
neato,1.3.3,2.0.0-alpha.0,63,2,5,4,9,2,TRUE
neato,1.2.2,1.2.3,52,2,33,24,57,2,TRUE
hawk-fox-terrier,1.0.4,1.0.5,5,2,2,2,4,2,FALSE
hawk-fox-terrier,1.0.5,1.0.6,6,2,5,1,6,4,FALSE
hawk-fox-terrier,1.0.6,1.1.0,7,4,3356,152,3508,18,FALSE
hawk-fox-terrier,1.1.2,1.1.3,10,1,1,1,2,1,FALSE
hawk-fox-terrier,1.0.0,1.0.1,1,2,31,7,38,4,TRUE
hawk-fox-terrier,1.0.1,1.0.2,2,2,18,1,19,2,FALSE
hawk-fox-terrier,1.0.2,1.0.3,3,2,6,3,9,2,FALSE
hawk-fox-terrier,1.0.3,1.0.4,4,2,482,449,931,9,FALSE
hawk-fox-terrier,1.1.0,1.1.1,8,5,57718,106,57824,76,FALSE
hawk-fox-terrier,1.1.1,1.1.2,9,5,1334,174,1508,17,FALSE
hawk-fox-terrier,1.0.0,1.0.1,1,2,31,7,38,4,FALSE
seneca-extended,1.1.1,1.1.2,1,1,1,1,2,1,FALSE
seneca-extended,1.1.3,1.1.4,3,3,25,9,34,7,FALSE
seneca-extended,1.1.2,1.1.3,2,2,218,5,223,8,FALSE
seneca-extended,1.1.5,1.1.6,5,2,1,217,218,7,FALSE
seneca-extended,1.1.4,1.1.5,4,3,15,6,21,8,FALSE
seneca-extended,1.1.7,1.1.8,7,1,1,1,2,1,FALSE
seneca-extended,1.1.6,1.1.7,6,2,9,1,10,3,FALSE
seneca-extended,1.1.9,1.1.10,9,2,3,4,7,3,FALSE
seneca-extended,1.1.8,1.1.9,8,1,2,2,4,4,FALSE
seneca-extended,1.3.3,1.3.4,15,3,6,4,10,4,FALSE
seneca-extended,1.3.2,1.3.3,14,2,26,12,38,4,FALSE
seneca-extended,1.3.1,1.3.2,13,3,11,12,23,4,FALSE
seneca-extended,1.3.0,1.3.1,12,2,125,15,140,4,FALSE
seneca-extended,1.3.5,1.3.6,17,2,115,26,141,5,FALSE
seneca-extended,1.3.4,1.3.5,16,2,3,2,5,2,FALSE
seneca-extended,1.2.0,1.3.0,11,3,72,26,98,11,FALSE
seneca-extended,1.1.10,1.2.0,10,4,45,121,166,20,FALSE
seneca-extended,1.3.3,1.3.4,15,3,6,4,10,4,TRUE
seneca-extended,1.3.5,1.3.6,17,2,115,26,141,5,TRUE
seneca-extended,1.3.0,1.3.1,12,2,125,15,140,4,TRUE
seneca-extended,1.2.0,1.3.0,11,3,72,26,98,11,TRUE
netiam,5.12.0,5.13.0,78,4,509,6,515,11,FALSE
netiam,3.1.0,3.2.0,33,1,179,1,180,7,FALSE
netiam,3.0.2,3.0.3,31,4,42,42,84,7,FALSE
netiam,3.0.3,3.1.0,32,1,350,0,350,7,FALSE
netiam,3.0.0,3.0.1,29,14,1017,162,1179,46,FALSE
netiam,3.0.1,3.0.2,30,2,4,7,11,2,FALSE
netiam,5.3.4,5.3.5,51,1,0,2,2,1,FALSE
netiam,1.2.5,1.3.0,12,5,544,164,708,29,FALSE
netiam,5.6.0,5.6.1,66,2,4,3,7,3,FALSE
netiam,6.0.0,6.1.0,85,5,117,16,133,9,FALSE
netiam,5.3.6,5.3.7,53,1,9,2,11,2,FALSE
netiam,1.10.1,2.0.0,26,1,26,28,54,5,FALSE
netiam,5.13.0,5.14.0,79,6,62,29,91,12,FALSE
netiam,5.5.1,5.5.2,64,1,4,8,12,1,FALSE
netiam,5.5.0,5.5.1,63,1,3,0,3,1,FALSE
netiam,5.5.2,5.6.0,65,21,2205,1250,3455,52,FALSE
netiam,4.1.0,4.1.1,39,2,6,3,9,2,FALSE
netiam,6.1.0,6.2.0,86,5,27,15,42,5,FALSE
netiam,5.4.2,5.5.0,62,2,15,1,16,3,FALSE
netiam,5.7.2,5.8.0,71,2,89,23,112,2,FALSE
netiam,1.7.1,1.7.2,20,2,3,20,23,3,FALSE
netiam,5.15.0,5.15.1,82,1,0,2,2,1,FALSE
netiam,2.0.0,2.0.1,27,8,158,257,415,13,FALSE
netiam,5.10.0,5.10.1,75,2,8,5,13,3,FALSE
netiam,1.6.0,1.7.0,18,5,47,12,59,6,TRUE
netiam,3.3.2,4.0.0,37,3,259,196,455,19,FALSE
netiam,5.6.2,5.7.0,68,1,2,2,4,2,FALSE
netiam,5.11.0,5.12.0,77,41,3228,1854,5082,97,FALSE
netiam,1.9.1,1.10.0,24,1,154,47,201,2,FALSE
netiam,1.9.0,1.9.1,23,3,94,108,202,16,FALSE
netiam,1.3.0,1.4.0,13,1,26,7,33,3,FALSE
netiam,1.8.0,1.9.0,22,7,86,44,130,14,FALSE
netiam,1.7.2,1.8.0,21,3,81,10,91,7,FALSE
netiam,5.14.0,5.14.1,80,20,839,910,1749,56,FALSE
netiam,5.14.1,5.15.0,81,45,763,1073,1836,94,FALSE
netiam,1.4.0,1.5.0,14,3,54,22,76,5,FALSE
netiam,2.0.1,3.0.0,28,7,162,223,385,14,FALSE
netiam,5.9.1,5.10.0,74,1,38,0,38,1,FALSE
netiam,5.9.0,5.9.1,73,1,1,1,2,1,FALSE
netiam,1.7.0,1.7.1,19,1,8,3,11,3,FALSE
netiam,4.0.0,4.1.0,38,6,127,68,195,14,FALSE
netiam,1.5.1,1.5.2,16,5,252,185,437,15,FALSE
netiam,1.5.0,1.5.1,15,6,17,19,36,8,TRUE
netiam,6.2.0,6.3.0,87,4,29,24,53,6,FALSE
netiam,5.15.1,5.16.0,83,2,12,2,14,2,FALSE
netiam,5.8.0,5.9.0,72,1,59,3,62,4,FALSE
netiam,5.2.0,5.2.1,45,1,12,0,12,1,FALSE
netiam,5.2.1,5.3.0,46,2,3,2,5,2,FALSE
netiam,1.2.2,1.2.3,9,4,4,6,10,3,FALSE
netiam,1.2.3,1.2.4,10,1,2,4,6,1,FALSE
netiam,5.3.9,5.3.10,56,2,11,4,15,2,FALSE
netiam,5.3.8,5.3.9,55,4,8,4,12,5,FALSE
netiam,5.3.7,5.3.8,54,1,1,1,2,1,FALSE
netiam,5.4.0,5.4.1,60,1,1,1,2,1,FALSE
netiam,5.3.5,5.3.6,52,8,319,539,858,34,FALSE
netiam,1.5.2,1.6.0,17,15,457,200,657,34,FALSE
netiam,5.3.3,5.3.4,50,6,52,163,215,13,FALSE
netiam,5.3.2,5.3.3,49,2,5,2,7,2,FALSE
netiam,5.3.1,5.3.2,48,7,233,100,333,14,FALSE
netiam,5.3.0,5.3.1,47,5,46,94,140,15,FALSE
netiam,5.0.0,5.1.0,42,1,19,5,24,4,FALSE
netiam,4.1.1,4.1.2,40,4,11,13,24,4,FALSE
netiam,6.5.0,6.5.1,90,235,2351,2455,4806,412,TRUE
netiam,6.5.1,6.6.0,91,12,54,74,128,18,FALSE
netiam,5.3.12,5.4.0,59,4,62,8,70,4,FALSE
netiam,5.3.11,5.3.12,58,1,6,11,17,1,FALSE
netiam,5.3.10,5.3.11,57,1,1,1,2,1,FALSE
netiam,3.2.0,3.3.0,34,1,90,9,99,7,FALSE
netiam,5.1.1,5.2.0,44,1,21,4,25,1,FALSE
netiam,5.1.0,5.1.1,43,3,10,3,13,3,FALSE
netiam,1.10.0,1.10.1,25,2,58,29,87,5,FALSE
netiam,6.4.0,6.5.0,89,33,1204,950,2154,80,FALSE
netiam,3.3.1,3.3.2,36,1,3,3,6,3,FALSE
netiam,3.3.0,3.3.1,35,1,6,2,8,2,FALSE
netiam,5.7.1,5.7.2,70,2,22,22,44,12,FALSE
netiam,5.7.0,5.7.1,69,9,159,198,357,25,FALSE
netiam,6.3.0,6.4.0,88,4,273,11,284,8,FALSE
netiam,1.2.4,1.2.5,11,2,3,3,6,3,FALSE
netiam,5.4.1,5.4.2,61,1,0,4,4,1,FALSE
netiam,5.6.1,5.6.2,67,1,18,2,20,1,FALSE
netiam,5.10.1,5.11.0,76,1,1,1,2,1,FALSE
netiam,4.1.2,5.0.0,41,6,672,655,1327,30,FALSE
netiam,3.1.0,3.2.0,33,1,179,1,180,7,TRUE
netiam,3.0.3,3.1.0,32,1,350,0,350,7,TRUE
netiam,3.3.2,4.0.0,37,3,259,196,455,19,TRUE
netiam,3.2.0,3.3.0,34,1,90,9,99,7,TRUE
netiam,4.0.0,4.1.0,38,6,127,68,195,14,TRUE
netiam,5.3.2,5.3.3,49,2,5,2,7,2,TRUE
netiam,5.3.0,5.3.1,47,5,46,94,140,15,TRUE
netiam,3.3.1,3.3.2,36,1,3,3,6,3,TRUE
netiam,1.0.0,1.1.0,1,4,113,139,252,5,FALSE
netiam,7.4.0,7.5.0,98,1,43,4,47,4,FALSE
netiam,1.6.0,1.7.0,18,5,47,12,59,6,FALSE
netiam,7.3.0,7.4.0,97,40,94,77,171,45,FALSE
netiam,7.0.0,7.1.0,93,1,15,1,16,2,FALSE
netiam,6.5.0,6.5.1,90,235,2351,2455,4806,412,FALSE
netiam,7.2.0,7.3.0,96,6,11,5,16,7,TRUE
netiam,1.2.0,1.2.1,7,1,1,1,2,1,FALSE
netiam,1.2.1,1.2.2,8,7,347,154,501,22,FALSE
netiam,1.1.1,1.1.2,3,5,4,6,10,6,FALSE
netiam,1.1.0,1.1.1,2,1,1680,503,2183,8,FALSE
netiam,1.1.3,1.1.4,5,14,409,356,765,36,FALSE
netiam,1.1.2,1.1.3,4,1,1,0,1,1,FALSE
netiam,1.1.4,1.2.0,6,8,305,733,1038,24,FALSE
netiam,7.1.0,7.1.1,94,13,16,22,38,13,FALSE
netiam,1.7.2,1.8.0,21,3,81,10,91,7,TRUE
netiam,5.3.5,5.3.6,52,8,319,539,858,34,TRUE
netiam,7.1.1,7.2.0,95,15,29,30,59,15,FALSE
netiam,6.6.0,7.0.0,92,11,285,9429,9714,144,FALSE
netiam,1.5.0,1.5.1,15,6,17,19,36,8,FALSE
netiam,1.5.1,1.5.2,16,5,252,185,437,15,TRUE
netiam,1.8.0,1.9.0,22,7,86,44,130,14,TRUE
netiam,5.3.11,5.3.12,58,1,6,11,17,1,TRUE
netiam,7.2.0,7.3.0,96,6,11,5,16,7,FALSE
netiam,1.2.1,1.2.2,8,7,347,154,501,22,TRUE
netiam,5.13.0,5.14.0,79,6,62,29,91,12,TRUE
netiam,1.1.4,1.2.0,6,8,305,733,1038,24,TRUE
netiam,4.1.2,5.0.0,41,6,672,655,1327,30,TRUE
netiam,5.5.2,5.6.0,65,21,2205,1250,3455,52,TRUE
netiam,7.1.1,7.2.0,95,15,29,30,59,15,TRUE
netiam,5.7.1,5.7.2,70,2,22,22,44,12,TRUE
netiam,5.3.8,5.3.9,55,4,8,4,12,5,TRUE
netiam,7.1.0,7.1.1,94,13,16,22,38,13,TRUE
netiam,5.6.2,5.7.0,68,1,2,2,4,2,TRUE
netiam,5.4.2,5.5.0,62,2,15,1,16,3,TRUE
netiam,3.0.0,3.0.1,29,14,1017,162,1179,46,TRUE
npm-module-path,2.0.0,2.0.2,2,17,60,3208,3268,24,FALSE
npm-module-path,2.0.0,2.0.2,2,17,60,3208,3268,24,TRUE
npm-module-path,1.0.0,2.0.0,1,13,7355,417,7772,48,FALSE
cirru-editor,0.5.4,0.5.5,11,1,6,7,13,3,FALSE
cirru-editor,0.5.5,0.5.6,12,1,92,36,128,9,FALSE
cirru-editor,0.5.6,0.5.7,13,1,12,11,23,3,FALSE
cirru-editor,0.5.7,0.5.8,14,2,35,44,79,8,FALSE
cirru-editor,0.5.1,0.5.2,8,1,12,10,22,5,FALSE
cirru-editor,0.5.2,0.5.3,9,1,28,25,53,6,FALSE
cirru-editor,0.5.3,0.5.4,10,1,2,2,4,4,FALSE
cirru-editor,0.6.9,0.6.10,23,1,5,5,10,2,FALSE
cirru-editor,0.6.8,0.6.9,22,1,7,1,8,2,FALSE
cirru-editor,0.6.3,0.6.4,19,3,133,90,223,17,FALSE
cirru-editor,0.6.2,0.6.3,18,1,6,7,13,3,FALSE
cirru-editor,0.6.1,0.6.2,17,2,9,9,18,6,FALSE
cirru-editor,0.6.0,0.6.1,16,3,24,33,57,7,FALSE
cirru-editor,0.6.7,0.6.8,21,2,13,12,25,6,FALSE
cirru-editor,0.6.4,0.6.7,20,5,93,111,204,19,FALSE
cirru-editor,0.6.22,0.6.23,35,3,68,10,78,14,FALSE
cirru-editor,0.6.23,0.6.24,36,1,15,11,26,3,FALSE
cirru-editor,0.6.20,0.6.21,33,1,12,2,14,2,FALSE
cirru-editor,0.6.21,0.6.22,34,1,16,8,24,3,FALSE
cirru-editor,0.6.24,0.6.25,37,1,5,5,10,2,FALSE
cirru-editor,0.6.25,0.6.26,38,1,6,7,13,3,FALSE
cirru-editor,0.6.19,0.6.20,32,1,6,7,13,3,FALSE
cirru-editor,0.6.18,0.6.19,31,1,4,3,7,3,FALSE
cirru-editor,0.6.13,0.6.14,26,1,11,9,20,3,FALSE
cirru-editor,0.6.11,0.6.13,25,7,122,57,179,17,FALSE
cirru-editor,0.6.10,0.6.11,24,1,9,7,16,2,FALSE
cirru-editor,0.6.17,0.6.18,30,1,12,7,19,3,FALSE
cirru-editor,0.6.16,0.6.17,29,3,10,3,13,4,FALSE
cirru-editor,0.6.15,0.6.16,28,1,13,12,25,2,FALSE
cirru-editor,0.6.14,0.6.15,27,2,195,30,225,12,FALSE
cirru-editor,0.5.8,0.6.0,15,17,1221,1318,2539,122,FALSE
cirru-editor,0.6.11,0.6.13,25,7,122,57,179,17,TRUE
cirru-editor,0.4.0,0.5.1,7,31,1659,1402,3061,180,FALSE
cirru-editor,0.2.4,0.2.5-1,4,3,46,26,72,9,FALSE
cirru-editor,0.2.3,0.2.4,3,1,6,7,13,3,FALSE
cirru-editor,0.2.2,0.2.3,2,1,6,7,13,3,FALSE
cirru-editor,0.2.5,0.4.0,6,14,1301,1218,2519,94,FALSE
detox,3.1.0,3.2.0,16,9,240,16,256,31,FALSE
detox,3.0.0,3.1.0,15,26,914,54,968,87,FALSE
detox,2.2.0,2.3.0,5,21,519,732,1251,863,FALSE
detox,4.0.11,4.0.12,34,8,391,147,538,47,FALSE
detox,4.0.10,4.0.11,33,18,961,900,1861,78,FALSE
detox,4.0.13,4.1.0,36,23,4478,1273,5751,140,FALSE
detox,4.0.12,4.0.13,35,7,19,12,31,8,FALSE
detox,4.0.0-experimental.1,4.0.0-experimental.2,20,2,20,14,34,2,FALSE
detox,4.0.0-experimental.0,4.0.0-experimental.1,19,5,153,153,306,5,FALSE
detox,2.5.5,2.5.6,13,8,182,63,245,15,FALSE
detox,4.0.0-experimental.2,4.0.0-experimental.3,21,2,36,3,39,4,FALSE
detox,4.1.4,4.2.0,41,46,5078,2186,7264,183,FALSE
detox,4.0.0,4.0.1,23,2,19,43,62,9,FALSE
detox,4.0.3,4.0.4,26,2,14,11,25,6,FALSE
detox,4.0.2,4.0.3,25,1,3,3,6,1,FALSE
detox,4.1.0,4.1.1,37,13,1868,4701,6569,93,FALSE
detox,4.1.1,4.1.2,38,3,69,68,137,5,FALSE
detox,4.0.7,4.0.8,30,2,6,8,14,5,FALSE
detox,4.0.6,4.0.7,29,2,3,3,6,2,FALSE
detox,4.0.9,4.0.10,32,2,71,72,143,3,FALSE
detox,4.0.8,4.0.9,31,1,2,2,4,2,FALSE
detox,4.0.0-experimental.3,4.0.0,22,3,43,14,57,5,FALSE
detox,2.5.1,2.5.2,9,12,1344,158,1502,123,FALSE
detox,4.0.1,4.0.2,24,6,1181,88506,89687,1041,FALSE
detox,2.3.0,2.4.0,6,9,2690,15,2705,59,FALSE
detox,2.5.6,3.0.0,14,25,1263,375,1638,77,FALSE
detox,4.0.5,4.0.6,28,4,39,34,73,6,FALSE
detox,2.5.4,2.5.5,12,1,63,37,100,3,FALSE
detox,2.4.0,2.5.0,7,1,63,37,100,3,FALSE
detox,2.5.2,2.5.3,10,20,31418,1211,32629,1074,FALSE
detox,2.5.3,2.5.4,11,5,65,88,153,7,FALSE
detox,2.5.0,2.5.1,8,4,67,11,78,8,FALSE
detox,4.0.4,4.0.5,27,3,3,3,6,3,FALSE
detox,4.1.2,4.1.3,39,4,179,194,373,30,FALSE
detox,4.1.3,4.1.4,40,6,88,55,143,13,FALSE
detox,4.2.0,4.3.0,42,18,402,130,532,37,FALSE
detox,3.2.0,3.2.1,17,6,108,36,144,11,FALSE
detox,3.2.1,4.0.0-experimental.0,18,19,1819,89008,90827,1094,FALSE
detox,4.3.0,4.3.1,43,3,3,3,6,3,FALSE
detox,5.0.1,5.0.3,46,4,4,4,8,4,FALSE
detox,5.0.3,5.0.4,47,10,126,121,247,10,FALSE
detox,5.0.4,5.0.5,48,31,1076,418,1494,70,FALSE
detox,5.0.5,5.0.6,49,68,4289,383,4672,140,FALSE
detox,5.0.6,5.0.7,50,9,26,73,99,9,FALSE
detox,5.0.7,5.0.8,51,1,63,37,100,3,FALSE
detox,5.0.8,5.0.9,52,129,2786,1648,4434,197,FALSE
detox,5.0.9,5.0.10,53,6,499,121,620,28,FALSE
detox,4.3.2,5.0.1,45,52,1979,1556,3535,268,FALSE
detox,4.3.1,4.3.2,44,34,2642,2367,5009,168,FALSE
detox,5.0.10,5.0.11,54,8,24,14,38,14,FALSE
detox,5.0.11,5.0.12,55,4,21,17,38,6,FALSE
detox,2.5.6,3.0.0,14,25,1263,375,1638,77,TRUE
detox,5.0.3,5.0.4,47,10,126,121,247,10,TRUE
detox,4.3.1,4.3.2,44,34,2642,2367,5009,168,TRUE
ngdatasheet,0.0.4,0.1.0,3,1,78,4,82,5,FALSE
ngdatasheet,0.0.1,0.0.3,1,2,3,3,6,3,FALSE
ngdatasheet,0.0.3,0.0.4,2,1,85,4,89,3,FALSE
ngdatasheet,0.3.0,0.3.1,6,1,6,594,600,26,FALSE
ngdatasheet,0.3.1,0.4.0,7,5,1165,19,1184,33,FALSE
ngdatasheet,0.1.0,0.2.0,4,1,41,5,46,4,TRUE
ngdatasheet,0.2.0,0.3.0,5,4,724,57,781,34,TRUE
ngdatasheet,0.4.1,0.4.2,9,2,82,32,114,7,FALSE
ngdatasheet,0.4.0,0.4.1,8,1,74,5,79,7,FALSE
ngdatasheet,0.4.2,0.5.0,10,1,134,42,176,12,FALSE
ngdatasheet,0.5.0,0.5.1,11,1,45,7,52,3,FALSE
ngdatasheet,0.1.0,0.2.0,4,1,41,5,46,4,FALSE
ngdatasheet,0.2.0,0.3.0,5,4,724,57,781,34,FALSE
rethinkdb-repository,1.1.0,1.2.0,2,3,315,6,321,8,FALSE
rethinkdb-repository,1.0.0,1.1.0,1,2,456,1,457,6,FALSE
rethinkdb-repository,1.14.0,1.15.0,15,2,8,1,9,3,FALSE
rethinkdb-repository,1.15.0,1.16.0,16,2,21,7,28,5,FALSE
rethinkdb-repository,1.24.0,1.25.0,25,2,5,3,8,3,FALSE
rethinkdb-repository,1.6.0,1.7.0,7,3,46,1,47,3,FALSE
rethinkdb-repository,1.23.0,1.24.0,24,2,16,13,29,3,FALSE
rethinkdb-repository,1.9.0,1.10.0,10,2,126,23,149,3,FALSE
rethinkdb-repository,1.19.0,1.20.0,20,2,12,1,13,3,FALSE
rethinkdb-repository,1.8.0,1.9.0,9,1,1,1,2,1,FALSE
rethinkdb-repository,1.22.0,1.23.0,23,3,152,151,303,7,FALSE
rethinkdb-repository,1.7.0,1.8.0,8,2,7,5,12,2,FALSE
rethinkdb-repository,1.4.0,1.5.0,5,2,21,5,26,2,FALSE
rethinkdb-repository,1.18.0,1.19.0,19,2,22,8,30,3,FALSE
rethinkdb-repository,1.21.0,1.22.0,22,2,23,23,46,3,FALSE
rethinkdb-repository,1.5.0,1.6.0,6,2,13,2,15,2,FALSE
rethinkdb-repository,1.20.0,1.21.0,21,3,139,24,163,9,FALSE
rethinkdb-repository,1.13.0,1.14.0,14,2,108,59,167,5,FALSE
rethinkdb-repository,1.3.0,1.4.0,4,2,14,3,17,2,FALSE
rethinkdb-repository,1.2.0,1.3.0,3,2,4,7,11,2,FALSE
rethinkdb-repository,1.12.0,1.13.0,13,2,10,16,26,3,FALSE
rethinkdb-repository,1.11.0,1.12.0,12,2,51,12,63,6,FALSE
rethinkdb-repository,1.27.0,1.28.0,28,1,2,0,2,2,FALSE
rethinkdb-repository,1.10.0,1.11.0,11,2,3,3,6,2,FALSE
rethinkdb-repository,1.16.0,1.17.0,17,2,50,24,74,3,FALSE
rethinkdb-repository,1.17.0,1.18.0,18,2,47,11,58,5,FALSE
rethinkdb-repository,1.25.0,1.26.0,26,2,3,3,6,3,FALSE
rethinkdb-repository,1.26.0,1.27.0,27,2,3,3,6,3,FALSE
rethinkdb-repository,1.23.0,1.24.0,24,2,16,13,29,3,TRUE
rethinkdb-repository,1.8.0,1.9.0,9,1,1,1,2,1,TRUE
rethinkdb-repository,1.22.0,1.23.0,23,3,152,151,303,7,TRUE
rethinkdb-repository,1.11.0,1.12.0,12,2,51,12,63,6,TRUE
fenix-ui-pivotator-utils,1.0.0-beta.4,1.0.0-beta.5,5,1,6,4,10,4,FALSE
fenix-ui-pivotator-utils,1.0.0-beta.2,1.0.0-beta.3,3,1,6,4,10,4,FALSE
fenix-ui-pivotator-utils,1.0.0-beta.3,1.0.0-beta.4,4,1,6,4,10,4,FALSE
fenix-ui-pivotator-utils,1.0.0-beta.0,1.0.0-beta.1,1,1,6,4,10,4,FALSE
fenix-ui-pivotator-utils,1.0.0-beta.1,1.0.0-beta.2,2,2,12,8,20,8,FALSE
fenix-ui-pivotator-utils,1.0.0-beta.0,1.0.0-beta.1,1,1,6,4,10,4,TRUE
fenix-ui-pivotator-utils,1.0.0-beta.1,1.0.0-beta.2,2,2,12,8,20,8,TRUE
api-key-validator,0.1.0,0.1.1,1,11,20,17,37,11,FALSE
api-key-validator,0.1.1,0.1.3,2,3,141,29,170,9,FALSE
api-key-validator,0.1.3,0.1.4,3,1,11,118,129,6,FALSE
api-key-validator,0.1.4,0.1.5,4,1,4,3,7,3,FALSE
api-key-validator,0.1.5,0.1.6,5,1,4,3,7,3,FALSE
api-key-validator,0.1.0,0.1.1,1,11,20,17,37,11,TRUE
jsonapi-store-relationaldb,1.2.6,1.2.7,13,2,8,4,12,4,FALSE
jsonapi-store-relationaldb,1.2.7,1.2.8,14,6,140,68,208,9,FALSE
jsonapi-store-relationaldb,1.2.4,1.2.5,11,5,58,30,88,9,FALSE
jsonapi-store-relationaldb,1.2.5,1.2.6,12,7,206,94,300,20,FALSE
jsonapi-store-relationaldb,1.2.2,1.2.3,9,5,94,60,154,7,FALSE
jsonapi-store-relationaldb,1.2.3,1.2.4,10,2,50,40,90,8,FALSE
jsonapi-store-relationaldb,1.2.0,1.2.1,7,3,8,8,16,6,FALSE
jsonapi-store-relationaldb,1.2.1,1.2.2,8,5,10,6,16,8,TRUE
jsonapi-store-relationaldb,1.1.0,1.2.0,6,5,127,81,208,9,FALSE
jsonapi-store-relationaldb,1.0.0,1.0.1,2,5,22,20,42,9,FALSE
jsonapi-store-relationaldb,1.0.1,1.0.2,3,6,62,91,153,8,FALSE
jsonapi-store-relationaldb,1.0.2,1.0.3,4,3,14,6,20,6,FALSE
jsonapi-store-relationaldb,1.0.3,1.1.0,5,22,237,119,356,37,FALSE
jsonapi-store-relationaldb,1.2.1,1.2.2,8,5,10,6,16,8,FALSE
jsonapi-store-relationaldb,0.0.1,1.0.0,1,12,181,51,232,19,FALSE
jsonapi-store-relationaldb,1.2.6,1.2.7,13,2,8,4,12,4,TRUE
jsonapi-store-relationaldb,1.1.0,1.2.0,6,5,127,81,208,9,TRUE
jsonapi-store-relationaldb,1.2.0,1.2.1,7,3,8,8,16,6,TRUE
fetch-gifs,0.1.10,0.1.11,11,7,157,57,214,20,FALSE
fetch-gifs,0.1.11,0.2.0,12,2,4,4,8,2,FALSE
fetch-gifs,0.1.0,0.1.1,1,1,1,0,1,1,FALSE
fetch-gifs,0.1.1,0.1.2,2,1,1,0,1,1,FALSE
fetch-gifs,0.1.2,0.1.3,3,1,1,0,1,1,FALSE
fetch-gifs,0.1.3,0.1.4,4,5,195,9,204,13,FALSE
fetch-gifs,0.1.4,0.1.5,5,2,20,2,22,2,FALSE
fetch-gifs,0.1.5,0.1.6,6,2,4,4,8,2,FALSE
fetch-gifs,0.1.6,0.1.7,7,7,184,165,349,30,FALSE
fetch-gifs,0.1.7,0.1.8,8,2,6,6,12,3,FALSE
fetch-gifs,0.1.8,0.1.9,9,2,21,31,52,8,FALSE
fetch-gifs,0.1.9,0.1.10,10,2,18,14,32,9,FALSE
fetch-gifs,0.1.3,0.1.4,4,5,195,9,204,13,TRUE
sweet-scroll,1.0.4,1.1.0,28,12,11323,463,11786,30,FALSE
sweet-scroll,1.1.0,2.0.0,29,14,6905,8089,14994,122,FALSE
sweet-scroll,0.3.1,0.4.0,16,10,444,51,495,34,FALSE
sweet-scroll,1.0.0,1.0.1,24,3,89,64,153,9,FALSE
sweet-scroll,1.0.1,1.0.2,25,5,538,226,764,14,FALSE
sweet-scroll,2.0.1,2.1.0,31,8,538,82,620,39,FALSE
sweet-scroll,1.0.3,1.0.4,27,8,4841,4737,9578,19,FALSE
sweet-scroll,0.2.5,0.3.0,14,4,272,94,366,14,FALSE
sweet-scroll,0.2.4,0.2.5,13,4,451,427,878,21,FALSE
sweet-scroll,0.2.3,0.2.4,12,6,1056,982,2038,20,FALSE
sweet-scroll,0.2.2,0.2.3,11,9,413,116,529,25,FALSE
sweet-scroll,0.2.1,0.2.2,10,2,8,8,16,5,FALSE
sweet-scroll,0.2.0,0.2.1,9,5,42,23,65,13,FALSE
sweet-scroll,0.1.0,0.1.1,5,4,127,12,139,13,FALSE
sweet-scroll,0.1.1,0.1.2,6,4,102,34,136,11,FALSE
sweet-scroll,0.1.2,0.1.3,7,3,39,41,80,6,FALSE
sweet-scroll,0.1.3,0.2.0,8,6,521,261,782,23,FALSE
sweet-scroll,2.1.0,2.2.0,32,6,1604,2214,3818,30,FALSE
sweet-scroll,0.0.4,0.1.0,4,9,265,32,297,18,FALSE
sweet-scroll,0.0.1,0.0.2,1,2,11,16,27,10,FALSE
sweet-scroll,1.0.2,1.0.3,26,9,72,29,101,21,FALSE
sweet-scroll,0.0.3,0.0.4,3,5,53,32,85,14,FALSE
sweet-scroll,0.0.2,0.0.3,2,4,601,131,732,17,FALSE
sweet-scroll,0.6.2,0.7.0,21,8,393,218,611,22,FALSE
sweet-scroll,0.3.0,0.3.1,15,8,280,211,491,21,FALSE
sweet-scroll,0.6.0,0.6.1,19,9,572,294,866,19,FALSE
sweet-scroll,0.7.0,0.7.1,22,6,80,78,158,22,FALSE
sweet-scroll,0.7.1,1.0.0,23,16,2430,2090,4520,95,FALSE
sweet-scroll,0.4.0,0.5.0,17,11,397,171,568,35,FALSE
sweet-scroll,0.5.0,0.6.0,18,4,38,18,56,16,FALSE
sweet-scroll,2.0.0,2.0.1,30,9,331,113,444,52,FALSE
sweet-scroll,0.6.1,0.6.2,20,3,78,82,160,14,FALSE
sweet-scroll,2.2.0,2.2.1,33,5,1295,1208,2503,10,FALSE
sweet-scroll,0.3.1,0.4.0,16,10,444,51,495,34,TRUE
sweet-scroll,2.0.1,2.1.0,31,8,538,82,620,39,TRUE
sweet-scroll,1.0.2,1.0.3,26,9,72,29,101,21,TRUE
sweet-scroll,0.5.0,0.6.0,18,4,38,18,56,16,TRUE
sweet-scroll,0.1.0,0.1.1,5,4,127,12,139,13,TRUE
sweet-scroll,2.0.0,2.0.1,30,9,331,113,444,52,TRUE
sweet-scroll,1.0.3,1.0.4,27,8,4841,4737,9578,19,TRUE
sweet-scroll,2.2.0,2.2.1,33,5,1295,1208,2503,10,TRUE
sweet-scroll,0.2.3,0.2.4,12,6,1056,982,2038,20,TRUE
sweet-scroll,1.0.1,1.0.2,25,5,538,226,764,14,TRUE
sweet-scroll,1.0.4,1.1.0,28,12,11323,463,11786,30,TRUE
sweet-scroll,2.1.0,2.2.0,32,6,1604,2214,3818,30,TRUE
sweet-scroll,0.7.0,0.7.1,22,6,80,78,158,22,TRUE
fsbx,1.3.124-inferno-preview,1.3.124-inferno-preview.2,16,12,1688,703,2391,90,FALSE
fsbx,1.3.128-preview,1.4.1-beta.1,20,54,5650,2190,7840,227,FALSE
fsbx,1.3.122,1.3.123-preview.1,1,8,397,772,1169,57,FALSE
fsbx,2.1.0-beta.3,2.1.0-beta.4,30,1,1,1,2,1,FALSE
fsbx,1.3.123-preview.2,1.3.123-preview.3,3,1,1,1,2,1,FALSE
fsbx,1.3.123-preview.3,1.3.123-preview.4,4,1,1,1,2,1,FALSE
fsbx,1.3.123-preview.1,1.3.123-preview.2,2,9,9215,8838,18053,29,FALSE
fsbx,1.3.123-preview.6,1.3.123-preview.8,7,1,1,1,2,1,FALSE
fsbx,1.3.123-preview.4,1.3.123-preview.5,5,1,1,1,2,1,FALSE
fsbx,1.3.123-preview.5,1.3.123-preview.6,6,1,79,70,149,7,FALSE
fsbx,1.3.123-preview.8,1.3.123-preview.9,8,7,239,117,356,18,FALSE
fsbx,1.3.123-preview.9,1.3.123-preview.10,9,1,86,75,161,3,FALSE
fsbx,1.3.123-preview.14,1.3.123-preview.15,14,5,83,15,98,9,FALSE
fsbx,1.3.123-preview.15,1.3.124-inferno-preview,15,67,19570,18324,37894,818,FALSE
fsbx,1.3.123-preview.10,1.3.123-preview.11,10,24,13529,2601,16130,157,FALSE
fsbx,1.3.123-preview.11,1.3.123-preview.12,11,2,1,1,2,2,FALSE
fsbx,1.3.123-preview.12,1.3.123-preview.13,12,1,623,87,710,8,FALSE
fsbx,1.3.123-preview.13,1.3.123-preview.14,13,1,1,1,2,1,FALSE
fsbx,1.4.1-preview.6,1.4.1-preview.7,27,12,420,139,559,19,FALSE
fsbx,1.4.1-preview.7,1.4.1-preview.8,28,1,1,1,2,1,FALSE
fsbx,1.4.1-preview,1.4.1-preview.2,22,10,1608,854,2462,52,FALSE
fsbx,1.4.1-preview.5,1.4.1-preview.6,26,6,1270,74,1344,44,FALSE
fsbx,1.4.1-preview.2,1.4.1-preview.3,23,1,1,1,2,1,FALSE
fsbx,1.4.1-preview.3,1.4.1-preview.4,24,2,216,22,238,8,FALSE
fsbx,1.3.124-inferno-preview.3,1.3.124-inferno-preview.4,18,1,1,1,2,1,FALSE
fsbx,1.3.124-inferno-preview.2,1.3.124-inferno-preview.3,17,9,4370,2865,7235,178,FALSE
fsbx,1.3.124-inferno-preview.4,1.3.128-preview,19,62,15200,11283,26483,385,FALSE
fsbx,1.4.1-preview.8,2.1.0-beta.3,29,279,13378,5379,18757,836,FALSE
fsbx,1.4.1-preview.4,1.4.1-preview.5,25,1,1,1,2,1,FALSE
fsbx,1.3.123-preview.8,1.3.123-preview.9,8,7,239,117,356,18,TRUE
fsbx,1.3.123-preview.11,1.3.123-preview.12,11,2,1,1,2,2,TRUE
fsbx,1.3.123-preview.15,1.3.124-inferno-preview,15,67,19570,18324,37894,818,TRUE
fsbx,1.3.124-inferno-preview,1.3.124-inferno-preview.2,16,12,1688,703,2391,90,TRUE
fsbx,1.3.128-preview,1.4.1-beta.1,20,54,5650,2190,7840,227,TRUE
fsbx,1.3.122,1.3.123-preview.1,1,8,397,772,1169,57,TRUE
fsbx,1.3.123-preview.6,1.3.123-preview.8,7,1,1,1,2,1,TRUE
fsbx,1.3.123-preview.10,1.3.123-preview.11,10,24,13529,2601,16130,157,TRUE
fsbx,1.4.1-preview.6,1.4.1-preview.7,27,12,420,139,559,19,TRUE
fsbx,1.4.1-preview.7,1.4.1-preview.8,28,1,1,1,2,1,TRUE
fsbx,1.4.1-preview.5,1.4.1-preview.6,26,6,1270,74,1344,44,TRUE
fsbx,1.4.1-preview.3,1.4.1-preview.4,24,2,216,22,238,8,TRUE
fsbx,1.3.124-inferno-preview.4,1.3.128-preview,19,62,15200,11283,26483,385,TRUE
redux-thunk-action-reducer,0.0.4,0.0.6,4,2,2,2,4,2,FALSE
redux-thunk-action-reducer,0.0.7,0.0.8,6,2,4,4,8,3,FALSE
redux-thunk-action-reducer,0.0.6,0.0.7,5,3,4,4,8,3,FALSE
redux-thunk-action-reducer,0.2.1,0.4.0,19,8,5871,1409,7280,116,TRUE
redux-thunk-action-reducer,0.0.3,0.0.4,3,3,75,1,76,8,FALSE
redux-thunk-action-reducer,0.0.2,0.0.3,2,1,31,0,31,1,FALSE
redux-thunk-action-reducer,0.2.0,0.2.1,18,1,1,1,2,1,FALSE
redux-thunk-action-reducer,0.0.9,0.0.10,8,2,4,4,8,3,FALSE
redux-thunk-action-reducer,0.0.8,0.0.9,7,1,1,1,2,1,FALSE
redux-thunk-action-reducer,0.0.15,0.0.16,14,2,2,2,4,2,FALSE
redux-thunk-action-reducer,0.0.14,0.0.15,13,1,1,1,2,1,FALSE
redux-thunk-action-reducer,0.0.17,0.1.0,16,1,1,1,2,1,FALSE
redux-thunk-action-reducer,0.0.16,0.0.17,15,1,1,1,2,1,FALSE
redux-thunk-action-reducer,0.0.11,0.0.12,10,2,2,2,4,2,FALSE
redux-thunk-action-reducer,0.0.10,0.0.11,9,1,1,1,2,1,FALSE
redux-thunk-action-reducer,0.0.13,0.0.14,12,2,2,2,4,2,FALSE
redux-thunk-action-reducer,0.0.12,0.0.13,11,1,1,1,2,1,FALSE
redux-thunk-action-reducer,0.1.0,0.2.0,17,1,1,1,2,1,FALSE
peters-toolbelt,0.3.8,0.3.9,18,2,3,3,6,3,FALSE
peters-toolbelt,0.3.2,0.3.3,12,2,394,394,788,16,FALSE
peters-toolbelt,0.3.3,0.3.4,13,2,31,45,76,3,FALSE
peters-toolbelt,0.3.1,0.3.2,11,2,6,21,27,4,FALSE
peters-toolbelt,0.3.6,0.3.7,16,2,3,3,6,3,FALSE
peters-toolbelt,0.3.7,0.3.8,17,2,11,69,80,3,FALSE
peters-toolbelt,0.3.4,0.3.5,14,2,26,11,37,3,FALSE
peters-toolbelt,0.3.5,0.3.6,15,2,11,7,18,3,FALSE
peters-toolbelt,0.2.3,0.3.1,10,3,396,150,546,12,FALSE
peters-toolbelt,0.2.2,0.2.3,9,2,66,991,1057,9,FALSE
peters-toolbelt,0.2.1,0.2.2,8,2,1104,428,1532,19,FALSE
peters-toolbelt,0.2.0,0.2.1,7,2,438,349,787,30,FALSE
peters-toolbelt,0.0.0,0.1.0,1,24,537,222,759,64,FALSE
peters-toolbelt,0.1.0,0.1.1,2,2,3,3,6,3,FALSE
peters-toolbelt,0.1.1,0.1.2,3,2,7,7,14,2,FALSE
peters-toolbelt,0.1.2,0.1.3,4,3,67,45,112,9,FALSE
peters-toolbelt,0.1.3,0.1.4,5,2,7,2,9,3,FALSE
peters-toolbelt,0.1.4,0.2.0,6,2,34,5,39,5,FALSE
peters-toolbelt,0.1.0,0.1.1,2,2,3,3,6,3,TRUE
peters-toolbelt,0.2.2,0.2.3,9,2,66,991,1057,9,TRUE
peters-toolbelt,0.2.1,0.2.2,8,2,1104,428,1532,19,TRUE
xliv,1.1.0,2.0.0,6,12,249,217,466,28,FALSE
xliv,1.0.1,1.0.2-alpha.1808bea0,3,3,15,8,23,7,FALSE
xliv,2.0.1,2.1.0,8,7,82,30,112,15,FALSE
xliv,2.0.0,2.0.1,7,2,14,5,19,5,FALSE
xliv,1.0.2,1.1.0,5,13,366,131,497,30,FALSE
xliv,2.1.0,2.2.0,9,40,835,499,1334,94,FALSE
xliv,1.0.2-alpha.1808bea0,1.0.2,4,1,3,3,6,1,FALSE
xliv,1.0.1,1.0.2-alpha.1808bea0,3,3,15,8,23,7,TRUE
xliv,1.0.2,1.1.0,5,13,366,131,497,30,TRUE
xliv,2.1.0,2.2.0,9,40,835,499,1334,94,TRUE
npm-library-starter,1.0.0,1.0.1,4,1,5211,4695,9906,18,FALSE
npm-library-starter,1.0.1,1.0.2,5,1,5211,4695,9906,18,FALSE
npm-library-starter,1.0.2,2.0.0,6,1,5211,4695,9906,18,FALSE
npm-library-starter,0.0.2,0.1.0,2,1,5211,4695,9906,18,FALSE
npm-library-starter,2.0.0,2.0.1,7,1,5211,4695,9906,18,FALSE
npm-library-starter,0.1.0,1.0.0,3,1,5211,4695,9906,18,FALSE
npm-library-starter,0.0.1,0.0.2,1,1,5211,4695,9906,18,FALSE
npm-library-starter,2.0.0,2.0.1,7,1,5211,4695,9906,18,TRUE
solid-permissions,0.3.0,0.4.0,5,7,53,31,84,12,FALSE
solid-permissions,0.2.1,0.3.0,4,21,2067,1237,3304,34,FALSE
solid-permissions,0.4.1,0.4.2,7,4,318,104,422,7,TRUE
solid-permissions,0.4.0,0.4.1,6,6,185,9,194,13,FALSE
solid-permissions,0.4.2,0.5.0,8,4,175,105,280,18,FALSE
solid-permissions,0.0.1,0.1.0,1,4,13,8,21,5,FALSE
solid-permissions,0.4.1,0.4.2,7,4,318,104,422,7,FALSE
solid-permissions,0.2.0,0.2.1,3,10,277,50,327,25,FALSE
solid-permissions,0.1.0,0.2.0,2,5,12,12,24,6,FALSE
solid-permissions,0.5.0,0.5.1,9,3,5,9,14,3,FALSE
koapi,0.2.26,0.2.27,43,2,1,2,3,2,FALSE
koapi,0.2.27,0.2.28,44,2,16,12,28,3,FALSE
koapi,0.2.24,0.2.25,41,2,5,5,10,3,FALSE
koapi,0.2.25,0.2.26,42,2,3,2,5,2,FALSE
koapi,0.2.23,0.2.24,40,2,2,3,5,2,FALSE
koapi,0.2.34,0.2.35,51,2,6,6,12,2,FALSE
koapi,0.2.62,0.2.63,79,2,30,34,64,5,FALSE
koapi,0.2.63,0.2.64,80,3,36,35,71,3,FALSE
koapi,0.2.60,0.2.61,77,2,6,5,11,2,FALSE
koapi,0.2.61,0.2.62,78,2,12,10,22,4,FALSE
koapi,0.2.66,0.2.67,82,1,1,1,2,1,FALSE
koapi,0.2.68,0.2.69,84,2,31,24,55,3,FALSE
koapi,0.2.28,0.2.29,45,2,16,2,18,3,FALSE
koapi,0.2.29,0.2.30,46,2,6,3,9,2,FALSE
koapi,0.2.69,0.2.70,85,2,8,6,14,19,FALSE
koapi,0.2.89,0.2.90,104,2,2,6,8,2,FALSE
koapi,0.2.88,0.2.89,103,2,30,4,34,4,FALSE
koapi,0.2.92,0.2.93,107,9,385,496,881,16,FALSE
koapi,0.2.91,0.2.92,106,2,4,4,8,3,FALSE
koapi,0.2.90,0.2.91,105,2,2,1,3,2,FALSE
koapi,0.3.0,0.3.1,109,4,4,4,8,4,FALSE
koapi,0.3.1,0.3.2,110,3,8,3,11,3,FALSE
koapi,0.2.53,0.2.54,70,3,3,3,6,3,FALSE
koapi,0.2.52,0.2.53,69,2,4,2,6,3,FALSE
koapi,0.2.51,0.2.52,68,2,2,2,4,2,FALSE
koapi,0.2.50,0.2.51,67,2,4,1,5,3,FALSE
koapi,0.2.57,0.2.58,74,2,3,3,6,2,FALSE
koapi,0.2.56,0.2.57,73,2,6,4,10,2,FALSE
koapi,0.2.55,0.2.56,72,2,120,9,129,5,FALSE
koapi,0.2.54,0.2.55,71,2,23,3,26,2,FALSE
koapi,0.2.59,0.2.60,76,2,7,5,12,3,FALSE
koapi,0.2.58,0.2.59,75,2,2,2,4,2,FALSE
koapi,0.2.35,0.2.36,52,2,6,3,9,3,FALSE
koapi,0.2.79,0.2.80,94,2,6,1,7,2,FALSE
koapi,0.2.78,0.2.79,93,2,1,2,3,2,FALSE
koapi,0.2.37,0.2.38,54,2,17,36,53,4,FALSE
koapi,0.2.36,0.2.37,53,2,3,2,5,3,FALSE
koapi,0.2.31,0.2.32,48,2,9,7,16,2,FALSE
koapi,0.2.30,0.2.31,47,2,9,3,12,3,FALSE
koapi,0.2.33,0.2.34,50,2,37,14,51,5,FALSE
koapi,0.2.32,0.2.33,49,2,6,7,13,3,FALSE
koapi,0.2.71,0.2.72,87,2,206,120,326,8,FALSE
koapi,0.2.70,0.2.71,86,2,8,7,15,3,FALSE
koapi,0.2.73,0.2.74,89,2,21,23,44,4,FALSE
koapi,0.2.72,0.2.73,88,3,3,3,6,3,FALSE
koapi,0.2.39,0.2.40,56,2,49,38,87,3,FALSE
koapi,0.2.38,0.2.39,55,2,21,9,30,5,FALSE
koapi,0.2.77,0.2.78,92,3,5,6,11,5,FALSE
koapi,0.2.67,0.2.68,83,3,3,3,6,3,FALSE
koapi,0.2.64,0.2.66,81,4,24,20,44,5,FALSE
koapi,0.2.76,0.2.77,91,1,12,11,23,1,FALSE
koapi,0.2.48,0.2.49,65,2,58,57,115,7,FALSE
koapi,0.2.74,0.2.76,90,4,49,6,55,7,FALSE
koapi,0.2.49,0.2.50,66,2,48,32,80,5,FALSE
koapi,0.2.44,0.2.45,61,1,34,25,59,2,FALSE
koapi,0.2.45,0.2.46,62,3,93,35,128,3,FALSE
koapi,0.2.46,0.2.47,63,1,38,18,56,4,FALSE
koapi,0.2.47,0.2.48,64,4,13,6,19,4,FALSE
koapi,0.2.40,0.2.41,57,3,23,23,46,9,FALSE
koapi,0.2.41,0.2.42,58,2,37,8,45,6,FALSE
koapi,0.2.42,0.2.43,59,2,29,22,51,4,FALSE
koapi,0.2.43,0.2.44,60,2,7,5,12,5,FALSE
koapi,0.2.80,0.2.81,95,2,162,20,182,6,FALSE
koapi,0.2.81,0.2.82,96,2,4,6,10,2,FALSE
koapi,0.2.82,0.2.83,97,2,5,9,14,3,FALSE
koapi,0.2.83,0.2.84,98,2,3,2,5,2,FALSE
koapi,0.2.84,0.2.85,99,2,1,2,3,2,FALSE
koapi,0.2.85,0.2.86,100,2,24,12,36,6,FALSE
koapi,0.2.86,0.2.87,101,2,29,49,78,4,FALSE
koapi,0.2.87,0.2.88,102,2,11,9,20,3,FALSE
koapi,0.3.8,0.3.9,117,2,6,3,9,3,FALSE
koapi,0.3.9,0.3.10,118,2,7,7,14,3,FALSE
koapi,0.3.2,0.3.3,111,2,3,6,9,2,FALSE
koapi,0.3.3,0.3.4,112,2,5,3,8,3,FALSE
koapi,0.3.6,0.3.7,115,2,2,3,5,2,FALSE
koapi,0.3.7,0.3.8,116,2,35,2,37,3,FALSE
koapi,0.3.4,0.3.5,113,2,6,6,12,2,FALSE
koapi,0.3.5,0.3.6,114,2,18,5,23,2,FALSE
koapi,0.3.18,0.4.0,127,3,1216,1098,2314,36,FALSE
koapi,0.3.14,0.3.15,123,2,6,6,12,2,FALSE
koapi,0.3.15,0.3.16,124,2,13,11,24,2,FALSE
koapi,0.3.16,0.3.17,125,2,28,8,36,2,FALSE
koapi,0.3.17,0.3.18,126,2,2,2,4,2,FALSE
koapi,0.3.10,0.3.11,119,2,3,4,7,3,FALSE
koapi,0.3.11,0.3.12,120,2,2,2,4,2,FALSE
koapi,0.3.12,0.3.13,121,2,10,4,14,3,FALSE
koapi,0.3.13,0.3.14,122,2,2,2,4,2,FALSE
koapi,0.9.0,0.9.1,190,2,2,2,4,2,FALSE
koapi,0.6.20,0.7.0,181,2,134,137,271,7,FALSE
koapi,0.4.11,0.4.12,139,2,94,32,126,7,FALSE
koapi,0.4.10,0.4.11,138,2,4,4,8,2,FALSE
koapi,0.4.12,0.5.0,140,3,425,425,850,19,FALSE
koapi,0.6.16,0.6.17,177,3,9,7,16,3,FALSE
koapi,0.5.18,0.5.19,159,2,2,2,4,2,FALSE
koapi,0.5.19,0.6.0,160,2,72,168,240,5,FALSE
koapi,0.5.16,0.5.17,157,2,88,76,164,3,FALSE
koapi,0.5.17,0.5.18,158,2,4,2,6,2,FALSE
koapi,0.5.14,0.5.15,155,2,7,5,12,3,FALSE
koapi,0.5.15,0.5.16,156,2,2,3,5,2,FALSE
koapi,0.5.12,0.5.13,153,2,4,4,8,3,FALSE
koapi,0.5.13,0.5.14,154,2,27,27,54,3,FALSE
koapi,0.5.10,0.5.11,151,2,56,54,110,7,FALSE
koapi,0.5.11,0.5.12,152,2,8,8,16,3,FALSE
koapi,0.6.9,0.6.10,170,2,7,7,14,3,FALSE
koapi,0.6.8,0.6.9,169,2,12,12,24,2,FALSE
koapi,0.6.3,0.6.4,164,2,7,13,20,4,FALSE
koapi,0.6.2,0.6.3,163,2,26,22,48,3,FALSE
koapi,0.6.1,0.6.2,162,2,2,1,3,2,FALSE
koapi,0.6.0,0.6.1,161,2,22,12,34,3,FALSE
koapi,0.6.7,0.6.8,168,2,2,2,4,2,FALSE
koapi,0.6.6,0.6.7,167,2,9,6,15,2,FALSE
koapi,0.6.5,0.6.6,166,2,76,41,117,4,FALSE
koapi,0.6.4,0.6.5,165,2,29,25,54,4,FALSE
koapi,0.4.9,0.4.10,137,2,2,2,4,2,FALSE
koapi,0.4.8,0.4.9,136,2,25,12,37,3,FALSE
koapi,0.4.1,0.4.2,129,2,1,9,10,3,FALSE
koapi,0.4.0,0.4.1,128,2,24,37,61,5,FALSE
koapi,0.4.3,0.4.4,131,2,32,21,53,8,FALSE
koapi,0.4.2,0.4.3,130,2,6,4,10,3,FALSE
koapi,0.4.5,0.4.6,133,2,15,11,26,5,FALSE
koapi,0.4.4,0.4.5,132,2,2,2,4,2,FALSE
koapi,0.4.7,0.4.8,135,2,20,13,33,2,FALSE
koapi,0.4.6,0.4.7,134,2,4,2,6,2,FALSE
koapi,0.8.4,0.9.0,189,3,360,307,667,4,FALSE
koapi,0.8.1,0.8.2,186,2,31,13,44,4,FALSE
koapi,0.8.0,0.8.1,185,4,28,23,51,5,FALSE
koapi,0.8.3,0.8.4,188,2,123,117,240,8,FALSE
koapi,0.8.2,0.8.3,187,2,36,11,47,5,FALSE
koapi,0.6.19,0.6.20,180,2,10,8,18,3,FALSE
koapi,0.6.18,0.6.19,179,2,2,2,4,2,FALSE
koapi,0.6.13,0.6.14,174,2,4,3,7,2,FALSE
koapi,0.6.12,0.6.13,173,2,14,7,21,2,FALSE
koapi,0.6.11,0.6.12,172,2,3,2,5,2,FALSE
koapi,0.6.10,0.6.11,171,2,21,4,25,4,FALSE
koapi,0.6.17,0.6.18,178,2,11,11,22,3,FALSE
koapi,0.6.15,0.6.16,176,3,9,6,15,3,FALSE
koapi,0.6.14,0.6.15,175,3,7,7,14,3,FALSE
koapi,0.10.1,0.10.2,197,2,22,21,43,6,FALSE
koapi,0.10.0,0.10.1,196,2,5,2,7,3,FALSE
koapi,0.10.3,0.10.4,199,2,134,68,202,11,FALSE
koapi,0.10.2,0.10.3,198,3,16,14,30,5,FALSE
koapi,0.7.2,0.8.0,184,2,137,193,330,8,FALSE
koapi,0.7.0,0.7.1,182,2,27,9,36,5,FALSE
koapi,0.7.1,0.7.2,183,2,47,57,104,5,FALSE
koapi,0.5.8,0.5.9,149,2,22,37,59,7,FALSE
koapi,0.5.9,0.5.10,150,2,6,2,8,2,FALSE
koapi,0.5.4,0.5.5,145,3,19,8,27,5,FALSE
koapi,0.5.5,0.5.6,146,2,10,2,12,3,FALSE
koapi,0.5.6,0.5.7,147,2,102,1,103,13,FALSE
koapi,0.5.7,0.5.8,148,3,15,9,24,4,FALSE
koapi,0.5.0,0.5.1,141,2,44,105,149,9,FALSE
koapi,0.5.1,0.5.2,142,2,19,4,23,3,FALSE
koapi,0.5.2,0.5.3,143,2,23,6,29,3,FALSE
koapi,0.5.3,0.5.4,144,2,8,8,16,3,FALSE
koapi,0.9.1,0.9.2,191,2,8,8,16,3,FALSE
koapi,0.9.2,0.9.3,192,2,8,6,14,2,FALSE
koapi,0.9.3,0.9.4,193,2,2,7,9,2,FALSE
koapi,0.9.4,0.9.5,194,2,35,25,60,2,FALSE
koapi,0.9.5,0.10.0,195,7,822,321,1143,35,FALSE
koapi,0.10.4,0.10.5,200,2,247,23,270,11,FALSE
koapi,1.0.0,1.0.1,202,3,53,52,105,12,FALSE
koapi,1.0.1,1.0.2,203,3,48,11,59,4,FALSE
koapi,1.0.2,1.0.3,204,2,15,8,23,3,FALSE
koapi,0.2.22,0.2.23,39,2,148,105,253,6,FALSE
koapi,0.2.20,0.2.21,37,2,8,8,16,2,FALSE
koapi,0.2.21,0.2.22,38,2,4,4,8,3,FALSE
koapi,0.2.19,0.2.20,36,5,130,113,243,7,FALSE
koapi,0.2.18,0.2.19,35,2,32,15,47,2,FALSE
koapi,0.2.17,0.2.18,34,3,227,282,509,10,FALSE
koapi,0.2.16,0.2.17,33,2,16,15,31,2,FALSE
koapi,0.2.15,0.2.16,32,2,30,27,57,3,FALSE
koapi,0.2.14,0.2.15,31,2,16,6,22,6,FALSE
koapi,0.2.13,0.2.14,30,2,21,10,31,3,FALSE
koapi,0.2.12,0.2.13,29,2,17,5,22,4,FALSE
koapi,0.2.11,0.2.12,28,2,121,41,162,7,FALSE
koapi,0.2.10,0.2.11,27,2,3,1,4,2,FALSE
koapi,0.1.8,0.1.9,9,3,5,5,10,3,FALSE
koapi,0.1.9,0.1.10,10,2,40,42,82,3,FALSE
koapi,0.2.7,0.2.8,24,2,9,13,22,4,FALSE
koapi,0.2.6,0.2.7,23,2,11,12,23,4,FALSE
koapi,0.2.5,0.2.6,22,2,118,17,135,6,FALSE
koapi,0.2.4,0.2.5,21,4,23,5,28,6,FALSE
koapi,0.2.3,0.2.4,20,2,2,2,4,2,FALSE
koapi,0.2.2,0.2.3,19,2,5,4,9,2,FALSE
koapi,0.2.1,0.2.2,18,2,1,4,5,2,FALSE
koapi,0.2.0,0.2.1,17,2,5,3,8,2,FALSE
koapi,0.1.0,0.1.1,1,2,20,41,61,3,FALSE
koapi,0.1.1,0.1.2,2,4,28,14,42,8,FALSE
koapi,0.1.2,0.1.3,3,2,11,8,19,2,FALSE
koapi,0.1.3,0.1.4,4,2,31,4,35,3,FALSE
koapi,0.1.4,0.1.5,5,4,120,22,142,7,FALSE
koapi,0.1.5,0.1.6,6,2,67,49,116,2,FALSE
koapi,0.2.9,0.2.10,26,3,256,16,272,11,FALSE
koapi,0.2.8,0.2.9,25,2,2,3,5,2,FALSE
koapi,0.1.6,0.1.7,7,3,27,3,30,3,FALSE
koapi,0.1.7,0.1.8,8,3,5,5,10,3,FALSE
koapi,0.1.12,0.1.13,13,2,4,6,10,2,FALSE
koapi,0.1.13,0.1.14,14,2,8,4,12,2,FALSE
koapi,0.1.10,0.1.11,11,2,15,2,17,2,FALSE
koapi,0.1.11,0.1.12,12,2,2,2,4,2,FALSE
koapi,0.1.14,0.1.15,15,2,3,1,4,2,FALSE
koapi,0.1.15,0.2.0,16,2,270,476,746,17,FALSE
koapi,0.6.5,0.6.6,166,2,76,41,117,4,TRUE
koapi,0.10.3,0.10.4,199,2,134,68,202,11,TRUE
koapi,0.3.2,0.3.3,111,2,3,6,9,2,TRUE
koapi,0.4.11,0.4.12,139,2,94,32,126,7,TRUE
koapi,0.1.10,0.1.11,11,2,15,2,17,2,TRUE
koapi,0.2.86,0.2.87,101,2,29,49,78,4,TRUE
koapi,0.2.71,0.2.72,87,2,206,120,326,8,TRUE
koapi,0.10.4,0.10.5,200,2,247,23,270,11,TRUE
koapi,0.2.22,0.2.23,39,2,148,105,253,6,TRUE
koapi,0.2.81,0.2.82,96,2,4,6,10,2,TRUE
koapi,0.2.2,0.2.3,19,2,5,4,9,2,TRUE
koapi,0.2.9,0.2.10,26,3,256,16,272,11,TRUE
koapi,0.2.74,0.2.76,90,4,49,6,55,7,TRUE
koapi,0.1.15,0.2.0,16,2,270,476,746,17,TRUE
koapi,0.2.0,0.2.1,17,2,5,3,8,2,TRUE
koapi,0.2.4,0.2.5,21,4,23,5,28,6,TRUE
koapi,0.2.37,0.2.38,54,2,17,36,53,4,TRUE
koapi,0.2.38,0.2.39,55,2,21,9,30,5,TRUE
koapi,0.2.15,0.2.16,32,2,30,27,57,3,TRUE
tiny.js,0.1.8,0.2.0,11,17,243,43,286,37,FALSE
tiny.js,0.2.3,0.2.4,15,8,35,28,63,12,FALSE
tiny.js,0.2.2,0.2.3,14,3,15,8,23,6,FALSE
tiny.js,0.2.1,0.2.2,13,3,21,7,28,8,FALSE
tiny.js,0.2.0,0.2.1,12,5,157,27,184,8,FALSE
tiny.js,0.1.3,0.1.4,6,4,80,26,106,12,FALSE
tiny.js,0.1.4,0.1.5,7,7,457,165,622,15,FALSE
tiny.js,0.1.5,0.1.6,8,5,424,138,562,17,FALSE
tiny.js,0.1.6,0.1.7,9,6,3316,3622,6938,22,FALSE
tiny.js,0.1.7,0.1.8,10,3,38,38,76,8,FALSE
tiny.js,0.0.5,0.0.6,2,4,102,34,136,10,FALSE
tiny.js,0.0.4,0.0.5,1,6,5189,61,5250,56,FALSE
tiny.js,0.0.6,0.1.1,3,8,393,73,466,17,FALSE
tiny.js,0.1.1,0.1.2,4,3,50,8,58,12,FALSE
tiny.js,0.1.2,0.1.3,5,3,512,738,1250,17,FALSE
tiny.js,0.1.3,0.1.4,6,4,80,26,106,12,TRUE
tiny.js,0.1.5,0.1.6,8,5,424,138,562,17,TRUE
tiny.js,0.0.6,0.1.1,3,8,393,73,466,17,TRUE
tiny.js,0.2.2,0.2.3,14,3,15,8,23,6,TRUE
tiny.js,0.1.1,0.1.2,4,3,50,8,58,12,TRUE
react-image-crop-component,0.2.3,0.2.4,21,2,2,2,4,2,FALSE
react-image-crop-component,0.2.2,0.2.3,20,22,23202,22200,45402,22,FALSE
react-image-crop-component,0.1.6,0.1.7,16,1,7,5,12,1,FALSE
react-image-crop-component,0.0.5,0.0.6,5,1,2,2,4,1,TRUE
react-image-crop-component,0.0.4,0.0.5,4,2,1,36,37,2,FALSE
react-image-crop-component,0.0.7,0.0.8,7,4,29,22,51,4,FALSE
react-image-crop-component,0.0.6,0.0.7,6,1,16,2,18,1,FALSE
react-image-crop-component,0.0.1,0.0.2,1,1,7,5,12,1,FALSE
react-image-crop-component,0.0.3,0.0.4,3,1,7,5,12,1,FALSE
react-image-crop-component,0.0.2,0.0.3,2,1,7,5,12,1,FALSE
react-image-crop-component,0.0.9,0.1.0,9,3,4,4,8,3,FALSE
react-image-crop-component,0.0.8,0.0.9,8,1,1,1,2,1,FALSE
react-image-crop-component,0.0.5,0.0.6,5,1,2,2,4,1,FALSE
react-image-crop-component,0.1.1,0.1.2,11,1,7,5,12,1,FALSE
react-image-crop-component,0.1.2,0.1.3,12,9,522,46,568,17,FALSE
react-image-crop-component,0.1.3,0.1.4,13,2,3,3,6,3,FALSE
react-image-crop-component,0.1.4,0.1.5,14,2,3,3,6,3,FALSE
exceljs,0.1.8,0.1.9,18,3,122,25,147,15,FALSE
exceljs,0.1.9,0.1.10,19,10,984,157,1141,23,FALSE
exceljs,0.2.4,0.2.5,26,13,10478,8909,19387,170,FALSE
exceljs,0.2.3,0.2.4,25,28,5428,3715,9143,94,FALSE
exceljs,0.2.2,0.2.3,24,2,284,129,413,6,FALSE
exceljs,0.2.1,0.2.2,23,1,1,1,2,1,FALSE
exceljs,0.2.0,0.2.1,22,2,140,67,207,6,FALSE
exceljs,0.1.0,0.1.1,10,4,676,212,888,28,FALSE
exceljs,0.1.1,0.1.2,11,1,164,15,179,17,FALSE
exceljs,0.1.2,0.1.3,12,2,676,306,982,19,FALSE
exceljs,0.1.3,0.1.4,13,1,993,160,1153,16,FALSE
exceljs,0.1.4,0.1.5,14,1,3,3,6,2,FALSE
exceljs,0.1.5,0.1.6,15,1,798,125,923,11,FALSE
exceljs,0.1.6,0.1.7,16,1,14,6,20,2,FALSE
exceljs,0.1.7,0.1.8,17,2,3,2,5,3,FALSE
exceljs,0.0.5,0.0.6,5,1,21,54,75,2,FALSE
exceljs,0.0.4,0.0.5,4,1,4,1,5,1,FALSE
exceljs,0.0.7,0.0.8,7,1,315,48,363,7,FALSE
exceljs,0.0.6,0.0.7,6,4,8,8,16,5,FALSE
exceljs,0.0.1,0.0.2,1,2,35,5,40,3,FALSE
exceljs,0.0.3,0.0.4,3,1,127,30,157,5,FALSE
exceljs,0.0.2,0.0.3,2,1,13,3,16,2,FALSE
exceljs,0.0.9,0.1.0,9,1,1062,329,1391,18,FALSE
exceljs,0.0.8,0.0.9,8,1,175,41,216,6,FALSE
exceljs,0.1.10,0.1.11,20,3,791,189,980,21,FALSE
exceljs,0.1.11,0.2.0,21,14,4572,1276,5848,102,FALSE
exceljs,0.2.26,0.2.27,48,4,281,247,528,12,FALSE
exceljs,0.2.27,0.2.28,49,5,135,66,201,20,FALSE
exceljs,0.2.37,0.2.38,59,12,294,65,359,35,FALSE
exceljs,0.2.25,0.2.26,47,4,41,8,49,7,FALSE
exceljs,0.2.31,0.2.32,53,7,56,9,65,16,FALSE
exceljs,0.2.30,0.2.31,52,4,59,21,80,9,FALSE
exceljs,0.2.33,0.2.34,55,3,44,7,51,9,FALSE
exceljs,0.2.32,0.2.33,54,6,174,99,273,14,TRUE
exceljs,0.2.39,0.2.40,61,12,829,330,1159,48,FALSE
exceljs,0.2.38,0.2.39,60,10,1088,58,1146,46,FALSE
exceljs,0.2.28,0.2.29,50,5,14,17,31,10,FALSE
exceljs,0.2.29,0.2.30,51,4,473,52,525,25,FALSE
exceljs,0.2.36,0.2.37,58,19,813,898,1711,69,FALSE
exceljs,0.2.40,0.2.41,62,1,1,1,2,1,FALSE
exceljs,0.2.41,0.2.42,63,2,58,135,193,8,FALSE
exceljs,0.2.42,0.2.43,64,4,68,26,94,9,FALSE
exceljs,0.2.34,0.2.35,56,1,464,328,792,9,FALSE
exceljs,0.2.35,0.2.36,57,4,138,148,286,10,FALSE
exceljs,0.2.24,0.2.25,46,4,1317,708,2025,74,FALSE
exceljs,0.2.22,0.2.23,44,2,81,28,109,8,FALSE
exceljs,0.2.23,0.2.24,45,3,67,12,79,8,FALSE
exceljs,0.2.20,0.2.21,42,4,25,16,41,8,FALSE
exceljs,0.2.21,0.2.22,43,2,12,5,17,3,FALSE
exceljs,0.2.7,0.2.8,29,17,3957,2395,6352,92,FALSE
exceljs,0.2.6,0.2.7,28,15,1832,626,2458,65,FALSE
exceljs,0.2.5,0.2.6,27,2,5,5,10,4,FALSE
exceljs,0.2.9,0.2.10,31,8,7012,3159,10171,216,FALSE
exceljs,0.2.8,0.2.9,30,14,446,86,532,36,FALSE
exceljs,0.2.19,0.2.20,41,1,78,9,87,5,FALSE
exceljs,0.3.0,0.3.1,69,12,374,382,756,47,FALSE
exceljs,0.2.32,0.2.33,54,6,174,99,273,14,FALSE
exceljs,0.4.9,0.4.10,80,7,208,70,278,20,FALSE
exceljs,0.4.8,0.4.9,79,1,1,1,2,1,FALSE
exceljs,0.4.1,0.4.2,72,4,392,54,446,14,FALSE
exceljs,0.4.0,0.4.1,71,4,46,31,77,11,FALSE
exceljs,0.4.3,0.4.4,74,11,1690,1037,2727,75,FALSE
exceljs,0.4.2,0.4.3,73,15,5546,2818,8364,273,FALSE
exceljs,0.4.5,0.4.6,76,1,3,3,6,2,FALSE
exceljs,0.4.4,0.4.5,75,12,5521,5495,11016,364,FALSE
exceljs,0.4.7,0.4.8,78,7,312,408,720,148,FALSE
exceljs,0.4.6,0.4.7,77,9,5202,5563,10765,471,FALSE
exceljs,0.2.18,0.2.19,40,4,100,21,121,10,FALSE
exceljs,0.2.17,0.2.18,39,5,32,5,37,6,FALSE
exceljs,0.2.16,0.2.17,38,2,360,82,442,11,FALSE
exceljs,0.2.15,0.2.16,37,2,90,43,133,7,FALSE
exceljs,0.2.14,0.2.15,36,9,1961,1441,3402,103,FALSE
exceljs,0.2.11,0.2.12,33,5,1086,195,1281,89,FALSE
exceljs,0.2.12,0.2.13,34,3,51,12,63,10,FALSE
exceljs,0.2.10,0.2.11,32,3,961,505,1466,41,FALSE
exceljs,0.3.1,0.4.0,70,6,726,356,1082,25,FALSE
exceljs,0.2.44,0.2.45,66,3,75,7,82,4,FALSE
exceljs,0.2.45,0.2.46,67,4,62,17,79,10,FALSE
exceljs,0.2.46,0.3.0,68,4,447,62,509,20,FALSE
exceljs,0.2.43,0.2.44,65,3,395,516,911,83,FALSE
exceljs,0.2.13,0.2.14,35,3,1022,405,1427,37,FALSE
exceljs,0.1.2,0.1.3,12,2,676,306,982,19,TRUE
exceljs,0.0.6,0.0.7,6,4,8,8,16,5,TRUE
exceljs,0.0.9,0.1.0,9,1,1062,329,1391,18,TRUE
exceljs,0.0.8,0.0.9,8,1,175,41,216,6,TRUE
exceljs,0.2.17,0.2.18,39,5,32,5,37,6,TRUE
exceljs,0.1.11,0.2.0,21,14,4572,1276,5848,102,TRUE
exceljs,0.2.30,0.2.31,52,4,59,21,80,9,TRUE
exceljs,0.2.26,0.2.27,48,4,281,247,528,12,TRUE
exceljs,0.2.25,0.2.26,47,4,41,8,49,7,TRUE
exceljs,0.4.6,0.4.7,77,9,5202,5563,10765,471,TRUE
exceljs,0.2.13,0.2.14,35,3,1022,405,1427,37,TRUE
exceljs,0.3.0,0.3.1,69,12,374,382,756,47,TRUE
exceljs,0.2.34,0.2.35,56,1,464,328,792,9,TRUE
element-size-reporter,0.3.8,0.3.9,7,1,4,4,8,1,TRUE
element-size-reporter,0.3.9,0.3.11,8,7,17,21,38,8,FALSE
element-size-reporter,0.3.2,0.3.4,2,2,2,2,4,2,FALSE
element-size-reporter,0.3.1,0.3.2,1,1,2,2,4,1,FALSE
element-size-reporter,0.3.6,0.3.7,5,3,21,19,40,4,FALSE
element-size-reporter,0.3.7,0.3.8,6,1,4,4,8,1,FALSE
element-size-reporter,0.3.4,0.3.5,3,1,21,17,38,2,TRUE
element-size-reporter,0.3.5,0.3.6,4,1,4,5,9,1,FALSE
element-size-reporter,0.4.1,0.4.2,14,5,9,6,15,6,FALSE
element-size-reporter,0.3.14,0.3.15,12,1,2,2,4,1,FALSE
element-size-reporter,0.3.15,0.4.1,13,3,47,22,69,5,FALSE
element-size-reporter,0.4.3,0.4.4,16,2,9,2,11,3,FALSE
element-size-reporter,0.4.2,0.4.3,15,1,2,2,4,1,FALSE
element-size-reporter,0.3.11,0.3.12,9,1,2,2,4,1,FALSE
element-size-reporter,0.3.12,0.3.13,10,1,17,14,31,3,FALSE
element-size-reporter,0.3.13,0.3.14,11,1,5,5,10,5,FALSE
element-size-reporter,0.3.8,0.3.9,7,1,4,4,8,1,FALSE
element-size-reporter,0.3.4,0.3.5,3,1,21,17,38,2,FALSE
element-size-reporter,0.3.14,0.3.15,12,1,2,2,4,1,TRUE
element-size-reporter,0.3.1,0.3.2,1,1,2,2,4,1,TRUE
element-size-reporter,0.3.2,0.3.4,2,2,2,2,4,2,TRUE
element-size-reporter,0.4.1,0.4.2,14,5,9,6,15,6,TRUE
element-size-reporter,0.3.15,0.4.1,13,3,47,22,69,5,TRUE
element-size-reporter,0.3.12,0.3.13,10,1,17,14,31,3,TRUE
mea-builder,0.0.5,0.0.6,5,1,22,4,26,6,FALSE
mea-builder,0.0.4,0.0.5,4,1,0,1422,1422,14,FALSE
mea-builder,0.0.7,0.0.8,7,2,15,9,24,4,FALSE
mea-builder,0.0.6,0.0.7,6,1,22,4,26,6,FALSE
mea-builder,0.0.1,0.0.2,1,1,1556,178,1734,20,FALSE
mea-builder,0.0.3,0.0.4,3,3,268,346,614,13,FALSE
mea-builder,0.0.2,0.0.3,2,1,4,2,6,2,FALSE
mea-builder,0.0.14,0.0.15,13,1,5,6,11,2,FALSE
mea-builder,0.0.8,0.0.10,8,3,84,41,125,10,FALSE
mea-builder,0.0.15,0.0.16,14,1,0,1422,1422,14,FALSE
mea-builder,0.0.17,0.0.18,16,1,0,1422,1422,14,FALSE
mea-builder,0.0.16,0.0.17,15,2,180,401,581,9,FALSE
mea-builder,0.0.11,0.0.12,10,1,101,58,159,4,FALSE
mea-builder,0.0.10,0.0.11,9,1,69,41,110,6,FALSE
mea-builder,0.0.13,0.0.14,12,3,249,121,370,15,FALSE
mea-builder,0.0.12,0.0.13,11,1,7,4,11,4,FALSE
mea-builder,0.0.19,0.0.21,18,3,150,21929,22079,35,FALSE
mea-builder,0.0.18,0.0.19,17,1,34,16,50,4,FALSE
mea-builder,0.0.13,0.0.14,12,3,249,121,370,15,TRUE
mea-builder,0.0.7,0.0.8,7,2,15,9,24,4,TRUE
weex-rx-framework,0.1.12,0.1.13,28,1,435,435,870,105,FALSE
weex-rx-framework,0.1.10,0.1.11,26,1,435,435,870,105,FALSE
weex-rx-framework,0.1.11,0.1.12,27,1,435,435,870,105,FALSE
weex-rx-framework,0.1.3-beta,0.1.3-beta2,15,1,435,435,870,105,FALSE
weex-rx-framework,0.1.0-beta,0.1.0-beta2,10,1,435,435,870,105,FALSE
weex-rx-framework,0.1.8,0.1.9,24,1,435,435,870,105,FALSE
weex-rx-framework,0.1.9,0.1.10,25,1,435,435,870,105,FALSE
weex-rx-framework,0.1.0,0.1.1,12,1,435,435,870,105,FALSE
weex-rx-framework,0.1.7,0.1.8,23,1,435,435,870,105,TRUE
weex-rx-framework,0.1.6,0.1.7,22,1,435,435,870,105,FALSE
weex-rx-framework,0.1.3-beta4,0.1.3,18,1,435,435,870,105,FALSE
weex-rx-framework,0.1.1,0.1.2,13,1,435,435,870,105,FALSE
weex-rx-framework,0.1.2,0.1.3-beta,14,1,435,435,870,105,FALSE
weex-rx-framework,0.1.3,0.1.4,19,1,435,435,870,105,FALSE
weex-rx-framework,0.1.4,0.1.5,20,1,435,435,870,105,FALSE
weex-rx-framework,0.1.5,0.1.6,21,1,435,435,870,105,FALSE
weex-rx-framework,0.1.3-beta2,0.1.3-beta3,16,1,435,435,870,105,FALSE
weex-rx-framework,0.1.3-beta3,0.1.3-beta4,17,1,435,435,870,105,FALSE
weex-rx-framework,0.1.12,0.1.13,28,1,435,435,870,105,TRUE
weex-rx-framework,0.1.7,0.1.8,23,1,435,435,870,105,FALSE
weex-rx-framework,0.2.4,0.3.0,34,2,331,313,644,19,FALSE
weex-rx-framework,0.2.3,0.2.4,33,18,2628,1408,4036,82,FALSE
weex-rx-framework,0.2.2,0.2.3,32,1,2,2,4,1,FALSE
weex-rx-framework,0.2.1,0.2.2,31,1,1,1,2,1,FALSE
weex-rx-framework,0.2.0,0.2.1,30,2,70,9,79,4,FALSE
weex-rx-framework,0.0.5,0.0.6,5,1,435,435,870,105,FALSE
weex-rx-framework,0.0.4,0.0.5,4,1,435,435,870,105,FALSE
weex-rx-framework,0.0.7,0.0.8,7,1,435,435,870,105,FALSE
weex-rx-framework,0.0.6,0.0.7,6,1,435,435,870,105,FALSE
weex-rx-framework,0.0.3,0.0.4,3,1,435,435,870,105,FALSE
weex-rx-framework,0.0.2,0.0.3,2,1,435,435,870,105,FALSE
weex-rx-framework,0.3.0,0.3.1,35,3,211,117,328,13,FALSE
weex-rx-framework,0.0.9,0.1.0-beta,9,1,435,435,870,105,FALSE
weex-rx-framework,0.0.8,0.0.9,8,1,435,435,870,105,FALSE
weex-rx-framework,0.1.13,0.2.0,29,129,31369,8720,40089,1067,FALSE
generator-teams-tab,0.4.11,0.4.13,11,7,514,275,789,39,FALSE
generator-teams-tab,0.4.10,0.4.11,10,1,84,15,99,6,FALSE
generator-teams-tab,0.4.8,0.4.10,9,2,925,327,1252,45,FALSE
generator-teams-tab,0.4.1,0.4.2,2,1,2,6,8,4,FALSE
generator-teams-tab,0.4.0,0.4.1,1,1,55,512,567,13,FALSE
generator-teams-tab,0.4.3,0.4.4,4,2,144,67,211,36,FALSE
generator-teams-tab,0.4.2,0.4.3,3,1,17,3,20,4,FALSE
generator-teams-tab,0.4.5,0.4.6,6,2,27,15,42,5,FALSE
generator-teams-tab,0.4.4,0.4.5,5,2,14,7,21,10,FALSE
generator-teams-tab,0.4.7,0.4.8,8,7,56,37,93,12,FALSE
generator-teams-tab,0.4.6,0.4.7,7,1,99,44,143,5,FALSE
generator-teams-tab,0.4.6,0.4.7,7,1,99,44,143,5,TRUE
generator-teams-tab,0.4.11,0.4.13,11,7,514,275,789,39,TRUE
generator-teams-tab,0.4.7,0.4.8,8,7,56,37,93,12,TRUE
kscli,1.0.4,1.0.5,5,2,679,295,974,8,FALSE
kscli,1.0.5,1.0.6,6,2,321,81,402,9,FALSE
kscli,1.0.6,1.0.7,7,2,316,131,447,7,FALSE
kscli,1.0.7,1.0.8,8,1,313,128,441,4,FALSE
kscli,1.0.1,1.0.2,2,1,1,1,2,1,FALSE
kscli,1.0.2,1.0.3,3,1,26,9,35,3,FALSE
kscli,1.0.3,1.0.4,4,1,313,128,441,4,FALSE
kscli,1.0.7,1.0.8,8,1,313,128,441,4,TRUE
kscli,1.0.0,1.0.1,1,6,867,97,964,22,FALSE
kscli,1.0.2,1.0.3,3,1,26,9,35,3,TRUE
kscli,1.0.3,1.0.4,4,1,313,128,441,4,TRUE
electrode-redux-router-engine,1.1.0,1.2.0,3,2,33,2,35,4,FALSE
electrode-redux-router-engine,1.0.0,1.0.1,1,12,64,38,102,16,FALSE
electrode-redux-router-engine,1.0.1,1.1.0,2,65,680,339,1019,106,FALSE
electrode-redux-router-engine,1.2.6,1.2.7,10,21,1090,920,2010,81,FALSE
electrode-redux-router-engine,1.2.7,1.2.8,11,205,111738,5378,117116,1236,FALSE
electrode-redux-router-engine,1.2.4,1.2.5,8,118,27423,2732,30155,446,FALSE
electrode-redux-router-engine,1.2.5,1.2.6,9,17,6991,81,7072,145,FALSE
electrode-redux-router-engine,1.2.2,1.2.3,6,58,72644,1161,73805,266,FALSE
electrode-redux-router-engine,1.2.3,1.2.4,7,112,30517,16052,46569,257,FALSE
electrode-redux-router-engine,1.2.0,1.2.1,4,56,1336,371,1707,95,FALSE
electrode-redux-router-engine,1.2.1,1.2.2,5,3,4,4,8,3,FALSE
electrode-redux-router-engine,1.3.0,1.4.0,13,6,116,62,178,19,FALSE
electrode-redux-router-engine,1.2.8,1.3.0,12,28,1755,1560,3315,152,FALSE
electrode-redux-router-engine,1.2.4,1.2.5,8,118,27423,2732,30155,446,TRUE
electrode-redux-router-engine,1.2.1,1.2.2,5,3,4,4,8,3,TRUE
node-snowmix,0.0.5,0.0.6,5,1,37,7,44,7,FALSE
node-snowmix,0.0.4,0.0.5,4,1,311,208,519,24,FALSE
node-snowmix,0.0.7,0.0.8,7,2,725,784,1509,31,FALSE
node-snowmix,0.0.6,0.0.7,6,2,1556,214,1770,56,FALSE
node-snowmix,0.0.1,0.0.2,1,2,72,2,74,5,FALSE
node-snowmix,0.0.3,0.0.4,3,1,167,63,230,17,FALSE
node-snowmix,0.0.2,0.0.3,2,1,407,84,491,23,FALSE
node-snowmix,0.0.9,0.1.0,9,8,1797,454,2251,133,FALSE
node-snowmix,0.0.8,0.0.9,8,6,1297,994,2291,54,FALSE
node-snowmix,0.1.0,0.1.1,10,5,200,53,253,31,FALSE
node-snowmix,0.1.1,0.2.0,11,2,245,150,395,44,FALSE
node-snowmix,0.1.1,0.2.0,11,2,245,150,395,44,TRUE
aspnet-webpack-react,1.0.4,1.0.5,5,2,23,8,31,4,FALSE
aspnet-webpack-react,1.0.0,1.0.1,1,5,75,311,386,14,FALSE
aspnet-webpack-react,1.0.1,1.0.2,2,193,35300,4990,40290,1047,FALSE
aspnet-webpack-react,1.0.2,1.0.3,3,184,8399,46059,54458,671,FALSE
aspnet-webpack-react,1.0.3,1.0.4,4,96,3583,1840,5423,331,FALSE
aspnet-webpack-react,1.0.1,1.0.2,2,193,35300,4990,40290,1047,TRUE
aspnet-webpack-react,1.0.5,2.0.0,6,131,3526,4062,7588,471,FALSE
aspnet-webpack-react,1.0.5,2.0.0,6,131,3526,4062,7588,471,TRUE
aspnet-webpack-react,1.0.3,1.0.4,4,96,3583,1840,5423,331,TRUE
apeman-react-toggle,1.0.0,1.0.1,1,2,7,6,13,4,FALSE
apeman-react-toggle,1.0.1,2.0.0,2,2,2966,2738,5704,37,FALSE
apeman-react-toggle,2.0.0,2.0.1,3,2,4827,4288,9115,40,FALSE
apeman-react-toggle,2.0.5,3.0.0,8,2,257,364,621,30,FALSE
apeman-react-toggle,2.0.4,2.0.5,7,9,2870,9878,12748,41,FALSE
apeman-react-toggle,2.0.3,2.0.4,6,1,2708,6382,9090,11,FALSE
apeman-react-toggle,2.0.2,2.0.3,5,2,28,33,61,9,FALSE
apeman-react-toggle,3.0.0,3.0.1,9,1,2,2,4,2,FALSE
apeman-react-toggle,2.0.1,2.0.2,4,2,7487,4218,11705,39,FALSE
apeman-react-toggle,3.0.1,3.0.2,10,3,152,169,321,13,FALSE
apeman-react-toggle,3.0.1,3.0.2,10,3,152,169,321,13,TRUE
apeman-react-toggle,2.0.3,2.0.4,6,1,2708,6382,9090,11,TRUE
apeman-react-toggle,2.0.2,2.0.3,5,2,28,33,61,9,TRUE
apeman-react-toggle,1.0.1,2.0.0,2,2,2966,2738,5704,37,TRUE
vue-tk,0.3.8,0.3.9,45,1,112,101,213,14,FALSE
vue-tk,0.3.9,0.3.10,46,1,112,101,213,14,FALSE
vue-tk,0.3.3,0.3.4,40,1,112,101,213,14,FALSE
vue-tk,0.3.6,0.3.7,43,1,112,101,213,14,FALSE
vue-tk,0.3.7,0.3.8,44,1,112,101,213,14,FALSE
vue-tk,0.3.4,0.3.5,41,1,112,101,213,14,FALSE
vue-tk,0.3.5,0.3.6,42,1,112,101,213,14,FALSE
vue-tk,0.3.10,0.3.11,47,1,112,101,213,14,FALSE
vue-tk,0.3.11,0.3.12,48,1,112,101,213,14,FALSE
vue-tk,0.3.12,0.3.13,49,1,112,101,213,14,FALSE
vue-tk,0.3.13,0.3.14,50,1,112,101,213,14,FALSE
vue-tk,0.1.20,0.2.0,20,1,112,101,213,14,FALSE
vue-tk,0.2.7,0.2.8,28,1,112,101,213,14,FALSE
vue-tk,0.1.8,0.1.9,9,1,112,101,213,14,FALSE
vue-tk,0.1.9,0.1.10,10,1,112,101,213,14,FALSE
vue-tk,0.2.5,0.2.6,26,1,112,101,213,14,FALSE
vue-tk,0.2.4,0.2.5,25,1,112,101,213,14,FALSE
vue-tk,0.2.3,0.2.4,24,1,112,101,213,14,FALSE
vue-tk,0.2.2,0.2.3,23,1,112,101,213,14,FALSE
vue-tk,0.2.1,0.2.2,22,1,112,101,213,14,TRUE
vue-tk,0.2.0,0.2.1,21,1,112,101,213,14,TRUE
vue-tk,0.1.0,0.1.1,1,1,561,33725,34286,347,FALSE
vue-tk,0.1.1,0.1.2,2,1,112,101,213,14,FALSE
vue-tk,0.1.2,0.1.3,3,1,112,101,213,14,FALSE
vue-tk,0.1.3,0.1.4,4,1,112,101,213,14,FALSE
vue-tk,0.1.4,0.1.5,5,1,335,705,1040,21,FALSE
vue-tk,0.1.5,0.1.6,6,1,475,802,1277,23,FALSE
vue-tk,0.1.6,0.1.7,7,1,112,101,213,14,FALSE
vue-tk,0.1.7,0.1.8,8,1,189,216,405,4,FALSE
vue-tk,0.3.2,0.3.3,39,1,112,101,213,14,FALSE
vue-tk,0.3.0,0.3.1,37,1,112,101,213,14,FALSE
vue-tk,0.3.1,0.3.2,38,1,112,101,213,14,FALSE
vue-tk,0.2.9,0.2.10,30,1,112,101,213,14,FALSE
vue-tk,0.1.15,0.1.16,16,1,112,101,213,14,FALSE
vue-tk,0.2.8,0.2.9,29,1,112,101,213,14,FALSE
vue-tk,0.2.15,0.3.0,36,1,112,101,213,14,FALSE
vue-tk,0.2.14,0.2.15,35,1,112,101,213,14,FALSE
vue-tk,0.2.13,0.2.14,34,1,112,101,213,14,TRUE
vue-tk,0.2.12,0.2.13,33,1,112,101,213,14,FALSE
vue-tk,0.2.11,0.2.12,32,1,112,101,213,14,FALSE
vue-tk,0.2.10,0.2.11,31,1,112,101,213,14,FALSE
vue-tk,0.1.12,0.1.13,13,1,112,101,213,14,FALSE
vue-tk,0.1.13,0.1.14,14,1,112,101,213,14,FALSE
vue-tk,0.1.10,0.1.11,11,1,112,101,213,14,FALSE
vue-tk,0.1.11,0.1.12,12,2,1370,559,1929,38,FALSE
vue-tk,0.1.16,0.1.17,17,1,112,101,213,14,FALSE
vue-tk,0.1.17,0.1.19,18,1,112,101,213,14,FALSE
vue-tk,0.1.14,0.1.15,15,1,112,101,213,14,FALSE
vue-tk,0.2.6,0.2.7,27,1,112,101,213,14,FALSE
vue-tk,0.1.19,0.1.20,19,1,112,101,213,14,FALSE
vue-tk,0.2.1,0.2.2,22,1,112,101,213,14,FALSE
vue-tk,0.2.0,0.2.1,21,1,112,101,213,14,FALSE
vue-tk,0.2.13,0.2.14,34,1,112,101,213,14,FALSE
vue-tk,0.2.4,0.2.5,25,1,112,101,213,14,TRUE
vue-tk,0.3.0,0.3.1,37,1,112,101,213,14,TRUE
vue-tk,0.2.15,0.3.0,36,1,112,101,213,14,TRUE
vue-tk,0.3.1,0.3.2,38,1,112,101,213,14,TRUE
vue-tk,0.2.11,0.2.12,32,1,112,101,213,14,TRUE
vue-tk,0.2.5,0.2.6,26,1,112,101,213,14,TRUE
vue-tk,0.3.2,0.3.3,39,1,112,101,213,14,TRUE
vue-tk,0.2.8,0.2.9,29,1,112,101,213,14,TRUE
vue-tk,0.2.7,0.2.8,28,1,112,101,213,14,TRUE
vue-tk,0.1.17,0.1.19,18,1,112,101,213,14,TRUE
tungstenjs,0.15.0,0.15.1,31,5,86,9,95,9,FALSE
tungstenjs,0.15.1,0.16.0,32,10,6291,1387,7678,37,FALSE
tungstenjs,0.13.5,0.14.0,29,13,832,169,1001,56,FALSE
tungstenjs,0.14.0,0.15.0,30,23,67636,87,67723,141,FALSE
tungstenjs,0.13.4,0.13.5,28,4,88,34,122,9,FALSE
tungstenjs,0.12.2,0.13.0,24,3,13,14,27,7,FALSE
tungstenjs,0.12.1,0.12.2,23,2,25,3,28,3,FALSE
tungstenjs,0.16.0,0.18.1,33,7,152,12,164,15,FALSE
tungstenjs,0.18.1,0.18.2,34,3,23,16,39,4,FALSE
tungstenjs,0.18.2,0.18.3,35,2,9,2,11,2,FALSE
tungstenjs,0.13.3,0.13.4,27,19,1215,294,1509,84,FALSE
tungstenjs,0.13.0,0.13.1,25,3,1559,1548,3107,38,FALSE
tungstenjs,0.13.1,0.13.3,26,5,30,10,40,6,FALSE
tungstenjs,0.9.0,0.12.1,22,180,95870,8833,104703,861,FALSE
tungstenjs,0.8.8,0.9.0,21,45,3778,3167,6945,210,FALSE
tungstenjs,0.15.1,0.16.0,32,10,6291,1387,7678,37,TRUE
tungstenjs,0.15.0,0.15.1,31,5,86,9,95,9,TRUE
tungstenjs,0.5.18,0.6.1,19,29,8275,2521,10796,151,FALSE
tungstenjs,0.2.0,0.3.2,5,81,4591,1291,5882,269,FALSE
tungstenjs,0.1.1,0.1.2,2,2,4,8,12,3,FALSE
tungstenjs,0.5.14,0.5.18,18,57,27543,2439,29982,376,FALSE
tungstenjs,0.1.3,0.2.0,4,7,3745,1234,4979,134,FALSE
tungstenjs,0.1.2,0.1.3,3,4,101,24,125,11,FALSE
tungstenjs,0.5.11,0.5.14,17,51,4036,675,4711,141,FALSE
tungstenjs,0.3.2,0.3.3,6,3,302,234,536,8,FALSE
tungstenjs,0.3.3,0.3.4,7,35,14859,1818,16677,239,FALSE
tungstenjs,0.6.1,0.8.8,20,360,43095,54487,97582,1841,FALSE
tungstenjs,0.3.6,0.4.0,9,22,800,586,1386,79,FALSE
tungstenjs,0.3.4,0.3.6,8,28,9665,1227,10892,191,FALSE
tungstenjs,0.5.8,0.5.11,16,25,1175,267,1442,72,FALSE
tungstenjs,0.4.1,0.5.0,11,81,19303,2806,22109,352,TRUE
tungstenjs,0.4.0,0.4.1,10,4,68,28,96,6,FALSE
tungstenjs,0.5.0,0.5.1,12,8,14494,686,15180,99,FALSE
tungstenjs,0.5.6,0.5.8,15,108,25170,2832,28002,683,FALSE
tungstenjs,0.5.1,0.5.3,13,56,10262,8262,18524,332,FALSE
tungstenjs,0.5.3,0.5.6,14,32,2037,343,2380,126,FALSE
tungstenjs,0.4.1,0.5.0,11,81,19303,2806,22109,352,FALSE
tungstenjs,0.5.8,0.5.11,16,25,1175,267,1442,72,TRUE
tungstenjs,0.13.4,0.13.5,28,4,88,34,122,9,TRUE
tungstenjs,0.1.1,0.1.2,2,2,4,8,12,3,TRUE
tungstenjs,0.5.18,0.6.1,19,29,8275,2521,10796,151,TRUE
tungstenjs,0.1.3,0.2.0,4,7,3745,1234,4979,134,TRUE
tungstenjs,0.5.11,0.5.14,17,51,4036,675,4711,141,TRUE
tungstenjs,0.14.0,0.15.0,30,23,67636,87,67723,141,TRUE
nokitjs,1.0.0,1.12.8,1,1,4,4,8,4,FALSE
nokitjs,1.19.8,1.20.0,70,6,1152,362,1514,112,FALSE
nokitjs,1.19.3,1.19.4,65,2,159,131,290,44,FALSE
nokitjs,1.19.2,1.19.3,64,2,170,130,300,44,FALSE
nokitjs,1.19.1,1.19.2,63,2,42,20,62,19,FALSE
nokitjs,1.19.0,1.19.1,62,2,60,24,84,23,FALSE
nokitjs,1.19.7,1.19.8,69,1,18,18,36,8,FALSE
nokitjs,1.19.6,1.19.7,68,1,27,18,45,10,FALSE
nokitjs,1.19.5,1.19.6,67,2,37,27,64,19,FALSE
nokitjs,1.19.4,1.19.5,66,2,21,20,41,18,FALSE
nokitjs,1.18.6,1.18.7,58,2,12,10,22,9,FALSE
nokitjs,1.18.7,1.18.8,59,1,38,18,56,11,FALSE
nokitjs,1.18.4,1.18.5,56,14,114,165,279,41,FALSE
nokitjs,1.18.5,1.18.6,57,5,329,233,562,22,FALSE
nokitjs,1.18.2,1.18.3,54,7,98,66,164,30,FALSE
nokitjs,1.18.3,1.18.4,55,2,39,28,67,21,FALSE
nokitjs,1.18.0,1.18.1,52,1,22,25,47,9,FALSE
nokitjs,1.18.1,1.18.2,53,1,9,9,18,9,FALSE
nokitjs,1.18.8,1.18.9,60,1,16,9,25,9,FALSE
nokitjs,1.18.9,1.19.0,61,2,462,362,824,40,FALSE
nokitjs,1.12.8,1.12.9,2,3,99,39,138,18,FALSE
nokitjs,1.12.9,1.13.0,3,3,9,6,15,7,FALSE
nokitjs,1.16.0,1.16.1,34,2,49,46,95,13,FALSE
nokitjs,1.16.1,1.16.2,35,8,176,134,310,23,FALSE
nokitjs,1.16.2,1.16.3,36,5,142,81,223,25,FALSE
nokitjs,1.16.3,1.16.4,37,1,62,66,128,9,FALSE
nokitjs,1.16.4,1.16.6,38,3,2231,78,2309,19,FALSE
nokitjs,1.16.6,1.16.7,39,3,191,146,337,53,FALSE
nokitjs,1.16.7,1.16.8,40,5,129,119,248,29,FALSE
nokitjs,1.16.8,1.16.9,41,3,112,111,223,15,FALSE
nokitjs,1.16.9,1.17.0,42,5,148,129,277,27,FALSE
nokitjs,1.17.1,1.17.2,44,5,167,75,242,45,FALSE
nokitjs,1.14.2,1.14.3,16,1,8,7,15,5,FALSE
nokitjs,1.14.3,1.14.4,17,2,8,7,15,7,FALSE
nokitjs,1.14.0,1.14.1,14,2,91,15,106,10,FALSE
nokitjs,1.14.1,1.14.2,15,1,7,6,13,6,FALSE
nokitjs,1.14.6,1.14.7,20,4,32,10,42,11,FALSE
nokitjs,1.14.7,1.14.8,21,2,117,48,165,13,FALSE
nokitjs,1.14.4,1.14.5,18,2,28,12,40,8,FALSE
nokitjs,1.14.5,1.14.6,19,1,8,7,15,7,FALSE
nokitjs,1.14.8,1.14.9,22,1,7,7,14,6,FALSE
nokitjs,1.14.9,1.15.0,23,1,9,6,15,6,FALSE
nokitjs,1.21.0-alpha.4,1.21.0,77,8,10090,9984,20074,286,FALSE
nokitjs,1.21.0-alpha.3,1.21.0-alpha.4,76,3,1224,1110,2334,82,FALSE
nokitjs,1.21.0-alpha.2,1.21.0-alpha.3,75,1,18,18,36,8,FALSE
nokitjs,1.21.0-alpha.1,1.21.0-alpha.2,74,1,18,18,36,8,FALSE
nokitjs,1.15.6,1.15.7,30,2,218,162,380,20,FALSE
nokitjs,1.21.2,1.21.3,81,1,18,18,36,8,FALSE
nokitjs,1.21.3,1.22.0,82,2,312,174,486,52,FALSE
nokitjs,1.21.0,1.21.1-beta1,78,1,8,8,16,8,FALSE
nokitjs,1.21.1,1.21.2,80,2,78,50,128,18,FALSE
nokitjs,1.13.1,1.13.2,5,1,14,14,28,9,FALSE
nokitjs,1.13.0,1.13.1,4,2,51,30,81,19,FALSE
nokitjs,1.13.3,1.13.4,7,2,6,6,12,6,FALSE
nokitjs,1.13.2,1.13.3,6,1,7,7,14,6,FALSE
nokitjs,1.13.5,1.13.6,9,6,67,26,93,14,FALSE
nokitjs,1.13.4,1.13.5,8,2,15,19,34,7,FALSE
nokitjs,1.13.7,1.13.8,11,1,6,6,12,6,FALSE
nokitjs,1.13.6,1.13.7,10,4,60,35,95,16,FALSE
nokitjs,1.13.9,1.14.0,13,2,43,7,50,6,FALSE
nokitjs,1.13.8,1.13.9,12,1,8,6,14,7,FALSE
nokitjs,1.25.6,1.25.7,109,1,91,86,177,13,FALSE
nokitjs,1.25.7,1.25.8,110,2,110,105,215,24,FALSE
nokitjs,1.25.4,1.25.5,107,1,18,18,36,8,FALSE
nokitjs,1.25.5,1.25.6,108,2,764,1566,2330,96,FALSE
nokitjs,1.25.2,1.25.3,105,1,11,8,19,8,FALSE
nokitjs,1.25.3,1.25.4,106,1,11,8,19,8,FALSE
nokitjs,1.25.0,1.25.1,103,5,1710,1758,3468,209,FALSE
nokitjs,1.25.1,1.25.2,104,3,24,24,48,22,FALSE
nokitjs,1.17.9,1.18.0,51,3,131,33,164,26,FALSE
nokitjs,1.17.8,1.17.9,50,3,194,34,228,29,FALSE
nokitjs,1.25.8,1.25.9,111,2,124,124,248,21,FALSE
nokitjs,1.25.9,1.26.0,112,2,158,154,312,20,FALSE
nokitjs,1.15.7,1.15.8,31,2,26,28,54,18,FALSE
nokitjs,1.21.1-beta1,1.21.1,79,2,288,172,460,30,FALSE
nokitjs,1.15.5,1.15.6,29,4,123,47,170,23,FALSE
nokitjs,1.15.4,1.15.5,28,3,293,174,467,41,FALSE
nokitjs,1.15.3,1.15.4,27,1,47,18,65,13,FALSE
nokitjs,1.15.2,1.15.3,26,1,14,8,22,9,FALSE
nokitjs,1.15.1,1.15.2,25,1,9,9,18,9,FALSE
nokitjs,1.15.0,1.15.1,24,4,105,79,184,19,FALSE
nokitjs,1.15.9,1.16.0,33,1,16,12,28,10,FALSE
nokitjs,1.15.8,1.15.9,32,2,46,22,68,20,FALSE
nokitjs,1.23.0,1.23.1,93,3,186,184,370,19,FALSE
nokitjs,1.23.1,1.23.2,94,1,10,13,23,9,FALSE
nokitjs,1.23.2,1.23.3,95,2,43,40,83,19,FALSE
nokitjs,1.23.3,1.24.0,96,2,386,288,674,32,FALSE
nokitjs,1.20.2,1.21.0-alpha.1,73,1,18,18,36,8,FALSE
nokitjs,1.20.1,1.20.2,72,2,216,230,446,24,FALSE
nokitjs,1.20.0,1.20.1,71,3,160,42,202,30,FALSE
nokitjs,1.26.1,1.26.2,114,2,20,20,40,15,FALSE
nokitjs,1.26.0,1.26.1,113,2,61,57,118,18,FALSE
nokitjs,1.26.2,1.26.3,115,1,18,18,36,8,FALSE
nokitjs,1.17.4,1.17.6,47,19,1684,303,1987,170,TRUE
nokitjs,1.24.3,1.24.4,100,2,64,45,109,19,FALSE
nokitjs,1.24.2,1.24.3,99,1,45,33,78,10,FALSE
nokitjs,1.24.1,1.24.2,98,2,22,19,41,16,FALSE
nokitjs,1.24.0,1.24.1,97,1,13,10,23,8,FALSE
nokitjs,1.17.7,1.17.8,49,2,348,175,523,42,FALSE
nokitjs,1.24.5,1.25.0,102,1,12,9,21,10,FALSE
nokitjs,1.24.4,1.24.5,101,2,29,19,48,19,FALSE
nokitjs,1.17.6,1.17.7,48,8,544,200,744,66,FALSE
nokitjs,1.22.9,1.23.0,92,2,24,18,42,18,FALSE
nokitjs,1.22.8,1.22.9,91,2,30,22,52,22,FALSE
nokitjs,1.22.5,1.22.6,88,1,451,391,842,27,FALSE
nokitjs,1.22.4,1.22.5,87,2,264,122,386,36,FALSE
nokitjs,1.22.7,1.22.8,90,2,52,24,76,20,FALSE
nokitjs,1.22.6,1.22.7,89,3,467,407,874,41,FALSE
nokitjs,1.22.1,1.22.2,84,2,458,902,1360,42,FALSE
nokitjs,1.22.0,1.22.1,83,2,44,40,84,18,FALSE
nokitjs,1.22.3,1.22.4,86,2,40,38,78,20,FALSE
nokitjs,1.22.2,1.22.3,85,2,148,24,172,26,FALSE
nokitjs,1.17.3,1.17.4,46,2,130,123,253,21,FALSE
nokitjs,1.17.2,1.17.3,45,2,91,85,176,21,FALSE
nokitjs,1.17.0,1.17.1,43,5,192,82,274,56,FALSE
nokitjs,1.17.4,1.17.6,47,19,1684,303,1987,170,FALSE
nokitjs,1.19.6,1.19.7,68,1,27,18,45,10,TRUE
nokitjs,1.16.4,1.16.6,38,3,2231,78,2309,19,TRUE
nokitjs,1.13.9,1.14.0,13,2,43,7,50,6,TRUE
nokitjs,1.25.9,1.26.0,112,2,158,154,312,20,TRUE
nokitjs,1.15.3,1.15.4,27,1,47,18,65,13,TRUE
nokitjs,1.24.0,1.24.1,97,1,13,10,23,8,TRUE
nokitjs,1.19.3,1.19.4,65,2,159,131,290,44,TRUE
nokitjs,1.25.5,1.25.6,108,2,764,1566,2330,96,TRUE
nokitjs,1.18.2,1.18.3,54,7,98,66,164,30,TRUE
nokitjs,1.23.3,1.24.0,96,2,386,288,674,32,TRUE
nokitjs,1.26.0,1.26.1,113,2,61,57,118,18,TRUE
nokitjs,1.14.7,1.14.8,21,2,117,48,165,13,TRUE
nokitjs,1.13.4,1.13.5,8,2,15,19,34,7,TRUE
electrode-react-webapp,1.4.0,1.4.1,8,35,1273,636,1909,135,FALSE
electrode-react-webapp,1.1.0,1.2.0,4,54,5652,1752,7404,204,FALSE
electrode-react-webapp,1.4.2,1.5.0,10,28,1755,1560,3315,152,FALSE
electrode-react-webapp,1.0.1,1.0.2,1,3,135,110,245,7,FALSE
electrode-react-webapp,1.0.2,1.0.3,2,98,1935,604,2539,161,FALSE
electrode-react-webapp,1.4.1,1.4.2,9,79,105507,2421,107928,557,FALSE
electrode-react-webapp,1.0.3,1.1.0,3,275,125133,18344,143477,829,FALSE
electrode-react-webapp,1.3.0,1.4.0,7,72,4086,2066,6152,485,FALSE
electrode-react-webapp,1.2.0,1.2.1,5,17,6991,81,7072,145,FALSE
electrode-react-webapp,1.2.1,1.3.0,6,40,1962,1175,3137,140,FALSE
electrode-react-webapp,1.2.1,1.3.0,6,40,1962,1175,3137,140,TRUE
xgen-cli,0.1.12,0.1.13,13,1,15,5,20,1,FALSE
xgen-cli,0.1.13,0.1.14,14,1,15,5,20,1,FALSE
xgen-cli,0.1.10,0.1.11,11,1,15,5,20,1,FALSE
xgen-cli,0.1.11,0.1.12,12,1,15,5,20,1,FALSE
xgen-cli,0.1.14,0.1.15,15,1,15,5,20,1,FALSE
xgen-cli,0.1.8,0.1.9,9,1,15,5,20,1,FALSE
xgen-cli,0.1.9,0.1.10,10,1,15,5,20,1,FALSE
xgen-cli,0.1.0,0.1.1,1,1,15,5,20,1,FALSE
xgen-cli,0.1.1,0.1.2,2,1,15,5,20,1,FALSE
xgen-cli,0.1.2,0.1.3,3,1,15,5,20,1,FALSE
xgen-cli,0.1.3,0.1.4,4,2,68,0,68,2,FALSE
xgen-cli,0.1.4,0.1.5,5,1,15,5,20,1,FALSE
xgen-cli,0.1.5,0.1.6,6,1,15,5,20,1,FALSE
xgen-cli,0.1.6,0.1.7,7,1,15,5,20,1,FALSE
xgen-cli,0.1.7,0.1.8,8,1,15,5,20,1,FALSE
xgen-cli,0.1.13,0.1.14,14,1,15,5,20,1,TRUE
xgen-cli,0.1.9,0.1.10,10,1,15,5,20,1,TRUE
react-pagination-table,1.0.4,1.0.5,4,5,13015,172,13187,77,FALSE
react-pagination-table,1.0.3,1.0.4,3,8,872,666,1538,43,FALSE
react-pagination-table,1.0.0,1.0.2,1,10,1663,16,1679,29,FALSE
react-pagination-table,1.0.2,1.0.3,2,8,5452,980,6432,20,FALSE
react-pagination-table,1.0.0,1.0.2,1,10,1663,16,1679,29,TRUE
hbs-helpers,1.0.2,1.0.3,3,5,36,37,73,16,FALSE
hbs-helpers,1.0.0,1.0.1,1,3,14,2,16,5,FALSE
hbs-helpers,1.0.2,1.0.3,3,5,36,37,73,16,TRUE
sequelize-virtual-fields,1.0.0,1.1.0,27,3,24,5,29,6,FALSE
sequelize-virtual-fields,0.2.7,0.2.8,12,5,19,7,26,8,FALSE
sequelize-virtual-fields,0.2.6,0.2.7,11,2,9,5,14,5,FALSE
sequelize-virtual-fields,0.2.5,0.2.6,10,3,8,9,17,6,FALSE
sequelize-virtual-fields,0.2.3,0.2.5,9,5,28,8,36,11,FALSE
sequelize-virtual-fields,0.2.2,0.2.3,8,7,44,13,57,13,FALSE
sequelize-virtual-fields,0.2.1,0.2.2,7,2,7,3,10,3,FALSE
sequelize-virtual-fields,0.2.0,0.2.1,6,3,13,2,15,4,FALSE
sequelize-virtual-fields,0.1.0,0.1.1,1,3,30,5,35,4,FALSE
sequelize-virtual-fields,0.1.1,0.1.3,2,15,154,38,192,22,FALSE
sequelize-virtual-fields,0.1.3,0.1.4,3,4,21,8,29,6,FALSE
sequelize-virtual-fields,0.1.4,0.1.5,4,3,15,3,18,4,FALSE
sequelize-virtual-fields,0.1.5,0.2.0,5,20,227,59,286,25,FALSE
sequelize-virtual-fields,0.2.9,0.2.10,14,2,7,3,10,4,FALSE
sequelize-virtual-fields,0.2.8,0.2.9,13,2,7,3,10,4,FALSE
sequelize-virtual-fields,0.3.8,1.0.0,26,7,164,93,257,29,FALSE
sequelize-virtual-fields,0.3.2,0.3.3,21,6,20,12,32,12,FALSE
sequelize-virtual-fields,0.3.3,0.3.4,22,5,130,79,209,13,FALSE
sequelize-virtual-fields,0.3.0,0.3.1,19,2,8,5,13,4,FALSE
sequelize-virtual-fields,0.3.1,0.3.2,20,3,12,8,20,6,FALSE
sequelize-virtual-fields,0.3.6,0.3.8,25,10,91,126,217,24,TRUE
sequelize-virtual-fields,0.3.4,0.3.5,23,3,60,46,106,7,FALSE
sequelize-virtual-fields,0.3.5,0.3.6,24,3,40,27,67,10,FALSE
sequelize-virtual-fields,0.2.13,0.3.0,18,8,95,21,116,27,FALSE
sequelize-virtual-fields,0.2.12,0.2.13,17,2,7,3,10,4,FALSE
sequelize-virtual-fields,0.2.11,0.2.12,16,9,39,47,86,19,FALSE
sequelize-virtual-fields,0.2.10,0.2.11,15,12,296,243,539,42,FALSE
sequelize-virtual-fields,0.3.6,0.3.8,25,10,91,126,217,24,FALSE
sequelize-virtual-fields,0.3.3,0.3.4,22,5,130,79,209,13,TRUE
sequelize-virtual-fields,0.1.3,0.1.4,3,4,21,8,29,6,TRUE
sequelize-virtual-fields,0.1.5,0.2.0,5,20,227,59,286,25,TRUE
sequelize-virtual-fields,0.2.13,0.3.0,18,8,95,21,116,27,TRUE
sequelize-virtual-fields,0.2.7,0.2.8,12,5,19,7,26,8,TRUE
sequelize-virtual-fields,0.2.2,0.2.3,8,7,44,13,57,13,TRUE
jenkins-cli,0.1.0,0.1.1,1,1,1,1,2,1,FALSE
jenkins-cli,0.1.1,0.1.2,2,4,272,146,418,16,FALSE
jenkins-cli,0.1.2,0.1.3,3,1,1,1,2,1,FALSE
jenkins-cli,0.1.3,0.1.4,4,1,1,1,2,1,FALSE
jenkins-cli,0.1.4,0.1.6,5,5,52,20,72,13,TRUE
jenkins-cli,0.1.6,0.1.7,6,1,27,6,33,5,FALSE
jenkins-cli,0.1.4,0.1.6,5,5,52,20,72,13,FALSE
vue-js-modal,1.0.21,1.1.0,16,4,140,29,169,11,FALSE
vue-js-modal,1.0.16,1.0.17,11,7,33,16,49,9,FALSE
vue-js-modal,1.0.17,1.0.18,12,5,155,50,205,10,FALSE
vue-js-modal,1.0.14,1.0.15,9,10,264,133,397,20,FALSE
vue-js-modal,1.0.15,1.0.16,10,6,749,589,1338,23,FALSE
vue-js-modal,1.0.12,1.0.13,7,5,101,61,162,12,FALSE
vue-js-modal,1.0.13,1.0.14,8,1,1,1,2,1,FALSE
vue-js-modal,1.0.10,1.0.11,5,1,10570,117,10687,15,FALSE
vue-js-modal,1.0.11,1.0.12,6,2,8705,8710,17415,10,FALSE
vue-js-modal,1.0.20,1.0.21,15,8,423,53,476,22,FALSE
vue-js-modal,1.0.18,1.0.19,13,2,30,3,33,2,FALSE
vue-js-modal,1.0.19,1.0.20,14,3,59,57,116,8,FALSE
vue-js-modal,1.1.1,1.1.2,18,8,90,14,104,12,FALSE
vue-js-modal,1.1.0,1.1.1,17,7,203,9540,9743,11,FALSE
vue-js-modal,1.0.0,1.0.1,1,9,253,136,389,12,FALSE
vue-js-modal,1.0.1,1.0.2,2,3,26,202,228,4,FALSE
vue-js-modal,1.0.2,1.0.3,3,1,14,1,15,1,FALSE
vue-js-modal,1.0.3,1.0.10,4,6,49,16,65,6,FALSE
vue-js-modal,1.0.0,1.0.1,1,9,253,136,389,12,TRUE
vue-js-modal,1.1.1,1.1.2,18,8,90,14,104,12,TRUE
vue-js-modal,1.0.2,1.0.3,3,1,14,1,15,1,TRUE
specberus,3.1.2,3.2.0,37,44,18996,282,19278,118,FALSE
specberus,3.1.1,3.1.2,36,19,21,23,44,23,FALSE
specberus,3.1.0,3.1.1,35,42,75,123,198,45,FALSE
specberus,3.0.2,3.1.0,34,21,281,89,370,39,FALSE
specberus,3.0.0,3.0.1,32,19,115,45,160,26,FALSE
specberus,3.0.1,3.0.2,33,20,66,130,196,29,FALSE
specberus,2.1.8,3.0.0,31,54,2684,2456,5140,193,FALSE
specberus,2.1.2,2.1.3,25,2,3,3,6,2,FALSE
specberus,2.1.3,2.1.4,26,2,3,3,6,2,FALSE
specberus,2.1.0,2.1.1,23,13,221,127,348,29,FALSE
specberus,2.1.1,2.1.2,24,2,6,6,12,2,FALSE
specberus,2.1.6,2.1.7,29,3,133,137,270,53,FALSE
specberus,2.1.7,2.1.8,30,26,207,51,258,38,FALSE
specberus,2.1.4,2.1.5,27,6,121,89,210,32,FALSE
specberus,2.1.5,2.1.6,28,69,6324,2742,9066,238,FALSE
specberus,2.0.0,2.1.0,22,16,288,380,668,54,FALSE
specberus,3.2.4,3.2.5,42,5,5,5,10,5,FALSE
specberus,3.2.5,3.2.6,43,27,319,249,568,37,FALSE
specberus,3.2.0,3.2.1,38,12,66,23,89,16,FALSE
specberus,3.2.1,3.2.2,39,23,4335,3759,8094,57,FALSE
specberus,3.2.2,3.2.3,40,18,3235,3190,6425,90,FALSE
specberus,3.2.3,3.2.4,41,3,27,41,68,5,FALSE
specberus,1.1.1,1.1.2,6,29,136,51322,51458,64,FALSE
specberus,1.1.0,1.1.1,5,31,22504,15926,38430,93,FALSE
specberus,1.1.3,1.1.4,8,3,3,3,6,3,FALSE
specberus,1.1.2,1.1.3,7,5,15,13,28,9,FALSE
specberus,1.0.0,1.0.1,1,8,732,140,872,21,TRUE
specberus,1.0.1,1.0.2,2,5,745,452,1197,19,FALSE
specberus,1.0.2,1.0.3,3,4,7,13,20,5,FALSE
specberus,1.0.3,1.1.0,4,24,438,310,748,50,FALSE
specberus,1.1.4,1.1.5,9,31,1191,760,1951,78,FALSE
specberus,1.1.6,1.2.0,11,4,84,21,105,12,FALSE
specberus,1.1.5,1.1.6,10,6,10,12,22,7,FALSE
specberus,1.4.0,1.4.1,16,3,27,9,36,7,FALSE
specberus,1.4.1,1.5.0,17,28,36471,29135,65606,94,FALSE
specberus,1.5.1,1.5.2,19,3,13,1,14,3,FALSE
specberus,1.5.0,1.5.1,18,10,65,39,104,14,FALSE
specberus,1.5.3,2.0.0,21,113,26206,22337,48543,479,FALSE
specberus,1.5.2,1.5.3,20,11,389,119,508,26,FALSE
specberus,1.3.1,1.4.0,15,40,1185,397,1582,135,FALSE
specberus,1.3.0,1.3.1,14,9,14,15,29,10,FALSE
specberus,1.2.0,1.2.1,12,11,94,44,138,16,FALSE
specberus,1.2.1,1.3.0,13,35,451,126,577,69,FALSE
specberus,1.0.0,1.0.1,1,8,732,140,872,21,FALSE
specberus,1.1.1,1.1.2,6,29,136,51322,51458,64,TRUE
specberus,3.1.1,3.1.2,36,19,21,23,44,23,TRUE
specberus,1.0.2,1.0.3,3,4,7,13,20,5,TRUE
specberus,3.2.5,3.2.6,43,27,319,249,568,37,TRUE
specberus,1.5.3,2.0.0,21,113,26206,22337,48543,479,TRUE
specberus,1.2.1,1.3.0,13,35,451,126,577,69,TRUE
cspace-ui,0.6.0,0.7.0,25,23,18567,4263,22830,451,FALSE
cspace-ui,0.2.0,0.2.1,19,1,257,3,260,4,FALSE
cspace-ui,0.0.11,0.0.12,11,1,2,2,4,2,FALSE
cspace-ui,0.0.10,0.0.11,10,2,4,3,7,3,FALSE
cspace-ui,0.2.1,0.3.0,20,12,17254,6246,23500,442,FALSE
cspace-ui,0.0.12,0.1.0,12,13,2679,2257,4936,129,FALSE
cspace-ui,0.1.0,0.1.1,13,3,223,11,234,11,FALSE
cspace-ui,0.1.1,0.1.2,14,3,2222,18,2240,63,FALSE
cspace-ui,0.1.2,0.1.3,15,4,87,87,174,23,FALSE
cspace-ui,0.1.3,0.1.4,16,1,3,3,6,2,FALSE
cspace-ui,0.1.4,0.1.5,17,2,2334,570,2904,84,FALSE
cspace-ui,0.1.5,0.2.0,18,6,11960,2234,14194,293,FALSE
cspace-ui,0.0.5,0.0.6,5,2,33,5,38,2,FALSE
cspace-ui,0.0.4,0.0.5,4,8,3297,1030,4327,90,FALSE
cspace-ui,0.0.7,0.0.8,7,3,7687,3250,10937,140,FALSE
cspace-ui,0.0.6,0.0.7,6,30,5795,443,6238,172,FALSE
cspace-ui,0.0.1,0.0.2,1,1,12,9,21,9,FALSE
cspace-ui,0.0.3,0.0.4,3,3,27,3,30,3,FALSE
cspace-ui,0.0.2,0.0.3,2,23,4198,763,4961,141,FALSE
cspace-ui,0.3.0,0.3.1,21,20,11308,2431,13739,301,FALSE
cspace-ui,0.3.1,0.4.0,22,29,7001,3632,10633,189,FALSE
cspace-ui,0.0.9,0.0.10,9,1,1,1,2,1,FALSE
cspace-ui,0.0.8,0.0.9,8,5,176,147,323,19,FALSE
cspace-ui,0.7.0,0.8.0,26,8,15551,2861,18412,319,FALSE
cspace-ui,0.4.0,0.5.0,23,7,963,159,1122,56,FALSE
cspace-ui,0.5.0,0.6.0,24,8,706,442,1148,55,FALSE
cspace-ui,0.9.0,0.9.1,32,1,3,3,6,3,FALSE
cspace-ui,0.8.4,0.9.0,31,9,5884,995,6879,125,FALSE
cspace-ui,0.8.1,0.8.2,28,6,5470,922,6392,141,FALSE
cspace-ui,0.8.0,0.8.1,27,1,5,2,7,2,FALSE
cspace-ui,0.8.3,0.8.4,30,6,4995,429,5424,64,FALSE
cspace-ui,0.8.2,0.8.3,29,5,2351,477,2828,79,FALSE
cspace-ui,0.0.3,0.0.4,3,3,27,3,30,3,TRUE
cspace-ui,0.7.0,0.8.0,26,8,15551,2861,18412,319,TRUE
cspace-ui,0.8.0,0.8.1,27,1,5,2,7,2,TRUE
cspace-ui,0.0.6,0.0.7,6,30,5795,443,6238,172,TRUE
cspace-ui,0.3.1,0.4.0,22,29,7001,3632,10633,189,TRUE
cspace-ui,0.4.0,0.5.0,23,7,963,159,1122,56,TRUE
cspace-ui,0.5.0,0.6.0,24,8,706,442,1148,55,TRUE
cspace-ui,0.3.0,0.3.1,21,20,11308,2431,13739,301,TRUE
cspace-ui,0.0.12,0.1.0,12,13,2679,2257,4936,129,TRUE
cspace-ui,0.1.1,0.1.2,14,3,2222,18,2240,63,TRUE
cspace-ui,0.8.2,0.8.3,29,5,2351,477,2828,79,TRUE
cspace-ui,0.0.7,0.0.8,7,3,7687,3250,10937,140,TRUE
cspace-ui,0.0.2,0.0.3,2,23,4198,763,4961,141,TRUE
fractal-core,1.0.4,1.0.5,40,1,7,1,8,3,FALSE
fractal-core,1.0.5,1.0.6,41,1,11,3,14,3,FALSE
fractal-core,1.0.6,1.0.7,42,1,1,0,1,1,FALSE
fractal-core,1.0.7,1.0.8,43,2,33,29,62,7,FALSE
fractal-core,1.0.0,1.0.1,36,4,86,65,151,12,FALSE
fractal-core,1.0.1,1.0.2,37,1,73,65,138,15,FALSE
fractal-core,1.0.2,1.0.3,38,2,28,14,42,7,FALSE
fractal-core,1.0.3,1.0.4,39,4,424,7,431,13,FALSE
fractal-core,0.0.9,0.0.10,4,1,2,2,4,2,FALSE
fractal-core,1.0.8,1.1.1,44,10,290,176,466,63,FALSE
fractal-core,1.4.2,1.4.3,52,3,100,110,210,12,FALSE
fractal-core,0.0.8,0.0.9,3,7,4328,84,4412,57,FALSE
fractal-core,0.2.5,0.3.0,12,8,115,66,181,17,FALSE
fractal-core,0.2.4,0.2.5,11,1,34,20,54,12,FALSE
fractal-core,0.2.3,0.2.4,10,3,57,20,77,9,FALSE
fractal-core,0.0.10,0.1.0,5,3,39,4,43,6,FALSE
fractal-core,0.2.1,0.2.2,8,4,13,4,17,6,FALSE
fractal-core,0.2.0,0.2.1,7,2,19,6,25,6,FALSE
fractal-core,0.1.0,0.2.0,6,5,86,19,105,12,FALSE
fractal-core,0.7.1,0.7.2,29,2,10,14,24,6,FALSE
fractal-core,0.0.7,0.0.8,2,1,14,7,21,2,FALSE
fractal-core,0.6.8,0.7.0,27,2,114,20,134,12,FALSE
fractal-core,0.6.3,0.6.4,22,1,148,26,174,10,FALSE
fractal-core,0.6.2,0.6.3,21,1,9,1,10,3,FALSE
fractal-core,0.7.4,0.7.5,32,1,79,12,91,4,FALSE
fractal-core,0.7.5,0.7.6,33,1,25,2,27,4,FALSE
fractal-core,0.6.7,0.6.8,26,1,6,2,8,2,FALSE
fractal-core,0.6.6,0.6.7,25,1,122,8,130,4,FALSE
fractal-core,0.6.5,0.6.6,24,1,6,2,8,3,FALSE
fractal-core,0.6.4,0.6.5,23,4,184,34,218,8,FALSE
fractal-core,1.5.5,1.5.6,69,3,14,12,26,6,FALSE
fractal-core,1.5.4,1.5.5,68,3,15,7,22,5,FALSE
fractal-core,0.4.0,0.5.0,16,6,108,56,164,16,FALSE
fractal-core,0.7.2,0.7.3,30,1,6,2,8,2,FALSE
fractal-core,0.5.0,0.5.1,17,1,45,3,48,4,FALSE
fractal-core,0.5.1,0.6.0,18,2,171,7,178,3,FALSE
fractal-core,1.4.0,1.4.1,50,2,17,12,29,6,FALSE
fractal-core,1.4.1,1.4.2,51,2,13,3,16,3,FALSE
fractal-core,1.1.1,1.2.0,45,5,62,45,107,10,FALSE
fractal-core,1.4.3,1.4.4,53,4,68,27,95,8,FALSE
fractal-core,1.4.4,1.4.5,54,5,233,16,249,7,FALSE
fractal-core,1.4.5,1.4.6,55,2,83,25,108,23,FALSE
fractal-core,1.4.6,1.4.7,56,1,7,3,10,3,FALSE
fractal-core,1.4.7,1.4.8,57,7,1603,1575,3178,57,FALSE
fractal-core,1.4.8,1.4.9,58,1,6,2,8,2,FALSE
fractal-core,1.4.9,1.4.10,59,2,11,2,13,3,FALSE
fractal-core,1.5.6,1.6.0,70,8,78,96,174,13,FALSE
fractal-core,1.5.1,1.5.2,65,2,41,19,60,8,FALSE
fractal-core,1.5.0,1.5.1,64,3,21,6,27,5,FALSE
fractal-core,1.5.3,1.5.4,67,2,7,3,10,3,FALSE
fractal-core,1.5.2,1.5.3,66,1,6,2,8,2,FALSE
fractal-core,1.3.1,1.4.0,49,11,300,315,615,26,FALSE
fractal-core,1.3.0,1.3.1,48,2,65,43,108,7,FALSE
fractal-core,1.2.0,1.2.1,46,2,13,5,18,4,FALSE
fractal-core,1.2.1,1.3.0,47,1,88,100,188,9,FALSE
fractal-core,0.7.3,0.7.4,31,6,117,33,150,24,FALSE
fractal-core,0.7.6,0.7.7,34,1,135,15,150,6,FALSE
fractal-core,0.3.1,0.3.2,14,1,21,15,36,3,FALSE
fractal-core,0.3.0,0.3.1,13,3,17,3,20,5,FALSE
fractal-core,0.6.0,0.6.1,19,4,307,15,322,16,FALSE
fractal-core,0.3.2,0.4.0,15,3,38,10,48,7,FALSE
fractal-core,0.7.7,1.0.0,35,2,251,214,465,32,FALSE
fractal-core,0.7.0,0.7.1,28,1,9,2,11,3,FALSE
fractal-core,1.4.12,1.4.13,62,3,72,14,86,6,FALSE
fractal-core,1.4.13,1.5.0,63,4,147,12,159,8,FALSE
fractal-core,1.4.10,1.4.11,60,4,86,82,168,9,FALSE
fractal-core,1.4.11,1.4.12,61,2,8,2,10,3,FALSE
fractal-core,0.6.1,0.6.2,20,2,74,9,83,8,FALSE
fractal-core,0.2.2,0.2.3,9,2,6,2,8,3,FALSE
fractal-core,0.0.6,0.0.7,1,1,6,2,8,2,FALSE
fractal-core,1.0.0,1.0.1,36,4,86,65,151,12,TRUE
fractal-core,0.0.8,0.0.9,3,7,4328,84,4412,57,TRUE
fractal-core,0.2.5,0.3.0,12,8,115,66,181,17,TRUE
fractal-core,0.2.3,0.2.4,10,3,57,20,77,9,TRUE
fractal-core,0.2.1,0.2.2,8,4,13,4,17,6,TRUE
fractal-core,0.0.6,0.0.7,1,1,6,2,8,2,TRUE
fractal-core,0.6.3,0.6.4,22,1,148,26,174,10,TRUE
fractal-core,0.6.7,0.6.8,26,1,6,2,8,2,TRUE
fractal-core,0.4.0,0.5.0,16,6,108,56,164,16,TRUE
fractal-core,0.5.1,0.6.0,18,2,171,7,178,3,TRUE
fractal-core,1.4.3,1.4.4,53,4,68,27,95,8,TRUE
fractal-core,1.4.4,1.4.5,54,5,233,16,249,7,TRUE
fractal-core,1.4.7,1.4.8,57,7,1603,1575,3178,57,TRUE
fractal-core,1.5.6,1.6.0,70,8,78,96,174,13,TRUE
fractal-core,1.5.0,1.5.1,64,3,21,6,27,5,TRUE
fractal-core,1.3.1,1.4.0,49,11,300,315,615,26,TRUE
fractal-core,1.2.0,1.2.1,46,2,13,5,18,4,TRUE
fractal-core,1.2.1,1.3.0,47,1,88,100,188,9,TRUE
fractal-core,0.3.0,0.3.1,13,3,17,3,20,5,TRUE
fractal-core,0.3.2,0.4.0,15,3,38,10,48,7,TRUE
fractal-core,1.3.0,1.3.1,48,2,65,43,108,7,TRUE
fractal-core,1.4.13,1.5.0,63,4,147,12,159,8,TRUE
fractal-core,1.1.1,1.2.0,45,5,62,45,107,10,TRUE
fractal-core,1.4.2,1.4.3,52,3,100,110,210,12,TRUE
fractal-core,0.6.0,0.6.1,19,4,307,15,322,16,TRUE
fractal-core,1.0.8,1.1.1,44,10,290,176,466,63,TRUE
inshorts,1.0.4,1.0.5,5,1,85,88,173,1,FALSE
inshorts,1.0.0,1.0.1,1,1,1,1,2,1,FALSE
inshorts,1.0.1,1.0.2,2,1,1,1,2,1,FALSE
inshorts,1.0.2,1.0.3,3,1,1,1,2,1,FALSE
inshorts,1.0.3,1.0.4,4,1,368,0,368,3,TRUE
inshorts,1.0.3,1.0.4,4,1,368,0,368,3,FALSE
steel,0.1.34,0.1.35,9,1,1,1,2,1,FALSE
steel,0.1.35,0.1.41,10,1,1,1,2,1,FALSE
steel,0.1.31,0.1.32,6,1,1,1,2,1,FALSE
steel,0.1.32,0.1.33,7,1,1,1,2,1,FALSE
steel,0.1.33,0.1.34,8,1,1,1,2,1,FALSE
steel,0.1.41,0.1.42,11,2,107,58,165,5,FALSE
steel,0.1.2,0.1.3,3,2,64,65,129,4,FALSE
steel,0.1.3,0.1.4,4,4,67,70,137,8,FALSE
steel,0.1.2,0.1.3,3,2,64,65,129,4,TRUE
steel,0.0.11,0.1.2,2,1,883,0,883,16,FALSE
remotedev-app,0.11.0-1,0.11.0-2,84,1,1,0,1,1,FALSE
remotedev-app,0.11.0-0,0.11.0-1,83,1,1,0,1,1,FALSE
remotedev-app,0.11.0-2,0.11.0-3,85,1,1,0,1,1,FALSE
remotedev-app,0.10.0-beta,0.10.0-beta-2,69,3,9,10,19,4,FALSE
remotedev-app,0.8.0-alpha-1,0.8.0-alpha-2,48,1,1,0,1,1,FALSE
remotedev-app,0.6.2-beta-1,0.6.2,44,2,21,18,39,2,FALSE
remotedev-app,0.1.0-beta-1,0.1.0,4,1,1,0,1,1,FALSE
remotedev-app,0.3.8,0.4.0-alpha-1,26,4,186,160,346,7,FALSE
remotedev-app,0.3.2,0.3.3,20,5,45,15,60,10,FALSE
remotedev-app,0.3.3,0.3.4,21,9,116,53,169,16,FALSE
remotedev-app,0.3.0,0.3.1,18,3,7,9,16,3,FALSE
remotedev-app,0.3.1,0.3.2,19,2,37,4,41,4,TRUE
remotedev-app,0.3.6,0.3.7,24,7,127,72,199,18,FALSE
remotedev-app,0.3.7,0.3.8,25,11,75,33,108,17,FALSE
remotedev-app,0.3.4,0.3.5,22,7,307,45,352,19,FALSE
remotedev-app,0.3.5,0.3.6,23,6,51,34,85,12,FALSE
remotedev-app,0.6.0-alpha-2,0.6.0-beta-1,40,3,29,27,56,6,FALSE
remotedev-app,0.6.0-alpha-1,0.6.0-alpha-2,39,2,10,8,18,2,FALSE
remotedev-app,0.6.0-beta-1,0.6.0,41,1,26,22,48,3,FALSE
remotedev-app,0.8.0-beta-8,0.8.0-beta-9,60,2,3,3,6,2,FALSE
remotedev-app,0.10.0-beta-2,0.10.0-beta-3,70,4,756,645,1401,10,FALSE
remotedev-app,0.10.0-beta-3,0.10.0-beta-4,71,1,33,19,52,3,FALSE
remotedev-app,0.10.0-beta-4,0.10.0-beta-5,72,17,1434,384,1818,62,FALSE
remotedev-app,0.10.0-beta-5,0.10.0,73,3,18,22,40,4,FALSE
remotedev-app,0.4.0-alpha-1,0.4.0-alpha-2,27,1,1,0,1,1,FALSE
remotedev-app,0.4.0-alpha-2,0.4.0,28,9,236,179,415,20,FALSE
remotedev-app,0.6.3,0.7.0,46,3,56,24,80,5,FALSE
remotedev-app,0.6.2,0.6.3,45,2,3,4,7,2,FALSE
remotedev-app,0.6.1,0.6.2-beta-1,43,4,47,23,70,8,FALSE
remotedev-app,0.6.0,0.6.1,42,6,24,15,39,9,FALSE
remotedev-app,0.4.1,0.4.2,30,7,17,16,33,8,FALSE
remotedev-app,0.4.0,0.4.1,29,5,13,8,21,8,FALSE
remotedev-app,0.4.2,0.5.0-alpha-1,31,10,410,45,455,26,FALSE
remotedev-app,0.8.1,0.8.2,63,1,1,0,1,1,FALSE
remotedev-app,0.8.0,0.8.1,62,1,1,0,1,1,FALSE
remotedev-app,0.8.3,0.8.4,65,6,53,9,62,6,FALSE
remotedev-app,0.8.2,0.8.3,64,4,19,16,35,8,FALSE
remotedev-app,0.8.0-beta-10,0.8.0-beta-11,51,2,17,6,23,2,FALSE
remotedev-app,0.8.0-beta-11,0.8.0-beta-12,52,1,1,0,1,1,FALSE
remotedev-app,0.5.0-beta-3,0.5.0-beta-4,36,1,7,7,14,1,FALSE
remotedev-app,0.5.0-beta-2,0.5.0-beta-3,35,1,5,3,8,3,FALSE
remotedev-app,0.5.0-beta-1,0.5.0-beta-2,34,1,1,0,1,1,FALSE
remotedev-app,0.5.0-beta-4,0.5.0,37,2,6,2,8,3,FALSE
remotedev-app,0.8.0-beta,0.8.0-beta-10,50,25,2241,1414,3655,118,FALSE
remotedev-app,0.9.0-beta,0.9.0,67,6,7153,47,7200,17,FALSE
remotedev-app,0.2.7,0.2.8,15,4,8,9,17,6,FALSE
remotedev-app,0.2.6,0.2.7,14,4,137,11,148,15,FALSE
remotedev-app,0.2.5,0.2.6,13,5,35,24,59,6,FALSE
remotedev-app,0.2.4,0.2.5,12,2,3,3,6,3,FALSE
remotedev-app,0.2.3,0.2.4,11,3,12,4,16,3,FALSE
remotedev-app,0.2.2,0.2.3,10,4,9,4,13,5,FALSE
remotedev-app,0.2.1,0.2.2,9,6,44,32,76,9,FALSE
remotedev-app,0.2.0,0.2.1,8,8,43,12,55,15,FALSE
remotedev-app,0.1.0,0.1.1,5,3,43,12,55,5,FALSE
remotedev-app,0.1.1,0.1.2,6,3,22,7,29,5,FALSE
remotedev-app,0.1.2,0.2.0,7,7,228,124,352,26,FALSE
remotedev-app,0.2.9,0.3.0,17,8,202,83,285,26,FALSE
remotedev-app,0.2.8,0.2.9,16,3,4,3,7,3,FALSE
remotedev-app,0.10.1,0.10.2,75,6,22,15,37,9,FALSE
remotedev-app,0.10.0,0.10.1,74,1,1,0,1,1,FALSE
remotedev-app,0.10.3,0.10.4,77,3,59,14,73,9,FALSE
remotedev-app,0.10.2,0.10.3,76,3,250,250,500,5,FALSE
remotedev-app,0.0.1,0.0.2,1,1,4,3,7,2,FALSE
remotedev-app,0.10.4,0.10.5,78,3,11,5,16,4,FALSE
remotedev-app,0.0.3,0.1.0-beta-1,3,18,463,140,603,43,FALSE
remotedev-app,0.0.2,0.0.3,2,1,2,2,4,2,FALSE
remotedev-app,0.5.0-alpha-1,0.5.0-alpha-2,32,1,1,0,1,1,FALSE
remotedev-app,0.5.0-alpha-2,0.5.0-beta-1,33,7,24,14,38,11,FALSE
remotedev-app,0.7.0,0.8.0-alpha-1,47,47,3763,2107,5870,256,FALSE
remotedev-app,0.8.0-beta-4,0.8.0-beta-5,56,2,7,4,11,2,FALSE
remotedev-app,0.8.0-beta-5,0.8.0-beta-6,57,1,8,2,10,3,FALSE
remotedev-app,0.8.0-beta-6,0.8.0-beta-7,58,6,479,469,948,29,FALSE
remotedev-app,0.8.0-beta-7,0.8.0-beta-8,59,2,106,0,106,6,FALSE
remotedev-app,0.8.0-beta-2,0.8.0-beta-3,54,7,1528,927,2455,65,FALSE
remotedev-app,0.8.0-beta-3,0.8.0-beta-4,55,5,110,9,119,11,FALSE
remotedev-app,0.5.0,0.6.0-alpha-1,38,10,421,127,548,26,FALSE
remotedev-app,0.8.0-beta-9,0.8.0,61,7,41,14,55,7,FALSE
remotedev-app,0.9.0,0.10.0-beta,68,2,70,32,102,7,FALSE
remotedev-app,0.10.5,0.10.6,79,4,75,33,108,6,FALSE
remotedev-app,0.10.7,0.10.8,81,2,4,3,7,3,FALSE
remotedev-app,0.10.6,0.10.7,80,3,93,41,134,4,FALSE
remotedev-app,0.3.1,0.3.2,19,2,37,4,41,4,FALSE
remotedev-app,0.8.0,0.8.1,62,1,1,0,1,1,TRUE
remotedev-app,0.2.5,0.2.6,13,5,35,24,59,6,TRUE
remotedev-app,0.10.2,0.10.3,76,3,250,250,500,5,TRUE
remotedev-app,0.0.3,0.1.0-beta-1,3,18,463,140,603,43,TRUE
remotedev-app,0.10.0-beta,0.10.0-beta-2,69,3,9,10,19,4,TRUE
remotedev-app,0.6.1,0.6.2-beta-1,43,4,47,23,70,8,TRUE
remotedev-app,0.8.0-beta-4,0.8.0-beta-5,56,2,7,4,11,2,TRUE
remotedev-app,0.9.0,0.10.0-beta,68,2,70,32,102,7,TRUE
remotedev-app,0.3.3,0.3.4,21,9,116,53,169,16,TRUE
remotedev-app,0.2.6,0.2.7,14,4,137,11,148,15,TRUE
remotedev-app,0.2.4,0.2.5,12,2,3,3,6,3,TRUE
remotedev-app,0.2.3,0.2.4,11,3,12,4,16,3,TRUE
remotedev-app,0.2.2,0.2.3,10,4,9,4,13,5,TRUE
remotedev-app,0.2.1,0.2.2,9,6,44,32,76,9,TRUE
remotedev-app,0.6.0-alpha-2,0.6.0-beta-1,40,3,29,27,56,6,TRUE
remotedev-app,0.6.0,0.6.1,42,6,24,15,39,9,TRUE
remotedev-app,0.3.7,0.3.8,25,11,75,33,108,17,TRUE
remotedev-app,0.2.9,0.3.0,17,8,202,83,285,26,TRUE
remotedev-app,0.10.5,0.10.6,79,4,75,33,108,6,TRUE
remotedev-app,0.2.7,0.2.8,15,4,8,9,17,6,TRUE
remotedev-app,0.9.0-beta,0.9.0,67,6,7153,47,7200,17,TRUE
remotedev-app,0.1.0,0.1.1,5,3,43,12,55,5,TRUE
remotedev-app,0.1.1,0.1.2,6,3,22,7,29,5,TRUE
remotedev-app,0.6.3,0.7.0,46,3,56,24,80,5,TRUE
remotedev-app,0.8.2,0.8.3,64,4,19,16,35,8,TRUE
remotedev-app,0.1.2,0.2.0,7,7,228,124,352,26,TRUE
remotedev-app,0.4.2,0.5.0-alpha-1,31,10,410,45,455,26,TRUE
remotedev-app,0.8.0-beta-10,0.8.0-beta-11,51,2,17,6,23,2,TRUE
remotedev-app,0.8.0-beta-11,0.8.0-beta-12,52,1,1,0,1,1,TRUE
remotedev-app,0.10.7,0.10.8,81,2,4,3,7,3,TRUE
remotedev-app,0.11.0-2,0.11.0-3,85,1,1,0,1,1,TRUE
remotedev-app,0.2.0,0.2.1,8,8,43,12,55,15,TRUE
remotedev-app,0.3.2,0.3.3,20,5,45,15,60,10,TRUE
node-jet,0.0.5,0.0.6,5,2,2,2,4,2,FALSE
node-jet,0.0.4,0.0.5,4,2,2,2,4,2,FALSE
node-jet,0.0.7,0.0.8,8,8,395,82,477,19,FALSE
node-jet,0.0.6,0.0.7-2,6,6,193,43,236,11,FALSE
node-jet,0.0.1,0.0.2,1,2,2,1,3,2,FALSE
node-jet,0.0.3,0.0.4,3,4,27,24,51,7,FALSE
node-jet,0.0.2,0.0.3,2,2,2,2,4,2,FALSE
node-jet,0.0.9,0.0.10,10,1,1,1,2,1,FALSE
node-jet,0.0.8,0.0.9,9,5,418,355,773,9,FALSE
node-jet,0.0.11,0.0.12,12,7,198,128,326,14,FALSE
node-jet,0.0.10,0.0.11,11,2,3,7,10,2,FALSE
node-jet,1.0.4,1.0.5,28,3,8,8,16,5,FALSE
node-jet,1.0.5,1.0.6,29,9,28001,27583,55584,58,FALSE
node-jet,1.0.6,1.1.0,30,38,146,126,272,57,FALSE
node-jet,1.0.0,1.0.2,25,21,890,10846,11736,53,FALSE
node-jet,1.0.2,1.0.3,26,31,267,75,342,37,FALSE
node-jet,1.0.3,1.0.4,27,36,1036,102,1138,56,FALSE
node-jet,0.2.0,0.3.0,20,111,42577,25753,68330,259,FALSE
node-jet,0.1.0,0.1.1,14,19,1427,301,1728,33,FALSE
node-jet,0.1.1,0.1.2,15,6,353,81,434,9,FALSE
node-jet,0.1.2,0.1.3,16,11,210,78,288,16,FALSE
node-jet,0.1.3,0.1.4,17,5,145,37,182,11,FALSE
node-jet,0.1.4,0.1.5,18,2,3,3,6,2,FALSE
node-jet,0.1.5,0.2.0,19,60,17651,8159,25810,154,FALSE
node-jet,0.3.2,0.3.4,23,18,544,95,639,25,FALSE
node-jet,0.3.0,0.3.1,21,3,19,9,28,4,FALSE
node-jet,0.3.1,0.3.2,22,4,28,13,41,8,FALSE
node-jet,0.3.4,1.0.0,24,79,14139,7884,22023,263,FALSE
node-jet,1.4.0,1.5.0,39,1,26,4,30,4,FALSE
node-jet,1.5.1,1.5.2,41,4,97,75,172,12,FALSE
node-jet,1.5.0,1.5.1,40,4,69,27,96,8,FALSE
node-jet,1.3.3,1.4.0,38,2,70,7,77,5,FALSE
node-jet,1.3.2,1.3.3,37,2,9,9,18,5,FALSE
node-jet,1.3.1,1.3.2,36,7,305,13,318,9,FALSE
node-jet,1.3.0,1.3.1,35,5,20,21,41,11,FALSE
node-jet,1.2.2,1.3.0,34,8,165,24,189,12,FALSE
node-jet,1.2.0,1.2.1,32,2,10,7,17,5,FALSE
node-jet,1.2.1,1.2.2,33,2,5,5,10,3,FALSE
node-jet,1.1.0,1.2.0,31,36,532,153,685,61,FALSE
node-jet,0.3.4,1.0.0,24,79,14139,7884,22023,263,TRUE
node-jet,0.0.12,0.1.0,13,68,9722,6616,16338,186,FALSE
node-jet,0.1.5,0.2.0,19,60,17651,8159,25810,154,TRUE
node-jet,0.0.8,0.0.9,9,5,418,355,773,9,TRUE
node-jet,1.0.2,1.0.3,26,31,267,75,342,37,TRUE
rb-component,0.1.1,0.1.2,1,1,9,3,12,3,FALSE
rb-component,0.1.2,0.1.3,2,1,9,3,12,3,FALSE
rb-component,0.1.3,0.1.4,3,1,9,3,12,3,FALSE
rb-component,0.1.4,0.1.5,4,1,9,3,12,3,FALSE
rb-component,0.1.5,0.1.6,5,1,9,3,12,3,FALSE
rb-component,0.1.6,0.1.7,6,1,9,3,12,3,FALSE
rb-component,0.1.7,0.2.8,7,1,9,3,12,3,FALSE
rb-component,0.2.20,0.2.21,19,1,15,11,26,3,FALSE
rb-component,0.2.18,0.2.20,18,1,18,12,30,4,FALSE
rb-component,0.2.17,0.2.18,17,2,5920,3,5923,116,FALSE
rb-component,0.2.16,0.2.17,16,1,9,3,12,3,FALSE
rb-component,0.2.15,0.2.16,15,1,9,3,12,3,FALSE
rb-component,0.2.14,0.2.15,14,1,9,3,12,3,FALSE
rb-component,0.2.13,0.2.14,13,1,9,3,12,3,FALSE
rb-component,0.2.12,0.2.13,12,1,9,3,12,3,FALSE
rb-component,0.2.11,0.2.12,11,1,9,3,12,3,FALSE
rb-component,0.2.10,0.2.11,10,1,9,3,12,3,FALSE
rb-component,0.2.8,0.2.9,8,1,9,3,12,3,FALSE
rb-component,0.2.9,0.2.10,9,1,9,3,12,3,FALSE
rb-component,0.2.21,2.0.1,20,1,9,3,12,3,FALSE
rb-component,0.2.18,0.2.20,18,1,18,12,30,4,TRUE
rb-component,0.2.21,2.0.1,20,1,9,3,12,3,TRUE
rb-component,0.2.14,0.2.15,14,1,9,3,12,3,TRUE
rb-component,0.2.12,0.2.13,12,1,9,3,12,3,TRUE
rb-component,0.2.11,0.2.12,11,1,9,3,12,3,TRUE
rb-component,0.2.20,0.2.21,19,1,15,11,26,3,TRUE
npm-registry-client,7.4.4,7.4.5,143,1,1,1,2,1,FALSE
npm-registry-client,7.1.0,7.1.1,133,2,2,2,4,2,TRUE
npm-registry-client,7.4.5,7.4.6,144,8,40,44,84,12,FALSE
npm-registry-client,7.4.0,7.4.1,139,2,2,2,4,2,TRUE
npm-registry-client,7.4.6,7.5.0,145,2,28,6,34,3,FALSE
npm-registry-client,7.0.9,7.1.0,132,2,57,19,76,5,FALSE
npm-registry-client,7.2.0,7.2.1,136,3,23,25,48,10,FALSE
npm-registry-client,7.2.1,7.3.0,137,3,24,3,27,7,FALSE
npm-registry-client,7.4.2,7.4.3,141,1,1,1,2,1,FALSE
npm-registry-client,7.4.3,7.4.4,142,2,106,3,109,4,FALSE
npm-registry-client,7.5.0,8.0.1,146,3,17,1,18,3,FALSE
npm-registry-client,7.4.1,7.4.2,140,3,4,3,7,3,FALSE
npm-registry-client,8.2.0,8.3.0,151,2,28,6,34,4,FALSE
npm-registry-client,8.0.1,8.0.2,147,2,2,3,5,2,FALSE
npm-registry-client,8.0.2,8.1.0,148,3,8,4,12,4,FALSE
npm-registry-client,8.1.0,8.1.1,149,2,2,2,4,2,FALSE
npm-registry-client,8.1.1,8.2.0,150,2,159,1,160,4,FALSE
npm-registry-client,7.1.2,7.2.0,135,6,118,9,127,8,FALSE
npm-registry-client,7.1.1,7.1.2,134,2,2,2,4,2,TRUE
npm-registry-client,7.3.0,7.4.0,138,3,136,24,160,8,FALSE
npm-registry-client,3.1.3,3.1.4,85,3,23,13,36,12,FALSE
npm-registry-client,3.1.2,3.1.3,84,3,9,5,14,3,FALSE
npm-registry-client,3.1.1,3.1.2,83,3,3,3,6,3,FALSE
npm-registry-client,3.1.0,3.1.1,82,1,1,1,2,1,FALSE
npm-registry-client,3.1.5,3.1.6,87,4,20,8,28,4,FALSE
npm-registry-client,3.1.4,3.1.5,86,1,1,7,8,1,FALSE
npm-registry-client,3.1.8,3.2.0,90,4,11,6,17,4,TRUE
npm-registry-client,7.1.0,7.1.1,133,2,2,2,4,2,FALSE
npm-registry-client,3.1.7,3.1.8,89,1,1,1,2,1,FALSE
npm-registry-client,3.1.6,3.1.7,88,1,14,5,19,1,FALSE
npm-registry-client,4.0.1,4.0.2,97,2,13,4,17,3,FALSE
npm-registry-client,4.0.0,4.0.1,96,2,3,3,6,2,FALSE
npm-registry-client,4.0.3,4.0.4,99,5,71,15,86,8,FALSE
npm-registry-client,4.0.2,4.0.3,98,2,71,2,73,4,FALSE
npm-registry-client,7.4.0,7.4.1,139,2,2,2,4,2,FALSE
npm-registry-client,0.3.2,0.3.3,48,2,2,2,4,2,FALSE
npm-registry-client,0.3.3,0.3.4,49,3,3,1,4,3,FALSE
npm-registry-client,0.3.0,0.3.1,46,2,5,3,8,3,FALSE
npm-registry-client,0.3.6,0.4.0,52,2,13,9,22,2,FALSE
npm-registry-client,0.3.4,0.3.5,50,2,2,2,4,2,FALSE
npm-registry-client,0.3.5,0.3.6,51,3,15,72,87,5,FALSE
npm-registry-client,7.0.2,7.0.3,125,2,56,2,58,3,FALSE
npm-registry-client,6.5.0,6.5.1,121,2,2,2,4,2,FALSE
npm-registry-client,7.0.1,7.0.2,124,3,131,58,189,50,FALSE
npm-registry-client,5.0.0,5.1.0,102,4,1026,11,1037,19,FALSE
npm-registry-client,7.0.3,7.0.4,126,3,2,3,5,3,FALSE
npm-registry-client,7.0.0,7.0.1,123,2,2,2,4,2,FALSE
npm-registry-client,6.5.1,7.0.0,122,7,777,121,898,10,FALSE
npm-registry-client,7.0.6,7.0.7,129,2,42,7,49,3,FALSE
npm-registry-client,7.0.7,7.0.8,130,3,78,10,88,4,TRUE
npm-registry-client,7.0.4,7.0.5,127,2,2,2,4,2,FALSE
npm-registry-client,7.0.5,7.0.6,128,2,7,2,9,2,FALSE
npm-registry-client,6.1.0,6.1.1,112,2,2,2,4,2,FALSE
npm-registry-client,7.0.8,7.0.9,131,2,2,2,4,2,FALSE
npm-registry-client,3.0.6,3.1.0,81,9,413,163,576,22,FALSE
npm-registry-client,0.2.27,0.2.28,41,2,4,4,8,2,TRUE
npm-registry-client,3.0.4,3.0.5,79,2,2,2,4,2,FALSE
npm-registry-client,3.0.5,3.0.6,80,2,5,5,10,2,FALSE
npm-registry-client,0.2.22,0.2.23,36,2,2,2,4,2,FALSE
npm-registry-client,3.0.3,3.0.4,78,2,2,2,4,2,TRUE
npm-registry-client,0.2.28,0.2.29,42,2,2,2,4,2,TRUE
npm-registry-client,0.2.29,0.2.30,43,2,2,2,4,2,FALSE
npm-registry-client,0.2.31,0.3.0,45,2,226,62,288,5,FALSE
npm-registry-client,0.2.30,0.2.31,44,6,63,3,66,10,FALSE
npm-registry-client,4.0.4,4.0.5,100,3,33,5,38,4,FALSE
npm-registry-client,0.2.26,0.2.27,40,2,2,2,4,2,FALSE
npm-registry-client,0.0.11,0.1.0,11,3,37,5,42,3,FALSE
npm-registry-client,0.0.10,0.0.11,10,2,12,4,16,2,FALSE
npm-registry-client,0.2.23,0.2.24,37,2,5,2,7,2,FALSE
npm-registry-client,0.2.20,0.2.21,34,2,2,2,4,2,FALSE
npm-registry-client,0.2.21,0.2.22,35,2,2,2,4,2,FALSE
npm-registry-client,0.4.9,0.4.10,62,1,1,1,2,1,FALSE
npm-registry-client,0.4.8,0.4.9,61,4,15,2,17,4,FALSE
npm-registry-client,0.4.1,0.4.2,54,2,10,8,18,8,FALSE
npm-registry-client,0.4.0,0.4.1,53,3,6,5,11,4,FALSE
npm-registry-client,0.4.3,0.4.4,56,2,2,2,4,2,FALSE
npm-registry-client,0.4.2,0.4.3,55,2,7,1,8,2,FALSE
npm-registry-client,0.4.5,0.4.6,58,2,7,1,8,2,FALSE
npm-registry-client,0.4.4,0.4.5,57,3,70,11,81,6,FALSE
npm-registry-client,0.4.7,0.4.8,60,1,1,1,2,1,FALSE
npm-registry-client,0.4.6,0.4.7,59,2,3,1,4,2,FALSE
npm-registry-client,0.2.19,0.2.20,33,2,2,1,3,2,FALSE
npm-registry-client,0.2.18,0.2.19,32,2,2,2,4,2,FALSE
npm-registry-client,0.2.17,0.2.18,31,4,23,27,50,4,FALSE
npm-registry-client,0.2.16,0.2.17,30,2,17,1,18,3,FALSE
npm-registry-client,0.2.15,0.2.16,29,1,1,1,2,1,FALSE
npm-registry-client,0.2.14,0.2.15,28,3,15,6,21,3,FALSE
npm-registry-client,0.2.13,0.2.14,27,2,2,2,4,2,FALSE
npm-registry-client,0.2.12,0.2.13,26,1,1,1,2,1,FALSE
npm-registry-client,0.2.11,0.2.12,25,4,4,4,8,4,FALSE
npm-registry-client,0.2.10,0.2.11,24,1,1,1,2,1,FALSE
npm-registry-client,0.3.1,0.3.2,47,2,5,1,6,3,FALSE
npm-registry-client,6.3.1,6.3.2,117,2,2,2,4,2,FALSE
npm-registry-client,6.3.2,6.3.3,118,3,16,5,21,4,FALSE
npm-registry-client,6.3.3,6.4.0,119,2,168,5,173,6,FALSE
npm-registry-client,6.0.3,6.0.4,107,2,6,19,25,3,FALSE
npm-registry-client,6.0.2,6.0.3,106,2,7,4,11,3,FALSE
npm-registry-client,6.0.1,6.0.2,105,2,8,5,13,3,FALSE
npm-registry-client,6.0.0,6.0.1,104,2,2,2,4,2,FALSE
npm-registry-client,6.0.7,6.1.0,111,4,109,2,111,5,TRUE
npm-registry-client,6.0.6,6.0.7,110,2,4,1,5,2,FALSE
npm-registry-client,6.0.5,6.0.6,109,2,2,2,4,2,FALSE
npm-registry-client,6.0.4,6.0.5,108,4,124,16,140,5,FALSE
npm-registry-client,5.1.0,6.0.0,103,2,57,3,60,9,FALSE
npm-registry-client,0.2.7,0.2.8,21,2,2,2,4,2,TRUE
npm-registry-client,0.2.6,0.2.7,20,2,8,2,10,2,FALSE
npm-registry-client,0.2.5,0.2.6,19,2,2,2,4,2,FALSE
npm-registry-client,0.2.1,0.2.5,18,8,15,19,34,10,FALSE
npm-registry-client,0.2.0,0.2.1,17,3,26,11,37,3,FALSE
npm-registry-client,0.1.0,0.1.1,12,2,10,5,15,2,FALSE
npm-registry-client,0.1.1,0.1.2,13,4,20,14,34,4,FALSE
npm-registry-client,0.1.2,0.1.3,14,2,3,12,15,2,FALSE
npm-registry-client,0.1.3,0.1.4,15,2,2,1,3,2,FALSE
npm-registry-client,0.1.4,0.2.0,16,3,98,119,217,8,FALSE
npm-registry-client,0.2.9,0.2.10,23,2,2,2,4,2,FALSE
npm-registry-client,0.2.8,0.2.9,22,3,4,2,6,3,FALSE
npm-registry-client,0.0.5,0.0.6,5,2,13,2,15,3,FALSE
npm-registry-client,0.0.4,0.0.5,4,2,2,2,4,2,FALSE
npm-registry-client,0.0.7,0.0.8,7,9,157,29,186,13,FALSE
npm-registry-client,0.0.6,0.0.7,6,2,2,2,4,2,FALSE
npm-registry-client,0.0.1,0.0.2,1,2,6,6,12,2,FALSE
npm-registry-client,0.0.3,0.0.4,3,2,3,3,6,3,FALSE
npm-registry-client,0.0.2,0.0.3,2,2,4,11,15,5,FALSE
npm-registry-client,0.0.9,0.0.10,9,2,20,9,29,4,FALSE
npm-registry-client,0.0.8,0.0.9,8,7,65,18,83,8,FALSE
npm-registry-client,6.1.2,6.2.0,114,2,2,2,4,2,FALSE
npm-registry-client,7.1.1,7.1.2,134,2,2,2,4,2,FALSE
npm-registry-client,6.4.0,6.5.0,120,4,170,43,213,7,FALSE
npm-registry-client,3.2.4,4.0.0,95,10,2394,1587,3981,117,FALSE
npm-registry-client,3.2.0,3.2.1,91,3,159,43,202,7,FALSE
npm-registry-client,3.2.1,3.2.2,92,3,148,12,160,8,FALSE
npm-registry-client,3.2.2,3.2.3,93,3,2,5,7,3,FALSE
npm-registry-client,3.2.3,3.2.4,94,2,2,2,4,2,FALSE
npm-registry-client,1.0.0,1.0.1,66,1,1,1,2,1,FALSE
npm-registry-client,1.0.1,2.0.0,67,17,891,480,1371,96,FALSE
npm-registry-client,3.1.8,3.2.0,90,4,11,6,17,4,FALSE
npm-registry-client,4.0.5,5.0.0,101,5,177,73,250,13,FALSE
npm-registry-client,6.1.1,6.1.2,113,5,2009,2031,4040,75,FALSE
npm-registry-client,7.0.7,7.0.8,130,3,78,10,88,4,FALSE
npm-registry-client,0.2.27,0.2.28,41,2,4,4,8,2,FALSE
npm-registry-client,3.0.3,3.0.4,78,2,2,2,4,2,FALSE
npm-registry-client,3.0.0,3.0.1,75,2,49,1,50,2,FALSE
npm-registry-client,3.0.1,3.0.2,76,4,90,7,97,5,FALSE
npm-registry-client,0.2.28,0.2.29,42,2,2,2,4,2,FALSE
npm-registry-client,0.4.11,0.4.12,64,7,14,35,49,13,FALSE
npm-registry-client,0.4.10,0.4.11,63,7,20,18,38,7,FALSE
npm-registry-client,0.4.12,1.0.0,65,1,20,41,61,4,FALSE
npm-registry-client,6.2.0,6.3.0,115,2,2,2,4,2,FALSE
npm-registry-client,2.0.6,2.0.7,73,4,10,6,16,4,FALSE
npm-registry-client,2.0.4,2.0.6,72,9,401,139,540,21,FALSE
npm-registry-client,2.0.3,2.0.4,71,12,113,42,155,14,FALSE
npm-registry-client,2.0.2,2.0.3,70,15,626,309,935,42,FALSE
npm-registry-client,2.0.1,2.0.2,69,1,1,1,2,1,FALSE
npm-registry-client,2.0.0,2.0.1,68,3,5,3,8,3,FALSE
npm-registry-client,0.2.24,0.2.25,38,2,3,3,6,3,FALSE
npm-registry-client,0.2.25,0.2.26,39,3,12,6,18,4,FALSE
npm-registry-client,3.0.2,3.0.3,77,1,1,1,2,1,FALSE
npm-registry-client,6.3.0,6.3.1,116,1,1,1,2,1,FALSE
npm-registry-client,6.0.7,6.1.0,111,4,109,2,111,5,FALSE
npm-registry-client,0.2.7,0.2.8,21,2,2,2,4,2,FALSE
npm-registry-client,7.0.8,7.0.9,131,2,2,2,4,2,TRUE
npm-registry-client,0.0.7,0.0.8,7,9,157,29,186,13,TRUE
npm-registry-client,0.2.26,0.2.27,40,2,2,2,4,2,TRUE
npm-registry-client,0.2.12,0.2.13,26,1,1,1,2,1,TRUE
npm-registry-client,0.2.1,0.2.5,18,8,15,19,34,10,TRUE
npm-registry-client,0.2.10,0.2.11,24,1,1,1,2,1,TRUE
npm-registry-client,0.0.2,0.0.3,2,2,4,11,15,5,TRUE
npm-registry-client,3.2.1,3.2.2,92,3,148,12,160,8,TRUE
npm-registry-client,7.4.5,7.4.6,144,8,40,44,84,12,TRUE
npm-registry-client,6.3.0,6.3.1,116,1,1,1,2,1,TRUE
stresser,2.0.2,2.0.3,6,4,52,17,69,6,FALSE
stresser,2.0.1,2.0.2,5,3,19,5,24,5,FALSE
stresser,2.0.0,2.0.1,4,2,2,2,4,3,FALSE
stresser,0.1.0,0.1.1,1,1,6,9,15,2,FALSE
stresser,0.1.1,1.0.0,2,10,678,390,1068,28,TRUE
stresser,1.0.0,2.0.0,3,2,461,218,679,11,FALSE
stresser,0.1.1,1.0.0,2,10,678,390,1068,28,FALSE
grunt-filerev-qiniu,0.1.0,0.1.1,1,2,396,1,397,14,FALSE
grunt-filerev-qiniu,0.1.1,0.1.2,2,1,68,21,89,3,FALSE
grunt-filerev-qiniu,0.1.2,0.1.3,3,3,134,90,224,17,FALSE
grunt-filerev-qiniu,0.1.3,0.1.4,4,2,96,37,133,6,FALSE
grunt-filerev-qiniu,0.1.3,0.1.4,4,2,96,37,133,6,TRUE
mdl-ext,0.6.0-beta.2,0.6.0,28,1,16,10,26,6,FALSE
mdl-ext,0.6.0-beta.1,0.6.0-beta.2,27,2,175,155,330,72,FALSE
mdl-ext,0.6.0-beta.0,0.6.0-beta.1,26,4,930,464,1394,128,FALSE
mdl-ext,0.3.0-beta.0,0.3.0,15,2,14,13,27,3,FALSE
mdl-ext,0.3.0,0.4.0-beta.0,16,6,2172,651,2823,88,FALSE
mdl-ext,0.8.11,0.8.12,57,2,12,10,22,10,FALSE
mdl-ext,0.8.10,0.8.11,56,3,143,70,213,34,FALSE
mdl-ext,0.8.12,0.9.0-beta.0,58,8,6466,1584,8050,160,FALSE
mdl-ext,0.17.0,0.17.1,119,2,1002,620,1622,80,FALSE
mdl-ext,0.6.6-beta.0,0.6.6,38,1,2,2,4,1,FALSE
mdl-ext,0.6.4-beta.0,0.6.4,35,1,802,95,897,8,FALSE
mdl-ext,0.7.0-beta.0,0.7.0,40,2,1219,100,1319,12,FALSE
mdl-ext,0.13.11-beta.1,0.13.11-beta.2,103,2,13399,28,13427,58,FALSE
mdl-ext,0.13.11-beta.0,0.13.11-beta.1,102,1,12,4,16,4,FALSE
mdl-ext,0.13.11-beta.3,0.13.11-beta.4,105,4,81,623,704,33,FALSE
mdl-ext,0.13.11-beta.2,0.13.11-beta.3,104,2,105,13248,13353,64,FALSE
mdl-ext,0.13.11-beta.5,0.13.11-beta.6,107,1,8,2,10,1,FALSE
mdl-ext,0.13.11-beta.4,0.13.11-beta.5,106,1,22,5,27,3,FALSE
mdl-ext,0.13.11-beta.7,0.14.0,109,1,9,13,22,5,FALSE
mdl-ext,0.13.11-beta.6,0.13.11-beta.7,108,2,1176,218,1394,44,FALSE
mdl-ext,0.8.0-beta.0,0.8.0,45,1,124,11,135,25,FALSE
mdl-ext,0.12.0-beta.3,0.12.0-beta.4,87,5,1514,1155,2669,70,FALSE
mdl-ext,0.12.0-beta.2,0.12.0-beta.3,86,3,635,151,786,29,FALSE
mdl-ext,0.9.18,0.9.19,78,11,2705,2409,5114,123,FALSE
mdl-ext,0.9.19,0.9.20,79,5,226,196,422,48,FALSE
mdl-ext,0.5.2,0.6.0-beta.0,25,8,6496,4051,10547,132,FALSE
mdl-ext,0.12.0-beta.5,0.12.3,89,10,551,327,878,108,FALSE
mdl-ext,0.12.0-beta.4,0.12.0-beta.5,88,3,53,81,134,15,FALSE
mdl-ext,0.9.12,0.9.13,72,23,12724,10974,23698,434,FALSE
mdl-ext,0.9.13,0.9.14,73,2,28,42,70,14,FALSE
mdl-ext,0.9.10,0.9.11,70,5,2914,1690,4604,72,FALSE
mdl-ext,0.9.11,0.9.12,71,2,31,52,83,12,FALSE
mdl-ext,0.9.16,0.9.17,76,1,61,41,102,12,FALSE
mdl-ext,0.9.17,0.9.18,77,3,351,255,606,41,FALSE
mdl-ext,0.9.14,0.9.15,74,2,302,269,571,9,FALSE
mdl-ext,0.9.15,0.9.16,75,1,771,256,1027,18,FALSE
mdl-ext,0.6.2-beta.0,0.6.2,32,2,16,20,36,10,FALSE
mdl-ext,0.6.1-beta.0,0.6.1,30,1,1,1,2,1,FALSE
mdl-ext,0.12.0-beta.1,0.12.0-beta.2,85,3,1552,966,2518,57,FALSE
mdl-ext,0.12.0-beta.0,0.12.0-beta.1,84,5,446,227,673,54,FALSE
mdl-ext,0.16.0,0.17.0,118,2,107,9,116,9,FALSE
mdl-ext,0.15.0,0.15.1,115,2,51,28,79,15,FALSE
mdl-ext,0.15.1,0.15.2,116,10,373,379,752,105,FALSE
mdl-ext,0.15.2,0.16.0,117,4,3307,1934,5241,54,FALSE
mdl-ext,0.9.0-beta.0,0.9.0,59,1,1,1,2,1,FALSE
mdl-ext,0.15.0-beta.2,0.15.0-beta.3,113,1,53,133,186,13,FALSE
mdl-ext,0.15.0-beta.3,0.15.0,114,5,599,293,892,41,FALSE
mdl-ext,0.15.0-beta.0,0.15.0-beta.1,111,3,826,434,1260,26,FALSE
mdl-ext,0.15.0-beta.1,0.15.0-beta.2,112,2,482,157,639,34,FALSE
mdl-ext,0.2.0-beta.3,0.2.0,11,2,14,14,28,4,FALSE
mdl-ext,0.2.0-beta.2,0.2.0-beta.3,10,1,84,65,149,13,FALSE
mdl-ext,0.2.0-beta.1,0.2.0-beta.2,9,1,4,4,8,4,FALSE
mdl-ext,0.2.0-beta.0,0.2.0-beta.1,8,1,232,103,335,12,FALSE
mdl-ext,0.9.21,0.10.0,81,2,1198,469,1667,27,FALSE
mdl-ext,0.9.20,0.9.21,80,1,263,1502,1765,53,FALSE
mdl-ext,0.6.3,0.6.4-beta.0,34,3,1200,475,1675,20,FALSE
mdl-ext,0.6.2,0.6.3,33,3,317,326,643,27,FALSE
mdl-ext,0.6.1,0.6.2-beta.0,31,1,32,27,59,26,FALSE
mdl-ext,0.6.0,0.6.1-beta.0,29,17,4830,1231,6061,231,FALSE
mdl-ext,0.11.0,0.12.0-beta.0,83,39,13149,7081,20230,489,FALSE
mdl-ext,0.6.6,0.7.0-beta.0,39,2,7916,32,7948,31,FALSE
mdl-ext,0.6.5,0.6.6-beta.0,37,4,415,434,849,28,FALSE
mdl-ext,0.6.4,0.6.5,36,2,18,14,32,5,FALSE
mdl-ext,0.13.8,0.13.9,99,25,716,785,1501,133,FALSE
mdl-ext,0.13.9,0.13.10,100,1,23,12,35,5,FALSE
mdl-ext,0.4.1,0.4.2,21,1,6,6,12,1,FALSE
mdl-ext,0.4.0,0.4.1-beta.0,18,2,554,448,1002,25,FALSE
mdl-ext,0.13.4,0.13.5,95,1,4,4,8,2,FALSE
mdl-ext,0.4.2,0.5.0-beta.0,22,1,1858,70,1928,31,FALSE
mdl-ext,0.13.2,0.13.3,93,1,60,26,86,7,FALSE
mdl-ext,0.13.3,0.13.4,94,1,1,1,2,1,FALSE
mdl-ext,0.13.0,0.13.1,91,8,1117,1546,2663,117,FALSE
mdl-ext,0.13.1,0.13.2,92,1,908,1337,2245,46,FALSE
mdl-ext,0.8.9,0.8.10,55,1,56,21,77,15,FALSE
mdl-ext,0.14.0,0.15.0-beta.0,110,11,3558,1206,4764,126,FALSE
mdl-ext,0.8.5,0.8.6,51,1,633,246,879,11,FALSE
mdl-ext,0.8.4,0.8.5,50,4,1816,523,2339,56,FALSE
mdl-ext,0.8.7,0.8.8,53,1,20,8,28,11,FALSE
mdl-ext,0.8.6,0.8.7,52,1,223,182,405,17,FALSE
mdl-ext,0.8.1,0.8.2,47,2,165,108,273,21,FALSE
mdl-ext,0.8.0,0.8.1,46,2,115,22,137,13,FALSE
mdl-ext,0.8.3,0.8.4,49,2,1293,314,1607,44,FALSE
mdl-ext,0.8.2,0.8.3,48,2,649,843,1492,23,FALSE
mdl-ext,0.13.6,0.13.7,97,1,3,3,6,3,FALSE
mdl-ext,0.13.7,0.13.8,98,1,260,115,375,10,FALSE
mdl-ext,0.13.5,0.13.6,96,1,202,97,299,18,FALSE
mdl-ext,0.4.1-beta.0,0.4.1-beta.1,19,1,635,603,1238,13,FALSE
mdl-ext,0.4.1-beta.1,0.4.1,20,3,208,158,366,11,FALSE
mdl-ext,0.2.1,0.2.2,13,1,1,1,2,1,FALSE
mdl-ext,0.2.2,0.3.0-beta.0,14,6,4295,954,5249,116,FALSE
mdl-ext,0.5.0-beta.0,0.5.1,23,4,5118,2711,7829,38,FALSE
mdl-ext,0.2.0,0.2.1,12,4,143,362,505,9,FALSE
mdl-ext,0.1.0,0.1.1,5,3,69,379,448,16,FALSE
mdl-ext,0.1.1,0.1.2,6,1,1,1,2,1,FALSE
mdl-ext,0.1.2,0.2.0-beta.0,7,1,1083,66,1149,15,FALSE
mdl-ext,0.8.8,0.8.9,54,1,179,170,349,15,FALSE
mdl-ext,0.10.0,0.11.0,82,3,228,5,233,7,FALSE
mdl-ext,0.0.1,0.1.0,4,3,70,16,86,6,FALSE
mdl-ext,0.7.2,0.7.3,43,3,522,448,970,31,FALSE
mdl-ext,0.7.3,0.8.0-beta.0,44,1,1785,168,1953,48,FALSE
mdl-ext,0.7.0,0.7.1,41,9,523,356,879,33,FALSE
mdl-ext,0.7.1,0.7.2,42,8,3540,1729,5269,67,FALSE
mdl-ext,0.12.3,0.13.0,90,3,1156,40,1196,33,FALSE
mdl-ext,0.0.1-beta.2,0.0.1,3,7,309,239,548,17,FALSE
mdl-ext,0.5.1,0.5.2,24,2,837,817,1654,10,FALSE
mdl-ext,0.0.1-beta.0,0.0.1-beta.1,1,1,802,95,897,8,FALSE
mdl-ext,0.0.1-beta.1,0.0.1-beta.2,2,2,3,3,6,2,FALSE
mdl-ext,0.9.0,0.9.1,60,1,59,55,114,23,FALSE
mdl-ext,0.9.1,0.9.2,61,2,105,87,192,14,FALSE
mdl-ext,0.9.2,0.9.3,62,1,25,43,68,5,FALSE
mdl-ext,0.9.3,0.9.4,63,1,21,29,50,5,FALSE
mdl-ext,0.9.4,0.9.5,64,1,2,2,4,2,FALSE
mdl-ext,0.9.5,0.9.6,65,1,16,16,32,16,FALSE
mdl-ext,0.9.6,0.9.7,66,2,204,52,256,26,FALSE
mdl-ext,0.9.7,0.9.8,67,2,476,28,504,30,FALSE
mdl-ext,0.9.8,0.9.9,68,5,1314,460,1774,82,FALSE
mdl-ext,0.9.9,0.9.10,69,15,4251,2974,7225,179,FALSE
mdl-ext,0.13.10,0.13.11-beta.0,101,3,664,299,963,47,FALSE
mdl-ext,0.4.0-beta.0,0.4.0,17,3,339,75,414,30,FALSE
mdl-ext,0.12.0-beta.5,0.12.3,89,10,551,327,878,108,TRUE
mdl-ext,0.9.10,0.9.11,70,5,2914,1690,4604,72,TRUE
mdl-ext,0.13.8,0.13.9,99,25,716,785,1501,133,TRUE
mdl-ext,0.2.0-beta.0,0.2.0-beta.1,8,1,232,103,335,12,TRUE
mdl-ext,0.6.3,0.6.4-beta.0,34,3,1200,475,1675,20,TRUE
mdl-ext,0.13.1,0.13.2,92,1,908,1337,2245,46,TRUE
mdl-ext,0.6.5,0.6.6-beta.0,37,4,415,434,849,28,TRUE
mdl-ext,0.4.1-beta.0,0.4.1-beta.1,19,1,635,603,1238,13,TRUE
mdl-ext,0.13.11-beta.1,0.13.11-beta.2,103,2,13399,28,13427,58,TRUE
mdl-ext,0.6.6-beta.0,0.6.6,38,1,2,2,4,1,TRUE
mdl-ext,0.15.0-beta.3,0.15.0,114,5,599,293,892,41,TRUE
mdl-ext,0.9.12,0.9.13,72,23,12724,10974,23698,434,TRUE
mdl-ext,0.15.0-beta.1,0.15.0-beta.2,112,2,482,157,639,34,TRUE
mdl-ext,0.4.0-beta.0,0.4.0,17,3,339,75,414,30,TRUE
mdl-ext,0.5.0-beta.0,0.5.1,23,4,5118,2711,7829,38,TRUE
mdl-ext,0.8.12,0.9.0-beta.0,58,8,6466,1584,8050,160,TRUE
mdl-ext,0.13.3,0.13.4,94,1,1,1,2,1,TRUE
mdl-ext,0.9.9,0.9.10,69,15,4251,2974,7225,179,TRUE
magicbook-codesplit,0.0.5,0.0.6,5,2,18,44,62,5,FALSE
magicbook-codesplit,0.0.4,0.0.5,4,1,6,6,12,2,FALSE
magicbook-codesplit,0.0.7,0.0.8,7,7,106,26,132,13,FALSE
magicbook-codesplit,0.0.6,0.0.7,6,6,206,95,301,12,FALSE
magicbook-codesplit,0.0.9,0.0.10,9,2,84,38,122,6,FALSE
magicbook-codesplit,0.0.8,0.0.9,8,1,57,57,114,4,FALSE
magicbook-codesplit,0.0.10,0.1.0,10,4,143,65,208,12,FALSE
magicbook-codesplit,0.1.0,0.1.1,11,3,10,5,15,6,FALSE
magicbook-codesplit,0.1.1,0.1.2,12,1,39,8,47,6,FALSE
magicbook-codesplit,0.0.1,0.0.2,1,3,273,2,275,11,FALSE
magicbook-codesplit,0.0.3,0.0.4,3,3,91,10,101,6,FALSE
magicbook-codesplit,0.0.2,0.0.3,2,1,2,1,3,1,FALSE
magicbook-codesplit,0.0.10,0.1.0,10,4,143,65,208,12,TRUE
pretur.sequelize,0.9.0,0.9.1,20,2,75,54,129,15,FALSE
pretur.sequelize,0.9.1,0.9.2,21,6,78,73,151,23,FALSE
pretur.sequelize,0.9.2,0.9.3,22,2,30,34,64,14,TRUE
pretur.sequelize,0.15.3,0.15.5,33,2,32,31,63,15,FALSE
pretur.sequelize,0.9.4,0.10.0,24,39,4738,4193,8931,364,FALSE
pretur.sequelize,0.12.0,0.13.0,27,6,106,81,187,23,FALSE
pretur.sequelize,0.14.0,0.15.0,29,5,200,111,311,31,FALSE
pretur.sequelize,0.10.0,0.11.0,25,38,959,1066,2025,151,FALSE
pretur.sequelize,0.3.2,0.4.0,17,16,475,271,746,55,FALSE
pretur.sequelize,0.3.1,0.3.2,16,2,192,117,309,66,FALSE
pretur.sequelize,0.11.0,0.12.0,26,1,2,2,4,2,FALSE
pretur.sequelize,0.17.0,0.17.1,39,3,565,50,615,31,FALSE
pretur.sequelize,0.16.4,0.17.0,38,4,199,233,432,63,FALSE
pretur.sequelize,0.17.1,0.18.0,40,10,216,931,1147,42,FALSE
pretur.sequelize,0.16.2,0.16.4,37,4,57,53,110,19,FALSE
pretur.sequelize,0.16.0,0.16.2,36,4,33,32,65,16,FALSE
pretur.sequelize,0.4.0,0.5.0,18,22,295,154,449,50,FALSE
pretur.sequelize,0.5.0,0.9.0,19,9,290,110,400,34,TRUE
pretur.sequelize,0.13.0,0.14.0,28,15,1443,685,2128,59,FALSE
pretur.sequelize,0.15.0,0.15.1,30,1,29,29,58,12,FALSE
pretur.sequelize,0.15.1,0.15.2,31,1,2,2,4,2,FALSE
pretur.sequelize,0.15.2,0.15.3,32,3,107,85,192,28,FALSE
pretur.sequelize,0.9.3,0.9.4,23,1,26,26,52,11,FALSE
pretur.sequelize,0.19.0,0.19.1,42,7,520,223,743,35,FALSE
pretur.sequelize,0.15.5,0.15.6,34,2,7,7,14,4,FALSE
pretur.sequelize,0.15.6,0.16.0,35,15,1420,2003,3423,91,FALSE
pretur.sequelize,0.18.0,0.19.0,41,11,1215,1013,2228,111,FALSE
pretur.sequelize,0.2.7,0.2.8,10,1,2,2,4,2,FALSE
pretur.sequelize,0.2.6,0.2.7,9,1,2,2,4,2,FALSE
pretur.sequelize,0.2.5,0.2.6,8,1,2,2,4,2,FALSE
pretur.sequelize,0.2.4,0.2.5,7,1,2,2,4,2,FALSE
pretur.sequelize,0.2.3,0.2.4,6,1,2,2,4,2,FALSE
pretur.sequelize,0.2.2,0.2.3,5,1,2,2,4,2,FALSE
pretur.sequelize,0.2.1,0.2.2,4,1,2,2,4,2,FALSE
pretur.sequelize,0.2.0,0.2.1,3,1,2,2,4,2,FALSE
pretur.sequelize,0.1.0,0.2.0,2,1,2,2,4,2,FALSE
pretur.sequelize,0.2.9,0.2.10,12,1,2,2,4,2,FALSE
pretur.sequelize,0.0.1,0.1.0,1,1,2,2,4,2,FALSE
pretur.sequelize,0.3.0,0.3.1,15,1,1050,0,1050,9,FALSE
pretur.sequelize,0.2.8,0.2.9,11,1,2,2,4,2,FALSE
pretur.sequelize,0.2.11,0.3.0,14,57,10772,1197,11969,313,FALSE
pretur.sequelize,0.2.10,0.2.11,13,1,2,2,4,2,FALSE
pretur.sequelize,0.9.2,0.9.3,22,2,30,34,64,14,FALSE
pretur.sequelize,0.3.1,0.3.2,16,2,192,117,309,66,TRUE
pretur.sequelize,0.5.0,0.9.0,19,9,290,110,400,34,FALSE
pretur.sequelize,0.2.4,0.2.5,7,1,2,2,4,2,TRUE
pretur.sequelize,0.2.10,0.2.11,13,1,2,2,4,2,TRUE
pretur.sequelize,0.2.5,0.2.6,8,1,2,2,4,2,TRUE
pretur.sequelize,0.15.5,0.15.6,34,2,7,7,14,4,TRUE
pretur.sequelize,0.15.2,0.15.3,32,3,107,85,192,28,TRUE
pretur.sequelize,0.19.0,0.19.1,42,7,520,223,743,35,TRUE
pretur.sequelize,0.14.0,0.15.0,29,5,200,111,311,31,TRUE
pretur.sequelize,0.10.0,0.11.0,25,38,959,1066,2025,151,TRUE
pretur.sequelize,0.3.2,0.4.0,17,16,475,271,746,55,TRUE
pretur.sequelize,0.3.0,0.3.1,15,1,1050,0,1050,9,TRUE
pretur.sequelize,0.17.0,0.17.1,39,3,565,50,615,31,TRUE
pretur.sequelize,0.12.0,0.13.0,27,6,106,81,187,23,TRUE
pretur.sequelize,0.17.1,0.18.0,40,10,216,931,1147,42,TRUE
pretur.sequelize,0.16.0,0.16.2,36,4,33,32,65,16,TRUE
pretur.sequelize,0.13.0,0.14.0,28,15,1443,685,2128,59,TRUE
pretur.sequelize,0.18.0,0.19.0,41,11,1215,1013,2228,111,TRUE
pretur.sequelize,0.16.4,0.17.0,38,4,199,233,432,63,TRUE
pretur.sequelize,0.2.8,0.2.9,11,1,2,2,4,2,TRUE
simple-adb,1.6.2,1.6.3,17,1,1,1,2,1,FALSE
simple-adb,1.6.3,1.7.0,18,2,25,1,26,2,FALSE
simple-adb,1.6.0,1.6.1,15,2,6,2,8,2,FALSE
simple-adb,1.6.1,1.6.2,16,1,1,1,2,1,FALSE
simple-adb,1.7.7,1.7.8,26,1,1,1,2,1,FALSE
simple-adb,1.7.6,1.7.7,25,2,7,9,16,2,FALSE
simple-adb,1.7.5,1.7.6,24,3,73,3,76,3,FALSE
simple-adb,1.7.4,1.7.5,23,1,1,1,2,1,FALSE
simple-adb,1.7.3,1.7.4,22,3,98,8,106,5,FALSE
simple-adb,1.7.2,1.7.3,21,2,28,1,29,2,FALSE
simple-adb,1.7.1,1.7.2,20,1,1,1,2,1,FALSE
simple-adb,1.7.0,1.7.1,19,2,18,1,19,2,FALSE
simple-adb,1.4.0,1.4.1,6,2,2,2,4,2,FALSE
simple-adb,1.4.1,1.4.2,7,2,4,4,8,2,FALSE
simple-adb,1.4.2,1.4.3,8,2,7,2,9,2,FALSE
simple-adb,1.4.3,1.4.4,9,2,16,11,27,2,FALSE
simple-adb,1.4.4,1.5.0,10,2,24,1,25,2,FALSE
simple-adb,1.5.1,1.5.2,12,3,6,5,11,3,FALSE
simple-adb,1.5.0,1.5.1,11,2,13,1,14,3,FALSE
simple-adb,1.5.3,1.6.0,14,7,173,60,233,10,FALSE
simple-adb,1.5.2,1.5.3,13,2,19,1,20,2,FALSE
simple-adb,1.3.0,1.4.0,5,2,99,15,114,2,FALSE
simple-adb,1.1.0,1.2.0,2,6,175,7,182,6,FALSE
simple-adb,1.0.0,1.1.0,1,2,99,9,108,3,FALSE
simple-adb,1.7.7,1.7.8,26,1,1,1,2,1,TRUE
simple-adb,1.2.0,1.2.1,3,2,12,1,13,2,FALSE
simple-adb,1.2.1,1.3.0,4,6,97,50,147,7,FALSE
simple-adb,1.4.3,1.4.4,9,2,16,11,27,2,TRUE
simple-adb,1.1.0,1.2.0,2,6,175,7,182,6,TRUE
simple-adb,1.6.1,1.6.2,16,1,1,1,2,1,TRUE
apeman-react-captcha,1.0.4,1.0.5,5,3,18,15,33,11,FALSE
apeman-react-captcha,1.0.5,1.0.6,6,2,62,17,79,7,FALSE
apeman-react-captcha,1.0.6,1.0.7,7,2,76,31,107,7,FALSE
apeman-react-captcha,1.0.7,1.0.8,8,3,38,31,69,9,FALSE
apeman-react-captcha,1.0.0,1.0.1,1,5,16265,4330,20595,47,FALSE
apeman-react-captcha,1.0.1,1.0.2,2,2,13,13,26,7,FALSE
apeman-react-captcha,1.0.2,1.0.3,3,2,1169,574,1743,5,FALSE
apeman-react-captcha,1.0.3,1.0.4,4,2,8,4,12,3,FALSE
apeman-react-captcha,2.0.0,2.0.1,14,3,3640,29560,33200,49,FALSE
apeman-react-captcha,1.0.8,1.0.9,9,1,2,2,4,2,FALSE
apeman-react-captcha,1.0.9,1.0.10,10,1,3030,2192,5222,10,FALSE
apeman-react-captcha,1.0.12,2.0.0,13,2,6378,33711,40089,41,FALSE
apeman-react-captcha,1.0.10,1.0.11,11,1,5,5,10,3,FALSE
apeman-react-captcha,2.0.1,2.0.2,15,1,12,12,24,8,FALSE
apeman-react-captcha,1.0.11,1.0.12,12,1,7,7,14,3,TRUE
apeman-react-captcha,2.0.7,2.0.8,21,3,93,109,202,13,FALSE
apeman-react-captcha,2.0.6,2.0.7,20,2,170,162,332,15,FALSE
apeman-react-captcha,3.1.1,3.1.2,27,3,61,67,128,7,FALSE
apeman-react-captcha,2.0.4,2.0.5,18,4,27,3454,3481,11,FALSE
apeman-react-captcha,2.0.3,2.0.4,17,5,8301,11015,19316,59,FALSE
apeman-react-captcha,3.0.0,3.0.1,23,2,12,15,27,8,FALSE
apeman-react-captcha,3.0.1,3.0.2,24,2,65,37,102,9,FALSE
apeman-react-captcha,2.0.5,2.0.6,19,7,180,150,330,23,FALSE
apeman-react-captcha,2.0.8,3.0.0,22,3,209,315,524,30,FALSE
apeman-react-captcha,3.1.0,3.1.1,26,2,9,8,17,4,FALSE
apeman-react-captcha,3.1.2,3.1.3,28,3,27,28,55,8,FALSE
apeman-react-captcha,3.1.3,3.1.4,29,2,18,19,37,5,FALSE
apeman-react-captcha,3.0.2,3.1.0,25,2,219,228,447,10,FALSE
apeman-react-captcha,2.0.2,2.0.3,16,1,1866,1553,3419,4,FALSE
apeman-react-captcha,1.0.11,1.0.12,12,1,7,7,14,3,FALSE
apeman-react-captcha,3.0.1,3.0.2,24,2,65,37,102,9,TRUE
apeman-react-captcha,2.0.8,3.0.0,22,3,209,315,524,30,TRUE
apeman-react-captcha,2.0.4,2.0.5,18,4,27,3454,3481,11,TRUE
apeman-react-captcha,2.0.2,2.0.3,16,1,1866,1553,3419,4,TRUE
apeman-react-captcha,1.0.2,1.0.3,3,2,1169,574,1743,5,TRUE
apeman-react-captcha,2.0.6,2.0.7,20,2,170,162,332,15,TRUE
apeman-react-captcha,1.0.12,2.0.0,13,2,6378,33711,40089,41,TRUE
apeman-react-captcha,3.1.3,3.1.4,29,2,18,19,37,5,TRUE
clientkit-scripts,0.0.1,0.0.2,1,7,22,14,36,8,FALSE
clientkit-scripts,0.0.1,0.0.2,1,7,22,14,36,8,TRUE
tinper-neoui,3.1.3,3.1.4,7,7,183510,114149,297659,137,FALSE
tinper-neoui,3.1.2,3.1.3,6,7,15821,19835,35656,41,FALSE
tinper-neoui,3.1.1,3.1.2,5,2,12,7,19,3,FALSE
tinper-neoui,3.1.7,3.1.8,11,2,18578,75167,93745,63,FALSE
tinper-neoui,3.1.6,3.1.7,10,16,131313,95002,226315,233,FALSE
tinper-neoui,3.1.5,3.1.6,9,5,57695,32251,89946,37,FALSE
tinper-neoui,3.1.4,3.1.5,8,11,103550,90291,193841,131,FALSE
tinper-neoui,3.1.9,3.1.12,13,7,97271,86828,184099,99,FALSE
tinper-neoui,3.1.8,3.1.9,12,4,82817,10051,92868,51,FALSE
tinper-neoui,0.1.0,0.1.1,3,4,40475,42376,82851,81,FALSE
tinper-neoui,0.1.1,3.1.1,4,13,89788,5325,95113,124,FALSE
tinper-neoui,0.0.1,0.0.2,1,1,360,348,708,39,FALSE
tinper-neoui,0.0.2,0.1.0,2,1,2,2,4,1,FALSE
tinper-neoui,3.1.22,3.1.23,24,3,5214,5022,10236,22,FALSE
tinper-neoui,3.1.23,3.1.24,25,6,5041,19048,24089,45,FALSE
tinper-neoui,3.1.20,3.1.21,22,5,11847,12139,23986,22,FALSE
tinper-neoui,3.1.21,3.1.22,23,15,9189,9764,18953,61,FALSE
tinper-neoui,3.1.26,3.1.27,28,6,38969,44424,83393,1159,FALSE
tinper-neoui,3.1.27,3.2.0,29,18,470772,69619,540391,628,FALSE
tinper-neoui,3.1.24,3.1.25,26,3,14192,9,14201,9,FALSE
tinper-neoui,3.1.25,3.1.26,27,9,37529,47609,85138,468,FALSE
tinper-neoui,3.1.13,3.1.14,15,7,182374,98170,280544,135,FALSE
tinper-neoui,3.1.12,3.1.13,14,12,105265,106122,211387,180,FALSE
tinper-neoui,3.1.17,3.1.18,19,35,25498,105478,130976,177,FALSE
tinper-neoui,3.1.16,3.1.17,18,11,11015,93758,104773,103,FALSE
tinper-neoui,3.1.15,3.1.16,17,19,93642,93489,187131,169,FALSE
tinper-neoui,3.1.14,3.1.15,16,5,177864,10097,187961,109,FALSE
tinper-neoui,3.1.19,3.1.20,21,23,10422,10216,20638,58,FALSE
tinper-neoui,3.1.18,3.1.19,20,16,10357,10204,20561,45,FALSE
tinper-neoui,3.2.0,3.2.1,30,12,242,3988,4230,47,FALSE
tinper-neoui,3.2.1,3.2.3,31,19,13051,12527,25578,400,FALSE
tinper-neoui,3.1.2,3.1.3,6,7,15821,19835,35656,41,TRUE
tinper-neoui,0.0.2,0.1.0,2,1,2,2,4,1,TRUE
tinper-neoui,3.1.3,3.1.4,7,7,183510,114149,297659,137,TRUE
tinper-neoui,3.1.15,3.1.16,17,19,93642,93489,187131,169,TRUE
tinper-neoui,3.2.1,3.2.3,31,19,13051,12527,25578,400,TRUE
tinper-neoui,3.1.1,3.1.2,5,2,12,7,19,3,TRUE
tinper-neoui,3.1.9,3.1.12,13,7,97271,86828,184099,99,TRUE
tinper-neoui,0.1.0,0.1.1,3,4,40475,42376,82851,81,TRUE
tinper-neoui,0.0.1,0.0.2,1,1,360,348,708,39,TRUE
tinper-neoui,3.1.5,3.1.6,9,5,57695,32251,89946,37,TRUE
tinper-neoui,0.1.1,3.1.1,4,13,89788,5325,95113,124,TRUE
tinper-neoui,3.1.26,3.1.27,28,6,38969,44424,83393,1159,TRUE
tinper-neoui,3.1.7,3.1.8,11,2,18578,75167,93745,63,TRUE
tinper-neoui,3.1.4,3.1.5,8,11,103550,90291,193841,131,TRUE
tinper-neoui,3.1.8,3.1.9,12,4,82817,10051,92868,51,TRUE
tinper-neoui,3.1.13,3.1.14,15,7,182374,98170,280544,135,TRUE
tinper-neoui,3.1.16,3.1.17,18,11,11015,93758,104773,103,TRUE
actor-sdk,1.0.240,1.0.241,190,1,1,1,2,1,FALSE
actor-sdk,1.0.241,1.0.242,191,1,1,1,2,1,FALSE
actor-sdk,1.0.242,1.0.243,192,1,18,19,37,7,FALSE
actor-sdk,1.0.243,1.0.244,193,1,278,306,584,22,FALSE
actor-sdk,1.0.244,1.0.245,194,1,201,246,447,24,FALSE
actor-sdk,1.0.245,1.0.246,195,1,576,141,717,34,FALSE
actor-sdk,1.0.246,1.0.247,196,1,1,1,2,1,FALSE
actor-sdk,1.0.247,1.0.248,197,1,4,4,8,4,FALSE
actor-sdk,1.0.248,1.0.249,198,1,302,197,499,30,FALSE
actor-sdk,1.0.249,1.0.250,199,1,27,10,37,7,FALSE
actor-sdk,1.0.400,1.0.401,323,1,16,6,22,4,FALSE
actor-sdk,1.0.401,1.0.402,324,1,6,12,18,4,FALSE
actor-sdk,1.0.406,1.0.407,329,1,1,1,2,1,FALSE
actor-sdk,1.0.407,1.0.408,330,1,1,1,2,1,FALSE
actor-sdk,1.0.404,1.0.405,327,1,127,127,254,131,FALSE
actor-sdk,1.0.405,1.0.406,328,1,1,1,2,1,FALSE
actor-sdk,1.0.152,1.0.153,113,1,145,68,213,21,FALSE
actor-sdk,1.0.166,1.0.168,125,1,491,438,929,213,FALSE
actor-sdk,1.0.161,1.0.162,122,1,9111,8856,17967,407,FALSE
actor-sdk,1.0.160,1.0.161,121,1,1,1,2,1,FALSE
actor-sdk,1.0.163,1.0.166,124,1,1898,945,2843,359,FALSE
actor-sdk,1.0.162,1.0.163,123,1,446,220,666,25,FALSE
actor-sdk,1.0.105,1.0.106,66,1,14,2,16,4,FALSE
actor-sdk,1.0.358,1.0.360,286,1,419,613,1032,41,FALSE
actor-sdk,1.0.169,1.0.170,127,1,162,158,320,27,FALSE
actor-sdk,1.0.168,1.0.169,126,1,78,28,106,13,FALSE
actor-sdk,1.0.367,1.0.368,294,1,103,45,148,19,FALSE
actor-sdk,1.0.366,1.0.367,293,1,23,11,34,7,FALSE
actor-sdk,1.0.365,1.0.366,292,1,164,80,244,4,FALSE
actor-sdk,1.0.364,1.0.365,291,1,11,3,14,6,FALSE
actor-sdk,1.0.363,1.0.364,290,1,13,12,25,7,FALSE
actor-sdk,1.0.362,1.0.363,289,1,7,4,11,3,FALSE
actor-sdk,1.0.98,1.0.99,59,1,928,914,1842,143,FALSE
actor-sdk,1.0.99,1.0.100,60,1,197,19,216,11,FALSE
actor-sdk,1.0.97,1.0.98,58,1,1,1,2,1,FALSE
actor-sdk,1.0.369,1.0.372,296,3,323,415,738,22,FALSE
actor-sdk,1.0.368,1.0.369,295,1,268,84,352,10,FALSE
actor-sdk,1.0.16,1.0.17,6,1,32,14,46,5,FALSE
actor-sdk,1.0.17,1.0.18,7,1,5,9,14,5,FALSE
actor-sdk,1.0.14,1.0.15,4,1,1,1,2,1,FALSE
actor-sdk,1.0.15,1.0.16,5,1,21513,1425,22938,298,FALSE
actor-sdk,1.0.12,1.0.13,2,1,1,1,2,1,FALSE
actor-sdk,1.0.13,1.0.14,3,1,1,1,2,1,FALSE
actor-sdk,1.0.225,1.0.227,177,1,212,164,376,4,FALSE
actor-sdk,1.0.11,1.0.12,1,1,1,1,2,1,FALSE
actor-sdk,1.0.78,1.0.79,47,1,9,7,16,7,FALSE
actor-sdk,1.0.18,1.0.19,8,1,2,2,4,2,FALSE
actor-sdk,1.0.19,1.0.23,9,1,735,390,1125,319,FALSE
actor-sdk,1.0.279,1.0.281,225,1,316,72,388,22,FALSE
actor-sdk,1.0.278,1.0.279,224,1,31,24,55,11,FALSE
actor-sdk,1.0.275,1.0.276,221,1,541,145,686,33,FALSE
actor-sdk,1.0.274,1.0.275,220,1,285,44,329,8,FALSE
actor-sdk,1.0.277,1.0.278,223,1,18,4,22,10,FALSE
actor-sdk,1.0.276,1.0.277,222,1,8,8,16,3,FALSE
actor-sdk,1.0.271,1.0.272,217,1,14,12,26,10,FALSE
actor-sdk,1.0.270,1.0.271,216,1,1411,1973,3384,58,FALSE
actor-sdk,1.0.273,1.0.274,219,1,20,7,27,4,FALSE
actor-sdk,1.0.272,1.0.273,218,1,91,73,164,12,FALSE
actor-sdk,1.0.172,1.0.173,130,1,60,54,114,20,FALSE
actor-sdk,1.0.173,1.0.174,131,1,17,15,32,7,FALSE
actor-sdk,1.0.170,1.0.171,128,1,71,26,97,20,FALSE
actor-sdk,1.0.171,1.0.172,129,1,11,7,18,7,FALSE
actor-sdk,1.0.174,1.0.178,132,1,8,6,14,6,FALSE
actor-sdk,1.0.178,1.0.179,133,1,711,80,791,50,FALSE
actor-sdk,1.0.179,1.0.180,134,1,247,121,368,39,FALSE
actor-sdk,1.0.408,1.0.409,331,1,1,1,2,1,FALSE
actor-sdk,1.0.113,1.0.114,74,1,1,1,2,1,FALSE
actor-sdk,1.0.374,1.0.375,298,1,61,23,84,9,FALSE
actor-sdk,1.0.375,1.0.376,299,1,1,1,2,1,FALSE
actor-sdk,1.0.376,1.0.378,300,1,259,132,391,20,FALSE
actor-sdk,1.0.89,1.0.90,55,1,1,1,2,1,FALSE
actor-sdk,1.0.88,1.0.89,54,1,42,22,64,9,FALSE
actor-sdk,1.0.372,1.0.374,297,1,10464,2400,12864,156,FALSE
actor-sdk,1.0.85,1.0.86,51,1,1,1,2,1,FALSE
actor-sdk,1.0.84,1.0.85,50,1,1,1,2,1,FALSE
actor-sdk,1.0.87,1.0.88,53,1,1,1,2,1,FALSE
actor-sdk,1.0.86,1.0.87,52,1,1,1,2,1,FALSE
actor-sdk,1.0.378,1.0.379,301,1,4,4,8,4,FALSE
actor-sdk,1.0.379,1.0.380,302,1,4,4,8,4,FALSE
actor-sdk,1.0.83,1.0.84,49,1,899,398,1297,42,FALSE
actor-sdk,1.0.77,1.0.78,46,1,360,68,428,35,FALSE
actor-sdk,1.0.153,1.0.154,114,1,1,1,2,2,FALSE
actor-sdk,1.0.351,1.0.352,279,1,1,1,2,1,FALSE
actor-sdk,1.0.158,1.0.159,119,1,21,45,66,12,FALSE
actor-sdk,1.0.269,1.0.270,215,1,149,48,197,4,FALSE
actor-sdk,1.0.262,1.0.263,210,1,2203,3385,5588,399,FALSE
actor-sdk,1.0.263,1.0.265,211,1,8,24,32,10,FALSE
actor-sdk,1.0.260,1.0.261,208,1,3,3,6,3,FALSE
actor-sdk,1.0.261,1.0.262,209,1,259,522,781,43,FALSE
actor-sdk,1.0.266,1.0.267,213,1,1,1,2,1,FALSE
actor-sdk,1.0.267,1.0.269,214,1,9254,8994,18248,283,FALSE
actor-sdk,1.0.265,1.0.266,212,1,56,74,130,13,FALSE
actor-sdk,1.0.399,1.0.400,322,1,1,1,2,1,FALSE
actor-sdk,1.0.336,1.0.337,266,1,1,1,2,1,FALSE
actor-sdk,1.0.189,1.0.190,144,1,305,188,493,17,FALSE
actor-sdk,1.0.188,1.0.189,143,1,25,4,29,4,FALSE
actor-sdk,1.0.187,1.0.188,142,1,1,1,2,1,FALSE
actor-sdk,1.0.186,1.0.187,141,1,375,346,721,22,FALSE
actor-sdk,1.0.185,1.0.186,140,1,67,59,126,10,FALSE
actor-sdk,1.0.184,1.0.185,139,1,132,97,229,19,FALSE
actor-sdk,1.0.183,1.0.184,138,1,251,133,384,15,FALSE
actor-sdk,1.0.182,1.0.183,137,1,49,34,83,7,FALSE
actor-sdk,1.0.181,1.0.182,136,1,75,41,116,10,FALSE
actor-sdk,1.0.180,1.0.181,135,1,66,64,130,11,FALSE
actor-sdk,1.0.107,1.0.108,68,1,1,1,2,1,FALSE
actor-sdk,1.0.106,1.0.107,67,1,6,6,12,4,FALSE
actor-sdk,1.0.343,1.0.345,272,1,4,4,8,4,FALSE
actor-sdk,1.0.104,1.0.105,65,1,1,1,2,1,FALSE
actor-sdk,1.0.103,1.0.104,64,1,71,49,120,16,FALSE
actor-sdk,1.0.102,1.0.103,63,1,211,217,428,39,FALSE
actor-sdk,1.0.101,1.0.102,62,1,14,7,21,4,FALSE
actor-sdk,1.0.346,1.0.347,274,1,1,1,2,1,FALSE
actor-sdk,1.0.349,1.0.350,277,1,1,1,2,1,FALSE
actor-sdk,1.0.348,1.0.349,276,1,1,1,2,1,FALSE
actor-sdk,1.0.109,1.0.110,70,1,16,4,20,4,FALSE
actor-sdk,1.0.108,1.0.109,69,1,1,1,2,1,FALSE
actor-sdk,1.0.215,1.0.216,169,1,120,67,187,5,FALSE
actor-sdk,1.0.34,1.0.38,11,1,2,2,4,1,FALSE
actor-sdk,1.0.38,1.0.39,12,1,99,68,167,14,FALSE
actor-sdk,1.0.39,1.0.42,13,1,25,22,47,15,FALSE
actor-sdk,1.0.390,1.0.391,313,1,51,29,80,10,FALSE
actor-sdk,1.0.391,1.0.392,314,1,1,1,2,1,FALSE
actor-sdk,1.0.213,1.0.214,167,1,868,1087,1955,248,FALSE
actor-sdk,1.0.285,1.0.286,228,1,70,48,118,4,FALSE
actor-sdk,1.0.352,1.0.353,280,1,5,4,9,4,FALSE
actor-sdk,1.0.286,1.0.287,229,1,44,60,104,10,FALSE
actor-sdk,1.0.287,1.0.288,230,1,38,21,59,10,FALSE
actor-sdk,1.0.198,1.0.199,153,1,26,6,32,4,FALSE
actor-sdk,1.0.199,1.0.200,154,1,108,112,220,10,FALSE
actor-sdk,1.0.219,1.0.220,173,1,236,117,353,24,FALSE
actor-sdk,1.0.218,1.0.219,172,1,257,153,410,18,FALSE
actor-sdk,1.0.217,1.0.218,171,1,1,1,2,1,FALSE
actor-sdk,1.0.216,1.0.217,170,1,21,6,27,5,FALSE
actor-sdk,1.0.196,1.0.197,151,1,8,5,13,4,FALSE
actor-sdk,1.0.197,1.0.198,152,1,110,128,238,13,FALSE
actor-sdk,1.0.190,1.0.191,145,1,24,14,38,4,FALSE
actor-sdk,1.0.191,1.0.192,146,1,83,59,142,7,FALSE
actor-sdk,1.0.192,1.0.193,147,1,314,602,916,96,FALSE
actor-sdk,1.0.193,1.0.194,148,1,2777,1854,4631,293,FALSE
actor-sdk,1.0.114,1.0.115,75,1,7,35,42,4,FALSE
actor-sdk,1.0.115,1.0.116,76,1,12,2,14,4,FALSE
actor-sdk,1.0.116,1.0.117,77,1,454,440,894,154,FALSE
actor-sdk,1.0.117,1.0.118,78,1,129,72,201,12,FALSE
actor-sdk,1.0.110,1.0.111,71,1,533,267,800,18,FALSE
actor-sdk,1.0.361,1.0.362,288,1,8,30,38,4,FALSE
actor-sdk,1.0.291,1.0.292,234,1,12,12,24,10,FALSE
actor-sdk,1.0.290,1.0.291,233,1,462,449,911,57,FALSE
actor-sdk,1.0.356,1.0.357,284,1,510,395,905,50,FALSE
actor-sdk,1.0.357,1.0.358,285,1,1,1,2,1,FALSE
actor-sdk,1.0.354,1.0.355,282,1,1,1,2,1,FALSE
actor-sdk,1.0.360,1.0.361,287,1,144,62,206,9,FALSE
actor-sdk,1.0.118,1.0.119,79,1,491,266,757,77,FALSE
actor-sdk,1.0.119,1.0.120,80,1,1,1,2,1,FALSE
actor-sdk,1.0.299,1.0.300,242,1,45,35,80,6,FALSE
actor-sdk,1.0.298,1.0.299,241,1,1,1,2,1,FALSE
actor-sdk,1.0.311,1.0.312,253,1,1,1,2,1,FALSE
actor-sdk,1.0.23,1.0.34,10,1,702,660,1362,72,FALSE
actor-sdk,1.0.230,1.0.231,181,1,123,16,139,16,FALSE
actor-sdk,1.0.159,1.0.160,120,1,1,1,2,1,FALSE
actor-sdk,1.0.314,1.0.315,256,1,185,213,398,16,FALSE
actor-sdk,1.0.135,1.0.136,96,1,17,9,26,7,FALSE
actor-sdk,1.0.76,1.0.77,45,1,1,1,2,1,FALSE
actor-sdk,1.0.194,1.0.195,149,1,51,53,104,12,FALSE
actor-sdk,1.0.337,1.0.338,267,1,1,1,2,1,FALSE
actor-sdk,1.0.208,1.0.209,163,1,139,172,311,10,FALSE
actor-sdk,1.0.209,1.0.211,164,1,89,20,109,8,FALSE
actor-sdk,1.0.195,1.0.196,150,1,135,127,262,13,FALSE
actor-sdk,1.0.204,1.0.205,159,1,16,4,20,4,FALSE
actor-sdk,1.0.205,1.0.206,160,1,43,27,70,7,FALSE
actor-sdk,1.0.206,1.0.207,161,1,602,408,1010,10,FALSE
actor-sdk,1.0.207,1.0.208,162,1,737,528,1265,27,FALSE
actor-sdk,1.0.200,1.0.201,155,1,234,82,316,30,FALSE
actor-sdk,1.0.201,1.0.202,156,1,1,1,2,1,FALSE
actor-sdk,1.0.202,1.0.203,157,1,45,85,130,10,FALSE
actor-sdk,1.0.203,1.0.204,158,1,1,1,2,1,FALSE
actor-sdk,1.0.121,1.0.122,82,1,1,1,2,1,FALSE
actor-sdk,1.0.120,1.0.121,81,1,6,4,10,4,FALSE
actor-sdk,1.0.123,1.0.124,84,1,4,4,8,4,FALSE
actor-sdk,1.0.122,1.0.123,83,1,1,1,2,1,FALSE
actor-sdk,1.0.125,1.0.126,86,1,19,23,42,12,FALSE
actor-sdk,1.0.124,1.0.125,85,1,507,294,801,57,FALSE
actor-sdk,1.0.127,1.0.128,88,1,285,232,517,33,FALSE
actor-sdk,1.0.126,1.0.127,87,1,44,21,65,16,FALSE
actor-sdk,1.0.129,1.0.130,90,1,127,134,261,28,FALSE
actor-sdk,1.0.128,1.0.129,89,1,35,32,67,4,FALSE
actor-sdk,1.0.320,1.0.333,262,1,319,202,521,22,FALSE
actor-sdk,1.0.288,1.0.289,231,1,40,21,61,7,FALSE
actor-sdk,1.0.289,1.0.290,232,1,861,507,1368,28,FALSE
actor-sdk,1.0.146,1.0.147,107,1,116,74,190,10,FALSE
actor-sdk,1.0.212,1.0.213,166,1,9,8,17,7,FALSE
actor-sdk,1.0.58,1.0.59,28,1,1,1,2,1,FALSE
actor-sdk,1.0.111,1.0.112,72,1,1,1,2,1,FALSE
actor-sdk,1.0.211,1.0.212,165,1,1602,1053,2655,73,FALSE
actor-sdk,1.0.133,1.0.134,94,1,254,140,394,36,FALSE
actor-sdk,1.0.53,1.0.54,23,1,389,223,612,44,FALSE
actor-sdk,1.0.50,1.0.51,21,1,1,1,2,1,FALSE
actor-sdk,1.0.51,1.0.53,22,1,12,7,19,4,FALSE
actor-sdk,1.0.56,1.0.57,26,1,63,36,99,13,FALSE
actor-sdk,1.0.57,1.0.58,27,1,356,30,386,6,FALSE
actor-sdk,1.0.54,1.0.55,24,1,612,197,809,47,FALSE
actor-sdk,1.0.55,1.0.56,25,1,17,14,31,7,FALSE
actor-sdk,1.0.409,1.0.411,332,1,266,277,543,276,FALSE
actor-sdk,1.0.297,1.0.298,240,1,1,1,2,1,FALSE
actor-sdk,1.0.292,1.0.293,235,1,433,226,659,12,FALSE
actor-sdk,1.0.214,1.0.215,168,1,187,115,302,23,FALSE
actor-sdk,1.0.296,1.0.297,239,1,1,1,2,1,FALSE
actor-sdk,1.0.295,1.0.296,238,1,1,1,2,1,FALSE
actor-sdk,1.0.347,1.0.348,275,1,1,1,2,1,FALSE
actor-sdk,1.0.239,1.0.240,189,1,35,17,52,4,FALSE
actor-sdk,1.0.238,1.0.239,188,1,140,1699,1839,7,FALSE
actor-sdk,1.0.294,1.0.295,237,1,1,1,2,1,FALSE
actor-sdk,1.0.383,1.0.384,306,1,186,200,386,32,FALSE
actor-sdk,1.0.231,1.0.232,182,1,461,368,829,27,FALSE
actor-sdk,1.0.293,1.0.294,236,1,70,123,193,15,FALSE
actor-sdk,1.0.233,1.0.234,184,1,362,61,423,10,FALSE
actor-sdk,1.0.232,1.0.233,183,1,25,7,32,6,FALSE
actor-sdk,1.0.234,1.0.236,185,1,3933,374,4307,59,FALSE
actor-sdk,1.0.237,1.0.238,187,1,1,1,2,1,FALSE
actor-sdk,1.0.236,1.0.237,186,1,1,1,2,1,FALSE
actor-sdk,1.0.338,1.0.339,268,1,1,1,2,1,FALSE
actor-sdk,1.0.339,1.0.341,269,2,262239,262175,524414,2096,FALSE
actor-sdk,1.0.112,1.0.113,73,1,1,1,2,1,FALSE
actor-sdk,1.0.138,1.0.139,99,1,1,1,2,1,FALSE
actor-sdk,1.0.139,1.0.140,100,1,2484,2465,4949,249,FALSE
actor-sdk,1.0.136,1.0.137,97,1,311,293,604,118,FALSE
actor-sdk,1.0.137,1.0.138,98,1,770,82,852,40,FALSE
actor-sdk,1.0.134,1.0.135,95,1,145,511,656,10,FALSE
actor-sdk,1.0.333,1.0.334,263,1,1,1,2,1,FALSE
actor-sdk,1.0.132,1.0.133,93,1,1,1,2,1,FALSE
actor-sdk,1.0.335,1.0.336,265,1,1,1,2,1,FALSE
actor-sdk,1.0.130,1.0.131,91,1,436,294,730,54,FALSE
actor-sdk,1.0.131,1.0.132,92,1,93,34,127,15,FALSE
actor-sdk,1.0.49,1.0.50,20,1,4,16,20,10,FALSE
actor-sdk,1.0.48,1.0.49,19,1,652,232,884,55,FALSE
actor-sdk,1.0.341,1.0.342,270,1,1,1,2,1,FALSE
actor-sdk,1.0.151,1.0.152,112,1,1229,459,1688,61,FALSE
actor-sdk,1.0.43,1.0.44,15,1,55,27,82,7,FALSE
actor-sdk,1.0.42,1.0.43,14,1,114,77,191,24,FALSE
actor-sdk,1.0.45,1.0.46,17,1,2275,2628,4903,160,FALSE
actor-sdk,1.0.44,1.0.45,16,1,20,17,37,4,FALSE
actor-sdk,1.0.334,1.0.335,264,1,1,1,2,1,FALSE
actor-sdk,1.0.46,1.0.48,18,1,443,191,634,29,FALSE
actor-sdk,1.0.398,1.0.399,321,1,4,6,10,4,FALSE
actor-sdk,1.0.227,1.0.228,178,1,8,6,14,4,FALSE
actor-sdk,1.0.224,1.0.225,176,1,39,26,65,7,FALSE
actor-sdk,1.0.355,1.0.356,283,1,1,1,2,1,FALSE
actor-sdk,1.0.389,1.0.390,312,1,60,23,83,11,FALSE
actor-sdk,1.0.388,1.0.389,311,1,11,15,26,6,FALSE
actor-sdk,1.0.220,1.0.221,174,1,190,121,311,24,FALSE
actor-sdk,1.0.221,1.0.224,175,1,2100,265,2365,60,FALSE
actor-sdk,1.0.385,1.0.386,308,1,27,15,42,2,FALSE
actor-sdk,1.0.384,1.0.385,307,1,35,19,54,13,FALSE
actor-sdk,1.0.387,1.0.388,310,1,4,6,10,4,FALSE
actor-sdk,1.0.386,1.0.387,309,1,20,15,35,8,FALSE
actor-sdk,1.0.381,1.0.382,304,1,1,1,2,1,FALSE
actor-sdk,1.0.380,1.0.381,303,1,160,147,307,17,FALSE
actor-sdk,1.0.228,1.0.229,179,1,22,42,64,10,FALSE
actor-sdk,1.0.382,1.0.383,305,1,927,699,1626,39,FALSE
actor-sdk,1.0.305,1.0.306,247,1,36,44,80,9,FALSE
actor-sdk,1.0.304,1.0.305,246,1,56,34,90,4,FALSE
actor-sdk,1.0.307,1.0.308,249,1,1,1,2,1,FALSE
actor-sdk,1.0.306,1.0.307,248,1,206,118,324,24,FALSE
actor-sdk,1.0.301,1.0.303,244,1,44,17,61,16,FALSE
actor-sdk,1.0.350,1.0.351,278,1,1,1,2,1,FALSE
actor-sdk,1.0.303,1.0.304,245,1,37,13,50,7,FALSE
actor-sdk,1.0.283,1.0.285,227,1,18,17,35,7,FALSE
actor-sdk,1.0.90,1.0.91,56,1,1,1,2,1,FALSE
actor-sdk,1.0.309,1.0.310,251,1,198,81,279,21,FALSE
actor-sdk,1.0.308,1.0.309,250,1,1069,376,1445,40,FALSE
actor-sdk,1.0.74,1.0.75,43,1,92,73,165,9,FALSE
actor-sdk,1.0.75,1.0.76,44,1,1,1,2,1,FALSE
actor-sdk,1.0.149,1.0.150,110,1,5,9,14,7,FALSE
actor-sdk,1.0.148,1.0.149,109,1,1,1,2,1,FALSE
actor-sdk,1.0.70,1.0.71,39,1,1,1,2,1,FALSE
actor-sdk,1.0.71,1.0.72,40,1,1,1,2,1,FALSE
actor-sdk,1.0.72,1.0.73,41,1,75,108,183,24,FALSE
actor-sdk,1.0.73,1.0.74,42,1,82,384,466,18,FALSE
actor-sdk,1.0.143,1.0.144,104,1,364,172,536,42,FALSE
actor-sdk,1.0.300,1.0.301,243,1,1,1,2,1,FALSE
actor-sdk,1.0.141,1.0.142,102,1,205079,107,205186,195,FALSE
actor-sdk,1.0.140,1.0.141,101,1,46,703,749,27,FALSE
actor-sdk,1.0.147,1.0.148,108,1,1374,796,2170,86,FALSE
actor-sdk,1.0.79,1.0.83,48,1,266,277,543,276,FALSE
actor-sdk,1.0.145,1.0.146,106,1,4,4,8,4,FALSE
actor-sdk,1.0.144,1.0.145,105,1,1,1,2,1,FALSE
actor-sdk,1.0.229,1.0.230,180,1,15,7,22,7,FALSE
actor-sdk,1.0.353,1.0.354,281,1,6,7,13,6,FALSE
actor-sdk,1.0.91,1.0.97,57,1,42,42,84,37,FALSE
actor-sdk,1.0.281,1.0.283,226,1,18,21,39,9,FALSE
actor-sdk,1.0.253,1.0.255,203,1,30,127,157,13,FALSE
actor-sdk,1.0.252,1.0.253,202,1,224,160,384,21,FALSE
actor-sdk,1.0.251,1.0.252,201,1,7,4,11,4,FALSE
actor-sdk,1.0.250,1.0.251,200,1,30,30,60,4,FALSE
actor-sdk,1.0.257,1.0.258,205,1,8,2,10,4,FALSE
actor-sdk,1.0.255,1.0.257,204,2,1313,425,1738,201,FALSE
actor-sdk,1.0.392,1.0.393,315,1,4,4,8,4,FALSE
actor-sdk,1.0.393,1.0.394,316,1,614,107,721,34,FALSE
actor-sdk,1.0.259,1.0.260,207,1,27,8,35,9,FALSE
actor-sdk,1.0.258,1.0.259,206,1,2,3,5,3,FALSE
actor-sdk,1.0.396,1.0.397,319,1,54,78,132,6,FALSE
actor-sdk,1.0.397,1.0.398,320,1,1,1,2,1,FALSE
actor-sdk,1.0.394,1.0.395,317,1,112,57,169,6,FALSE
actor-sdk,1.0.395,1.0.396,318,1,739,38,777,9,FALSE
actor-sdk,1.0.312,1.0.313,254,1,70,18,88,9,FALSE
actor-sdk,1.0.313,1.0.314,255,1,976,353,1329,21,FALSE
actor-sdk,1.0.310,1.0.311,252,1,105,42,147,9,FALSE
actor-sdk,1.0.342,1.0.343,271,1,1,1,2,1,FALSE
actor-sdk,1.0.316,1.0.317,258,1,23,23,46,7,FALSE
actor-sdk,1.0.317,1.0.318,259,1,118,22,140,9,FALSE
actor-sdk,1.0.402,1.0.403,325,1,10,10,20,4,FALSE
actor-sdk,1.0.315,1.0.316,257,1,29,11,40,7,FALSE
actor-sdk,1.0.345,1.0.346,273,1,1,1,2,1,FALSE
actor-sdk,1.0.318,1.0.319,260,1,1,1,2,1,FALSE
actor-sdk,1.0.319,1.0.320,261,1,4,4,8,4,FALSE
actor-sdk,1.0.100,1.0.101,61,1,8,4,12,4,FALSE
actor-sdk,1.0.63,1.0.64,32,1,1,1,2,1,FALSE
actor-sdk,1.0.62,1.0.63,31,1,1,1,2,1,FALSE
actor-sdk,1.0.60,1.0.62,30,1,7,77,84,5,FALSE
actor-sdk,1.0.67,1.0.68,36,1,553,118,671,39,FALSE
actor-sdk,1.0.66,1.0.67,35,1,1,1,2,1,FALSE
actor-sdk,1.0.65,1.0.66,34,1,1,1,2,1,FALSE
actor-sdk,1.0.64,1.0.65,33,1,1,1,2,1,FALSE
actor-sdk,1.0.150,1.0.151,111,1,105,53,158,16,FALSE
actor-sdk,1.0.59,1.0.60,29,1,1,1,2,1,FALSE
actor-sdk,1.0.69,1.0.70,38,1,1,1,2,1,FALSE
actor-sdk,1.0.68,1.0.69,37,1,1,1,2,1,FALSE
actor-sdk,1.0.154,1.0.155,115,1,974,396,1370,63,FALSE
actor-sdk,1.0.155,1.0.156,116,1,343,147,490,24,FALSE
actor-sdk,1.0.156,1.0.157,117,1,1,1,2,1,FALSE
actor-sdk,1.0.157,1.0.158,118,1,3,3,6,3,FALSE
actor-sdk,1.0.403,1.0.404,326,1,1,1,2,1,FALSE
actor-sdk,1.0.142,1.0.143,103,1,2,2,4,1,FALSE
actor-sdk,1.0.19,1.0.23,9,1,735,390,1125,319,TRUE
actor-sdk,1.0.154,1.0.155,115,1,974,396,1370,63,TRUE
actor-sdk,1.0.155,1.0.156,116,1,343,147,490,24,TRUE
actor-sdk,1.0.225,1.0.227,177,1,212,164,376,4,TRUE
actor-sdk,1.0.244,1.0.245,194,1,201,246,447,24,TRUE
actor-sdk,1.0.369,1.0.372,296,3,323,415,738,22,TRUE
actor-sdk,1.0.219,1.0.220,173,1,236,117,353,24,TRUE
actor-sdk,1.0.270,1.0.271,216,1,1411,1973,3384,58,TRUE
actor-sdk,1.0.158,1.0.159,119,1,21,45,66,12,TRUE
actor-sdk,1.0.214,1.0.215,168,1,187,115,302,23,TRUE
actor-sdk,1.0.257,1.0.258,205,1,8,2,10,4,TRUE
actor-sdk,1.0.233,1.0.234,184,1,362,61,423,10,TRUE
actor-sdk,1.0.130,1.0.131,91,1,436,294,730,54,TRUE
actor-sdk,1.0.160,1.0.161,121,1,1,1,2,1,TRUE
actor-sdk,1.0.166,1.0.168,125,1,491,438,929,213,TRUE
actor-sdk,1.0.98,1.0.99,59,1,928,914,1842,143,TRUE
actor-sdk,1.0.188,1.0.189,143,1,25,4,29,4,TRUE
actor-sdk,1.0.184,1.0.185,139,1,132,97,229,19,TRUE
actor-sdk,1.0.124,1.0.125,85,1,507,294,801,57,TRUE
actor-sdk,1.0.228,1.0.229,179,1,22,42,64,10,TRUE
actor-sdk,1.0.65,1.0.66,34,1,1,1,2,1,TRUE
actor-sdk,1.0.403,1.0.404,326,1,1,1,2,1,TRUE
actor-sdk,1.0.404,1.0.405,327,1,127,127,254,131,TRUE
actor-sdk,1.0.142,1.0.143,103,1,2,2,4,1,TRUE
actor-sdk,1.0.408,1.0.409,331,1,1,1,2,1,TRUE
actor-sdk,1.0.203,1.0.204,158,1,1,1,2,1,TRUE
actor-sdk,1.0.135,1.0.136,96,1,17,9,26,7,TRUE
actor-sdk,1.0.174,1.0.178,132,1,8,6,14,6,TRUE
actor-sdk,1.0.113,1.0.114,74,1,1,1,2,1,TRUE
actor-sdk,1.0.261,1.0.262,209,1,259,522,781,43,TRUE
actor-sdk,1.0.202,1.0.203,157,1,45,85,130,10,TRUE
actor-sdk,1.0.234,1.0.236,185,1,3933,374,4307,59,TRUE
actor-sdk,1.0.134,1.0.135,95,1,145,511,656,10,TRUE
actor-sdk,1.0.44,1.0.45,16,1,20,17,37,4,TRUE
actor-sdk,1.0.382,1.0.383,305,1,927,699,1626,39,TRUE
actor-sdk,1.0.60,1.0.62,30,1,7,77,84,5,TRUE
actor-sdk,1.0.401,1.0.402,324,1,6,12,18,4,TRUE
actor-sdk,1.0.206,1.0.207,161,1,602,408,1010,10,TRUE
actor-sdk,1.0.406,1.0.407,329,1,1,1,2,1,TRUE
actor-sdk,1.0.407,1.0.408,330,1,1,1,2,1,TRUE
actor-sdk,1.0.57,1.0.58,27,1,356,30,386,6,TRUE
actor-sdk,1.0.307,1.0.308,249,1,1,1,2,1,TRUE
actor-sdk,1.0.119,1.0.120,80,1,1,1,2,1,TRUE
actor-sdk,1.0.58,1.0.59,28,1,1,1,2,1,TRUE
actor-sdk,1.0.62,1.0.63,31,1,1,1,2,1,TRUE
actor-sdk,1.0.196,1.0.197,151,1,8,5,13,4,TRUE
actor-sdk,1.0.409,1.0.411,332,1,266,277,543,276,TRUE
actor-sdk,1.0.248,1.0.249,198,1,302,197,499,30,TRUE
actor-sdk,1.0.120,1.0.121,81,1,6,4,10,4,TRUE
actor-sdk,1.0.238,1.0.239,188,1,140,1699,1839,7,TRUE
actor-sdk,1.0.132,1.0.133,93,1,1,1,2,1,TRUE
actor-sdk,1.0.148,1.0.149,109,1,1,1,2,1,TRUE
actor-sdk,1.0.205,1.0.206,160,1,43,27,70,7,TRUE
actor-sdk,1.0.383,1.0.384,306,1,186,200,386,32,TRUE
actor-sdk,1.0.140,1.0.141,101,1,46,703,749,27,TRUE
actor-sdk,1.0.258,1.0.259,206,1,2,3,5,3,TRUE
react-headroom,1.1.0,1.2.0,2,2,22,3,25,3,FALSE
react-headroom,1.0.0,1.1.0,1,5,27,3,30,5,FALSE
react-headroom,2.0.0,2.1.0,23,13,61,118,179,20,FALSE
react-headroom,2.1.2,2.1.3,26,14,138,81,219,30,FALSE
react-headroom,2.1.3,2.1.4,27,5,13,40,53,6,FALSE
react-headroom,2.1.0,2.1.1,24,13,80,128,208,31,FALSE
react-headroom,2.1.1,2.1.2,25,5,146,34,180,5,FALSE
react-headroom,2.1.4,2.1.5,28,3,8,5,13,4,FALSE
react-headroom,1.6.2,1.7.0,13,15,46,34,80,22,FALSE
react-headroom,1.6.0,1.6.1,11,2,2,1,3,2,FALSE
react-headroom,1.6.1,1.6.2,12,3,18,9,27,4,FALSE
react-headroom,1.8.4,2.0.0,22,8,708,623,1331,40,FALSE
react-headroom,1.7.3,1.8.0,17,6,83,49,132,11,FALSE
react-headroom,1.7.2,1.7.3,16,3,19,6,25,4,FALSE
react-headroom,1.7.1,1.7.2,15,3,6,5,11,3,FALSE
react-headroom,1.7.0,1.7.1,14,2,3,3,6,2,FALSE
react-headroom,1.4.0,1.5.0,8,2,2,2,4,2,FALSE
react-headroom,1.5.1,1.6.0,10,2,2,2,4,2,FALSE
react-headroom,1.5.0,1.5.1,9,3,7,7,14,3,FALSE
react-headroom,1.3.2,1.4.0,7,3,15,4,19,4,FALSE
react-headroom,1.3.1,1.3.2,6,4,24,10,34,5,FALSE
react-headroom,1.3.0,1.3.1,5,4,6,47,53,4,FALSE
react-headroom,1.2.0,1.2.1,3,3,33,3,36,3,FALSE
react-headroom,1.2.1,1.3.0,4,13,291,100,391,18,FALSE
react-headroom,1.8.0,1.8.1,18,3,5,3,8,5,FALSE
react-headroom,1.8.1,1.8.2,19,15,1403,1159,2562,55,FALSE
react-headroom,1.8.2,1.8.3,20,3,17,17,34,3,FALSE
react-headroom,1.8.3,1.8.4,21,5,24,20,44,6,FALSE
react-headroom,1.8.2,1.8.3,20,3,17,17,34,3,TRUE
react-headroom,2.1.4,2.1.5,28,3,8,5,13,4,TRUE
react-headroom,2.1.2,2.1.3,26,14,138,81,219,30,TRUE
react-headroom,1.8.4,2.0.0,22,8,708,623,1331,40,TRUE
react-headroom,2.0.0,2.1.0,23,13,61,118,179,20,TRUE
basic-tree,1.1.1,1.1.2,9,1,397,278,675,3,FALSE
basic-tree,1.1.0,1.1.1,8,1,5340,6,5346,5,FALSE
basic-tree,1.1.2,1.1.4,10,1,586,324,910,7,FALSE
basic-tree,1.1.5,1.1.6,12,1,1,10,11,2,FALSE
basic-tree,1.1.4,1.1.5,11,1,12,3,15,3,FALSE
basic-tree,1.1.7,1.1.8,14,1,58,7,65,4,FALSE
basic-tree,1.1.6,1.1.7,13,1,15,17,32,3,FALSE
basic-tree,1.1.9,1.2.0,16,1,174,59,233,4,FALSE
basic-tree,1.1.8,1.1.9,15,1,100,96,196,5,FALSE
basic-tree,1.2.2,1.2.3,19,1,15,53,68,5,FALSE
basic-tree,1.2.0,1.2.1,17,1,71,52,123,4,FALSE
basic-tree,1.2.1,1.2.2,18,1,2080,2033,4113,5,FALSE
basic-tree,1.1.8,1.1.9,15,1,100,96,196,5,TRUE
basic-tree,1.2.0,1.2.1,17,1,71,52,123,4,TRUE
get-selenium,1.1.1,1.1.2,5,2,42,38,80,8,FALSE
get-selenium,1.1.0,1.1.1,4,3,31,18,49,9,FALSE
get-selenium,1.0.0,1.0.1,1,2,15,5,20,3,FALSE
get-selenium,1.0.1,1.0.2,2,2,48,12,60,8,TRUE
get-selenium,1.0.2,1.1.0,3,2,212,106,318,16,FALSE
get-selenium,1.0.1,1.0.2,2,2,48,12,60,8,FALSE
get-selenium,1.1.1,1.1.2,5,2,42,38,80,8,TRUE
get-selenium,1.0.2,1.1.0,3,2,212,106,318,16,TRUE
cat-components,1.1.1,1.1.2,30,1,44,10,54,4,FALSE
cat-components,1.1.0,1.1.1,29,2,209,244,453,5,FALSE
cat-components,1.1.3,1.2.0,32,2,52,44,96,8,FALSE
cat-components,1.1.2,1.1.3,31,1,6,6,12,5,FALSE
cat-components,1.0.0,1.0.1,27,2,178,139,317,47,FALSE
cat-components,1.0.1,1.1.0,28,1,4,4,8,4,FALSE
cat-components,0.9.0,0.9.1,21,1,314,20,334,14,FALSE
cat-components,0.2.0,0.3.0,11,5,685,62,747,45,FALSE
cat-components,0.1.0,0.2.0,10,1,3,3,6,1,FALSE
cat-components,0.0.5,0.0.6-beta,6,2,171,141,312,4,FALSE
cat-components,0.0.4,0.0.5,5,4,98,6,104,8,FALSE
cat-components,0.0.7,0.1.0,9,4,2891,383,3274,49,FALSE
cat-components,0.0.6,0.0.7,8,2,3,2,5,2,FALSE
cat-components,0.0.1,0.0.2,2,1,3,3,6,1,FALSE
cat-components,0.0.0,0.0.1,1,1,5,3,8,2,FALSE
cat-components,0.0.3,0.0.4,4,2,37,12,49,3,FALSE
cat-components,0.0.2,0.0.3,3,2,6,2,8,3,FALSE
cat-components,0.3.0,0.3.1,12,1,3,3,6,1,FALSE
cat-components,0.6.0,0.7.0,17,1,271,39,310,13,FALSE
cat-components,0.11.0,0.12.0,25,2,706,50,756,29,FALSE
cat-components,0.7.0,0.7.1,18,1,240,33,273,14,FALSE
cat-components,0.7.1,0.8.0,19,1,28,15,43,7,FALSE
cat-components,0.12.0,1.0.0,26,1,250,19,269,12,FALSE
cat-components,0.4.0,0.5.0,14,1,191,22,213,14,FALSE
cat-components,1.2.9,1.2.10,42,1,353,64,417,14,TRUE
cat-components,0.5.0,0.5.1,15,2,325,134,459,21,FALSE
cat-components,0.5.1,0.6.0,16,1,3,3,6,1,FALSE
cat-components,0.9.1,0.10.0,22,1,171,112,283,17,FALSE
cat-components,0.10.0,0.10.1,23,1,300,22,322,12,FALSE
cat-components,0.8.0,0.9.0,20,1,295,23,318,16,FALSE
cat-components,1.2.6,1.2.7,39,2,84,66,150,19,FALSE
cat-components,1.2.7,1.2.8,40,1,6,9,15,4,FALSE
cat-components,1.2.4,1.2.5,37,1,7,3,10,4,FALSE
cat-components,1.2.5,1.2.6,38,2,35,13,48,9,FALSE
cat-components,1.2.2,1.2.3,35,1,14,7,21,6,FALSE
cat-components,1.2.3,1.2.4,36,1,3,3,6,3,FALSE
cat-components,1.2.0,1.2.1,33,1,92,14,106,9,FALSE
cat-components,1.2.1,1.2.2,34,1,4,4,8,4,FALSE
cat-components,1.2.8,1.2.9,41,2,201,201,402,6,FALSE
cat-components,0.3.1,0.4.0,13,2,74,28,102,13,FALSE
cat-components,0.10.1,0.11.0,24,1,5,4,9,4,FALSE
cat-components,1.2.9,1.2.10,42,1,353,64,417,14,FALSE
cat-components,1.0.1,1.1.0,28,1,4,4,8,4,TRUE
cat-components,0.12.0,1.0.0,26,1,250,19,269,12,TRUE
cat-components,0.8.0,0.9.0,20,1,295,23,318,16,TRUE
cat-components,0.10.1,0.11.0,24,1,5,4,9,4,TRUE
cat-components,1.1.0,1.1.1,29,2,209,244,453,5,TRUE
cat-components,1.1.3,1.2.0,32,2,52,44,96,8,TRUE
cat-components,1.2.6,1.2.7,39,2,84,66,150,19,TRUE
cat-components,0.11.0,0.12.0,25,2,706,50,756,29,TRUE
cat-components,1.2.1,1.2.2,34,1,4,4,8,4,TRUE
cat-components,0.0.7,0.1.0,9,4,2891,383,3274,49,TRUE
cat-components,1.2.4,1.2.5,37,1,7,3,10,4,TRUE
cat-components,1.2.8,1.2.9,41,2,201,201,402,6,TRUE
react-virtualized,1.0.4,2.0.0,9,29,747,1078,1825,70,FALSE
react-virtualized,3.1.1,4.0.0,30,13,3227,3000,6227,97,FALSE
react-virtualized,3.1.0,3.1.1,29,9,2565,2594,5159,34,FALSE
react-virtualized,6.1.2,6.2.0,91,17,5636,1787,7423,117,FALSE
react-virtualized,6.1.0,6.1.1,89,1,13,10,23,2,FALSE
react-virtualized,6.1.1,6.1.2,90,3,8,5,13,4,FALSE
react-virtualized,7.16.0,7.17.0,143,9,341,62,403,15,FALSE
react-virtualized,7.18.0,7.18.1,146,1,51,10,61,4,FALSE
react-virtualized,7.18.1,7.19.0,147,4,322,34,356,18,FALSE
react-virtualized,5.0.0,5.0.1,57,2,16,7,23,7,FALSE
react-virtualized,4.0.1,4.0.2,32,4,23,14,37,10,FALSE
react-virtualized,5.5.0,5.5.1,71,5,1310,1641,2951,28,FALSE
react-virtualized,5.5.3,5.5.4,76,3,123,68,191,13,FALSE
react-virtualized,4.0.2,4.1.0,33,4,59,5,64,17,FALSE
react-virtualized,5.5.5,5.5.6,78,7,554,172,726,29,FALSE
react-virtualized,5.5.4,5.5.5,77,4,11,7,18,6,FALSE
react-virtualized,5.5.6,6.0.0,79,14,1780,1144,2924,91,FALSE
react-virtualized,5.3.1,5.3.2,68,8,308,78,386,18,FALSE
react-virtualized,7.10.0,7.11.0,125,2,91,36,127,13,FALSE
react-virtualized,7.0.2,7.0.3,101,1,8,1,9,4,FALSE
react-virtualized,7.13.0,7.14.0,139,1,59,13,72,6,FALSE
react-virtualized,7.0.3,7.0.4,102,5,23,10,33,8,FALSE
react-virtualized,4.4.1,4.4.2,40,3,390,33,423,11,FALSE
react-virtualized,6.2.0,6.2.1,92,11,4461,1138,5599,68,FALSE
react-virtualized,5.2.2,5.2.3,64,3,30,26,56,14,FALSE
react-virtualized,5.2.3,5.2.4,65,5,212,62,274,17,FALSE
react-virtualized,5.2.0,5.2.1,62,10,4764,5765,10529,106,FALSE
react-virtualized,4.7.1,4.8.0,52,6,282,171,453,21,FALSE
react-virtualized,7.15.1,7.16.0,142,1,46,3,49,9,FALSE
react-virtualized,7.15.0,7.15.1,141,1,25,19,44,6,FALSE
react-virtualized,5.2.4,5.3.0,66,10,8263,2139,10402,98,FALSE
react-virtualized,7.11.8,7.12.0,134,1,26,5,31,5,FALSE
react-virtualized,4.5.0,4.6.0,43,4,137,99,236,24,FALSE
react-virtualized,5.0.1,5.1.0,58,5,1421,618,2039,22,FALSE
react-virtualized,7.0.0,7.0.1,99,5,11,11637,11648,85,FALSE
react-virtualized,7.0.1,7.0.2,100,8,165,175,340,46,FALSE
react-virtualized,7.0.4,7.0.5,103,2,65,6,71,5,FALSE
react-virtualized,7.0.5,7.1.0,104,18,258,42,300,41,FALSE
react-virtualized,2.8.0,3.0.0,26,13,3293,1482,4775,72,FALSE
react-virtualized,7.2.0,7.3.0,109,15,2768,12573,15341,192,FALSE
react-virtualized,4.3.0,4.3.1,37,1,32,11,43,4,FALSE
react-virtualized,4.3.1,4.4.0,38,8,3042,506,3548,54,FALSE
react-virtualized,7.1.0,7.1.1,105,2,173,30,203,8,FALSE
react-virtualized,7.9.1,7.10.0,124,1,95,3,98,9,FALSE
react-virtualized,3.0.1,3.1.0,28,7,1225,174,1399,46,FALSE
react-virtualized,4.4.3,4.5.0,42,8,1306,492,1798,44,FALSE
react-virtualized,2.7.0,2.7.1,20,4,28,5,33,8,FALSE
react-virtualized,2.6.0,2.6.1,17,3,54,5,59,8,FALSE
react-virtualized,5.4.0,5.5.0,70,5,637,282,919,26,FALSE
react-virtualized,7.19.1,7.19.2,149,5,73,5,78,8,FALSE
react-virtualized,7.19.0,7.19.1,148,8,149,45,194,13,FALSE
react-virtualized,7.19.3,7.19.4,151,4,30,6,36,5,FALSE
react-virtualized,7.19.2,7.19.3,150,1,52,14,66,4,FALSE
react-virtualized,7.19.4,7.20.0,152,13,496,146,642,20,FALSE
react-virtualized,7.11.1,7.11.2,127,2,58,27,85,7,FALSE
react-virtualized,7.11.0,7.11.1,126,5,22,25,47,11,FALSE
react-virtualized,7.11.3,7.11.4,129,1,7,24,31,3,FALSE
react-virtualized,7.11.2,7.11.3,128,6,198,131,329,24,FALSE
react-virtualized,7.11.5,7.11.6,131,3,150,104,254,23,FALSE
react-virtualized,7.11.4,7.11.5,130,1,16,7,23,3,FALSE
react-virtualized,7.11.7,7.11.8,133,4,179,42,221,26,FALSE
react-virtualized,7.11.6,7.11.7,132,1,9,7,16,4,FALSE
react-virtualized,6.3.0,6.3.1,95,28,867,694,1561,151,FALSE
react-virtualized,2.7.1,2.7.2,21,1,7,4,11,5,FALSE
react-virtualized,5.1.2-rc1,5.2.0,61,7,126,20,146,21,FALSE
react-virtualized,5.5.1,5.5.2,72,7,357,508,865,20,FALSE
react-virtualized,4.1.0,4.2.0,34,5,270,81,351,22,FALSE
react-virtualized,4.0.0,4.0.1,31,3,64,1362,1426,7,FALSE
react-virtualized,5.5.2,5.5.3-rc1,73,1,1,1,2,1,FALSE
react-virtualized,7.21.0,7.21.1,154,1,6,3,9,3,FALSE
react-virtualized,7.21.1,7.22.0,155,1,153,64,217,10,FALSE
react-virtualized,4.8.1,4.9.0,54,5,227,115,342,19,FALSE
react-virtualized,7.22.2,7.22.3,158,1,112,10,122,7,FALSE
react-virtualized,7.22.1,7.22.2,157,7,58,29,87,17,FALSE
react-virtualized,7.22.0,7.22.1,156,1,60,4,64,4,FALSE
react-virtualized,5.3.0,5.3.1,67,8,163,49,212,15,FALSE
react-virtualized,7.23.0,7.24.0,160,7,97,22,119,14,FALSE
react-virtualized,7.24.1,7.24.2,162,10,468,431,899,99,FALSE
react-virtualized,7.24.0,7.24.1,161,1,20,3,23,3,FALSE
react-virtualized,7.24.3,8.0.0-rc.1,164,11,870,795,1665,85,FALSE
react-virtualized,7.24.2,7.24.3,163,3,13,3,16,5,FALSE
react-virtualized,7.7.1,7.8.0,118,28,932,706,1638,84,FALSE
react-virtualized,7.7.0,7.7.1,117,1,42,6,48,5,FALSE
react-virtualized,6.2.2,6.3.0,94,3,108,5,113,6,FALSE
react-virtualized,2.7.3,2.7.4,23,3,1648,2540,4188,13,FALSE
react-virtualized,7.4.0,7.5.0,114,26,884,214,1098,62,FALSE
react-virtualized,5.1.0,5.1.1,59,5,70,85,155,16,TRUE
react-virtualized,6.2.1,6.2.2,93,3,34,11,45,12,FALSE
react-virtualized,4.10.0,5.0.0,56,24,6865,3030,9895,167,FALSE
react-virtualized,2.0.0,2.1.0,10,11,660,505,1165,92,FALSE
react-virtualized,7.22.3,7.23.0,159,12,268,111,379,25,FALSE
react-virtualized,7.5.0,7.6.0,115,13,1173,246,1419,70,FALSE
react-virtualized,2.2.0,2.3.0,13,4,139,23,162,19,FALSE
react-virtualized,4.8.0,4.8.1,53,1,13,8,21,5,FALSE
react-virtualized,7.8.2,7.8.3,121,4,117,35,152,13,FALSE
react-virtualized,7.8.3,7.9.0,122,1,58,3,61,8,FALSE
react-virtualized,7.8.0,7.8.1,119,1,8,2,10,3,FALSE
react-virtualized,7.8.1,7.8.2,120,8,75,20,95,12,FALSE
react-virtualized,5.5.3-rc2,5.5.3,75,6,73,49,122,21,FALSE
react-virtualized,5.5.3-rc1,5.5.3-rc2,74,3,15,26,41,7,FALSE
react-virtualized,7.0.0-rc.1,7.0.0,98,2,2885,1149,4034,90,FALSE
react-virtualized,3.0.0,3.0.1,27,5,469,87,556,24,FALSE
react-virtualized,7.17.0,7.17.1,144,1,22,3,25,4,FALSE
react-virtualized,5.3.2,5.4.0,69,3,836,326,1162,34,FALSE
react-virtualized,8.0.0-rc.2,8.0.0-rc.3,166,3,9,11,20,5,FALSE
react-virtualized,4.6.0,4.6.1,44,1,4,6,10,5,FALSE
react-virtualized,2.4.0,2.5.0,15,4,2385,1323,3708,32,FALSE
react-virtualized,4.9.0,4.10.0,55,18,5123,971,6094,105,FALSE
react-virtualized,7.17.1,7.18.0,145,7,12073,10934,23007,194,FALSE
react-virtualized,2.6.1,2.6.2,18,6,85,33,118,23,FALSE
react-virtualized,7.20.0,7.21.0,153,10,630,82,712,33,FALSE
react-virtualized,2.6.2,2.7.0,19,4,570,50,620,15,FALSE
react-virtualized,7.6.0,7.7.0,116,7,136,404,540,21,FALSE
react-virtualized,6.3.1,6.3.2,96,23,2901,1158,4059,100,FALSE
react-virtualized,6.3.2,7.0.0-rc.1,97,29,1204,561,1765,108,FALSE
react-virtualized,6.0.3,6.0.4,83,3,81,108,189,7,FALSE
react-virtualized,6.0.2,6.0.3,82,14,226,38,264,20,FALSE
react-virtualized,6.0.1,6.0.2,81,12,371,142,513,31,FALSE
react-virtualized,6.0.0,6.0.1,80,2,348,236,584,38,FALSE
react-virtualized,6.0.7,6.0.8,87,3,8,5,13,4,FALSE
react-virtualized,6.0.6,6.0.7,86,6,96,43,139,11,FALSE
react-virtualized,6.0.5,6.0.6,85,3,149,85,234,8,FALSE
react-virtualized,6.0.4,6.0.5,84,10,136,29,165,36,FALSE
react-virtualized,5.1.1,5.1.2-rc1,60,3,50,32,82,13,FALSE
react-virtualized,4.6.2,4.6.3,46,5,12662,181,12843,12,FALSE
react-virtualized,6.0.8,6.1.0,88,3,301,124,425,9,FALSE
react-virtualized,7.1.2,7.1.3,107,5,8,5,13,6,FALSE
react-virtualized,2.7.2,2.7.3,22,1,35,15,50,5,FALSE
react-virtualized,2.1.0,2.1.1,11,4,261,152,413,21,FALSE
react-virtualized,2.1.1,2.2.0,12,6,68,10,78,10,FALSE
react-virtualized,0.0.1,0.0.2,1,8,347,74,421,22,FALSE
react-virtualized,0.0.3,0.0.4,3,5,80,3,83,9,FALSE
react-virtualized,0.0.2,0.0.3,2,1,5,1,6,2,FALSE
react-virtualized,4.2.0,4.2.1,35,1,6,1,7,4,FALSE
react-virtualized,7.9.0,7.9.1,123,1,7,2,9,3,FALSE
react-virtualized,2.3.0,2.4.0,14,3,202,13,215,18,FALSE
react-virtualized,7.12.2,7.12.3,137,7,244,196,440,11,FALSE
react-virtualized,7.12.3,7.13.0,138,7,893,339,1232,21,FALSE
react-virtualized,7.12.0,7.12.1,135,1,17,2,19,4,FALSE
react-virtualized,7.12.1,7.12.2,136,8,97,22,119,15,FALSE
react-virtualized,7.14.0,7.15.0,140,3,182,48,230,13,FALSE
react-virtualized,4.6.6,4.7.0,50,3,33,13,46,15,FALSE
react-virtualized,4.6.5,4.6.6,49,1,9,4,13,5,FALSE
react-virtualized,4.6.4,4.6.5,48,1,86,12454,12540,5,FALSE
react-virtualized,4.6.3,4.6.4,47,3,25,19,44,10,FALSE
react-virtualized,8.0.0-rc.1,8.0.0-rc.2,165,1,27,39,66,6,FALSE
react-virtualized,4.6.1,4.6.2,45,4,215,534,749,18,FALSE
react-virtualized,4.7.0,4.7.1,51,4,166,59,225,15,FALSE
react-virtualized,2.7.4,2.7.5,24,3,171,121,292,8,FALSE
react-virtualized,2.7.5,2.8.0,25,1,204,58,262,10,FALSE
react-virtualized,7.1.3,7.2.0,108,10,511,66,577,34,FALSE
react-virtualized,4.4.0,4.4.1,39,3,566,10,576,7,FALSE
react-virtualized,7.1.1,7.1.2,106,6,147,22,169,33,FALSE
react-virtualized,4.4.2,4.4.3,41,2,213,27,240,7,FALSE
react-virtualized,4.2.1,4.3.0,36,2,71,19,90,8,FALSE
react-virtualized,5.2.1,5.2.2,63,9,1093,2051,3144,55,FALSE
react-virtualized,2.5.0,2.6.0,16,11,1601,815,2416,50,FALSE
react-virtualized,7.3.1,7.3.2,111,17,510,152,662,30,FALSE
react-virtualized,7.3.0,7.3.1,110,1,1,1,2,1,FALSE
react-virtualized,7.3.3,7.4.0,113,8,267,58,325,26,FALSE
react-virtualized,7.3.2,7.3.3,112,6,188,45,233,17,FALSE
react-virtualized,8.11.4,9.0.0-rc.0,209,35,9329,3203,12532,150,FALSE
react-virtualized,9.7.2,9.7.3,235,10,275,86,361,17,FALSE
react-virtualized,8.11.0,8.11.1,205,3,8,3,11,4,TRUE
react-virtualized,8.11.1,8.11.2,206,2,40,2,42,4,FALSE
react-virtualized,8.11.2,8.11.3,207,13,332,76,408,28,FALSE
react-virtualized,8.11.3,8.11.4,208,4,168,30,198,55,FALSE
react-virtualized,9.0.4,9.0.5,217,4,109,5,114,8,FALSE
react-virtualized,9.1.0,9.2.0,219,28,346,518,864,64,FALSE
react-virtualized,9.0.0,9.0.1,213,13,113,48,161,18,FALSE
react-virtualized,9.0.1,9.0.2,214,4,242,42,284,9,FALSE
react-virtualized,9.0.2,9.0.3,215,3,61,19,80,5,FALSE
react-virtualized,9.0.3,9.0.4,216,6,229,71,300,9,FALSE
react-virtualized,9.2.3,9.3.0,223,3,29,2,31,6,FALSE
react-virtualized,8.10.0,8.11.0,204,6,102,5,107,9,FALSE
react-virtualized,8.4.1,8.5.0,188,4,25,7,32,7,FALSE
react-virtualized,9.7.5,9.7.6,238,11,216,79,295,17,FALSE
react-virtualized,9.7.4,9.7.5,237,9,360,73,433,19,FALSE
react-virtualized,8.5.0,8.5.1,189,4,33,4,37,6,FALSE
react-virtualized,8.5.1,8.5.2,190,9,20,11,31,12,FALSE
react-virtualized,9.7.1,9.7.2,234,2,56,41,97,9,FALSE
react-virtualized,8.5.3,8.6.0,193,14,342,117,459,21,FALSE
react-virtualized,8.8.0-alpha.1,8.8.0-alpha.2,198,1,1,1,2,1,FALSE
react-virtualized,8.8.0-alpha.2,8.8.0-alpha.3,199,3,4,4,8,3,FALSE
react-virtualized,8.8.0-alpha.3,8.8.0,200,6,555,56,611,22,FALSE
react-virtualized,9.7.0,9.7.1,233,1,72,32,104,33,FALSE
react-virtualized,9.5.0,9.6.0,230,15,1374,266,1640,48,FALSE
react-virtualized,9.0.5,9.1.0,218,9,547,54,601,33,FALSE
react-virtualized,8.9.0,8.10.0,203,43,719,278,997,71,FALSE
react-virtualized,9.6.0,9.6.1,231,1,6,5,11,3,FALSE
react-virtualized,9.6.1,9.7.0,232,5,272,99,371,18,FALSE
react-virtualized,9.0.0-rc.2,9.0.0,212,7,1767,1498,3265,71,FALSE
react-virtualized,9.0.0-rc.1,9.0.0-rc.2,211,16,405,313,718,53,FALSE
react-virtualized,9.0.0-rc.0,9.0.0-rc.1,210,4,386,336,722,9,TRUE
react-virtualized,8.0.4,8.0.5,172,1,34,1,35,4,FALSE
react-virtualized,8.8.1,8.9.0,202,28,2240,373,2613,69,FALSE
react-virtualized,8.8.0,8.8.1,201,1,46,1,47,4,FALSE
react-virtualized,8.0.0-rc.3,8.0.0,167,7,1446,1574,3020,114,FALSE
react-virtualized,8.4.0,8.4.1,187,1,9,1,10,4,FALSE
react-virtualized,9.4.0-rc.1,9.4.0,226,2,1478,18,1496,15,FALSE
react-virtualized,9.4.0-rc.0,9.4.0-rc.1,225,15,1811,249,2060,45,FALSE
react-virtualized,8.0.11,8.0.12,179,5,20,9,29,8,FALSE
react-virtualized,8.0.10,8.0.11,178,4,7,4,11,5,FALSE
react-virtualized,8.0.13,8.1.0,181,11,368,206,574,23,FALSE
react-virtualized,8.0.12,8.0.13,180,10,18,11,29,14,FALSE
react-virtualized,8.3.0,8.3.1,185,2,7,3,10,3,FALSE
react-virtualized,8.3.1,8.4.0,186,1,192,50,242,7,FALSE
react-virtualized,9.7.3,9.7.4,236,12,455,63,518,38,FALSE
react-virtualized,8.2.0,8.3.0,184,11,178,105,283,24,FALSE
react-virtualized,8.1.0,8.1.1,182,4,1500,1444,2944,35,FALSE
react-virtualized,8.1.1,8.2.0,183,18,1642,1525,3167,87,FALSE
react-virtualized,9.3.0,9.4.0-rc.0,224,14,267,51,318,20,FALSE
react-virtualized,8.0.9,8.0.10,177,1,6,3,9,3,FALSE
react-virtualized,8.0.8,8.0.9,176,3,24,13,37,8,FALSE
react-virtualized,8.0.5,8.0.6,173,10,71,57,128,19,FALSE
react-virtualized,9.4.1,9.4.2,228,4,22,17,39,9,FALSE
react-virtualized,8.0.7,8.0.8,175,5,92,15,107,15,FALSE
react-virtualized,8.0.6,8.0.7,174,1,10,4,14,3,FALSE
react-virtualized,8.0.1,8.0.2,169,1,17,12,29,4,FALSE
react-virtualized,8.0.0,8.0.1,168,3,14,7,21,6,FALSE
react-virtualized,8.0.3,8.0.4,171,1,6,2,8,3,FALSE
react-virtualized,8.0.2,8.0.3,170,3,9,5,14,4,FALSE
react-virtualized,9.4.0,9.4.1,227,9,41,41,82,10,FALSE
react-virtualized,8.6.1,8.7.0,195,1,133,14,147,6,FALSE
react-virtualized,8.6.0,8.6.1,194,3,46,65,111,10,FALSE
react-virtualized,8.7.0,8.7.1,196,1,15,56,71,4,FALSE
react-virtualized,8.7.1,8.8.0-alpha.1,197,1,1,1,2,1,FALSE
react-virtualized,8.5.2,8.5.3-beta,191,12,938,377,1315,58,FALSE
react-virtualized,8.5.3-beta,8.5.3,192,2,126,62,188,9,FALSE
react-virtualized,9.2.2,9.2.3,222,8,402,101,503,22,FALSE
react-virtualized,9.4.2,9.5.0,229,3,50,10,60,8,FALSE
react-virtualized,9.2.0,9.2.1,220,3,79,22,101,4,FALSE
react-virtualized,9.2.1,9.2.2,221,2,13,14,27,3,FALSE
react-virtualized,5.1.0,5.1.1,59,5,70,85,155,16,FALSE
react-virtualized,8.0.0-rc.2,8.0.0-rc.3,166,3,9,11,20,5,TRUE
react-virtualized,8.11.0,8.11.1,205,3,8,3,11,4,FALSE
react-virtualized,6.2.2,6.3.0,94,3,108,5,113,6,TRUE
react-virtualized,9.0.0-rc.0,9.0.0-rc.1,210,4,386,336,722,9,FALSE
react-virtualized,2.7.2,2.7.3,22,1,35,15,50,5,TRUE
react-virtualized,2.7.0,2.7.1,20,4,28,5,33,8,TRUE
react-virtualized,9.7.2,9.7.3,235,10,275,86,361,17,TRUE
react-virtualized,9.7.1,9.7.2,234,2,56,41,97,9,TRUE
react-virtualized,1.0.0,1.0.1,5,4,56,24,80,7,FALSE
react-virtualized,1.0.1,1.0.2,6,6,283,114,397,20,FALSE
react-virtualized,1.0.2,1.0.3,7,10,959,696,1655,54,FALSE
react-virtualized,1.0.3,1.0.4,8,6,41,23,64,11,FALSE
react-virtualized,7.10.0,7.11.0,125,2,91,36,127,13,TRUE
react-virtualized,4.5.0,4.6.0,43,4,137,99,236,24,TRUE
react-virtualized,7.11.8,7.12.0,134,1,26,5,31,5,TRUE
react-virtualized,7.8.1,7.8.2,120,8,75,20,95,12,TRUE
react-virtualized,6.0.2,6.0.3,82,14,226,38,264,20,TRUE
react-virtualized,6.0.1,6.0.2,81,12,371,142,513,31,TRUE
react-virtualized,0.0.4,1.0.0,4,4,2007,23,2030,10,FALSE
react-virtualized,4.4.3,4.5.0,42,8,1306,492,1798,44,TRUE
react-virtualized,8.11.4,9.0.0-rc.0,209,35,9329,3203,12532,150,TRUE
react-virtualized,7.18.0,7.18.1,146,1,51,10,61,4,TRUE
react-virtualized,4.6.0,4.6.1,44,1,4,6,10,5,TRUE
react-virtualized,5.2.4,5.3.0,66,10,8263,2139,10402,98,TRUE
react-virtualized,9.0.0-rc.1,9.0.0-rc.2,211,16,405,313,718,53,TRUE
react-virtualized,9.2.1,9.2.2,221,2,13,14,27,3,TRUE
react-virtualized,7.18.1,7.19.0,147,4,322,34,356,18,TRUE
react-virtualized,9.0.0,9.0.1,213,13,113,48,161,18,TRUE
react-virtualized,7.11.5,7.11.6,131,3,150,104,254,23,TRUE
react-virtualized,9.7.0,9.7.1,233,1,72,32,104,33,TRUE
react-virtualized,6.0.8,6.1.0,88,3,301,124,425,9,TRUE
react-virtualized,7.24.1,7.24.2,162,10,468,431,899,99,TRUE
react-virtualized,8.0.0-rc.3,8.0.0,167,7,1446,1574,3020,114,TRUE
react-virtualized,1.0.3,1.0.4,8,6,41,23,64,11,TRUE
react-virtualized,5.4.0,5.5.0,70,5,637,282,919,26,TRUE
react-virtualized,7.0.3,7.0.4,102,5,23,10,33,8,TRUE
react-virtualized,7.4.0,7.5.0,114,26,884,214,1098,62,TRUE
react-virtualized,2.7.4,2.7.5,24,3,171,121,292,8,TRUE
react-virtualized,4.6.2,4.6.3,46,5,12662,181,12843,12,TRUE
react-virtualized,7.11.2,7.11.3,128,6,198,131,329,24,TRUE
react-virtualized,4.0.1,4.0.2,32,4,23,14,37,10,TRUE
react-virtualized,4.3.1,4.4.0,38,8,3042,506,3548,54,TRUE
react-virtualized,6.2.1,6.2.2,93,3,34,11,45,12,TRUE
react-virtualized,6.1.0,6.1.1,89,1,13,10,23,2,TRUE
react-virtualized,7.8.3,7.9.0,122,1,58,3,61,8,TRUE
react-virtualized,5.5.3-rc1,5.5.3-rc2,74,3,15,26,41,7,TRUE
react-virtualized,7.12.2,7.12.3,137,7,244,196,440,11,TRUE
react-virtualized,5.3.2,5.4.0,69,3,836,326,1162,34,TRUE
react-virtualized,2.2.0,2.3.0,13,4,139,23,162,19,TRUE
react-virtualized,0.0.4,1.0.0,4,4,2007,23,2030,10,TRUE
react-virtualized,1.0.4,2.0.0,9,29,747,1078,1825,70,TRUE
react-virtualized,7.22.3,7.23.0,159,12,268,111,379,25,TRUE
react-virtualized,7.24.3,8.0.0-rc.1,164,11,870,795,1665,85,TRUE
react-virtualized,7.19.0,7.19.1,148,8,149,45,194,13,TRUE
react-virtualized,8.8.0-alpha.2,8.8.0-alpha.3,199,3,4,4,8,3,TRUE
react-virtualized,8.11.3,8.11.4,208,4,168,30,198,55,TRUE
react-virtualized,5.5.4,5.5.5,77,4,11,7,18,6,TRUE
react-virtualized,4.4.1,4.4.2,40,3,390,33,423,11,TRUE
react-virtualized,7.1.3,7.2.0,108,10,511,66,577,34,TRUE
react-virtualized,7.3.1,7.3.2,111,17,510,152,662,30,TRUE
react-virtualized,7.19.2,7.19.3,150,1,52,14,66,4,TRUE
react-virtualized,7.11.6,7.11.7,132,1,9,7,16,4,TRUE
react-virtualized,7.6.0,7.7.0,116,7,136,404,540,21,TRUE
react-virtualized,8.1.0,8.1.1,182,4,1500,1444,2944,35,TRUE
react-virtualized,9.0.4,9.0.5,217,4,109,5,114,8,TRUE
react-virtualized,7.12.3,7.13.0,138,7,893,339,1232,21,TRUE
react-virtualized,9.0.3,9.0.4,216,6,229,71,300,9,TRUE
react-virtualized,8.5.2,8.5.3-beta,191,12,938,377,1315,58,TRUE
react-virtualized,8.1.1,8.2.0,183,18,1642,1525,3167,87,TRUE
react-virtualized,9.1.0,9.2.0,219,28,346,518,864,64,TRUE
react-virtualized,5.5.0,5.5.1,71,5,1310,1641,2951,28,TRUE
react-virtualized,7.19.4,7.20.0,152,13,496,146,642,20,TRUE
react-virtualized,7.22.1,7.22.2,157,7,58,29,87,17,TRUE
react-virtualized,2.3.0,2.4.0,14,3,202,13,215,18,TRUE
react-virtualized,7.11.0,7.11.1,126,5,22,25,47,11,TRUE
react-virtualized,2.7.1,2.7.2,21,1,7,4,11,5,TRUE
react-virtualized,7.1.2,7.1.3,107,5,8,5,13,6,TRUE
react-virtualized,1.0.2,1.0.3,7,10,959,696,1655,54,TRUE
react-virtualized,8.0.10,8.0.11,178,4,7,4,11,5,TRUE
react-virtualized,4.9.0,4.10.0,55,18,5123,971,6094,105,TRUE
react-virtualized,5.5.3,5.5.4,76,3,123,68,191,13,TRUE
react-virtualized,2.4.0,2.5.0,15,4,2385,1323,3708,32,TRUE
react-virtualized,2.7.3,2.7.4,23,3,1648,2540,4188,13,TRUE
react-virtualized,5.2.3,5.2.4,65,5,212,62,274,17,TRUE
react-virtualized,4.10.0,5.0.0,56,24,6865,3030,9895,167,TRUE
react-virtualized,7.17.1,7.18.0,145,7,12073,10934,23007,194,TRUE
react-virtualized,8.0.9,8.0.10,177,1,6,3,9,3,TRUE
react-virtualized,8.5.3-beta,8.5.3,192,2,126,62,188,9,TRUE
react-virtualized,5.3.1,5.3.2,68,8,308,78,386,18,TRUE
casparcg-connection,0.9.0,0.9.1,45,4,18643,4354,22997,202,FALSE
casparcg-connection,0.15.1,0.15.2,55,2,4,4,8,4,FALSE
casparcg-connection,0.15.2,0.16.0,56,4,7031,2143,9174,161,FALSE
casparcg-connection,0.14.1,0.14.2,52,4,632,124,756,39,FALSE
casparcg-connection,0.14.0,0.14.1,51,2,317,301,618,64,FALSE
casparcg-connection,0.14.3,0.15.1,54,19,27443,17784,45227,1114,FALSE
casparcg-connection,0.9.1,0.12.0,46,128,15209,8210,23419,482,FALSE
casparcg-connection,0.14.2,0.14.3,53,6,197,29,226,12,FALSE
casparcg-connection,0.12.1,0.13.0,48,2,31,683,714,4,FALSE
casparcg-connection,0.17.0,0.17.1,58,3,10219,59645,69864,160,FALSE
casparcg-connection,0.16.0,0.17.0,57,6,222,178,400,14,FALSE
casparcg-connection,0.12.0,0.12.1,47,3,39652,3792,43444,280,FALSE
casparcg-connection,0.13.0,0.13.1,49,2,16,4,20,2,FALSE
casparcg-connection,0.13.1,0.14.0,50,32,29784,5630,35414,391,FALSE
casparcg-connection,0.6.0,0.7.4,35,19,6145,49,6194,47,FALSE
casparcg-connection,0.7.9,0.7.10,39,2,3,3,6,2,FALSE
casparcg-connection,0.7.6,0.7.9,38,6,34,31,65,11,FALSE
casparcg-connection,0.7.4,0.7.5,36,9,117374,627,118001,357,FALSE
casparcg-connection,0.7.5,0.7.6,37,2,2,2,4,2,FALSE
casparcg-connection,0.8.4,0.9.0,44,16,772,189,961,35,FALSE
casparcg-connection,0.8.0,0.8.2,41,6,2912,755,3667,179,FALSE
casparcg-connection,0.8.3,0.8.4,43,5,4069,3700,7769,172,FALSE
casparcg-connection,0.8.2,0.8.3,42,9,125,89,214,14,FALSE
casparcg-connection,0.2.1,0.2.2,23,1,3,3,6,1,FALSE
casparcg-connection,0.1.8,0.1.9,18,1,3,3,6,1,FALSE
casparcg-connection,0.1.9,0.1.10,19,1,3,3,6,1,FALSE
casparcg-connection,0.2.5,0.2.6,26,1,3,3,6,1,FALSE
casparcg-connection,0.2.4,0.2.5,25,1,3,3,6,1,FALSE
casparcg-connection,0.2.2,0.2.4,24,1,3,3,6,1,FALSE
casparcg-connection,0.0.13,0.1.0,11,1,3,3,6,1,FALSE
casparcg-connection,0.2.0,0.2.1,22,1,3,3,6,1,FALSE
casparcg-connection,0.1.0,0.1.3,12,1,3,3,6,1,FALSE
casparcg-connection,0.1.3,0.1.4,13,1,3,3,6,1,FALSE
casparcg-connection,0.1.4,0.1.5,14,1,3,3,6,1,FALSE
casparcg-connection,0.1.5,0.1.6,15,1,3,3,6,1,FALSE
casparcg-connection,0.1.6,0.1.7,16,1,3,3,6,1,FALSE
casparcg-connection,0.1.7,0.1.8,17,1,3,3,6,1,FALSE
casparcg-connection,0.3.0,0.4.0,32,1,676,0,676,2,FALSE
casparcg-connection,0.2.9,0.2.10,30,1,3,3,6,1,FALSE
casparcg-connection,0.4.0,0.5.0,33,1,3,3,6,1,FALSE
casparcg-connection,0.2.8,0.2.9,29,1,3,3,6,1,FALSE
casparcg-connection,0.5.0,0.6.0,34,1,3,3,6,1,FALSE
casparcg-connection,0.7.10,0.8.0,40,26,15174,11948,27122,552,FALSE
casparcg-connection,0.2.10,0.3.0,31,1,3,3,6,1,FALSE
casparcg-connection,0.2.7,0.2.8,28,1,3,3,6,1,FALSE
casparcg-connection,0.1.10,0.1.11,20,1,3,3,6,1,FALSE
casparcg-connection,0.1.11,0.2.0,21,1,3,3,6,1,FALSE
casparcg-connection,0.2.6,0.2.7,27,1,3,3,6,1,FALSE
casparcg-connection,0.17.0,0.17.1,58,3,10219,59645,69864,160,TRUE
casparcg-connection,0.13.0,0.13.1,49,2,16,4,20,2,TRUE
casparcg-connection,0.13.1,0.14.0,50,32,29784,5630,35414,391,TRUE
casparcg-connection,0.14.1,0.14.2,52,4,632,124,756,39,TRUE
casparcg-connection,0.14.3,0.15.1,54,19,27443,17784,45227,1114,TRUE
casparcg-connection,0.14.2,0.14.3,53,6,197,29,226,12,TRUE
molecule-3d-for-react,0.3.0,0.4.0,6,19,379,68,447,38,FALSE
molecule-3d-for-react,0.2.4,0.3.0,5,7,11,50986,50997,15,FALSE
molecule-3d-for-react,0.2.3,0.2.4,4,7,12744,5,12749,22,FALSE
molecule-3d-for-react,0.2.2,0.2.3,3,4,167,81,248,15,FALSE
molecule-3d-for-react,0.2.1,0.2.2,2,9,80,55,135,19,FALSE
molecule-3d-for-react,0.2.0,0.2.1,1,11,352,253,605,36,FALSE
molecule-3d-for-react,0.4.0,0.4.2,7,6,11,4,15,6,FALSE
molecule-3d-for-react,0.2.4,0.3.0,5,7,11,50986,50997,15,TRUE
molecule-3d-for-react,0.3.0,0.4.0,6,19,379,68,447,38,TRUE
molecule-3d-for-react,0.2.3,0.2.4,4,7,12744,5,12749,22,TRUE
molecule-3d-for-react,0.2.1,0.2.2,2,9,80,55,135,19,TRUE
molecule-3d-for-react,0.2.0,0.2.1,1,11,352,253,605,36,TRUE
meshblu-core-task-create-subscription,2.0.5,2.0.6,6,1,1,1,2,1,FALSE
meshblu-core-task-create-subscription,2.0.4,2.0.5,5,4,38,14,52,7,FALSE
meshblu-core-task-create-subscription,2.0.3,2.0.4,4,3,4,2,6,3,FALSE
meshblu-core-task-create-subscription,1.0.1,2.0.0,1,1,8,6,14,3,FALSE
meshblu-core-task-create-subscription,2.0.1,2.0.3,3,2,11,10,21,3,FALSE
meshblu-core-task-create-subscription,2.0.0,2.0.1,2,1,2,2,4,1,FALSE
meshblu-core-task-create-subscription,2.0.0,2.0.1,2,1,2,2,4,1,TRUE
meshblu-core-task-create-subscription,2.0.4,2.0.5,5,4,38,14,52,7,TRUE
bingspeech-api-client,2.1.2,2.2.0,5,2,132,53,185,6,FALSE
bingspeech-api-client,2.1.1,2.1.2,4,2,4,2,6,3,FALSE
bingspeech-api-client,1.0.0,2.0.0,1,2,133,42,175,7,FALSE
bingspeech-api-client,2.0.0,2.0.1,2,1,1,1,2,1,FALSE
bingspeech-api-client,2.0.1,2.1.1,3,10,116,23,139,14,FALSE
bingspeech-api-client,2.0.0,2.0.1,2,1,1,1,2,1,TRUE
bingspeech-api-client,1.0.0,2.0.0,1,2,133,42,175,7,TRUE
bingspeech-api-client,2.0.1,2.1.1,3,10,116,23,139,14,TRUE
bingspeech-api-client,2.1.1,2.1.2,4,2,4,2,6,3,TRUE
ncs,1.0.4,1.0.5,3,1,1,1,2,1,FALSE
ncs,1.0.5,1.0.6,4,1,1,1,2,1,FALSE
ncs,1.0.6,1.0.7,5,1,1,1,2,1,FALSE
ncs,1.0.7,1.0.8,6,1,1,1,2,1,FALSE
ncs,1.1.0,1.1.1,9,1,1,1,2,1,FALSE
ncs,1.0.8,1.0.9,7,1,1,1,2,1,FALSE
ncs,1.0.9,1.1.0,8,1,1,1,2,1,FALSE
ncs,1.0.3,1.0.4,2,1,1,1,2,1,FALSE
ncs,1.1.1,1.2.0,10,1,1,1,2,1,FALSE
ncs,1.4.0,1.4.1,16,1,1,1,2,1,FALSE
ncs,1.4.1,1.4.2,17,1,1,1,2,1,FALSE
ncs,1.4.2,1.4.4,18,1,1,1,2,1,FALSE
ncs,1.4.4,1.4.5,19,1,1,1,2,1,FALSE
ncs,1.4.5,1.4.6,20,1,1,1,2,1,FALSE
ncs,1.4.6,1.4.7,21,1,1,1,2,1,FALSE
ncs,1.4.7,1.4.8,22,1,1,1,2,1,FALSE
ncs,1.3.3,1.4.0,15,1,1,1,2,1,FALSE
ncs,1.3.2,1.3.3,14,1,1,1,2,1,FALSE
ncs,1.3.1,1.3.2,13,1,1,1,2,1,FALSE
ncs,1.3.0,1.3.1,12,1,1,1,2,1,FALSE
ncs,1.2.0,1.3.0,11,1,1,1,2,1,FALSE
ncs,2.1.2,2.1.3,36,1,0,1,1,1,FALSE
ncs,2.1.3,2.1.4,37,3,14,21,35,8,FALSE
ncs,2.1.4,2.1.5,38,3,66,2,68,6,TRUE
ncs,1.0.2,1.0.3,1,1,1,1,2,1,FALSE
ng2-pipe,1.0.5,1.0.6,8,3,136,4,140,3,FALSE
ng2-pipe,1.0.6,1.0.7,9,4,41,12,53,4,FALSE
ng2-pipe,1.0.7,1.0.8,10,2,4,2,6,3,FALSE
ng2-pipe,1.0.0,1.0.1,4,1,4,2,6,2,FALSE
ng2-pipe,1.0.1,1.0.2,5,1,2,1,3,1,FALSE
ng2-pipe,1.0.2,1.0.3,6,3,6,3,9,3,FALSE
ng2-pipe,0.0.2,1.0.0,3,6,133,40487,40620,43,FALSE
ng2-pipe,1.0.3,1.0.5,7,6,3704,20,3724,24,FALSE
ng2-pipe,1.0.8,1.0.9,11,1,7,1,8,5,FALSE
ng2-pipe,0.0.1,0.0.2,2,6,40610,36,40646,60,FALSE
ng2-pipe,0.0.0,0.0.1,1,1,4,4,8,1,FALSE
ng2-pipe,1.0.5,1.0.6,8,3,136,4,140,3,TRUE
ng2-pipe,1.0.6,1.0.7,9,4,41,12,53,4,TRUE
ng2-pipe,1.0.7,1.0.8,10,2,4,2,6,3,TRUE
eruda,1.1.1,1.1.2,47,9,352,43,395,22,FALSE
eruda,1.1.0,1.1.1,46,9,232,129,361,19,FALSE
eruda,1.1.3,1.2.0,49,20,4592,3441,8033,90,FALSE
eruda,1.1.2,1.1.3,48,12,786,549,1335,43,FALSE
eruda,1.2.2,1.2.3,52,14,604,276,880,32,FALSE
eruda,1.2.0,1.2.1,50,12,396,156,552,37,FALSE
eruda,1.2.1,1.2.2,51,20,923,345,1268,40,FALSE
eruda,1.0.4,1.0.5,42,5,1361,818,2179,14,FALSE
eruda,1.0.5,1.0.6,43,9,696,219,915,21,FALSE
eruda,1.0.6,1.0.7,44,1,25,0,25,1,FALSE
eruda,1.0.7,1.1.0,45,28,2574,1269,3843,132,FALSE
eruda,1.0.0,1.0.1,38,1,7,7,14,5,FALSE
eruda,1.0.1,1.0.2,39,1,25,0,25,1,FALSE
eruda,1.0.2,1.0.3,40,3,11,4,15,4,FALSE
eruda,1.0.3,1.0.4,41,1,2,2,4,2,FALSE
eruda,0.2.2,0.3.0,13,7,550,104,654,35,FALSE
eruda,0.2.1,0.2.2,12,2,74,31,105,9,FALSE
eruda,0.2.0,0.2.1,11,2,6,2,8,3,FALSE
eruda,0.1.0,0.1.1,8,1,6,2,8,4,FALSE
eruda,0.1.1,0.1.2,9,3,59,33,92,6,FALSE
eruda,0.1.2,0.2.0,10,14,791,289,1080,82,FALSE
eruda,0.6.4,0.6.5,34,1,35,20,55,4,FALSE
eruda,0.0.5,0.0.6,5,3,133,80,213,9,FALSE
eruda,0.0.4,0.0.5,4,2,6,2,8,2,FALSE
eruda,0.0.7,0.1.0,7,13,2398,1506,3904,87,FALSE
eruda,0.0.6,0.0.7,6,6,88,25,113,22,FALSE
eruda,0.0.1,0.0.2,1,1,25,0,25,1,FALSE
eruda,0.0.3,0.0.4,3,2,71,25,96,9,FALSE
eruda,0.0.2,0.0.3,2,1,25,0,25,1,FALSE
eruda,0.3.2,0.3.3,16,7,213,131,344,25,FALSE
eruda,0.3.3,0.3.4,17,1,20,4,24,2,FALSE
eruda,0.3.0,0.3.1,14,1,286,18,304,11,FALSE
eruda,0.6.0,0.6.1,30,4,356,146,502,41,FALSE
eruda,0.3.4,0.4.0,18,14,677,511,1188,58,FALSE
eruda,0.7.1,1.0.0,37,6,19801,19730,39531,28,FALSE
eruda,0.5.8,0.5.9,28,2,39,14,53,9,FALSE
eruda,0.5.9,0.6.0,29,1,297,180,477,22,FALSE
eruda,0.5.4,0.5.5,24,6,124,71,195,18,FALSE
eruda,0.4.0,0.5.0,19,11,627,587,1214,88,FALSE
eruda,0.5.6,0.5.7,26,6,158,85,243,16,FALSE
eruda,0.5.7,0.5.8,27,2,13,4,17,4,FALSE
eruda,0.5.0,0.5.1,20,1,47,9,56,6,FALSE
eruda,0.5.1,0.5.2,21,5,220,23,243,12,FALSE
eruda,0.5.2,0.5.3,22,1,3,3,6,2,FALSE
eruda,0.5.3,0.5.4,23,1,25,0,25,1,FALSE
eruda,0.6.5,0.7.0,35,8,1337,265,1602,30,TRUE
eruda,0.5.5,0.5.6,25,6,237,154,391,19,FALSE
eruda,0.3.1,0.3.2,15,1,2,2,4,2,FALSE
eruda,0.7.0,0.7.1,36,4,575,582,1157,8,TRUE
eruda,0.6.3,0.6.4,33,5,291,154,445,35,FALSE
eruda,0.6.2,0.6.3,32,3,122,63,185,12,FALSE
eruda,0.6.1,0.6.2,31,1,69,110,179,21,FALSE
eruda,0.7.1,1.0.0,37,6,19801,19730,39531,28,TRUE
eruda,0.6.5,0.7.0,35,8,1337,265,1602,30,FALSE
eruda,0.7.0,0.7.1,36,4,575,582,1157,8,FALSE
eruda,0.0.7,0.1.0,7,13,2398,1506,3904,87,TRUE
eruda,0.5.1,0.5.2,21,5,220,23,243,12,TRUE
eruda,1.0.4,1.0.5,42,5,1361,818,2179,14,TRUE
eruda,0.6.1,0.6.2,31,1,69,110,179,21,TRUE
eruda,1.1.0,1.1.1,46,9,232,129,361,19,TRUE
taucharts,0.2.27,0.3.0,3,47,3793,28567,32360,226,FALSE
taucharts,0.2.24,0.2.27,2,19,872,333,1205,72,FALSE
taucharts,0.7.5,0.7.6,34,2,11,2,13,3,FALSE
taucharts,0.9.1-beta.1,0.9.1-beta.2,45,8,1015,778,1793,42,FALSE
taucharts,0.3.4,0.3.13,7,55,6188,15526,21714,240,FALSE
taucharts,0.6.3,0.7.0,21,35,4959,487,5446,157,FALSE
taucharts,0.7.3-alpha.1,0.7.3-alpha.2,25,1,1,1,2,1,FALSE
taucharts,0.7.3-alpha.2,0.7.3-alpha.3,26,1,1,1,2,1,FALSE
taucharts,0.7.3-alpha.3,0.7.3-alpha.4,27,1,1,1,2,1,FALSE
taucharts,0.7.3-alpha.4,0.7.3-alpha.5,28,1,1,1,2,1,FALSE
taucharts,0.7.3-alpha.5,0.7.3-alpha.6,29,1,1,1,2,1,FALSE
taucharts,0.7.3-alpha.6,0.7.3-alpha.7,30,1,1,1,2,1,FALSE
taucharts,0.7.3-alpha.7,0.7.3-alpha.8,31,8,549,730,1279,115,FALSE
taucharts,0.3.2,0.3.4,6,28,1029,257,1286,57,FALSE
taucharts,0.6.2,0.6.3,20,13,206,87,293,23,FALSE
taucharts,0.3.0,0.3.1,4,21,562,229,791,34,FALSE
taucharts,0.3.1,0.3.2,5,1,1,1,2,1,FALSE
taucharts,0.7.2,0.7.3-alpha.1,24,23,572,673,1245,68,FALSE
taucharts,0.7.0,0.7.1,22,9,115,57,172,16,FALSE
taucharts,0.7.1,0.7.2,23,8,196,39,235,16,FALSE
taucharts,0.4.1,0.4.2,13,21,3326,599,3925,110,FALSE
taucharts,0.5.1,0.6.2,19,91,19906,7842,27748,370,FALSE
taucharts,0.3.17,0.3.20,9,10,270,78,348,25,FALSE
taucharts,0.4.5,0.4.6,16,4,1435,1384,2819,18,FALSE
taucharts,0.4.4,0.4.5,15,14,1372,291,1663,53,FALSE
taucharts,0.4.6,0.5.0,17,53,5028,1389,6417,214,FALSE
taucharts,0.9.0,0.9.1-beta.0,43,15,1099,476,1575,52,FALSE
taucharts,0.9.1,0.9.2-beta.0,47,11,1308,566,1874,80,FALSE
taucharts,0.9.2,0.9.3-beta.0,54,1,1,1,2,1,FALSE
taucharts,0.9.3,0.9.4-beta.1,60,32,5312,3779,9091,425,FALSE
taucharts,0.8.4,0.9.0,42,7,558,548,1106,57,FALSE
taucharts,0.8.1,0.8.2,39,10,1374,262,1636,62,FALSE
taucharts,0.8.0,0.8.1,38,13,801,399,1200,79,FALSE
taucharts,0.8.3,0.8.4,41,14,2792,1945,4737,95,FALSE
taucharts,0.8.2,0.8.3,40,16,800,968,1768,42,FALSE
taucharts,0.9.2-beta.0,0.9.2-beta.1,48,5,40,8,48,7,FALSE
taucharts,0.9.2-beta.1,0.9.2-beta.2,49,6,1695,183,1878,38,FALSE
taucharts,0.9.2-beta.2,0.9.2-beta.3,50,15,890,730,1620,47,FALSE
taucharts,0.9.2-beta.3,0.9.2-beta.4,51,7,319,134,453,33,FALSE
taucharts,0.9.2-beta.4,0.9.2-beta.5,52,18,1409,576,1985,58,FALSE
taucharts,0.9.2-beta.5,0.9.2,53,45,4535,2065,6600,133,FALSE
taucharts,0.9.4-beta.6,0.9.4,66,9,2141,681,2822,119,FALSE
taucharts,0.9.1-beta.0,0.9.1-beta.1,44,16,947,664,1611,79,FALSE
taucharts,0.9.4-beta.4,0.9.4-beta.5,64,14,214,67,281,24,FALSE
taucharts,0.9.4-beta.5,0.9.4-beta.6,65,13,2899,573,3472,104,FALSE
taucharts,0.9.4-beta.2,0.9.4-beta.3,62,3,2,4,6,4,FALSE
taucharts,0.9.4-beta.3,0.9.4-beta.4,63,8,90,32,122,13,FALSE
taucharts,0.9.4-beta.1,0.9.4-beta.2,61,28,1331,792,2123,82,FALSE
taucharts,0.7.6,0.7.7,35,15,787,239,1026,30,FALSE
taucharts,0.4.2,0.4.4,14,71,9446,3799,13245,236,FALSE
taucharts,0.3.20,0.3.21,10,2,2,2,4,2,FALSE
taucharts,0.7.8,0.8.0,37,10,1455,1205,2660,44,FALSE
taucharts,0.5.0,0.5.1,18,52,315263,11448,326711,239,FALSE
taucharts,0.9.1-beta.2,0.9.1,46,1,1,1,2,1,FALSE
taucharts,0.9.3-beta.4,0.9.3,59,8,206,106,312,27,FALSE
taucharts,0.9.3-beta.3,0.9.3-beta.4,58,6,30,40,70,12,FALSE
taucharts,0.9.3-beta.2,0.9.3-beta.3,57,20,1230,561,1791,89,FALSE
taucharts,0.9.3-beta.1,0.9.3-beta.2,56,25,7289,2893,10182,73,FALSE
taucharts,0.9.3-beta.0,0.9.3-beta.1,55,20,722,304,1026,41,FALSE
taucharts,0.3.21,0.3.22,11,1,6,5,11,4,FALSE
taucharts,0.7.3-alpha.8,0.7.4,32,8,1291,1156,2447,15,FALSE
taucharts,0.3.22,0.4.1,12,143,26190,17043,43233,690,FALSE
taucharts,0.7.7,0.7.8,36,17,1158,1104,2262,33,FALSE
taucharts,0.3.13,0.3.17,8,43,977,595,1572,83,FALSE
taucharts,0.7.4,0.7.5,33,5,591,275,866,23,FALSE
taucharts,1.0.0,1.1.0,94,2,343,4,347,9,FALSE
taucharts,0.10.0-beta.19,0.10.0-beta.20,87,3,39,17,56,6,FALSE
taucharts,0.10.0-beta.18,0.10.0-beta.19,86,5,280,67,347,18,FALSE
taucharts,0.10.0-beta.11,0.10.0-beta.12,79,1,10,7,17,2,FALSE
taucharts,0.10.0-beta.10,0.10.0-beta.11,78,3,46,41,87,26,FALSE
taucharts,0.10.0-beta.13,0.10.0-beta.14,81,3,339,86,425,11,FALSE
taucharts,0.10.0-beta.12,0.10.0-beta.13,80,3,9,4,13,4,FALSE
taucharts,0.10.0-beta.15,0.10.0-beta.16,83,2,3,2,5,3,FALSE
taucharts,0.10.0-beta.14,0.10.0-beta.15,82,5,2998,221,3219,19,FALSE
taucharts,0.10.0-beta.17,0.10.0-beta.18,85,4,469,130,599,14,FALSE
taucharts,0.10.0-beta.16,0.10.0-beta.17,84,2,28,25,53,5,FALSE
taucharts,0.10.0-beta.24,0.10.0-beta.25,92,2,180,44,224,9,FALSE
taucharts,0.10.0-beta.25,1.0.0,93,2,71,22,93,5,FALSE
taucharts,0.10.0-beta.20,0.10.0-beta.21,88,9,1018,289,1307,29,FALSE
taucharts,0.10.0-beta.21,0.10.0-beta.22,89,5,201,69,270,11,FALSE
taucharts,0.10.0-beta.22,0.10.0-beta.23,90,4,75,37,112,8,FALSE
taucharts,0.10.0-beta.23,0.10.0-beta.24,91,4,34,19,53,19,FALSE
taucharts,1.1.1,1.1.2,96,4,23,4,27,6,FALSE
taucharts,1.1.0,1.1.1,95,3,278,64,342,8,FALSE
taucharts,1.1.3,1.1.4,98,4,12,10,22,9,FALSE
taucharts,1.1.2,1.1.3,97,6,39,25,64,7,FALSE
taucharts,1.1.4,1.2.0,99,4,1235,36,1271,19,FALSE
taucharts,0.10.0-beta.1,0.10.0-beta.2,69,8,1066,241,1307,24,FALSE
taucharts,0.10.0-beta.0,0.10.0-beta.1,68,14,1994,1366,3360,65,FALSE
taucharts,0.10.0-beta.3,0.10.0-beta.4,71,23,2106,1088,3194,115,FALSE
taucharts,0.10.0-beta.2,0.10.0-beta.3,70,2,262,35,297,13,FALSE
taucharts,0.10.0-beta.5,0.10.0-beta.6,73,14,1342,517,1859,52,FALSE
taucharts,0.10.0-beta.4,0.10.0-beta.5,72,7,360,134,494,22,FALSE
taucharts,0.10.0-beta.7,0.10.0-beta.8,75,2,21,13,34,6,FALSE
taucharts,0.10.0-beta.6,0.10.0-beta.7,74,2,8,7,15,3,FALSE
taucharts,0.10.0-beta.9,0.10.0-beta.10,77,3,680,391,1071,27,FALSE
taucharts,0.10.0-beta.8,0.10.0-beta.9,76,3,252,115,367,14,FALSE
taucharts,0.9.0,0.9.1-beta.0,43,15,1099,476,1575,52,TRUE
taucharts,0.9.4,0.10.0-beta.0,67,37,3433,1490,4923,100,FALSE
taucharts,1.2.0,1.2.1,100,4,11,10,21,9,FALSE
taucharts,1.2.1,1.2.2,101,2,6,6,12,3,FALSE
taucharts,0.2.19,0.2.24,1,13,366,271,637,80,FALSE
taucharts,0.10.0-beta.18,0.10.0-beta.19,86,5,280,67,347,18,TRUE
taucharts,0.10.0-beta.17,0.10.0-beta.18,85,4,469,130,599,14,TRUE
taucharts,0.7.3-alpha.7,0.7.3-alpha.8,31,8,549,730,1279,115,TRUE
taucharts,0.7.7,0.7.8,36,17,1158,1104,2262,33,TRUE
taucharts,0.6.2,0.6.3,20,13,206,87,293,23,TRUE
taucharts,0.4.4,0.4.5,15,14,1372,291,1663,53,TRUE
taucharts,0.4.6,0.5.0,17,53,5028,1389,6417,214,TRUE
taucharts,0.5.0,0.5.1,18,52,315263,11448,326711,239,TRUE
taucharts,0.9.2-beta.0,0.9.2-beta.1,48,5,40,8,48,7,TRUE
taucharts,0.9.2-beta.3,0.9.2-beta.4,51,7,319,134,453,33,TRUE
taucharts,0.9.1-beta.1,0.9.1-beta.2,45,8,1015,778,1793,42,TRUE
taucharts,0.5.1,0.6.2,19,91,19906,7842,27748,370,TRUE
taucharts,0.9.4-beta.6,0.9.4,66,9,2141,681,2822,119,TRUE
taucharts,0.9.3-beta.2,0.9.3-beta.3,57,20,1230,561,1791,89,TRUE
taucharts,0.6.3,0.7.0,21,35,4959,487,5446,157,TRUE
taucharts,0.4.2,0.4.4,14,71,9446,3799,13245,236,TRUE
taucharts,0.7.5,0.7.6,34,2,11,2,13,3,TRUE
taucharts,0.10.0-beta.4,0.10.0-beta.5,72,7,360,134,494,22,TRUE
taucharts,0.7.3-alpha.8,0.7.4,32,8,1291,1156,2447,15,TRUE
taucharts,0.10.0-beta.13,0.10.0-beta.14,81,3,339,86,425,11,TRUE
taucharts,0.7.8,0.8.0,37,10,1455,1205,2660,44,TRUE
react-joyride,1.0.4,1.0.5,28,3,6,6,12,4,FALSE
react-joyride,1.0.5,1.1.0,29,2,38,15,53,4,FALSE
react-joyride,1.4.0,1.4.1,40,5,12,17,29,5,FALSE
react-joyride,1.0.1,1.0.2,25,2,92,64,156,2,FALSE
react-joyride,1.0.2,1.0.3,26,4,30,20,50,4,FALSE
react-joyride,1.0.3,1.0.4,27,2,8,9,17,2,FALSE
react-joyride,1.1.0,1.1.1,30,2,15,10,25,3,FALSE
react-joyride,1.3.4,1.3.5,37,7,113,93,206,13,FALSE
react-joyride,1.3.3,1.3.4,36,4,13,7,20,6,FALSE
react-joyride,1.3.2,1.3.3,35,4,9,14,23,9,FALSE
react-joyride,1.3.1,1.3.2,34,2,2,2,4,2,FALSE
react-joyride,1.3.0,1.3.1,33,2,19,13,32,3,FALSE
react-joyride,1.1.1,1.2.0,31,12,213,112,325,30,FALSE
react-joyride,1.3.6,1.4.0,39,10,152,71,223,12,FALSE
react-joyride,1.3.5,1.3.6,38,2,2,2,4,2,FALSE
react-joyride,1.4.1,1.4.2,41,5,46,15,61,5,FALSE
react-joyride,1.2.0,1.3.0,32,9,1061,1076,2137,16,FALSE
react-joyride,0.4.0,0.4.6,1,11,114,83,197,18,FALSE
react-joyride,0.4.6,0.5.0,2,4,92,73,165,6,FALSE
react-joyride,0.5.0,0.5.1,3,3,112,65,177,3,FALSE
react-joyride,0.5.1,0.5.2,4,7,75,40,115,8,FALSE
react-joyride,0.5.2,0.5.3,5,3,90,60,150,6,FALSE
react-joyride,1.10.0,1.10.1,61,9,103,154,257,18,FALSE
react-joyride,1.9.2,1.9.3,59,4,557,216,773,28,FALSE
react-joyride,1.4.4,1.4.5,43,2,10,21,31,8,FALSE
react-joyride,1.4.5,1.4.6,44,12,204,99,303,17,FALSE
react-joyride,1.4.6,1.4.7,45,5,56,35,91,7,FALSE
react-joyride,1.4.7,1.4.8,46,17,1102,488,1590,44,FALSE
react-joyride,1.4.8,1.5.0,47,5,205,139,344,11,FALSE
react-joyride,1.7.0,1.8.0,52,15,789,579,1368,40,FALSE
react-joyride,1.5.1,1.5.2,49,16,113,40,153,33,FALSE
react-joyride,1.5.0,1.5.1,48,11,360,250,610,35,FALSE
react-joyride,1.5.2,1.6.0,50,5,339,242,581,8,FALSE
react-joyride,1.6.0,1.7.0,51,57,2505,1355,3860,143,FALSE
react-joyride,1.9.1,1.9.2,58,3,30,26,56,9,FALSE
react-joyride,1.9.0,1.9.1,57,19,508,265,773,47,FALSE
react-joyride,1.9.3,1.10.0,60,14,1330,1236,2566,73,FALSE
react-joyride,1.8.0,1.8.1,53,2,52,8,60,4,FALSE
react-joyride,1.8.1,1.8.2,54,10,109,60,169,24,FALSE
react-joyride,1.8.2,1.8.3,55,25,367,156,523,55,FALSE
react-joyride,1.8.3,1.9.0,56,1,0,2,2,1,FALSE
react-joyride,1.4.2,1.4.4,42,7,1420,1077,2497,28,FALSE
react-joyride,1.4.8,1.5.0,47,5,205,139,344,11,TRUE
react-joyride,1.5.0,1.5.1,48,11,360,250,610,35,TRUE
react-joyride,0.7.5,0.7.6,22,5,75,76,151,8,FALSE
react-joyride,1.0.0,1.0.1,24,5,123,67,190,11,FALSE
react-joyride,0.6.7,0.7.0,16,5,157,130,287,6,FALSE
react-joyride,0.6.6,0.6.7,15,3,44,12,56,7,FALSE
react-joyride,0.7.0,0.7.1,17,9,104,36,140,9,FALSE
react-joyride,0.7.1,0.7.2,18,4,22,23,45,4,FALSE
react-joyride,0.5.4,0.5.5,7,2,6,5,11,4,FALSE
react-joyride,0.6.3,0.6.4,12,10,136,129,265,13,FALSE
react-joyride,0.6.2,0.6.3,11,2,3,3,6,2,FALSE
react-joyride,0.7.4,0.7.5,21,6,70,70,140,8,FALSE
react-joyride,0.6.0,0.6.1,9,4,97,48,145,12,FALSE
react-joyride,0.7.2,0.7.3,19,2,48,5,53,3,FALSE
react-joyride,0.7.3,0.7.4,20,8,81,35,116,10,FALSE
react-joyride,0.6.5,0.6.6,14,4,31,19,50,5,FALSE
react-joyride,0.6.4,0.6.5,13,11,273,194,467,13,FALSE
react-joyride,0.5.3,0.5.4,6,5,41,42,83,7,FALSE
react-joyride,0.5.5,0.6.0,8,7,240,215,455,8,FALSE
react-joyride,0.7.6,1.0.0,23,17,1681,1368,3049,36,FALSE
react-joyride,0.6.1,0.6.2,10,6,182,93,275,14,FALSE
react-joyride,1.4.5,1.4.6,44,12,204,99,303,17,TRUE
react-joyride,0.5.1,0.5.2,4,7,75,40,115,8,TRUE
react-joyride,0.5.3,0.5.4,6,5,41,42,83,7,TRUE
react-joyride,1.4.4,1.4.5,43,2,10,21,31,8,TRUE
react-joyride,1.4.6,1.4.7,45,5,56,35,91,7,TRUE
react-joyride,1.3.4,1.3.5,37,7,113,93,206,13,TRUE
react-joyride,1.10.0,1.10.1,61,9,103,154,257,18,TRUE
react-joyride,1.0.4,1.0.5,28,3,6,6,12,4,TRUE
react-joyride,0.6.4,0.6.5,13,11,273,194,467,13,TRUE
react-joyride,0.5.5,0.6.0,8,7,240,215,455,8,TRUE
react-joyride,1.0.2,1.0.3,26,4,30,20,50,4,TRUE
react-joyride,0.7.2,0.7.3,19,2,48,5,53,3,TRUE
react-joyride,1.9.0,1.9.1,57,19,508,265,773,47,TRUE
react-joyride,0.7.5,0.7.6,22,5,75,76,151,8,TRUE
react-joyride,0.6.5,0.6.6,14,4,31,19,50,5,TRUE
react-joyride,0.6.3,0.6.4,12,10,136,129,265,13,TRUE
react-joyride,0.6.0,0.6.1,9,4,97,48,145,12,TRUE
react-joyride,0.7.1,0.7.2,18,4,22,23,45,4,TRUE
react-joyride,1.5.2,1.6.0,50,5,339,242,581,8,TRUE
react-joyride,1.7.0,1.8.0,52,15,789,579,1368,40,TRUE
react-joyride,1.6.0,1.7.0,51,57,2505,1355,3860,143,TRUE
react-joyride,1.8.1,1.8.2,54,10,109,60,169,24,TRUE
react-joyride,1.0.1,1.0.2,25,2,92,64,156,2,TRUE
hue-hacking-node,1.1.5,1.1.6,18,19,655,238,893,36,FALSE
hue-hacking-node,1.1.1,1.1.2,14,4,165,119,284,10,FALSE
hue-hacking-node,1.1.0,1.1.1,13,2,7,5,12,5,FALSE
hue-hacking-node,1.1.3,1.1.4,16,2,2,1,3,2,FALSE
hue-hacking-node,1.1.2,1.1.3,15,2,367,284,651,13,FALSE
hue-hacking-node,1.0.0,1.1.0,12,13,2278,2004,4282,60,FALSE
hue-hacking-node,1.1.4,1.1.5,17,5,475,152,627,15,FALSE
hue-hacking-node,1.1.7,1.1.8,20,2,2,1,3,2,FALSE
hue-hacking-node,1.1.6,1.1.7,19,10,77,27,104,14,FALSE
hue-hacking-node,1.1.9,1.1.10,22,5,30,29,59,6,FALSE
hue-hacking-node,1.1.8,1.1.9,21,2,2,2,4,2,FALSE
hue-hacking-node,0.0.5,0.0.6,5,1,1,0,1,1,FALSE
hue-hacking-node,0.0.4,0.0.5,4,1,1,0,1,1,FALSE
hue-hacking-node,0.0.7,0.0.8,7,7,1011,11,1022,17,FALSE
hue-hacking-node,0.0.6,0.0.7,6,1,1,0,1,1,FALSE
hue-hacking-node,0.0.1,0.0.2,1,1,1,0,1,1,FALSE
hue-hacking-node,0.0.3,0.0.4,3,1,1,0,1,1,FALSE
hue-hacking-node,0.0.2,0.0.3,2,1,1,0,1,1,FALSE
hue-hacking-node,0.0.9,0.0.10,9,4,169,40,209,6,FALSE
hue-hacking-node,0.0.8,0.0.9,8,1,1,0,1,1,FALSE
hue-hacking-node,0.0.10,0.0.11,10,2,5,7,12,2,FALSE
hue-hacking-node,0.0.11,1.0.0,11,5,5938,4707,10645,45,FALSE
hue-hacking-node,1.1.3,1.1.4,16,2,2,1,3,2,TRUE
hue-hacking-node,1.1.2,1.1.3,15,2,367,284,651,13,TRUE
hue-hacking-node,1.0.0,1.1.0,12,13,2278,2004,4282,60,TRUE
hue-hacking-node,1.1.4,1.1.5,17,5,475,152,627,15,TRUE
hue-hacking-node,1.1.7,1.1.8,20,2,2,1,3,2,TRUE
hue-hacking-node,1.1.6,1.1.7,19,10,77,27,104,14,TRUE
hue-hacking-node,1.1.8,1.1.9,21,2,2,2,4,2,TRUE
hue-hacking-node,1.1.5,1.1.6,18,19,655,238,893,36,TRUE
zen-i18n,0.3.1,0.4.0,16,1,98,1,99,5,FALSE
zen-i18n,0.1.8,0.1.9,10,1,4,1,5,3,FALSE
zen-i18n,0.1.9,0.1.10,11,1,1,1,2,2,FALSE
zen-i18n,0.1.0,0.1.1,2,1,283,13,296,18,FALSE
zen-i18n,0.1.1,0.1.2,3,1,157,2,159,2,FALSE
zen-i18n,0.1.2,0.1.3,4,1,67,3,70,2,FALSE
zen-i18n,0.1.3,0.1.4,5,1,2,2,4,2,FALSE
zen-i18n,0.1.4,0.1.5,6,2,18,2,20,2,FALSE
zen-i18n,0.1.5,0.1.6,7,1,137,116,253,11,FALSE
zen-i18n,0.1.6,0.1.7,8,1,1,1,2,1,FALSE
zen-i18n,0.1.7,0.1.8,9,2,9,5,14,3,FALSE
zen-i18n,0.3.0,0.3.1,15,1,3,3,6,3,FALSE
zen-i18n,0.6.0,0.6.1,21,2,937,5,942,12,FALSE
zen-i18n,0.7.0,0.7.1,23,2,246,17,263,19,FALSE
zen-i18n,0.7.1,0.8.0,24,1,103,24,127,13,FALSE
zen-i18n,0.4.1,0.4.2,18,1,20,18,38,3,FALSE
zen-i18n,0.4.0,0.4.1,17,1,137,116,253,11,FALSE
zen-i18n,0.4.2,0.5.0,19,3,657,22,679,11,FALSE
zen-i18n,0.5.0,0.6.0,20,1,2,2,4,2,FALSE
zen-i18n,0.8.1,0.9.0,26,1,137,116,253,11,FALSE
zen-i18n,0.8.0,0.8.1,25,1,3,3,6,2,FALSE
zen-i18n,0.1.12,0.3.0,14,2,175,7,182,10,FALSE
zen-i18n,0.1.10,0.1.11,12,1,137,116,253,11,FALSE
zen-i18n,0.1.11,0.1.12,13,8,449,193,642,30,FALSE
zen-i18n,0.6.1,0.7.0,22,1,805,2,807,6,FALSE
zen-i18n,0.3.0,0.3.1,15,1,3,3,6,3,TRUE
zen-i18n,0.1.12,0.3.0,14,2,175,7,182,10,TRUE
zen-i18n,0.3.1,0.4.0,16,1,98,1,99,5,TRUE
zen-i18n,0.8.1,0.9.0,26,1,137,116,253,11,TRUE
zen-i18n,0.4.2,0.5.0,19,3,657,22,679,11,TRUE
zen-i18n,0.0.1,0.1.0,1,3,364,3,367,9,FALSE
react-stickynode,1.0.4,1.0.5,5,1,1,1,2,1,FALSE
react-stickynode,1.0.5,1.0.6,6,5,11,13,24,7,FALSE
react-stickynode,1.0.6,1.0.7,7,5,13,9,22,5,FALSE
react-stickynode,1.0.7,1.0.8,8,3,15,11,26,3,FALSE
react-stickynode,1.1.5,1.2.0,30,3,67,5,72,7,FALSE
react-stickynode,1.0.1,1.0.2,2,5,189,120,309,9,FALSE
react-stickynode,1.0.2,1.0.3,3,2,444,326,770,18,FALSE
react-stickynode,1.0.3,1.0.4,4,7,155,141,296,8,FALSE
react-stickynode,1.0.8,1.0.9,9,3,3,3,6,3,FALSE
react-stickynode,1.0.9,1.0.10,10,3,7,7,14,3,FALSE
react-stickynode,1.1.2,1.1.3,27,3,17,5,22,5,FALSE
react-stickynode,0.1.1,1.0.1,1,12,342,273,615,32,FALSE
react-stickynode,1.1.4,1.1.5,29,2,4,4,8,3,FALSE
react-stickynode,1.0.16,1.0.18,17,4,136,18,154,10,FALSE
react-stickynode,1.0.14,1.0.15,15,4,187,77,264,9,FALSE
react-stickynode,1.0.15,1.0.16,16,3,11,3,14,5,FALSE
react-stickynode,1.1.3,1.1.4,28,6,188,198,386,7,FALSE
react-stickynode,1.0.13,1.0.14,14,3,48,5,53,5,FALSE
react-stickynode,1.0.10,1.0.11,11,2,9,5,14,3,FALSE
react-stickynode,1.0.11,1.0.12,12,5,59,127,186,11,FALSE
react-stickynode,1.0.12,1.0.13,13,4,16,7,23,5,FALSE
react-stickynode,1.0.18,1.0.19,18,5,53,53,106,17,FALSE
react-stickynode,1.0.19,1.0.20,19,4,55,10,65,6,FALSE
react-stickynode,1.1.1,1.1.2,26,4,43,29,72,6,FALSE
react-stickynode,1.3.0,1.3.1,33,2,3,1,4,2,FALSE
react-stickynode,1.2.0,1.2.1,31,4,4,3,7,4,FALSE
react-stickynode,1.2.1,1.3.0,32,4,10,5,15,5,FALSE
react-stickynode,1.1.0,1.1.1,25,4,4,2,6,4,FALSE
react-stickynode,1.0.24,1.1.0,24,6,56,12,68,9,FALSE
react-stickynode,1.0.23,1.0.24,23,3,5,1,6,3,FALSE
react-stickynode,1.0.22,1.0.23,22,3,27,21,48,3,FALSE
react-stickynode,1.0.21,1.0.22,21,3,5,5,10,3,FALSE
react-stickynode,1.0.20,1.0.21,20,2,49,8,57,4,FALSE
react-stickynode,1.0.5,1.0.6,6,5,11,13,24,7,TRUE
react-stickynode,1.0.15,1.0.16,16,3,11,3,14,5,TRUE
react-stickynode,1.0.24,1.1.0,24,6,56,12,68,9,TRUE
react-stickynode,1.0.23,1.0.24,23,3,5,1,6,3,TRUE
react-stickynode,1.0.21,1.0.22,21,3,5,5,10,3,TRUE
react-stickynode,1.0.22,1.0.23,22,3,27,21,48,3,TRUE
react-stickynode,1.0.14,1.0.15,15,4,187,77,264,9,TRUE
react-stickynode,1.1.2,1.1.3,27,3,17,5,22,5,TRUE
react-stickynode,1.1.0,1.1.1,25,4,4,2,6,4,TRUE
botpress-scheduler,2.0.6,2.0.7,9,2,88,63,151,4,FALSE
botpress-scheduler,2.0.5,2.0.6,8,2,15,3,18,2,FALSE
botpress-scheduler,2.0.4,2.0.5,7,2,3775,40,3815,7,FALSE
botpress-scheduler,2.0.3,2.0.4,6,2,4,1,5,2,FALSE
botpress-scheduler,2.0.2,2.0.3,5,2,3,2,5,2,FALSE
botpress-scheduler,2.0.1,2.0.2,4,2,3707,1,3708,2,FALSE
botpress-scheduler,2.0.0,2.0.1,3,2,16,1,17,3,FALSE
botpress-scheduler,1.0.0,1.0.1,1,2,62,139,201,7,FALSE
botpress-scheduler,1.0.1,2.0.0,2,6,57,43,100,10,FALSE
botpress-scheduler,2.0.5,2.0.6,8,2,15,3,18,2,TRUE
apeman-react-chat,2.0.1,2.0.2,6,3,146,110,256,10,FALSE
apeman-react-chat,1.0.0,1.0.1,1,7,80,6993,7073,27,FALSE
apeman-react-chat,1.0.1,1.0.2,2,7,168,159,327,27,FALSE
apeman-react-chat,1.0.2,1.0.3,3,2,21,25,46,6,FALSE
apeman-react-chat,2.0.0,2.0.1,5,2,250,300,550,30,FALSE
apeman-react-chat,1.0.3,2.0.0,4,2,198,279,477,25,FALSE
apeman-react-chat,2.0.0,2.0.1,5,2,250,300,550,30,TRUE
apeman-react-chat,2.0.1,2.0.2,6,3,146,110,256,10,TRUE
apeman-react-chat,1.0.2,1.0.3,3,2,21,25,46,6,TRUE
apeman-react-chat,1.0.3,2.0.0,4,2,198,279,477,25,TRUE
apeman-react-chat,1.0.0,1.0.1,1,7,80,6993,7073,27,TRUE
entree,0.0.1-beta-1,0.0.2,1,2,211,109,320,15,FALSE
entree,0.1.8,0.1.9,16,14,16236,5378,21614,351,FALSE
entree,0.1.9,0.1.10,17,16,1596,933,2529,101,FALSE
entree,0.1.0,0.1.3,10,11,12287,2169,14456,72,FALSE
entree,0.1.3,0.1.4,11,28,322267,116256,438523,407,FALSE
entree,0.1.4,0.1.5,12,9,1374,441,1815,39,FALSE
entree,0.1.5,0.1.6,13,3,5,5,10,4,FALSE
entree,0.1.6,0.1.7,14,1,1,1,2,1,FALSE
entree,0.1.7,0.1.8,15,2,72,48,120,3,FALSE
entree,0.0.5,0.0.6,5,1,9,1,10,2,FALSE
entree,0.0.4,0.0.5,4,2,50,32,82,2,FALSE
entree,0.0.7,0.0.8,7,2,274,5154,5428,26,FALSE
entree,0.0.6,0.0.7,6,2,214,76,290,9,TRUE
entree,0.0.3,0.0.4,3,2,174,77,251,14,FALSE
entree,0.0.2,0.0.3,2,2,32,26,58,4,FALSE
entree,0.0.9,0.1.0,9,8,690,343,1033,23,FALSE
entree,0.0.8,0.0.9,8,3,283,43,326,12,FALSE
entree,0.1.12,0.1.13,20,6,1444,234,1678,51,FALSE
entree,0.1.13,0.1.14,21,19,3060,1672,4732,135,FALSE
entree,0.1.10,0.1.11,18,1,1,1,2,1,FALSE
entree,0.1.11,0.1.12,19,4,984,284,1268,37,FALSE
entree,0.1.14,0.1.15,22,2,10,10,20,3,FALSE
entree,0.1.8,0.1.9,16,14,16236,5378,21614,351,TRUE
entree,0.1.9,0.1.10,17,16,1596,933,2529,101,TRUE
entree,0.1.4,0.1.5,12,9,1374,441,1815,39,TRUE
entree,0.0.6,0.0.7,6,2,214,76,290,9,FALSE
entree,0.1.11,0.1.12,19,4,984,284,1268,37,TRUE
rc-banner-anim,0.2.13,0.2.14,15,1,6,5,11,4,FALSE
rc-banner-anim,0.2.12,0.2.13,14,1,7,7,14,2,FALSE
rc-banner-anim,0.2.11,0.2.12,13,1,8,2,10,4,FALSE
rc-banner-anim,0.2.10,0.2.11,12,2,42,10,52,10,FALSE
rc-banner-anim,0.2.7,0.2.8,9,9,132,90,222,34,FALSE
rc-banner-anim,0.2.6,0.2.7,8,1,3,3,6,2,FALSE
rc-banner-anim,0.2.5,0.2.6,7,4,430,477,907,17,FALSE
rc-banner-anim,0.2.4,0.2.5,6,4,43,23,66,6,FALSE
rc-banner-anim,0.2.3,0.2.4,5,3,7,5,12,5,FALSE
rc-banner-anim,0.2.2,0.2.3,4,1,96,46,142,8,FALSE
rc-banner-anim,0.2.1,0.2.2,3,2,75,73,148,8,FALSE
rc-banner-anim,0.2.0,0.2.1,2,1,2,2,4,2,FALSE
rc-banner-anim,0.1.0,0.2.0,1,10,593,241,834,30,FALSE
rc-banner-anim,0.2.9,0.2.10,11,3,20,25,45,13,FALSE
rc-banner-anim,0.2.8,0.2.9,10,1,14,3,17,13,FALSE
rc-banner-anim,0.5.10,0.5.11,31,2,20,13,33,8,FALSE
rc-banner-anim,0.5.11,0.5.12,32,2,4,3,7,3,FALSE
rc-banner-anim,0.5.10,0.5.11,31,2,20,13,33,8,TRUE
rc-banner-anim,0.3.0,0.3.1,17,4,9,5,14,4,FALSE
rc-banner-anim,0.3.1,0.4.0,18,2,78,77,155,4,TRUE
rc-banner-anim,0.5.8,0.5.9,29,2,62,31,93,2,FALSE
rc-banner-anim,0.5.9,0.5.10,30,1,33,13,46,7,FALSE
rc-banner-anim,0.5.4,0.5.5,25,5,50,5,55,7,TRUE
rc-banner-anim,0.5.5,0.5.6,26,1,2,1,3,2,FALSE
rc-banner-anim,0.5.6,0.5.7,27,1,2,2,4,1,FALSE
rc-banner-anim,0.5.0,0.5.1,21,1,136,21,157,8,FALSE
rc-banner-anim,0.5.1,0.5.2,22,3,86,107,193,9,FALSE
rc-banner-anim,0.5.2,0.5.3,23,4,5,4,9,5,TRUE
rc-banner-anim,0.5.3,0.5.4,24,1,31,43,74,3,TRUE
rc-banner-anim,0.2.14,0.3.0,16,3,553,356,909,27,TRUE
rc-banner-anim,0.2.10,0.2.11,12,2,42,10,52,10,TRUE
rc-banner-anim,0.4.1,0.5.0,20,1,1,1,2,1,TRUE
rc-banner-anim,0.4.0,0.4.1,19,3,7,11,18,3,FALSE
rc-banner-anim,0.5.7,0.5.8,28,1,18,21,39,2,FALSE
rc-banner-anim,0.3.0,0.3.1,17,4,9,5,14,4,TRUE
rc-banner-anim,0.3.1,0.4.0,18,2,78,77,155,4,FALSE
rc-banner-anim,0.5.4,0.5.5,25,5,50,5,55,7,FALSE
rc-banner-anim,0.5.2,0.5.3,23,4,5,4,9,5,FALSE
rc-banner-anim,0.5.3,0.5.4,24,1,31,43,74,3,FALSE
rc-banner-anim,0.2.14,0.3.0,16,3,553,356,909,27,FALSE
rc-banner-anim,0.4.1,0.5.0,20,1,1,1,2,1,FALSE
rc-banner-anim,0.2.2,0.2.3,4,1,96,46,142,8,TRUE
angular-bootstrap-calendar,0.14.5,0.14.6,15,10,86,41,127,29,FALSE
angular-bootstrap-calendar,0.15.1,0.15.2,18,5,21,18,39,14,FALSE
angular-bootstrap-calendar,0.19.6,0.20.0,47,26,1114,459,1573,126,FALSE
angular-bootstrap-calendar,0.26.1,0.27.0,66,3,50,25,75,17,FALSE
angular-bootstrap-calendar,0.18.1,0.18.2,32,4,34,24,58,14,TRUE
angular-bootstrap-calendar,0.15.3,0.15.4,20,4,13,14,27,13,FALSE
angular-bootstrap-calendar,0.25.2,0.26.0,64,2,594,566,1160,16,FALSE
angular-bootstrap-calendar,0.19.0,0.19.1,41,4,29,21,50,14,FALSE
angular-bootstrap-calendar,0.27.5,0.28.0,72,32,22752,11505,34257,135,FALSE
angular-bootstrap-calendar,0.15.5,0.16.0,22,11,251,137,388,39,FALSE
angular-bootstrap-calendar,0.18.2,0.18.3,33,5,33,23,56,18,FALSE
angular-bootstrap-calendar,0.22.0,0.23.0,57,23,449,711,1160,82,FALSE
angular-bootstrap-calendar,0.28.0,0.28.1,73,12,731,612,1343,29,FALSE
angular-bootstrap-calendar,0.27.0,0.27.1,67,4,30,20,50,15,FALSE
angular-bootstrap-calendar,0.28.1,0.28.2,74,7,8745,8586,17331,27,FALSE
angular-bootstrap-calendar,0.17.2,0.17.3,26,2,25,15,40,12,FALSE
angular-bootstrap-calendar,0.17.3,0.17.4,27,2,103,473,576,16,FALSE
angular-bootstrap-calendar,0.17.0,0.17.1,24,9,114,79,193,23,FALSE
angular-bootstrap-calendar,0.17.1,0.17.2,25,3,43,20,63,15,FALSE
angular-bootstrap-calendar,0.20.0,0.20.1,48,8,125,77,202,22,FALSE
angular-bootstrap-calendar,0.20.1,0.20.2,49,3,73,97,170,17,FALSE
angular-bootstrap-calendar,0.17.4,0.17.5,28,3,32,16,48,13,FALSE
angular-bootstrap-calendar,0.17.5,0.17.6,29,2,39,23,62,15,FALSE
angular-bootstrap-calendar,0.17.6,0.18.0,30,53,3616,2017,5633,258,FALSE
angular-bootstrap-calendar,0.24.0-beta.0,0.24.0-beta.1,59,5,15,4,19,6,TRUE
angular-bootstrap-calendar,0.27.3,0.27.4,70,3,81,32,113,13,FALSE
angular-bootstrap-calendar,0.19.4,0.19.5,45,5,38,21,59,16,FALSE
angular-bootstrap-calendar,0.19.5,0.19.6,46,3,64,23,87,15,FALSE
angular-bootstrap-calendar,0.15.2,0.15.3,19,2,10,15,25,11,FALSE
angular-bootstrap-calendar,0.14.6,0.15.0,16,24,337,138,475,66,FALSE
angular-bootstrap-calendar,0.15.4,0.15.5,21,8,72,64,136,23,FALSE
angular-bootstrap-calendar,0.19.1,0.19.2,42,3,40,18,58,14,FALSE
angular-bootstrap-calendar,0.19.2,0.19.3,43,4,36,19,55,15,FALSE
angular-bootstrap-calendar,0.19.3,0.19.4,44,9,379,283,662,23,FALSE
angular-bootstrap-calendar,0.21.1,0.21.2,52,2,43,21,64,14,FALSE
angular-bootstrap-calendar,0.21.0,0.21.1,51,2,26,16,42,13,FALSE
angular-bootstrap-calendar,0.21.3,0.21.4,54,3,183,29,212,13,FALSE
angular-bootstrap-calendar,0.21.2,0.21.3,53,2,49,30,79,13,FALSE
angular-bootstrap-calendar,0.21.5,0.22.0,56,18,1642,1072,2714,93,FALSE
angular-bootstrap-calendar,0.21.4,0.21.5,55,3,18,11,29,13,FALSE
angular-bootstrap-calendar,0.25.0,0.25.1,62,7,780,606,1386,26,FALSE
angular-bootstrap-calendar,0.18.9,0.19.0,40,10,221,73,294,38,TRUE
angular-bootstrap-calendar,0.18.8,0.18.9,39,4,82,20,102,15,FALSE
angular-bootstrap-calendar,0.24.0,0.25.0,61,10,104,52,156,21,FALSE
angular-bootstrap-calendar,0.25.1,0.25.2,63,9,654,620,1274,39,FALSE
angular-bootstrap-calendar,0.28.4,0.29.0,77,6,698,554,1252,32,FALSE
angular-bootstrap-calendar,0.18.0,0.18.1,31,13,163,78,241,26,FALSE
angular-bootstrap-calendar,0.26.0,0.26.1,65,3,35,31,66,13,FALSE
angular-bootstrap-calendar,0.27.4,0.27.5,71,7,124,107,231,20,FALSE
angular-bootstrap-calendar,0.18.5,0.18.6,36,2,22,12,34,12,FALSE
angular-bootstrap-calendar,0.18.4,0.18.5,35,11,201,45,246,25,FALSE
angular-bootstrap-calendar,0.27.1,0.27.2,68,8,209,91,300,39,FALSE
angular-bootstrap-calendar,0.18.6,0.18.7,37,2,86,73,159,12,FALSE
angular-bootstrap-calendar,0.28.2,0.28.3,75,2,23,13,36,12,FALSE
angular-bootstrap-calendar,0.23.0,0.24.0-beta.0,58,32,463,215,678,91,FALSE
angular-bootstrap-calendar,0.24.0-beta.1,0.24.0,60,1,3298,381,3679,11,FALSE
angular-bootstrap-calendar,0.29.0,0.29.1,78,6,756,403,1159,20,FALSE
angular-bootstrap-calendar,0.18.7,0.18.8,38,11,193,102,295,32,FALSE
angular-bootstrap-calendar,0.27.2,0.27.3,69,7,399,303,702,23,FALSE
angular-bootstrap-calendar,0.16.0,0.17.0,23,8,777,160,937,29,FALSE
angular-bootstrap-calendar,0.20.2,0.21.0,50,22,1275,444,1719,81,FALSE
angular-bootstrap-calendar,0.18.3,0.18.4,34,4,36,19,55,18,FALSE
angular-bootstrap-calendar,0.15.0,0.15.1,17,9,119,49,168,24,FALSE
angular-bootstrap-calendar,0.28.3,0.28.4,76,8,814,652,1466,26,FALSE
angular-bootstrap-calendar,0.10.7,0.11.0,3,17,2203,936,3139,80,FALSE
angular-bootstrap-calendar,0.10.6,0.10.7,2,35,1236,695,1931,136,FALSE
angular-bootstrap-calendar,0.11.0,0.11.1,4,2,16,16,32,12,FALSE
angular-bootstrap-calendar,0.11.1,0.11.2,5,2,93,29,122,18,FALSE
angular-bootstrap-calendar,0.11.2,0.11.3,6,4,99,40,139,21,FALSE
angular-bootstrap-calendar,0.11.3,0.12.0,7,10,4355,2525,6880,89,FALSE
angular-bootstrap-calendar,0.12.0,0.13.0,8,33,1682,1417,3099,101,FALSE
angular-bootstrap-calendar,0.18.1,0.18.2,32,4,34,24,58,14,FALSE
angular-bootstrap-calendar,0.24.0-beta.0,0.24.0-beta.1,59,5,15,4,19,6,FALSE
angular-bootstrap-calendar,0.18.9,0.19.0,40,10,221,73,294,38,FALSE
angular-bootstrap-calendar,0.14.1,0.14.2,11,4,168,147,315,16,FALSE
angular-bootstrap-calendar,0.10.5,0.10.6,1,3,23,13,36,13,FALSE
angular-bootstrap-calendar,0.13.0,0.14.0,9,26,3464,719,4183,98,FALSE
angular-bootstrap-calendar,0.14.4,0.14.5,14,3,57,40,97,17,FALSE
angular-bootstrap-calendar,0.14.0,0.14.1,10,5,97,43,140,14,FALSE
angular-bootstrap-calendar,0.14.2,0.14.3,12,3,105,84,189,23,FALSE
angular-bootstrap-calendar,0.14.3,0.14.4,13,7,96,117,213,33,FALSE
angular-bootstrap-calendar,0.10.6,0.10.7,2,35,1236,695,1931,136,TRUE
angular-bootstrap-calendar,0.11.2,0.11.3,6,4,99,40,139,21,TRUE
angular-bootstrap-calendar,0.15.1,0.15.2,18,5,21,18,39,14,TRUE
angular-bootstrap-calendar,0.18.3,0.18.4,34,4,36,19,55,18,TRUE
angular-bootstrap-calendar,0.14.6,0.15.0,16,24,337,138,475,66,TRUE
angular-bootstrap-calendar,0.14.2,0.14.3,12,3,105,84,189,23,TRUE
angular-bootstrap-calendar,0.16.0,0.17.0,23,8,777,160,937,29,TRUE
angular-bootstrap-calendar,0.19.2,0.19.3,43,4,36,19,55,15,TRUE
angular-bootstrap-calendar,0.27.3,0.27.4,70,3,81,32,113,13,TRUE
angular-bootstrap-calendar,0.19.5,0.19.6,46,3,64,23,87,15,TRUE
angular-bootstrap-calendar,0.19.1,0.19.2,42,3,40,18,58,14,TRUE
angular-bootstrap-calendar,0.27.4,0.27.5,71,7,124,107,231,20,TRUE
angular-bootstrap-calendar,0.18.7,0.18.8,38,11,193,102,295,32,TRUE
angular-bootstrap-calendar,0.19.4,0.19.5,45,5,38,21,59,16,TRUE
angular-bootstrap-calendar,0.22.0,0.23.0,57,23,449,711,1160,82,TRUE
angular-bootstrap-calendar,0.13.0,0.14.0,9,26,3464,719,4183,98,TRUE
angular-bootstrap-calendar,0.26.1,0.27.0,66,3,50,25,75,17,TRUE
angular-bootstrap-calendar,0.15.3,0.15.4,20,4,13,14,27,13,TRUE
angular-bootstrap-calendar,0.15.5,0.16.0,22,11,251,137,388,39,TRUE
angular-bootstrap-calendar,0.28.0,0.28.1,73,12,731,612,1343,29,TRUE
angular-bootstrap-calendar,0.17.5,0.17.6,29,2,39,23,62,15,TRUE
angular-bootstrap-calendar,0.18.8,0.18.9,39,4,82,20,102,15,TRUE
angular-bootstrap-calendar,0.27.1,0.27.2,68,8,209,91,300,39,TRUE
angular-bootstrap-calendar,0.27.2,0.27.3,69,7,399,303,702,23,TRUE
angular-bootstrap-calendar,0.28.1,0.28.2,74,7,8745,8586,17331,27,TRUE
angular-bootstrap-calendar,0.21.4,0.21.5,55,3,18,11,29,13,TRUE
angular-bootstrap-calendar,0.21.3,0.21.4,54,3,183,29,212,13,TRUE
angular-bootstrap-calendar,0.18.0,0.18.1,31,13,163,78,241,26,TRUE
angular-bootstrap-calendar,0.25.1,0.25.2,63,9,654,620,1274,39,TRUE
blur-overlay,1.0.0,1.0.1,1,2,8,6,14,4,FALSE
blur-overlay,1.0.1,1.0.2,2,2,54,12,66,6,FALSE
blur-overlay,1.0.2,1.0.3,3,4,287,78,365,12,FALSE
blur-overlay,1.0.1,1.0.2,2,2,54,12,66,6,TRUE
justo-reporter,0.8.13,0.8.14,20,1,21,13,34,8,FALSE
justo-reporter,0.2.0,0.3.0,1,1,444,302,746,18,FALSE
justo-reporter,0.10.1,0.10.2,25,1,15,4,19,5,FALSE
justo-reporter,0.10.0,0.10.1,24,1,30,34,64,4,FALSE
justo-reporter,0.10.2,0.10.3,26,1,218,204,422,14,FALSE
justo-reporter,0.8.14,0.9.0,21,1,292,427,719,11,FALSE
justo-reporter,0.3.0,0.4.0,2,1,758,73,831,13,FALSE
justo-reporter,0.6.0,0.7.0,5,2,1013,324,1337,25,FALSE
justo-reporter,0.8.11,0.8.12,18,1,37,36,73,4,FALSE
justo-reporter,0.8.10,0.8.11,17,1,208,26,234,15,FALSE
justo-reporter,0.7.0,0.8.0,6,1,188,244,432,14,FALSE
justo-reporter,0.8.12,0.8.13,19,1,47,20,67,14,FALSE
justo-reporter,0.9.0,0.9.1,22,1,8,8,16,4,FALSE
justo-reporter,0.9.1,0.10.0,23,1,254,231,485,8,FALSE
justo-reporter,0.8.9,0.8.10,16,1,4,4,8,4,FALSE
justo-reporter,0.8.8,0.8.9,15,1,214,1013,1227,21,FALSE
justo-reporter,0.8.5,0.8.6,12,1,4,8,12,4,FALSE
justo-reporter,0.8.4,0.8.5,11,1,127,199,326,12,FALSE
justo-reporter,0.8.7,0.8.8,14,1,98,38,136,12,FALSE
justo-reporter,0.8.6,0.8.7,13,1,18,25,43,13,FALSE
justo-reporter,0.8.1,0.8.2,8,1,22,22,44,10,FALSE
justo-reporter,0.8.0,0.8.1,7,1,865,688,1553,18,FALSE
justo-reporter,0.8.3,0.8.4,10,1,63,5,68,6,FALSE
justo-reporter,0.8.2,0.8.3,9,1,718,506,1224,23,FALSE
justo-reporter,0.4.0,0.5.0,3,1,547,1429,1976,25,FALSE
justo-reporter,0.5.0,0.6.0,4,1,1919,728,2647,28,FALSE
justo-reporter,0.8.8,0.8.9,15,1,214,1013,1227,21,TRUE
justo-reporter,0.8.2,0.8.3,9,1,718,506,1224,23,TRUE
justo-reporter,0.10.0,0.10.1,24,1,30,34,64,4,TRUE
react-stepper-horizontal,1.0.4,1.0.5,5,1,83,84,167,4,FALSE
react-stepper-horizontal,1.0.5,1.0.6,6,4,5161,139,5300,18,FALSE
react-stepper-horizontal,1.0.0,1.0.1,1,3,37,7,44,3,FALSE
react-stepper-horizontal,1.0.1,1.0.2,2,1,1,1,2,1,FALSE
react-stepper-horizontal,1.0.2,1.0.3,3,1,83,84,167,4,FALSE
react-stepper-horizontal,1.0.3,1.0.4,4,1,83,84,167,4,FALSE
react-stepper-horizontal,1.0.1,1.0.2,2,1,1,1,2,1,TRUE
eslint-config-ship-components,1.3.1,1.4.0,4,5,56,17,73,10,FALSE
eslint-config-ship-components,1.3.0,1.3.1,3,2,8,6,14,6,FALSE
eslint-config-ship-components,1.3.0,1.3.1,3,2,8,6,14,6,TRUE
eslint-config-ship-components,1.3.1,1.4.0,4,5,56,17,73,10,TRUE
zhihu-api,0.6.0,0.6.1,21,2,7,7,14,3,FALSE
zhihu-api,1.0.0,1.0.1,26,4,20,38,58,7,FALSE
zhihu-api,1.0.1,2.0.0,27,19,2447,4018,6465,163,FALSE
zhihu-api,2.0.0,2.1.0,28,4,144,19,163,13,FALSE
zhihu-api,0.7.2,1.0.0,25,32,2028,2888,4916,123,FALSE
zhihu-api,0.0.12,0.0.13,10,4,189,71,260,13,FALSE
zhihu-api,0.0.14,0.1.0,12,2,4,3,7,3,FALSE
zhihu-api,0.0.11,0.0.12,9,9,628,578,1206,33,FALSE
zhihu-api,0.0.10,0.0.11,8,3,59,7,66,9,FALSE
zhihu-api,0.0.13,0.0.14,11,4,370,187,557,17,FALSE
zhihu-api,0.2.0,0.3.1,15,6,51,52,103,14,FALSE
zhihu-api,0.1.0,0.1.1,13,4,12,4,16,4,FALSE
zhihu-api,0.1.1,0.2.0,14,2,1,85,86,7,FALSE
zhihu-api,2.1.0,2.1.1,29,3,177,137,314,14,FALSE
zhihu-api,2.1.1,2.2.0,30,1,141,2,143,8,FALSE
zhihu-api,0.0.5,0.0.7,4,10,265,31,296,29,FALSE
zhihu-api,0.0.4,0.0.5,3,4,49,23,72,6,FALSE
zhihu-api,0.0.7,0.0.8,5,6,178,6,184,22,FALSE
zhihu-api,0.0.3,0.0.4,2,3,35,5,40,4,FALSE
zhihu-api,0.0.2,0.0.3,1,22,1135,611,1746,62,FALSE
zhihu-api,0.6.1,0.7.0,22,4,125,14,139,4,FALSE
zhihu-api,0.3.1,0.4.0,16,24,2262,364,2626,121,FALSE
zhihu-api,0.0.9,0.0.10,7,10,358,92,450,35,FALSE
zhihu-api,0.0.8,0.0.9,6,7,354,71,425,30,FALSE
zhihu-api,0.7.0,0.7.1,23,2,31,1,32,2,FALSE
zhihu-api,0.7.1,0.7.2,24,1,6,5,11,2,FALSE
zhihu-api,0.4.1,0.5.0,18,6,325,9,334,21,FALSE
zhihu-api,0.4.0,0.4.1,17,3,94,50,144,10,FALSE
zhihu-api,0.5.0,0.5.1,19,3,55,105,160,9,FALSE
zhihu-api,0.5.1,0.6.0,20,7,2025,1757,3782,50,FALSE
zhihu-api,2.3.0,2.3.1,32,2,6,2,8,3,FALSE
zhihu-api,2.3.1,2.3.2,33,4,12,4,16,6,FALSE
zhihu-api,2.3.2,2.4.0,34,3,90,146,236,5,FALSE
zhihu-api,2.4.0,2.4.1,35,3,7,3,10,4,FALSE
zhihu-api,2.2.0,2.3.0,31,4,219,177,396,14,FALSE
zhihu-api,0.0.13,0.0.14,11,4,370,187,557,17,TRUE
zhihu-api,2.3.1,2.3.2,33,4,12,4,16,6,TRUE
zhihu-api,2.1.1,2.2.0,30,1,141,2,143,8,TRUE
zhihu-api,0.0.8,0.0.9,6,7,354,71,425,30,TRUE
trailpack-core,1.0.0,1.0.1,24,15,215,189,404,30,FALSE
trailpack-core,0.0.14,0.0.16,10,28,570,295,865,72,FALSE
trailpack-core,0.0.17,0.0.18,12,5,10,4,14,4,FALSE
trailpack-core,0.0.16,0.0.17,11,7,7,10,17,7,FALSE
trailpack-core,0.0.11,0.0.12,7,10,247,60,307,10,FALSE
trailpack-core,0.0.10,0.0.11,6,25,186,99,285,40,FALSE
trailpack-core,0.0.12,0.0.13,8,25,705,315,1020,59,FALSE
trailpack-core,0.0.19,0.0.20,14,5,17,9,26,7,FALSE
trailpack-core,0.0.18,0.0.19,13,1,59,151,210,12,FALSE
trailpack-core,0.0.1,0.0.2,2,1,59,151,210,12,FALSE
trailpack-core,0.0.0,0.0.1,1,16,759,21,780,117,FALSE
trailpack-core,0.0.2,0.0.8,3,10,167,20,187,12,FALSE
trailpack-core,0.0.9,0.0.10,5,4,141,92,233,8,FALSE
trailpack-core,0.0.8,0.0.9,4,11,54,11,65,14,FALSE
trailpack-core,1.0.0-alpha-1,1.0.0-alpha-2,16,10,50,15,65,13,TRUE
trailpack-core,1.0.0-alpha-2,1.0.0-alpha-3,17,6,82,86,168,16,FALSE
trailpack-core,1.0.0-alpha-3,1.0.0-beta-1,18,23,298,242,540,48,FALSE
trailpack-core,0.0.20,1.0.0-alpha-1,15,2,23,21,44,6,FALSE
trailpack-core,1.0.0-beta-3,1.0.0-beta-4,20,31,433,226,659,55,FALSE
trailpack-core,1.0.0-beta-1,1.0.0-beta-3,19,1,0,2,2,1,FALSE
trailpack-core,1.0.0-beta-6,1.0.0,23,154,5055,1899,6954,390,FALSE
trailpack-core,1.0.0-beta-5,1.0.0-beta-6,22,1,59,151,210,12,FALSE
trailpack-core,1.0.0-beta-4,1.0.0-beta-5,21,1,4,1,5,1,FALSE
trailpack-core,1.0.0-alpha-1,1.0.0-alpha-2,16,10,50,15,65,13,FALSE
trailpack-core,0.0.14,0.0.16,10,28,570,295,865,72,TRUE
trailpack-core,1.0.0,1.0.1,24,15,215,189,404,30,TRUE
trailpack-core,1.0.0-alpha-3,1.0.0-beta-1,18,23,298,242,540,48,TRUE
trailpack-core,1.0.0-beta-6,1.0.0,23,154,5055,1899,6954,390,TRUE
trailpack-core,1.0.0-beta-4,1.0.0-beta-5,21,1,4,1,5,1,TRUE
vue-marquee-ho,1.0.4,1.0.5,5,1,53,1,54,1,FALSE
vue-marquee-ho,1.0.5,1.0.6,6,1,53,1,54,1,FALSE
vue-marquee-ho,1.0.6,1.0.7,7,1,53,1,54,1,FALSE
vue-marquee-ho,1.0.7,1.0.8,8,1,53,1,54,1,FALSE
vue-marquee-ho,1.0.0,1.0.1,1,1,53,1,54,1,FALSE
vue-marquee-ho,1.0.1,1.0.2,2,1,53,1,54,1,FALSE
vue-marquee-ho,1.0.2,1.0.3,3,1,53,1,54,1,FALSE
vue-marquee-ho,1.0.3,1.0.4,4,1,53,1,54,1,FALSE
vue-marquee-ho,1.1.9,1.2.0,19,1,53,1,54,1,FALSE
vue-marquee-ho,1.1.8,1.1.9,18,1,53,1,54,1,FALSE
vue-marquee-ho,1.1.0,1.1.1,11,1,53,1,54,1,FALSE
vue-marquee-ho,1.1.6,1.1.8,17,1,53,1,54,1,FALSE
vue-marquee-ho,1.0.8,1.0.9,9,1,53,1,54,1,FALSE
vue-marquee-ho,1.0.9,1.1.0,10,1,53,1,54,1,FALSE
vue-marquee-ho,1.1.2,1.1.3,13,1,53,1,54,1,FALSE
vue-marquee-ho,1.1.1,1.1.2,12,1,53,1,54,1,FALSE
vue-marquee-ho,1.2.0,1.2.1,20,1,53,1,54,1,FALSE
vue-marquee-ho,1.1.5,1.1.6,16,1,53,1,54,1,FALSE
vue-marquee-ho,1.1.3,1.1.4,14,1,53,1,54,1,FALSE
vue-marquee-ho,1.1.4,1.1.5,15,1,53,1,54,1,FALSE
vue-marquee-ho,1.0.0,1.0.1,1,1,53,1,54,1,TRUE
ts-loader,1.1.0,1.2.0,42,13,797,393,1190,141,FALSE
ts-loader,0.6.0,0.6.1,26,8,127,292,419,27,FALSE
ts-loader,1.0.0,1.1.0,41,13,1305,171,1476,115,FALSE
ts-loader,1.2.1,1.2.2,44,11,1311,91,1402,84,FALSE
ts-loader,0.2.3,0.3.0,5,8,208,495,703,23,FALSE
ts-loader,0.2.2,0.2.3,4,2,71,3,74,8,FALSE
ts-loader,0.2.1,0.2.2,3,2,6,2,8,3,FALSE
ts-loader,0.2.0,0.2.1,2,6,84,30,114,19,FALSE
ts-loader,1.0.0-beta.1,1.0.0,40,8,1468,1045,2513,67,FALSE
ts-loader,0.3.2,0.3.3,8,9,84,30,114,11,FALSE
ts-loader,0.3.3,0.3.4,9,3,8,4,12,4,FALSE
ts-loader,0.3.0,0.3.1,6,4,59,4,63,8,FALSE
ts-loader,0.3.1,0.3.2,7,4,102,35,137,13,FALSE
ts-loader,0.7.2,0.8.0,30,22,30675,9824,40499,906,FALSE
ts-loader,0.3.4,0.4.0,10,15,260,251,511,58,FALSE
ts-loader,0.7.1,0.7.2,29,8,4659,53,4712,44,FALSE
ts-loader,0.5.4,0.5.5,23,6,176,29,205,14,FALSE
ts-loader,0.4.0,0.4.1,11,2,11,2,13,3,FALSE
ts-loader,0.5.6,0.6.0,25,18,698,4554,5252,70,FALSE
ts-loader,0.4.2,0.4.3,13,2,40,3,43,6,FALSE
ts-loader,0.5.0,0.5.1,19,12,2042,1634,3676,62,FALSE
ts-loader,0.5.1,0.5.2,20,2,113,6,119,13,FALSE
ts-loader,0.5.2,0.5.3,21,10,759,86,845,49,FALSE
ts-loader,0.5.3,0.5.4,22,4,2469,319,2788,10,FALSE
ts-loader,0.9.0,0.9.1,34,37,5174,3661,8835,2019,FALSE
ts-loader,0.9.1,0.9.2,35,23,2775,97,2872,360,FALSE
ts-loader,0.9.2,0.9.3,36,6,307,41,348,60,FALSE
ts-loader,0.9.3,0.9.4,37,4,70,23,93,8,FALSE
ts-loader,0.9.4,0.9.5,38,19,586,136,722,258,FALSE
ts-loader,0.9.5,1.0.0-beta.1,39,29,2372,1674,4046,138,FALSE
ts-loader,0.8.1,0.8.2,32,11,1480,1401,2881,39,FALSE
ts-loader,0.8.0,0.8.1,31,16,14767,54,14821,343,FALSE
ts-loader,0.8.2,0.9.0,33,27,14038,6945,20983,703,FALSE
ts-loader,1.3.2,1.3.3,48,15,8020,1156,9176,86,FALSE
ts-loader,1.3.1,1.3.2,47,11,155,190,345,36,FALSE
ts-loader,1.3.0,1.3.1,46,3,134,104,238,60,FALSE
ts-loader,1.2.2,1.3.0,45,7,684,31,715,84,FALSE
ts-loader,1.2.0,1.2.1,43,9,8242,134,8376,188,FALSE
ts-loader,0.5.5,0.5.6,24,17,776,180,956,63,FALSE
ts-loader,0.4.3,0.4.4,14,10,115,28,143,17,FALSE
ts-loader,0.4.5,0.4.6,16,7,1051,32,1083,16,FALSE
ts-loader,0.4.4,0.4.5,15,7,79,19,98,15,FALSE
ts-loader,0.4.7,0.5.0,18,59,12101,1324,13425,370,FALSE
ts-loader,0.7.0,0.7.1,28,2,6,2,8,3,FALSE
ts-loader,0.4.6,0.4.7,17,3,17,3,20,4,FALSE
ts-loader,0.6.1,0.7.0,27,6,445,3,448,31,FALSE
ts-loader,0.4.1,0.4.2,12,5,67,21,88,11,FALSE
ts-loader,2.0.2,2.0.3,52,2,478,174,652,47,FALSE
ts-loader,2.0.1,2.0.2,51,8,2435,2595,5030,325,FALSE
ts-loader,2.0.0,2.0.1,50,14,21643,319,21962,508,FALSE
ts-loader,2.0.3,2.1.0,53,14,11557,873,12430,433,FALSE
ts-loader,1.3.3,2.0.0,49,28,11041,5951,16992,524,FALSE
ts-loader,0.1.0,0.2.0,1,10,2349,122,2471,49,FALSE
ts-loader,0.4.6,0.4.7,17,3,17,3,20,4,TRUE
ts-loader,2.0.1,2.0.2,51,8,2435,2595,5030,325,TRUE
ts-loader,0.5.2,0.5.3,21,10,759,86,845,49,TRUE
ts-loader,0.5.3,0.5.4,22,4,2469,319,2788,10,TRUE
ts-loader,0.9.0,0.9.1,34,37,5174,3661,8835,2019,TRUE
ts-loader,1.3.2,1.3.3,48,15,8020,1156,9176,86,TRUE
ts-loader,2.0.2,2.0.3,52,2,478,174,652,47,TRUE
ts-loader,0.3.3,0.3.4,9,3,8,4,12,4,TRUE
ts-loader,0.5.0,0.5.1,19,12,2042,1634,3676,62,TRUE
ts-loader,0.8.1,0.8.2,32,11,1480,1401,2881,39,TRUE
ts-loader,1.0.0-beta.1,1.0.0,40,8,1468,1045,2513,67,TRUE
ts-loader,0.5.6,0.6.0,25,18,698,4554,5252,70,TRUE
ts-loader,1.0.0,1.1.0,41,13,1305,171,1476,115,TRUE
ts-loader,2.0.0,2.0.1,50,14,21643,319,21962,508,TRUE
ts-loader,0.6.1,0.7.0,27,6,445,3,448,31,TRUE
ts-loader,0.6.0,0.6.1,26,8,127,292,419,27,TRUE
ts-loader,0.7.2,0.8.0,30,22,30675,9824,40499,906,TRUE
ts-loader,0.7.0,0.7.1,28,2,6,2,8,3,TRUE
ts-loader,0.7.1,0.7.2,29,8,4659,53,4712,44,TRUE
ts-loader,0.9.1,0.9.2,35,23,2775,97,2872,360,TRUE
ts-loader,0.9.3,0.9.4,37,4,70,23,93,8,TRUE
ts-loader,0.9.4,0.9.5,38,19,586,136,722,258,TRUE
ts-loader,0.9.5,1.0.0-beta.1,39,29,2372,1674,4046,138,TRUE
ts-loader,0.8.0,0.8.1,31,16,14767,54,14821,343,TRUE
ts-loader,0.8.2,0.9.0,33,27,14038,6945,20983,703,TRUE
ts-loader,1.3.3,2.0.0,49,28,11041,5951,16992,524,TRUE
ts-loader,1.3.1,1.3.2,47,11,155,190,345,36,TRUE
ts-loader,1.3.0,1.3.1,46,3,134,104,238,60,TRUE
ts-loader,1.2.2,1.3.0,45,7,684,31,715,84,TRUE
ts-loader,1.2.0,1.2.1,43,9,8242,134,8376,188,TRUE
ts-loader,1.2.1,1.2.2,44,11,1311,91,1402,84,TRUE
react-talend-components,0.61.4,0.62.0,141,1,207,68,275,6,FALSE
react-talend-components,0.61.1,0.61.2,138,1,207,68,275,6,FALSE
react-talend-components,0.61.0,0.61.1,137,1,207,68,275,6,FALSE
react-talend-components,0.61.3,0.61.4,140,1,207,68,275,6,FALSE
react-talend-components,0.61.2,0.61.3,139,1,207,68,275,6,FALSE
react-talend-components,0.72.0,0.72.1,161,1,207,68,275,6,FALSE
react-talend-components,0.76.0,0.77.0,171,1,207,68,275,6,FALSE
react-talend-components,0.77.0,0.78.0,172,1,207,68,275,6,FALSE
react-talend-components,0.74.1,0.74.2,167,1,207,68,275,6,FALSE
react-talend-components,0.71.2,0.72.0,160,1,207,68,275,6,FALSE
react-talend-components,0.74.2,0.75.0,168,1,207,68,275,6,FALSE
react-talend-components,0.71.0,0.71.1,158,1,207,68,275,6,FALSE
react-talend-components,0.71.1,0.71.2,159,1,207,68,275,6,FALSE
react-talend-components,0.70.1,0.71.0,157,1,207,68,275,6,FALSE
react-talend-components,0.70.0,0.70.1,156,1,207,68,275,6,FALSE
react-talend-components,0.75.0,0.75.1,169,1,207,68,275,6,FALSE
react-talend-components,0.75.1,0.76.0,170,1,207,68,275,6,FALSE
react-talend-components,0.73.0,0.74.0,165,1,207,68,275,6,FALSE
react-talend-components,0.72.1,0.72.2,162,1,207,68,275,6,FALSE
react-talend-components,0.74.0,0.74.1,166,1,207,68,275,6,FALSE
react-talend-components,0.72.3,0.73.0,164,1,207,68,275,6,FALSE
react-talend-components,0.72.2,0.72.3,163,1,207,68,275,6,FALSE
react-talend-components,0.68.0,0.68.1,153,1,207,68,275,6,FALSE
react-talend-components,0.68.1,0.69.0,154,1,207,68,275,6,FALSE
react-talend-components,0.69.0,0.70.0,155,1,207,68,275,6,FALSE
react-talend-components,0.65.0,0.66.0,146,1,207,68,275,6,FALSE
react-talend-components,0.64.0,0.65.0,145,1,207,68,275,6,FALSE
react-talend-components,0.62.0,0.63.0,142,1,207,68,275,6,FALSE
react-talend-components,0.67.0,0.68.0,152,1,207,68,275,6,FALSE
react-talend-components,0.63.1,0.64.0,144,1,207,68,275,6,FALSE
react-talend-components,0.63.0,0.63.1,143,1,207,68,275,6,FALSE
react-talend-components,0.66.4,0.67.0,151,1,207,68,275,6,FALSE
react-talend-components,0.66.2,0.66.3,149,1,207,68,275,6,FALSE
react-talend-components,0.66.3,0.66.4,150,1,207,68,275,6,FALSE
react-talend-components,0.66.0,0.66.1,147,1,207,68,275,6,FALSE
react-talend-components,0.66.1,0.66.2,148,1,207,68,275,6,FALSE
react-talend-components,0.37.0,0.38.0,93,1,748,33,781,12,FALSE
react-talend-components,0.18.0,0.18.1,51,1,2536,369,2905,41,FALSE
react-talend-components,0.35.0,0.35.1,86,1,134,137,271,8,FALSE
react-talend-components,0.35.1,0.36.0,87,1,470,156,626,10,FALSE
react-talend-components,0.60.6,0.60.7,135,1,207,68,275,6,FALSE
react-talend-components,0.12.2,0.13.0,36,1,1380,109,1489,32,FALSE
react-talend-components,0.3.0,0.4.0,10,1,200,0,200,8,FALSE
react-talend-components,0.17.2,0.18.0,50,1,1119,490,1609,19,FALSE
react-talend-components,0.17.0,0.17.1,48,1,22,0,22,1,FALSE
react-talend-components,0.17.1,0.17.2,49,1,149,151,300,4,FALSE
react-talend-components,0.25.5,0.26.0,67,1,781,74,855,17,FALSE
react-talend-components,0.25.4,0.25.5,66,2,141,97,238,15,FALSE
react-talend-components,0.25.1,0.25.2,63,1,9,9,18,1,FALSE
react-talend-components,0.25.0,0.25.1,62,1,133,70,203,4,FALSE
react-talend-components,0.25.3,0.25.4,65,1,108,125,233,8,FALSE
react-talend-components,0.25.2,0.25.3,64,1,279,182,461,17,FALSE
react-talend-components,0.18.1,0.18.2,52,2,32,1,33,2,FALSE
react-talend-components,0.18.2,0.19.0,53,3,271,115,386,16,FALSE
react-talend-components,0.27.0,0.28.0,74,1,1257,2376,3633,10,FALSE
react-talend-components,0.49.0,0.49.1,119,1,1,1,2,1,FALSE
react-talend-components,0.10.0,0.10.1,29,1,236,93,329,15,FALSE
react-talend-components,0.42.0,0.43.0,105,2,380,17,397,9,FALSE
react-talend-components,0.36.4,0.37.0,92,2,162,4,166,7,FALSE
react-talend-components,0.36.1,0.36.2,89,1,80,64,144,3,FALSE
react-talend-components,0.36.0,0.36.1,88,1,282,152,434,9,FALSE
react-talend-components,0.36.3,0.36.4,91,1,7,0,7,1,FALSE
react-talend-components,0.36.2,0.36.3,90,1,4,1,5,1,FALSE
react-talend-components,0.51.0,0.51.1,128,1,62,15,77,5,FALSE
react-talend-components,0.40.0,0.41.0,101,1,270,2,272,8,FALSE
react-talend-components,0.51.1,0.52.0,129,2,19022,70,19092,34,FALSE
react-talend-components,0.34.2,0.35.0,85,1,504,2,506,8,FALSE
react-talend-components,0.34.1,0.34.2,84,1,190,172,362,6,FALSE
react-talend-components,0.34.0,0.34.1,83,1,94,80,174,5,FALSE
react-talend-components,0.49.1,0.50.0,120,2,2554,52,2606,23,FALSE
react-talend-components,0.52.0,0.60.2,130,1,207,68,275,6,FALSE
react-talend-components,0.16.0,0.17.0,47,1,743,0,743,9,FALSE
react-talend-components,0.23.0,0.24.0,60,1,140,82,222,11,FALSE
react-talend-components,0.15.0,0.15.1,44,1,186,209,395,4,FALSE
react-talend-components,0.15.1,0.15.2,45,2,15,15,30,5,FALSE
react-talend-components,0.15.2,0.16.0,46,1,1680,143,1823,12,FALSE
react-talend-components,0.22.0,0.23.0,59,1,314,10,324,14,FALSE
react-talend-components,0.46.0,0.46.1,110,4,6308,2687,8995,58,FALSE
react-talend-components,0.46.1,0.47.0,111,1,55,25,80,5,FALSE
react-talend-components,0.28.0,0.29.0,75,1,449,1010,1459,11,FALSE
react-talend-components,0.38.3,0.39.0,97,1,709,111,820,9,FALSE
react-talend-components,0.44.0,0.45.0,108,1,307,1,308,8,FALSE
react-talend-components,0.30.2,0.31.0,79,2,15,21,36,3,FALSE
react-talend-components,0.30.1,0.30.2,78,1,643,532,1175,13,FALSE
react-talend-components,0.30.0,0.30.1,77,1,48,34,82,8,FALSE
react-talend-components,0.60.2,0.60.3,131,1,207,68,275,6,FALSE
react-talend-components,0.60.3,0.60.4,132,1,207,68,275,6,FALSE
react-talend-components,0.60.4,0.60.5,133,1,207,68,275,6,FALSE
react-talend-components,0.60.5,0.60.6,134,1,207,68,275,6,FALSE
react-talend-components,0.31.0,0.32.0,80,1,804,1,805,10,FALSE
react-talend-components,0.60.7,0.61.0,136,1,207,68,275,6,FALSE
react-talend-components,0.11.0,0.12.0,33,1,97,15,112,9,FALSE
react-talend-components,0.43.1,0.44.0,107,1,134,107,241,8,FALSE
react-talend-components,0.43.0,0.43.1,106,1,12,3,15,1,FALSE
react-talend-components,0.6.1,0.7.0,15,4,1073,81,1154,18,FALSE
react-talend-components,0.6.0,0.6.1,14,2,17,7,24,3,FALSE
react-talend-components,0.39.2,0.40.0,100,1,852,17,869,13,FALSE
react-talend-components,0.39.0,0.39.1,98,2,338,75,413,16,FALSE
react-talend-components,0.39.1,0.39.2,99,1,397,352,749,5,FALSE
react-talend-components,0.20.0,0.20.1,55,1,1,1,2,1,FALSE
react-talend-components,0.20.1,0.21.0,56,1,1207,153,1360,8,FALSE
react-talend-components,0.4.1,0.5.0,12,2,218,62,280,14,FALSE
react-talend-components,0.4.0,0.4.1,11,3,267,108,375,17,FALSE
react-talend-components,0.13.0,0.13.1,37,2,323,229,552,9,FALSE
react-talend-components,0.13.1,0.14.0,38,1,487,11,498,12,FALSE
react-talend-components,0.14.4,0.15.0,43,2,842,550,1392,12,FALSE
react-talend-components,0.14.1,0.14.2,40,1,9,20,29,2,FALSE
react-talend-components,0.14.0,0.14.1,39,2,15,38,53,11,FALSE
react-talend-components,0.14.3,0.14.4,42,2,7,1,8,2,FALSE
react-talend-components,0.14.2,0.14.3,41,1,159,170,329,7,FALSE
react-talend-components,0.21.1,0.22.0,58,2,936,166,1102,14,FALSE
react-talend-components,0.8.4,0.8.5,23,4,38,9,47,10,FALSE
react-talend-components,0.8.7,0.9.0,26,1,242,0,242,9,FALSE
react-talend-components,0.8.6,0.8.7,25,1,74,29,103,4,FALSE
react-talend-components,0.8.1,0.8.2,20,1,849,257,1106,9,FALSE
react-talend-components,0.8.0,0.8.1,19,1,35,26,61,7,FALSE
react-talend-components,0.8.3,0.8.4,22,1,10,2,12,2,FALSE
react-talend-components,0.8.2,0.8.3,21,1,104,10,114,3,FALSE
react-talend-components,0.29.0,0.30.0,76,1,105,21,126,7,FALSE
react-talend-components,0.47.5,0.48.0,117,1,676,232,908,12,FALSE
react-talend-components,0.47.4,0.47.5,116,2,11732,2553,14285,18,FALSE
react-talend-components,0.47.1,0.47.2,113,1,230,473,703,9,FALSE
react-talend-components,0.47.0,0.47.1,112,1,9,7,16,3,FALSE
react-talend-components,0.47.3,0.47.4,115,1,2,2,4,2,FALSE
react-talend-components,0.47.2,0.47.3,114,2,5,4,9,2,FALSE
react-talend-components,0.21.0,0.21.1,57,1,6,3,9,3,FALSE
react-talend-components,0.45.0,0.46.0,109,1,207,377,584,14,FALSE
react-talend-components,0.33.0,0.34.0,82,1,291,373,664,21,FALSE
react-talend-components,0.32.0,0.33.0,81,2,408,193,601,16,FALSE
react-talend-components,0.50.5,0.50.6,126,4,255,113,368,25,FALSE
react-talend-components,0.2.5,0.3.0,9,1,1404,3,1407,43,FALSE
react-talend-components,0.2.4,0.2.5,8,1,45,20,65,2,FALSE
react-talend-components,0.2.3,0.2.4,7,2,25,25,50,10,FALSE
react-talend-components,0.2.2,0.2.3,6,2,200,88,288,11,FALSE
react-talend-components,0.2.1,0.2.2,5,2,6130,5,6135,4,FALSE
react-talend-components,0.2.0,0.2.1,4,1,475,117,592,10,FALSE
react-talend-components,0.1.0,0.2.0,3,1,374,0,374,9,FALSE
react-talend-components,0.50.4,0.50.5,125,2,21,1,22,7,FALSE
react-talend-components,0.50.6,0.51.0,127,1,50,0,50,2,FALSE
react-talend-components,0.50.1,0.50.2,122,2,4638,320,4958,10,FALSE
react-talend-components,0.50.0,0.50.1,121,4,323,267,590,40,FALSE
react-talend-components,0.50.3,0.50.4,124,1,8,10,18,3,FALSE
react-talend-components,0.50.2,0.50.3,123,1,19,13,32,4,FALSE
react-talend-components,0.10.1,0.10.2,30,1,19,0,19,3,FALSE
react-talend-components,0.38.2,0.38.3,96,1,15,14,29,1,FALSE
react-talend-components,0.38.1,0.38.2,95,1,1,1,2,1,FALSE
react-talend-components,0.38.0,0.38.1,94,1,0,1,1,1,FALSE
react-talend-components,0.0.1,0.1.0,2,7,609,11,620,21,FALSE
react-talend-components,0.0.0,0.0.1,1,5,13,2,15,6,FALSE
react-talend-components,0.7.2,0.8.0,18,2,377,3,380,21,FALSE
react-talend-components,0.7.0,0.7.1,16,1,42,18,60,3,FALSE
react-talend-components,0.7.1,0.7.2,17,4,130,20,150,8,FALSE
react-talend-components,0.8.5,0.8.6,24,3,61,35,96,13,FALSE
react-talend-components,0.12.1,0.12.2,35,1,16,9,25,1,FALSE
react-talend-components,0.12.0,0.12.1,34,1,38,12,50,6,FALSE
react-talend-components,0.41.2,0.42.0,104,4,2732,5641,8373,54,FALSE
react-talend-components,0.5.0,0.6.0,13,1,155,0,155,8,FALSE
react-talend-components,0.41.1,0.41.2,103,3,856,284,1140,10,FALSE
react-talend-components,0.9.0,0.9.1,27,1,16,5,21,2,FALSE
react-talend-components,0.9.1,0.10.0,28,1,1356,119,1475,11,FALSE
react-talend-components,0.41.0,0.41.1,102,1,23,7,30,4,FALSE
react-talend-components,0.19.0,0.20.0,54,1,987,0,987,12,FALSE
react-talend-components,0.24.0,0.25.0,61,3,60,43,103,14,FALSE
react-talend-components,0.10.3,0.11.0,32,1,879,52,931,10,FALSE
react-talend-components,0.10.2,0.10.3,31,1,13,14,27,4,FALSE
react-talend-components,0.26.2,0.26.3,70,1,1311,24,1335,12,FALSE
react-talend-components,0.26.3,0.26.4,71,3,132,270,402,12,FALSE
react-talend-components,0.26.0,0.26.1,68,1,2,2,4,1,FALSE
react-talend-components,0.26.1,0.26.2,69,1,471,34,505,4,FALSE
react-talend-components,0.26.4,0.26.5,72,1,26,4,30,2,FALSE
react-talend-components,0.26.5,0.27.0,73,2,778,244,1022,5,FALSE
react-talend-components,0.48.0,0.49.0,118,1,107,59,166,7,FALSE
react-talend-components,0.52.0,0.60.2,130,1,207,68,275,6,TRUE
react-talend-components,0.60.2,0.60.3,131,1,207,68,275,6,TRUE
react-talend-components,0.38.2,0.38.3,96,1,15,14,29,1,TRUE
react-talend-components,0.70.0,0.70.1,156,1,207,68,275,6,TRUE
react-talend-components,0.8.0,0.8.1,19,1,35,26,61,7,TRUE
react-talend-components,0.61.1,0.61.2,138,1,207,68,275,6,TRUE
react-talend-components,0.63.1,0.64.0,144,1,207,68,275,6,TRUE
react-talend-components,0.8.2,0.8.3,21,1,104,10,114,3,TRUE
react-talend-components,0.33.0,0.34.0,82,1,291,373,664,21,TRUE
react-talend-components,0.61.2,0.61.3,139,1,207,68,275,6,TRUE
react-talend-components,0.26.2,0.26.3,70,1,1311,24,1335,12,TRUE
react-talend-components,0.4.1,0.5.0,12,2,218,62,280,14,TRUE
react-talend-components,0.14.4,0.15.0,43,2,842,550,1392,12,TRUE
react-talend-components,0.14.2,0.14.3,41,1,159,170,329,7,TRUE
react-talend-components,0.46.0,0.46.1,110,4,6308,2687,8995,58,TRUE
react-talend-components,0.10.1,0.10.2,30,1,19,0,19,3,TRUE
react-talend-components,0.0.0,0.0.1,1,5,13,2,15,6,TRUE
react-talend-components,0.24.0,0.25.0,61,3,60,43,103,14,TRUE
react-talend-components,0.36.4,0.37.0,92,2,162,4,166,7,TRUE
react-talend-components,0.12.1,0.12.2,35,1,16,9,25,1,TRUE
react-talend-components,0.10.2,0.10.3,31,1,13,14,27,4,TRUE
react-talend-components,0.71.0,0.71.1,158,1,207,68,275,6,TRUE
react-talend-components,0.71.1,0.71.2,159,1,207,68,275,6,TRUE
react-talend-components,0.26.3,0.26.4,71,3,132,270,402,12,TRUE
react-talend-components,0.65.0,0.66.0,146,1,207,68,275,6,TRUE
react-talend-components,0.15.1,0.15.2,45,2,15,15,30,5,TRUE
react-talend-components,0.69.0,0.70.0,155,1,207,68,275,6,TRUE
react-talend-components,0.61.4,0.62.0,141,1,207,68,275,6,TRUE
react-talend-components,0.63.0,0.63.1,143,1,207,68,275,6,TRUE
react-talend-components,0.13.0,0.13.1,37,2,323,229,552,9,TRUE
react-talend-components,0.14.3,0.14.4,42,2,7,1,8,2,TRUE
react-talend-components,0.8.4,0.8.5,23,4,38,9,47,10,TRUE
react-talend-components,0.18.1,0.18.2,52,2,32,1,33,2,TRUE
react-talend-components,0.29.0,0.30.0,76,1,105,21,126,7,TRUE
react-talend-components,0.47.3,0.47.4,115,1,2,2,4,2,TRUE
koa-ship,0.6.0,0.6.1,26,2,4,654,658,11,FALSE
koa-ship,0.6.5,0.6.6,31,3,4,261,265,6,TRUE
koa-ship,0.6.4,0.6.5,30,2,4,62,66,4,TRUE
koa-ship,0.6.8,0.7.0,34,6,52,64,116,8,FALSE
koa-ship,0.6.3,0.6.4,29,4,11,2,13,4,FALSE
koa-ship,0.6.2,0.6.3,28,2,4,4,8,3,FALSE
koa-ship,0.6.1,0.6.2,27,4,29,25,54,4,FALSE
koa-ship,0.3.1,0.3.2,11,6,94,18,112,9,FALSE
koa-ship,0.6.7,0.6.8,33,3,9,4,13,3,FALSE
koa-ship,0.6.6,0.6.7,32,2,2,1,3,2,FALSE
koa-ship,0.7.0,0.7.1,35,4,117,7,124,6,FALSE
koa-ship,0.4.9,0.5.0,22,6,29,3,32,6,FALSE
koa-ship,0.4.8,0.4.9,21,4,25,7,32,4,FALSE
koa-ship,0.4.1,0.4.2,14,5,133,34,167,5,FALSE
koa-ship,0.4.0,0.4.1,13,5,29,18,47,5,FALSE
koa-ship,0.4.3,0.4.4,16,3,8,5,13,3,FALSE
koa-ship,0.4.2,0.4.3,15,5,36,2,38,6,FALSE
koa-ship,0.5.0,0.5.1,23,6,67,16,83,14,FALSE
koa-ship,0.5.1,0.5.2,24,2,22,17,39,4,FALSE
koa-ship,0.5.2,0.6.0,25,2,4,4,8,2,FALSE
koa-ship,0.4.6,0.4.7,19,3,21,4,25,3,FALSE
koa-ship,0.4.5,0.4.6,18,2,18,1,19,2,FALSE
koa-ship,0.4.4,0.4.5,17,2,5,1,6,2,FALSE
koa-ship,0.3.2,0.4.0,12,14,143,42,185,17,FALSE
koa-ship,0.4.7,0.4.8,20,3,25,4,29,4,FALSE
koa-ship,0.2.0,0.3.0,9,19,933,31,964,26,FALSE
koa-ship,0.1.0,0.1.1,7,3,81,2,83,5,FALSE
koa-ship,0.1.1,0.2.0,8,6,492,10,502,15,FALSE
koa-ship,0.0.5,0.0.6,5,2,49,8,57,5,FALSE
koa-ship,0.3.0,0.3.1,10,8,327,9,336,11,FALSE
koa-ship,0.6.5,0.6.6,31,3,4,261,265,6,FALSE
koa-ship,0.6.4,0.6.5,30,2,4,62,66,4,FALSE
koa-ship,0.0.6,0.1.0,6,14,322,28,350,22,FALSE
koa-ship,0.4.5,0.4.6,18,2,18,1,19,2,TRUE
koa-ship,0.4.8,0.4.9,21,4,25,7,32,4,TRUE
koa-ship,0.5.2,0.6.0,25,2,4,4,8,2,TRUE
koa-ship,0.0.4,0.0.5,4,5,117,6,123,13,FALSE
koa-ship,0.4.9,0.5.0,22,6,29,3,32,6,TRUE
koa-ship,0.6.3,0.6.4,29,4,11,2,13,4,TRUE
koa-ship,0.4.4,0.4.5,17,2,5,1,6,2,TRUE
koa-ship,0.6.8,0.7.0,34,6,52,64,116,8,TRUE
koa-ship,0.5.1,0.5.2,24,2,22,17,39,4,TRUE
koa-ship,0.4.6,0.4.7,19,3,21,4,25,3,TRUE
koa-ship,0.2.0,0.3.0,9,19,933,31,964,26,TRUE
koa-ship,0.4.1,0.4.2,14,5,133,34,167,5,TRUE
koa-ship,0.3.2,0.4.0,12,14,143,42,185,17,TRUE
koa-ship,0.4.0,0.4.1,13,5,29,18,47,5,TRUE
koa-ship,0.0.1,0.0.2,1,2,33,14,47,7,FALSE
koa-ship,0.0.3,0.0.4,3,8,799,38,837,41,FALSE
koa-ship,0.0.2,0.0.3,2,2,16,1,17,2,FALSE
leek,0.0.4,0.0.5,4,11,413,58,471,24,TRUE
leek,0.0.1,0.0.2,1,1,2,2,4,2,FALSE
leek,0.0.3,0.0.4,3,3,24,32,56,7,FALSE
leek,0.0.2,0.0.3,2,2,165,64,229,7,FALSE
leek,0.0.5,0.0.6,5,10,357,194,551,23,FALSE
leek,0.0.4,0.0.5,4,11,413,58,471,24,FALSE
leek,0.0.7,0.0.8,7,4,3,35,38,4,FALSE
leek,0.0.6,0.0.7,6,2,57,53,110,9,FALSE
leek,0.0.9,0.0.10,9,2,6,8,14,3,FALSE
leek,0.0.8,0.0.9,8,6,78,36,114,8,FALSE
leek,0.0.15,0.0.16,15,8,223,85,308,14,FALSE
leek,0.0.14,0.0.15,14,2,7,7,14,2,FALSE
leek,0.0.16,0.0.17,16,7,230,10,240,13,FALSE
leek,0.0.11,0.0.12,11,3,3,2,5,3,FALSE
leek,0.0.10,0.0.11,10,3,3,3,6,3,FALSE
leek,0.0.13,0.0.14,13,2,2,1,3,2,FALSE
leek,0.0.12,0.0.13,12,4,7,6,13,4,FALSE
leek,0.0.17,0.0.18,17,7,33,8,41,9,FALSE
leek,0.0.12,0.0.13,12,4,7,6,13,4,TRUE
leek,0.0.19,0.0.20,19,4,8,8,16,6,FALSE
leek,0.0.18,0.0.19,18,2,2,4,6,2,FALSE
leek,0.0.20,0.0.21,20,3,1,11,12,3,FALSE
leek,0.0.21,0.0.22,21,3,105,105,210,9,FALSE
leek,0.0.23,0.0.24,23,6,194,18,212,10,FALSE
leek,0.0.22,0.0.23,22,3,13,3,16,5,FALSE
leek,0.0.18,0.0.19,18,2,2,4,6,2,TRUE
leek,0.0.17,0.0.18,17,7,33,8,41,9,TRUE
routist,0.1.0,0.1.1,10,1,29,7,36,8,FALSE
routist,0.0.9,0.1.0,9,1,29,7,36,8,FALSE
routist,0.0.5,0.0.6,5,5,388,355,743,58,FALSE
routist,0.0.4,0.0.5,4,4,27,2842,2869,76,TRUE
routist,0.0.7,0.0.8,7,1,29,7,36,8,FALSE
routist,0.0.6,0.0.7,6,1,1,0,1,1,FALSE
routist,0.0.1,0.0.2,1,283,46532,41144,87676,1782,TRUE
routist,0.0.3,0.0.4,3,6,1515,1567,3082,37,FALSE
routist,0.0.2,0.0.3,2,2,863,52,915,7,FALSE
routist,0.0.8,0.0.9,8,61,2753,2498,5251,165,TRUE
routist,0.1.0,0.1.1,10,1,29,7,36,8,TRUE
routist,0.0.4,0.0.5,4,4,27,2842,2869,76,FALSE
routist,0.0.1,0.0.2,1,283,46532,41144,87676,1782,FALSE
routist,0.0.8,0.0.9,8,61,2753,2498,5251,165,FALSE
express-vue-builder,1.1.0,1.1.2,3,2,6,6,12,3,FALSE
express-vue-builder,1.0.0,1.1.0,2,1,116,11,127,4,FALSE
express-vue-builder,1.1.2,2.0.0,4,1,11,5,16,2,FALSE
express-vue-builder,2.0.2,2.0.3,6,1,18,17,35,2,FALSE
express-vue-builder,2.0.0,2.0.2,5,3,27,139,166,11,FALSE
express-vue-builder,2.3.0,2.3.1,11,2,5,6,11,3,FALSE
express-vue-builder,2.3.1,2.3.2,12,1,2,1,3,1,FALSE
express-vue-builder,2.3.2,2.3.3,13,1,3,1,4,2,TRUE
express-vue-builder,2.2.0,2.3.0,10,1,1,1,2,1,FALSE
express-vue-builder,2.0.3,2.1.0,7,1,9,12,21,4,FALSE
express-vue-builder,2.1.0,2.1.1,8,1,11,5,16,2,FALSE
express-vue-builder,2.1.1,2.2.0,9,2,6,5,11,3,FALSE
express-vue-builder,2.6.0,2.7.0,17,1,2,3,5,2,FALSE
express-vue-builder,2.4.0,2.5.0,15,1,2,2,4,2,FALSE
express-vue-builder,2.5.0,2.6.0,16,1,2,2,4,1,FALSE
express-vue-builder,2.15.0,2.15.1,27,1,143,119,262,2,FALSE
express-vue-builder,2.15.1,2.15.2,28,1,11,5,16,2,FALSE
express-vue-builder,2.14.1,2.15.0,26,2,11,6,17,3,FALSE
express-vue-builder,2.14.0,2.14.1,25,1,11,5,16,2,FALSE
express-vue-builder,2.13.0,2.14.0,24,1,3,8,11,2,FALSE
express-vue-builder,2.11.0,2.12.0,22,1,43,43,86,2,FALSE
express-vue-builder,2.12.0,2.13.0,23,1,160,467,627,10,FALSE
express-vue-builder,2.3.2,2.3.3,13,1,3,1,4,2,FALSE
express-vue-builder,2.3.3,2.4.0,14,1,3,2,5,1,FALSE
express-vue-builder,2.9.0,2.10.1,20,2,4,3,7,3,FALSE
express-vue-builder,2.10.1,2.11.0,21,1,4790,20,4810,2,FALSE
express-vue-builder,2.7.0,2.8.0,18,1,16,22,38,3,FALSE
express-vue-builder,2.8.0,2.9.0,19,1,3,2,5,3,FALSE
express-vue-builder,2.6.0,2.7.0,17,1,2,3,5,2,TRUE
express-vue-builder,2.15.1,2.15.2,28,1,11,5,16,2,TRUE
express-vue-builder,2.10.1,2.11.0,21,1,4790,20,4810,2,TRUE
knex-csv-seeder,0.3.2,0.3.3,11,2,17,17,34,3,FALSE
knex-csv-seeder,0.3.3,0.3.4,12,2,9,9,18,3,FALSE
knex-csv-seeder,0.3.0,0.3.1,9,2,2,2,4,2,FALSE
knex-csv-seeder,0.3.1,0.3.2,10,5,8,9,17,6,FALSE
knex-csv-seeder,0.3.4,0.4.0,13,4,229,309,538,9,FALSE
knex-csv-seeder,0.2.5,0.3.0,8,23,201177,237,201414,53,TRUE
knex-csv-seeder,0.2.4,0.2.5,7,4,36,46,82,5,FALSE
knex-csv-seeder,0.2.3,0.2.4,6,2,4,4,8,3,FALSE
knex-csv-seeder,0.2.2,0.2.3,5,2,20,6,26,6,FALSE
knex-csv-seeder,0.2.1,0.2.2,4,2,7,4,11,3,FALSE
knex-csv-seeder,0.2.0,0.2.1,3,3,34,34,68,8,FALSE
knex-csv-seeder,0.1.0,0.1.1,1,1,1,1,2,1,FALSE
knex-csv-seeder,0.1.1,0.2.0,2,9,501,234,735,19,FALSE
knex-csv-seeder,0.4.0,0.4.1,14,3,8,5,13,3,FALSE
knex-csv-seeder,0.2.5,0.3.0,8,23,201177,237,201414,53,FALSE
knex-csv-seeder,0.3.3,0.3.4,12,2,9,9,18,3,TRUE
knex-csv-seeder,0.4.0,0.4.1,14,3,8,5,13,3,TRUE
kero,3.1.3,3.1.25,23,135,18399,39332,57731,610,FALSE
kero,3.1.2,3.1.3,22,1,1127,182,1309,5,FALSE
kero,3.4.9,3.4.10,40,4,633,562,1195,12,FALSE
kero,3.4.10,3.4.11,41,13,8197,7459,15656,170,FALSE
kero,3.0.3,3.1.1,20,117,62766,62658,125424,1265,FALSE
kero,3.4.12,3.4.13,43,2,25,12,37,5,FALSE
kero,3.4.13,3.4.14,44,7,299,217,516,21,FALSE
kero,2.1.8,2.1.9,7,4,167,22,189,11,FALSE
kero,2.1.9,2.1.12,8,4,11,6,17,5,FALSE
kero,3.4.14,3.4.15,45,6,137,56,193,30,FALSE
kero,2.1.2,2.1.3,1,3,473,300,773,12,FALSE
kero,2.1.3,2.1.4,2,3,640,489,1129,10,FALSE
kero,3.5.0,3.5.1,47,1,1,1,2,1,FALSE
kero,2.1.6,2.1.7,5,3,62,33,95,9,FALSE
kero,2.1.7,2.1.8,6,2,65,14,79,8,FALSE
kero,2.1.4,2.1.5,3,2,18,14,32,5,FALSE
kero,3.4.11,3.4.12,42,3,66,22,88,7,FALSE
kero,2.1.21,2.1.22,17,4,50,47,97,9,FALSE
kero,2.1.22,2.1.23,18,6,454,4268,4722,27,FALSE
kero,3.4.15,3.5.0,46,1,2,2,4,1,FALSE
kero,2.1.5,2.1.6,4,3,125,43,168,11,FALSE
kero,3.1.25,3.1.26,24,7,4859,36686,41545,916,FALSE
kero,2.1.18,2.1.19,15,3,161,42,203,9,FALSE
kero,3.4.7,3.4.8,38,1,189,185,374,3,FALSE
kero,3.4.2,3.4.3,33,1,38,20,58,3,FALSE
kero,3.4.3,3.4.4,34,6,1153,1158,2311,17,FALSE
kero,3.4.0,3.4.1,31,3,821,21,842,17,FALSE
kero,3.4.1,3.4.2,32,2,12,2,14,2,FALSE
kero,3.4.6,3.4.7,37,5,217,192,409,8,FALSE
kero,2.1.19,2.1.21,16,8,567,110,677,15,FALSE
kero,3.4.4,3.4.5,35,1,535,535,1070,2,FALSE
kero,3.4.5,3.4.6,36,2,4,4,8,2,FALSE
kero,2.1.14,2.1.15,11,3,333,98,431,6,FALSE
kero,2.1.15,2.1.16,12,11,150,56,206,22,FALSE
kero,3.4.8,3.4.9,39,1,2,2,4,1,FALSE
kero,2.1.17,2.1.18,14,2,16,6,22,5,FALSE
kero,2.1.12,2.1.13,9,2,16,8,24,6,FALSE
kero,2.1.13,2.1.14,10,4,695,200,895,19,FALSE
kero,3.3.0,3.4.0,30,1,286,282,568,4,FALSE
kero,2.1.16,2.1.17,13,3,95,30,125,9,FALSE
kero,3.1.26,3.1.27,25,4,8948,5596,14544,73,FALSE
kero,3.1.27,3.2.0,26,28,30649,27314,57963,490,FALSE
kero,3.2.0,3.2.2,27,9,400,283,683,23,FALSE
kero,3.2.2,3.2.3,28,13,9625,7573,17198,94,FALSE
kero,2.1.2,2.1.3,1,3,473,300,773,12,TRUE
kero,3.4.6,3.4.7,37,5,217,192,409,8,TRUE
kero,3.4.14,3.4.15,45,6,137,56,193,30,TRUE
kero,3.4.15,3.5.0,46,1,2,2,4,1,TRUE
kero,2.1.3,2.1.4,2,3,640,489,1129,10,TRUE
kero,2.1.15,2.1.16,12,11,150,56,206,22,TRUE
kero,3.4.1,3.4.2,32,2,12,2,14,2,TRUE
kero,3.2.2,3.2.3,28,13,9625,7573,17198,94,TRUE
kero,2.1.5,2.1.6,4,3,125,43,168,11,TRUE
kero,3.1.26,3.1.27,25,4,8948,5596,14544,73,TRUE
kero,3.4.9,3.4.10,40,4,633,562,1195,12,TRUE
kero,2.1.8,2.1.9,7,4,167,22,189,11,TRUE
kero,2.1.7,2.1.8,6,2,65,14,79,8,TRUE
kero,2.1.4,2.1.5,3,2,18,14,32,5,TRUE
kero,2.1.13,2.1.14,10,4,695,200,895,19,TRUE
kero,2.1.16,2.1.17,13,3,95,30,125,9,TRUE
generator-node,1.1.1,1.2.0,23,23,317,41,358,39,FALSE
generator-node,1.1.0,1.1.1,22,3,3,3,6,3,FALSE
generator-node,1.0.0,1.1.0,21,6,153,28,181,20,FALSE
generator-node,2.0.1,2.1.0,47,3,328,419,747,6,FALSE
generator-node,2.0.0,2.0.1,46,5,390,432,822,26,FALSE
generator-node,1.6.0,1.6.1,32,9,25,91,116,23,FALSE
generator-node,1.6.1,1.7.0,33,4,54,10,64,7,FALSE
generator-node,1.8.0,1.8.1,36,2,3,3,6,2,FALSE
generator-node,1.8.1,1.8.2,37,19,263,47,310,32,FALSE
generator-node,1.8.2,1.8.3,38,19,197,609,806,45,FALSE
generator-node,1.8.3,1.10.0,39,19,260,63,323,36,FALSE
generator-node,1.4.0,1.5.0,28,7,107,119,226,15,FALSE
generator-node,1.5.1,1.5.2,30,4,66,19,85,7,FALSE
generator-node,1.5.0,1.5.1,29,2,4,2,6,2,FALSE
generator-node,1.5.2,1.6.0,31,11,87,34,121,19,FALSE
generator-node,1.3.1,1.4.0,27,11,463,328,791,43,FALSE
generator-node,1.3.0,1.3.1,26,11,46,25,71,17,FALSE
generator-node,1.2.0,1.2.1,24,2,3,2,5,3,FALSE
generator-node,1.2.1,1.3.0,25,17,259,162,421,42,FALSE
generator-node,1.12.0,1.12.1,44,2,15,12,27,2,FALSE
generator-node,1.12.1,2.0.0,45,20,6089,2855,8944,104,FALSE
generator-node,1.11.0,1.12.0,43,4,21,23,44,8,FALSE
generator-node,1.10.2,1.11.0,42,3,17,13,30,7,FALSE
generator-node,1.10.0,1.10.1,40,5,15,19,34,6,FALSE
generator-node,1.10.1,1.10.2,41,7,136,147,283,16,TRUE
generator-node,1.7.1,1.8.0,35,8,821,76,897,35,FALSE
generator-node,1.7.0,1.7.1,34,2,6,6,12,2,FALSE
generator-node,0.3.0,0.3.1,11,3,148,159,307,3,FALSE
generator-node,0.3.1,0.4.0,12,6,164,168,332,10,FALSE
generator-node,0.2.0,0.3.0,10,15,252,78,330,40,FALSE
generator-node,0.1.0,0.2.0,9,4,4,2,6,4,FALSE
generator-node,1.10.1,1.10.2,41,7,136,147,283,16,FALSE
generator-node,0.0.5,0.0.6,5,10,25,20,45,13,FALSE
generator-node,0.0.4,0.0.5,4,6,7,3,10,6,FALSE
generator-node,0.0.7,0.0.8,7,5,9,5,14,5,FALSE
generator-node,0.0.6,0.0.7,6,10,42,18,60,13,FALSE
generator-node,0.0.1,0.0.2,1,2,5,7,12,2,FALSE
generator-node,0.0.3,0.0.4,3,7,33,25,58,15,FALSE
generator-node,0.0.2,0.0.3,2,9,19,19,38,10,FALSE
generator-node,0.6.0,0.7.0,19,26,91,72,163,39,FALSE
generator-node,0.0.8,0.1.0,8,19,295,272,567,29,FALSE
generator-node,0.7.0,1.0.0,20,38,1742,898,2640,141,FALSE
generator-node,0.4.1,0.4.2,14,8,13,14,27,9,TRUE
generator-node,0.4.0,0.4.1,13,1,103,94,197,2,FALSE
generator-node,0.4.3,0.4.4,16,17,153,81,234,23,FALSE
generator-node,0.4.2,0.4.3,15,2,2,2,4,2,FALSE
generator-node,0.5.0,0.6.0,18,8,414,382,796,16,FALSE
generator-node,0.4.4,0.5.0,17,4,192,270,462,28,FALSE
generator-node,0.4.1,0.4.2,14,8,13,14,27,9,FALSE
generator-node,1.5.1,1.5.2,30,4,66,19,85,7,TRUE
generator-node,1.4.0,1.5.0,28,7,107,119,226,15,TRUE
generator-node,1.11.0,1.12.0,43,4,21,23,44,8,TRUE
orbit-web,0.0.5,0.0.6,4,6,3231,420,3651,59,FALSE
orbit-web,0.0.4,0.0.5,3,2,67,19,86,7,FALSE
orbit-web,0.0.6,0.1.1,5,16,2417,1870,4287,132,FALSE
orbit-web,0.0.3,0.0.4,2,2,67,62,129,8,FALSE
orbit-web,0.0.2,0.0.3,1,3,136,224,360,6,FALSE
orbit-web,0.1.1,0.1.2,6,8,105,103,208,8,FALSE
orbit-web,0.1.2,0.1.3,7,3,27,18,45,3,FALSE
orbit-web,0.0.6,0.1.1,5,16,2417,1870,4287,132,TRUE
orbit-web,0.1.1,0.1.2,6,8,105,103,208,8,TRUE
one-based-array,0.1.0,0.1.1,1,2,2,1,3,2,FALSE
one-based-array,0.1.1,0.1.2,2,2,7,1,8,2,FALSE
one-based-array,0.1.2,0.1.3,3,2,2,1,3,2,FALSE
one-based-array,0.1.3,0.1.4,4,4,4,4,8,4,FALSE
one-based-array,0.1.3,0.1.4,4,4,4,4,8,4,TRUE
one-based-array,0.1.1,0.1.2,2,2,7,1,8,2,TRUE
vue-duoshuo,1.0.4,1.0.5,4,2,11,10,21,4,FALSE
vue-duoshuo,1.0.5,1.0.6,5,2,102,74,176,10,FALSE
vue-duoshuo,1.0.6,1.0.7,6,2,7,7,14,4,FALSE
vue-duoshuo,1.0.1,1.0.2,1,2,5,5,10,4,FALSE
vue-duoshuo,1.0.2,1.0.3,2,2,16,13,29,7,TRUE
vue-duoshuo,1.0.3,1.0.4,3,2,22,9,31,5,FALSE
vue-duoshuo,1.0.2,1.0.3,2,2,16,13,29,7,FALSE
vue-duoshuo,1.0.3,1.0.4,3,2,22,9,31,5,TRUE
vue-duoshuo,1.0.4,1.0.5,4,2,11,10,21,4,TRUE
vue-select-wc,2.3.8,2.3.9,11,1,4,4,8,4,FALSE
vue-select-wc,2.3.0,2.3.1,3,1,31,19,50,1,FALSE
vue-select-wc,2.3.1,2.3.2,4,1,8,4,12,4,FALSE
vue-select-wc,2.3.2,2.3.3,5,1,4,4,8,4,FALSE
vue-select-wc,2.3.3,2.3.4,6,1,4,4,8,4,FALSE
vue-select-wc,2.3.4,2.3.5,7,1,4,4,8,4,FALSE
vue-select-wc,2.3.5,2.3.6,8,1,4,4,8,4,FALSE
vue-select-wc,2.3.6,2.3.7,9,1,4,4,8,4,FALSE
vue-select-wc,2.3.7,2.3.8,10,2,25,11,36,8,FALSE
vue-select-wc,2.2.1,2.2.2,1,1,4,4,8,4,FALSE
vue-select-wc,2.2.2,2.3.0,2,5,64,22,86,10,FALSE
vue-select-wc,2.3.1,2.3.2,4,1,8,4,12,4,TRUE
redux-model-utils,0.4.1,0.4.2,2,1,27,18,45,8,FALSE
redux-model-utils,0.4.0,0.4.1,1,1,864,1044,1908,25,FALSE
redux-model-utils,0.4.3,0.4.4,4,2,228,118,346,15,FALSE
redux-model-utils,0.4.2,0.4.3,3,1,130,10,140,6,FALSE
redux-model-utils,0.4.5,0.4.6,6,1,79,14,93,4,FALSE
redux-model-utils,0.4.4,0.4.5,5,1,141,101,242,13,FALSE
redux-model-utils,0.4.7,0.4.8,8,1,155,22,177,10,FALSE
redux-model-utils,0.4.6,0.4.7,7,1,178,56,234,6,FALSE
redux-model-utils,0.4.8,0.5.0,9,1,256,732,988,41,FALSE
redux-model-utils,0.5.0,0.5.1,10,1,1,78,79,2,FALSE
redux-model-utils,0.5.1,0.5.2,11,1,88,30,118,10,FALSE
redux-model-utils,0.4.7,0.4.8,8,1,155,22,177,10,TRUE
generator-drupal-module,1.0.0,1.0.1,7,13,11,17,28,13,FALSE
generator-drupal-module,0.1.0,0.1.1,1,2,4,44,48,2,FALSE
generator-drupal-module,0.1.1,0.1.2,2,1,78,14,92,6,FALSE
generator-drupal-module,0.1.2,0.1.3,3,18,238,155,393,29,FALSE
generator-drupal-module,0.1.3,0.1.4,4,1,1,1,2,1,FALSE
generator-drupal-module,0.1.4,0.1.5,5,8,216,87,303,18,FALSE
generator-drupal-module,0.1.5,1.0.0,6,32,897,371,1268,66,FALSE
generator-drupal-module,0.1.2,0.1.3,3,18,238,155,393,29,TRUE
markrun,0.15.0,0.16.0,19,10,221,406,627,47,FALSE
markrun,0.10.0,0.11.0,14,4,17134,15493,32627,192,FALSE
markrun,0.19.0,0.20.0,23,3,160,5,165,9,FALSE
markrun,0.14.0,0.15.0,18,1,1,1,2,1,FALSE
markrun,0.11.0,0.12.0,15,2,105,32,137,4,FALSE
markrun,0.8.0,0.9.0,12,1,37068,8,37076,12,FALSE
markrun,0.17.0,0.18.0,21,4,92,89,181,14,FALSE
markrun,0.12.0,0.13.0,16,2,65,38,103,23,TRUE
markrun,0.9.0,0.10.0,13,3,5214,25352,30566,281,FALSE
markrun,0.18.0,0.19.0,22,3,23,22,45,7,FALSE
markrun,0.16.0,0.17.0,20,1,1,3,4,2,FALSE
markrun,0.20.0,0.21.0,24,1,70,21,91,5,FALSE
markrun,0.13.0,0.14.0,17,6,217,112,329,40,FALSE
markrun,0.2.0,0.3.0,6,4,41,34,75,16,FALSE
markrun,0.1.0,0.2.0,5,10,20197,172,20369,52,FALSE
markrun,0.0.1,0.0.2,2,1,1,1,2,1,FALSE
markrun,0.0.3,0.1.0,4,55,27057,638,27695,440,FALSE
markrun,0.0.2,0.0.3,3,1,1,1,2,1,FALSE
markrun,0.3.0,0.4.0,7,6,235,19883,20118,31,FALSE
markrun,0.6.0,0.7.0,10,4,70,21,91,23,FALSE
markrun,0.7.0,0.8.0,11,1,6,6,12,3,FALSE
markrun,0.12.0,0.13.0,16,2,65,38,103,23,FALSE
markrun,0.4.0,0.5.0,8,1,35,10,45,8,FALSE
markrun,0.5.0,0.6.0,9,2,17,17,34,17,FALSE
markrun,0.3.0,0.4.0,7,6,235,19883,20118,31,TRUE
markrun,0.1.0,0.2.0,5,10,20197,172,20369,52,TRUE
peranta-electron,0.1.2,0.1.3,3,1,16,366,382,4,FALSE
peranta-electron,0.1.3,0.1.4,4,1,2,2,4,1,FALSE
peranta-electron,0.1.4,0.1.5,5,1,2,2,4,1,FALSE
peranta-electron,0.1.0,0.1.1,1,1,8,8,16,3,FALSE
peranta-electron,0.1.1,0.1.2,2,1,419,9,428,10,FALSE
peranta-electron,0.1.4,0.1.5,5,1,2,2,4,1,TRUE
node-jivesbs-rest,0.0.1,0.0.2,1,2,7,8,15,2,FALSE
node-jivesbs-rest,0.0.2,0.0.3,2,2,151,16,167,4,FALSE
node-jivesbs-rest,0.0.1,0.0.2,1,2,7,8,15,2,TRUE
grind-framework,0.3.1,0.3.2,11,2,28,3,31,2,FALSE
grind-framework,0.3.2,0.3.3,12,2,10,11,21,2,FALSE
grind-framework,0.6.2,0.7.0-beta.1,28,29,1533,154,1687,78,FALSE
grind-framework,0.6.1,0.6.2,27,3,8,4,12,3,FALSE
grind-framework,0.6.0,0.6.1,26,9,111,45,156,16,FALSE
grind-framework,0.5.8,0.6.0,25,17,599,240,839,27,FALSE
grind-framework,0.5.4,0.5.5,21,2,3,3,6,2,FALSE
grind-framework,0.4.0,0.4.1,14,4,130,42,172,5,FALSE
grind-framework,0.5.6,0.5.7,23,2,2,2,4,2,FALSE
grind-framework,0.5.7,0.5.8,24,2,6,2,8,2,FALSE
grind-framework,0.5.0,0.5.1,17,2,2,2,4,2,FALSE
grind-framework,0.5.1,0.5.2,18,3,22,12,34,6,FALSE
grind-framework,0.5.2,0.5.3,19,9,104,42,146,9,FALSE
grind-framework,0.5.3,0.5.4,20,3,26,2,28,5,FALSE
grind-framework,0.5.5,0.5.6,22,3,3,2,5,3,FALSE
grind-framework,0.7.0-beta.4,0.7.0-beta.5,32,11,162,26,188,18,FALSE
grind-framework,0.7.0-beta.1,0.7.0-beta.2,29,2,2,2,4,2,FALSE
grind-framework,0.7.0-beta.2,0.7.0-beta.3,30,13,496,53,549,29,FALSE
grind-framework,0.7.0-beta.3,0.7.0-beta.4,31,5,56,24,80,6,FALSE
grind-framework,0.4.2,0.5.0,16,18,393,215,608,26,FALSE
grind-framework,0.3.3,0.4.0,13,15,258,44,302,22,FALSE
grind-framework,0.3.0,0.3.1,10,2,28,11,39,2,FALSE
grind-framework,0.4.1,0.4.2,15,2,22,20,42,3,FALSE
grind-framework,0.1.8,0.3.0,9,17,500,98,598,34,FALSE
grind-framework,0.1.0,0.1.1,1,1,2,2,4,1,FALSE
grind-framework,0.1.1,0.1.2,2,3,18,1,19,6,FALSE
grind-framework,0.1.2,0.1.3,3,2,53,2,55,4,FALSE
grind-framework,0.1.3,0.1.4,4,2,9,3,12,2,FALSE
grind-framework,0.1.4,0.1.5,5,2,5,1,6,2,FALSE
grind-framework,0.1.5,0.1.6,6,4,79,5,84,5,FALSE
grind-framework,0.1.6,0.1.7,7,2,19,2,21,2,FALSE
grind-framework,0.1.7,0.1.8,8,9,102,64,166,23,FALSE
grind-framework,0.7.0-beta.4,0.7.0-beta.5,32,11,162,26,188,18,TRUE
grind-framework,0.7.0-beta.1,0.7.0-beta.2,29,2,2,2,4,2,TRUE
spy-debugger,3.0.6,3.0.7,39,2,9,3,12,3,FALSE
spy-debugger,3.0.7,3.1.0,40,2,239,96,335,9,FALSE
spy-debugger,3.1.1,3.1.2,42,4,513,5,518,12,FALSE
spy-debugger,3.0.5,3.0.6,38,2,26,22,48,5,FALSE
spy-debugger,3.0.2,3.0.3,35,11,289,46,335,17,FALSE
spy-debugger,3.0.3,3.0.4,36,1,4,1,5,1,FALSE
spy-debugger,3.0.0,3.0.1,33,2,11,1,12,2,FALSE
spy-debugger,3.0.1,3.0.2,34,4,8,5,13,4,FALSE
spy-debugger,3.0.4,3.0.5,37,1,1,0,1,1,FALSE
spy-debugger,3.1.0,3.1.1,41,2,4765,129,4894,7,FALSE
spy-debugger,2.2.1,2.2.2,28,3,7,11,18,5,FALSE
spy-debugger,2.2.2,2.3.0,29,8,38,19,57,14,FALSE
spy-debugger,3.2.4,3.2.5,46,4,6110,4685,10795,7,FALSE
spy-debugger,3.2.5,3.2.6,47,2,3,3,6,3,FALSE
spy-debugger,3.2.6,3.3.0,48,5,165,105,270,10,FALSE
spy-debugger,3.6.1,3.6.2,57,1,1,0,1,1,FALSE
spy-debugger,3.3.1,3.3.2,50,2,22,7,29,4,FALSE
spy-debugger,2.3.0,2.3.1,30,5,14,4,18,6,FALSE
spy-debugger,2.3.1,2.3.2,31,1,22,8,30,3,FALSE
spy-debugger,2.3.2,3.0.0,32,6,730,234,964,18,FALSE
spy-debugger,3.4.0,3.5.0,53,1,22,6,28,3,FALSE
spy-debugger,3.5.1,3.6.0,55,2,8,2,10,2,FALSE
spy-debugger,3.5.0,3.5.1,54,4,7,6,13,7,FALSE
spy-debugger,3.6.0,3.6.1,56,3,9,5,14,7,FALSE
spy-debugger,3.3.0,3.3.1,49,3,15,3,18,3,FALSE
spy-debugger,3.3.2,3.3.3,51,1,2,2,4,1,FALSE
spy-debugger,3.1.2,3.2.2,43,5,118,41,159,13,FALSE
spy-debugger,3.2.2,3.2.3,44,5,219,5,224,8,FALSE
spy-debugger,3.2.3,3.2.4,45,2,13,3,16,3,FALSE
spy-debugger,3.3.3,3.4.0,52,4,87023,6850,93873,446,FALSE
spy-debugger,2.0.7,2.0.8,20,3,23,49,72,6,FALSE
spy-debugger,2.0.6,2.0.7,19,2,20,16,36,9,FALSE
spy-debugger,2.0.5,2.0.6,18,1,42,2,44,6,FALSE
spy-debugger,2.0.4,2.0.5,17,1,2,2,4,1,FALSE
spy-debugger,2.0.3,2.0.4,16,1,5,5,10,3,FALSE
spy-debugger,2.0.1,2.0.2,14,1,1,0,1,1,FALSE
spy-debugger,2.0.0,2.0.1,13,6,589,764,1353,24,FALSE
spy-debugger,2.0.9,2.0.10,22,6,60,15,75,14,FALSE
spy-debugger,2.0.8,2.0.9,21,1,1,1,2,1,FALSE
spy-debugger,2.2.0,2.2.1,27,2,6,3,9,4,FALSE
spy-debugger,2.1.2,2.1.3,25,3,11,8,19,8,FALSE
spy-debugger,2.1.1,2.1.2,24,3,8,4,12,5,FALSE
spy-debugger,2.0.2,2.0.3,15,2,5,5,10,4,FALSE
spy-debugger,2.1.3,2.2.0,26,4,68,23,91,6,FALSE
spy-debugger,2.0.10,2.1.1,23,2,5,3,8,4,FALSE
spy-debugger,1.0.4,1.0.5,9,1,1,0,1,1,FALSE
spy-debugger,1.1.0,2.0.0,12,4,63,39,102,14,FALSE
spy-debugger,1.0.6,1.1.0,11,1,1,1,2,1,FALSE
spy-debugger,1.0.1,1.0.2,6,1,8,3,11,3,FALSE
spy-debugger,1.0.5,1.0.6,10,8,39,74,113,22,FALSE
spy-debugger,0.0.4,1.0.0,4,1,1,0,1,1,FALSE
spy-debugger,1.0.2,1.0.3,7,3,124,66,190,13,FALSE
spy-debugger,0.0.3,0.0.4,3,1,1,0,1,1,FALSE
spy-debugger,0.0.2,0.0.3,2,1,1,0,1,1,FALSE
spy-debugger,1.0.3,1.0.4,8,1,1,0,1,1,FALSE
spy-debugger,1.0.0,1.0.1,5,3,520,152,672,20,FALSE
spy-debugger,1.1.0,2.0.0,12,4,63,39,102,14,TRUE
spy-debugger,3.0.5,3.0.6,38,2,26,22,48,5,TRUE
spy-debugger,2.1.1,2.1.2,24,3,8,4,12,5,TRUE
spy-debugger,3.0.7,3.1.0,40,2,239,96,335,9,TRUE
spy-debugger,3.3.3,3.4.0,52,4,87023,6850,93873,446,TRUE
spy-debugger,3.3.1,3.3.2,50,2,22,7,29,4,TRUE
spy-debugger,3.1.1,3.1.2,42,4,513,5,518,12,TRUE
spy-debugger,2.1.2,2.1.3,25,3,11,8,19,8,TRUE
spy-debugger,2.3.0,2.3.1,30,5,14,4,18,6,TRUE
vue-in-viewport-directive,1.1.1,1.1.2,4,2,5,5,10,3,FALSE
vue-in-viewport-directive,1.1.0,1.1.1,3,2,9,8,17,4,FALSE
vue-in-viewport-directive,1.1.3,1.1.4,6,2,6,6,12,4,FALSE
vue-in-viewport-directive,1.1.2,1.1.3,5,2,5,5,10,3,FALSE
vue-in-viewport-directive,1.0.0,1.0.1,1,2,83,254,337,5,FALSE
vue-in-viewport-directive,1.0.1,1.1.0,2,4,124,112,236,10,FALSE
vue-in-viewport-directive,1.0.0,1.0.1,1,2,83,254,337,5,TRUE
vue-in-viewport-directive,1.1.0,1.1.1,3,2,9,8,17,4,TRUE
vue-in-viewport-directive,1.0.1,1.1.0,2,4,124,112,236,10,TRUE
solfegejs-server,2.0.7,2.0.8,25,1,35,7,42,3,FALSE
solfegejs-server,2.0.6,2.0.7,24,1,61,358,419,12,FALSE
solfegejs-server,2.0.4,2.0.6,23,1,19,22,41,12,FALSE
solfegejs-server,2.0.2,2.0.4,22,1,17,63,80,6,FALSE
solfegejs-server,2.0.1,2.0.2,21,1,215,142,357,16,FALSE
solfegejs-server,2.0.0,2.0.1,20,1,19,4,23,3,FALSE
solfegejs-server,2.0.8,2.1.0,26,2,1112,679,1791,40,FALSE
solfegejs-server,1.6.2,1.6.3,18,1,226,4,230,5,FALSE
solfegejs-server,1.6.3,2.0.0,19,2,1759,1513,3272,31,FALSE
solfegejs-server,1.6.0,1.6.1,16,1,3,3,6,3,FALSE
solfegejs-server,1.6.1,1.6.2,17,1,215,7,222,3,FALSE
solfegejs-server,1.1.0,1.2.0,5,3,249,20,269,8,FALSE
solfegejs-server,1.0.0,1.1.0,4,3,293,60,353,7,FALSE
solfegejs-server,0.1.0,1.0.0,3,2,31,11,42,3,FALSE
solfegejs-server,0.0.3,0.1.0,2,1,5,5,10,2,FALSE
solfegejs-server,1.4.0,1.5.0,9,1,1245,553,1798,13,FALSE
solfegejs-server,1.5.5,1.6.0,15,1,329,128,457,5,FALSE
solfegejs-server,1.5.4,1.5.5,14,1,11,6,17,5,FALSE
solfegejs-server,1.5.1,1.5.2,11,1,8,12,20,3,FALSE
solfegejs-server,1.5.0,1.5.1,10,1,8,5,13,3,FALSE
solfegejs-server,1.5.3,1.5.4,13,1,4,4,8,3,FALSE
solfegejs-server,1.5.2,1.5.3,12,1,27,3,30,3,FALSE
solfegejs-server,1.3.0,1.4.0,8,1,3,3,6,2,FALSE
solfegejs-server,1.2.0,1.2.1,6,2,10,1,11,2,FALSE
solfegejs-server,1.2.1,1.3.0,7,3,17,3,20,4,FALSE
solfegejs-server,2.0.4,2.0.6,23,1,19,22,41,12,TRUE
solfegejs-server,2.0.0,2.0.1,20,1,19,4,23,3,TRUE
solfegejs-server,1.5.1,1.5.2,11,1,8,12,20,3,TRUE
react-respond-to,0.0.1,0.0.2,1,1,22,2,24,2,FALSE
react-respond-to,0.0.2,0.1.0,2,3,18,1,19,3,FALSE
react-respond-to,0.3.0,0.4.0,7,3,91,32,123,8,FALSE
react-respond-to,0.2.1,0.3.0,6,1,1,1,2,1,FALSE
react-respond-to,0.2.0,0.2.1,5,4,86,42,128,6,FALSE
react-respond-to,0.1.0,0.1.1,3,8,91,38,129,12,FALSE
react-respond-to,0.1.1,0.2.0,4,2,69,28,97,7,FALSE
react-respond-to,0.4.0,0.4.1,8,3,58,29,87,5,FALSE
react-respond-to,0.1.0,0.1.1,3,8,91,38,129,12,TRUE
react-respond-to,0.1.1,0.2.0,4,2,69,28,97,7,TRUE
react-respond-to,0.3.0,0.4.0,7,3,91,32,123,8,TRUE
abaplint,0.29.5,0.29.6,73,13,1501,544,2045,472,FALSE
abaplint,0.29.7,0.29.8,75,4,319,60,379,68,FALSE
abaplint,0.29.6,0.29.7,74,4,371,54,425,59,FALSE
abaplint,0.29.15,0.29.16,83,9,181,44,225,61,FALSE
abaplint,0.29.14,0.29.15,82,3,55,19,74,26,FALSE
abaplint,0.29.16,0.29.17,84,6,34,23,57,13,FALSE
abaplint,0.29.11,0.29.12,79,1,8,2,10,3,FALSE
abaplint,0.29.10,0.29.11,78,10,603,95,698,94,FALSE
abaplint,0.29.13,0.29.14,81,31,1336,488,1824,311,FALSE
abaplint,0.29.12,0.29.13,80,8,561,107,668,115,FALSE
abaplint,0.29.9,0.29.10,77,2,10,5,15,6,FALSE
abaplint,0.29.8,0.29.9,76,2,26,17,43,7,FALSE
abaplint,0.28.5,0.28.6,66,4,27,33,60,16,FALSE
abaplint,0.27.14,0.27.15,58,1,42,6,48,8,FALSE
abaplint,0.27.1,0.27.2,45,4,132,79,211,17,FALSE
abaplint,0.26.1,0.26.2,34,1,3,2,5,3,FALSE
abaplint,0.25.0,0.25.1,27,2,1,2,3,2,FALSE
abaplint,0.0.15,0.0.16,11,15,576,131,707,58,FALSE
abaplint,0.0.14,0.0.15,10,3,104,18,122,12,FALSE
abaplint,0.0.17,0.0.18,13,5,102,41,143,23,FALSE
abaplint,0.0.16,0.0.17,12,19,616,228,844,76,FALSE
abaplint,0.0.11,0.0.12,7,13,678,388,1066,78,FALSE
abaplint,0.0.10,0.0.11,6,17,1108,270,1378,81,FALSE
abaplint,0.0.13,0.0.14,9,12,249,155,404,67,FALSE
abaplint,0.0.12,0.0.13,8,15,490,374,864,189,FALSE
abaplint,0.0.19,0.0.20,15,9,35,11,46,12,FALSE
abaplint,0.0.18,0.0.19,14,2,3,3,6,2,FALSE
abaplint,0.0.5,0.0.6,1,2,4,4,8,2,FALSE
abaplint,0.0.7,0.0.8,3,8,279,82,361,52,FALSE
abaplint,0.0.6,0.0.7,2,1,1,1,2,1,FALSE
abaplint,0.28.4,0.28.5,65,1,12,1,13,3,FALSE
abaplint,0.0.22,0.23.0,18,2,252,97,349,23,FALSE
abaplint,0.28.0,0.28.1,61,13,727,1126,1853,180,TRUE
abaplint,0.27.0,0.27.1,44,44,4115,2596,6711,508,FALSE
abaplint,0.0.9,0.0.10,5,7,480,88,568,83,FALSE
abaplint,0.0.8,0.0.9,4,9,1639,310,1949,132,TRUE
abaplint,0.27.2,0.27.3,46,8,707,204,911,144,FALSE
abaplint,0.25.4,0.25.5,31,1,21,16,37,2,FALSE
abaplint,0.27.16,0.28.0,60,14,1935,1635,3570,256,FALSE
abaplint,0.27.15,0.27.16,59,3,32,28,60,10,FALSE
abaplint,0.23.0,0.24.0,19,7,187,69,256,68,FALSE
abaplint,0.27.13,0.27.14,57,22,1451,737,2188,138,FALSE
abaplint,0.27.12,0.27.13,56,2,26,7,33,8,FALSE
abaplint,0.27.11,0.27.12,55,4,20,5,25,8,FALSE
abaplint,0.27.10,0.27.11,54,4,106,37,143,17,FALSE
abaplint,0.27.7,0.27.8,51,1,4,4,8,2,FALSE
abaplint,0.25.5,0.26.0,32,10,868,191,1059,40,FALSE
abaplint,0.24.1,0.24.2,21,6,41,30,71,15,FALSE
abaplint,0.24.2,0.24.3,22,2,140,84,224,24,FALSE
abaplint,0.24.3,0.24.4,23,5,37,77,114,24,FALSE
abaplint,0.25.1,0.25.2,28,1,3,1,4,2,FALSE
abaplint,0.24.5,0.24.6,25,1,15,4,19,2,FALSE
abaplint,0.24.6,0.25.0,26,3,1382,1382,2764,56,FALSE
abaplint,0.25.2,0.25.3,29,2,9,6,15,5,FALSE
abaplint,0.29.1,0.29.2,69,1,6,16,22,2,FALSE
abaplint,0.0.21,0.0.22,17,1,17,1,18,4,FALSE
abaplint,0.26.8,0.26.9,41,2,76,46,122,9,FALSE
abaplint,0.26.9,0.26.10,42,12,603,331,934,69,FALSE
abaplint,0.24.0,0.24.1,20,2,6,3,9,4,FALSE
abaplint,0.25.3,0.25.4,30,7,405,369,774,65,FALSE
abaplint,0.27.9,0.27.10,53,2,69,10,79,16,FALSE
abaplint,0.27.8,0.27.9,52,1,10,3,13,4,TRUE
abaplint,0.27.6,0.27.7,50,2,78,26,104,14,FALSE
abaplint,0.28.6,0.29.0,67,1,53,2,55,4,FALSE
abaplint,0.27.4,0.27.5,48,2,4,4,8,4,FALSE
abaplint,0.27.3,0.27.4,47,10,629,196,825,54,FALSE
abaplint,0.28.1,0.28.2,62,1,7,1,8,3,FALSE
abaplint,0.28.2,0.28.3,63,2,12,37,49,19,FALSE
abaplint,0.26.5,0.26.6,38,2,16,11,27,5,FALSE
abaplint,0.26.10,0.27.0,43,24,2684,1371,4055,220,FALSE
abaplint,0.0.20,0.0.21,16,3,18,9,27,6,FALSE
abaplint,0.24.4,0.24.5,24,1,83,77,160,23,FALSE
abaplint,0.26.7,0.26.8,40,2,32,14,46,6,FALSE
abaplint,0.26.3,0.26.4,36,2,93,12,105,6,FALSE
abaplint,0.29.0,0.29.1,68,2,23,19,42,5,FALSE
abaplint,0.26.4,0.26.5,37,3,105,152,257,9,FALSE
abaplint,0.27.5,0.27.6,49,3,53,16,69,21,FALSE
abaplint,0.29.3,0.29.4,71,3,56,18,74,20,FALSE
abaplint,0.26.0,0.26.1,33,1,34,7,41,3,FALSE
abaplint,0.26.2,0.26.3,35,1,4,2,6,3,FALSE
abaplint,0.29.2,0.29.3,70,4,17,8,25,6,FALSE
abaplint,0.26.6,0.26.7,39,1,14,5,19,6,FALSE
abaplint,0.28.3,0.28.4,64,3,6,5,11,5,FALSE
abaplint,0.29.4,0.29.5,72,28,2277,377,2654,382,FALSE
abaplint,0.28.0,0.28.1,61,13,727,1126,1853,180,FALSE
abaplint,0.0.8,0.0.9,4,9,1639,310,1949,132,FALSE
abaplint,0.27.8,0.27.9,52,1,10,3,13,4,FALSE
abaplint,0.25.3,0.25.4,30,7,405,369,774,65,TRUE
abaplint,0.27.5,0.27.6,49,3,53,16,69,21,TRUE
abaplint,0.29.16,0.29.17,84,6,34,23,57,13,TRUE
abaplint,0.29.13,0.29.14,81,31,1336,488,1824,311,TRUE
abaplint,0.27.6,0.27.7,50,2,78,26,104,14,TRUE
abaplint,0.29.15,0.29.16,83,9,181,44,225,61,TRUE
abaplint,0.24.6,0.25.0,26,3,1382,1382,2764,56,TRUE
abaplint,0.29.7,0.29.8,75,4,319,60,379,68,TRUE
abaplint,0.29.6,0.29.7,74,4,371,54,425,59,TRUE
abaplint,0.0.15,0.0.16,11,15,576,131,707,58,TRUE
abaplint,0.0.14,0.0.15,10,3,104,18,122,12,TRUE
abaplint,0.0.17,0.0.18,13,5,102,41,143,23,TRUE
abaplint,0.0.16,0.0.17,12,19,616,228,844,76,TRUE
abaplint,0.0.13,0.0.14,9,12,249,155,404,67,TRUE
abaplint,0.0.12,0.0.13,8,15,490,374,864,189,TRUE
abaplint,0.0.19,0.0.20,15,9,35,11,46,12,TRUE
abaplint,0.0.18,0.0.19,14,2,3,3,6,2,TRUE
abaplint,0.0.22,0.23.0,18,2,252,97,349,23,TRUE
abaplint,0.29.11,0.29.12,79,1,8,2,10,3,TRUE
abaplint,0.29.10,0.29.11,78,10,603,95,698,94,TRUE
abaplint,0.23.0,0.24.0,19,7,187,69,256,68,TRUE
abaplint,0.24.0,0.24.1,20,2,6,3,9,4,TRUE
abaplint,0.0.21,0.0.22,17,1,17,1,18,4,TRUE
abaplint,0.29.5,0.29.6,73,13,1501,544,2045,472,TRUE
abaplint,0.28.6,0.29.0,67,1,53,2,55,4,TRUE
abaplint,0.0.20,0.0.21,16,3,18,9,27,6,TRUE
abaplint,0.29.0,0.29.1,68,2,23,19,42,5,TRUE
abaplint,0.29.3,0.29.4,71,3,56,18,74,20,TRUE
abaplint,0.29.2,0.29.3,70,4,17,8,25,6,TRUE
abaplint,0.29.12,0.29.13,80,8,561,107,668,115,TRUE
abaplint,0.28.3,0.28.4,64,3,6,5,11,5,TRUE
abaplint,0.29.4,0.29.5,72,28,2277,377,2654,382,TRUE
abaplint,0.27.3,0.27.4,47,10,629,196,825,54,TRUE
abaplint,0.26.1,0.26.2,34,1,3,2,5,3,TRUE
abaplint,0.28.5,0.28.6,66,4,27,33,60,16,TRUE
abaplint,0.24.1,0.24.2,21,6,41,30,71,15,TRUE
abaplint,0.24.3,0.24.4,23,5,37,77,114,24,TRUE
abaplint,0.26.6,0.26.7,39,1,14,5,19,6,TRUE
abaplint,0.26.4,0.26.5,37,3,105,152,257,9,TRUE
abaplint,0.26.2,0.26.3,35,1,4,2,6,3,TRUE
abaplint,0.26.3,0.26.4,36,2,93,12,105,6,TRUE
digitalocean,0.9.0,0.9.1,25,6,92,67,159,9,FALSE
digitalocean,0.9.1,0.10.0,26,6,9,80,89,8,FALSE
digitalocean,0.7.2,0.7.3,18,3,1224,419,1643,8,FALSE
digitalocean,0.3.0,0.4.0,8,4,59075,1262,60337,23,FALSE
digitalocean,0.6.0,0.6.1,14,3,385,1117,1502,14,FALSE
digitalocean,0.8.1,0.8.2,22,2,33,30,63,5,FALSE
digitalocean,0.7.3,0.7.4,19,2,230,82,312,4,TRUE
digitalocean,0.7.0,0.7.1,16,7,1002,216,1218,29,FALSE
digitalocean,0.7.1,0.7.2,17,4,1379,514,1893,29,FALSE
digitalocean,0.8.3,0.9.0,24,5,6014,2513,8527,9,FALSE
digitalocean,0.8.0,0.8.1,21,4,283,111,394,17,FALSE
digitalocean,0.4.1,0.5.0,10,6,1679,558,2237,38,FALSE
digitalocean,0.4.0,0.4.1,9,6,400,28,428,10,FALSE
digitalocean,0.7.4,0.8.0,20,3,381,70,451,7,FALSE
digitalocean,0.8.2,0.8.3,23,2,9,9,18,5,FALSE
digitalocean,0.5.0,0.5.1,11,2,57,65,122,10,FALSE
digitalocean,0.6.1,0.7.0,15,7,61008,50595,111603,39,FALSE
digitalocean,0.5.2,0.6.0,13,4,2655,2921,5576,27,FALSE
digitalocean,0.5.1,0.5.2,12,2,148,7,155,6,TRUE
digitalocean,0.7.3,0.7.4,19,2,230,82,312,4,FALSE
digitalocean,0.5.1,0.5.2,12,2,148,7,155,6,FALSE
react-lazyload,0.2.2,0.2.3,7,1,3,3,6,3,FALSE
react-lazyload,0.2.1,0.2.2,6,2,13,5,18,4,FALSE
react-lazyload,0.2.0,0.2.1,5,1,40,10,50,5,FALSE
react-lazyload,0.1.0,0.1.1,2,2,198,74,272,13,FALSE
react-lazyload,0.1.1,0.1.2,3,2,44,20,64,6,FALSE
react-lazyload,0.1.2,0.2.0,4,1,79,28,107,7,FALSE
react-lazyload,2.0.4,2.1.0,30,3,237,207,444,17,FALSE
react-lazyload,2.0.3,2.0.4,29,2,5,5,10,3,FALSE
react-lazyload,2.0.2,2.0.3,28,4,55,11,66,7,FALSE
react-lazyload,2.0.1,2.0.2,27,4,122,8,130,9,FALSE
react-lazyload,2.0.0,2.0.1,26,5,178,12,190,11,FALSE
react-lazyload,2.2.5,2.2.6,43,2,35,29,64,5,FALSE
react-lazyload,2.2.4,2.2.5,42,4,121,57,178,16,FALSE
react-lazyload,2.2.6,2.2.7,44,2,5,3,8,2,FALSE
react-lazyload,2.2.1,2.2.2,39,7,28,21,49,10,FALSE
react-lazyload,2.2.0,2.2.1,38,5,40,24,64,9,FALSE
react-lazyload,2.2.3,2.2.4,41,2,2,2,4,2,FALSE
react-lazyload,2.2.2,2.2.3,40,3,8,3,11,3,FALSE
react-lazyload,2.1.2,2.1.3,33,3,5,7,12,4,FALSE
react-lazyload,2.1.3,2.1.4,34,4,82,128,210,7,FALSE
react-lazyload,2.1.0,2.1.1,31,2,5,5,10,3,FALSE
react-lazyload,2.1.1,2.1.2,32,2,5,3,8,3,FALSE
react-lazyload,2.1.6,2.2.0,37,4,50,12,62,11,FALSE
react-lazyload,2.1.4,2.1.5,35,4,27,27,54,5,FALSE
react-lazyload,2.1.5,2.1.6,36,3,30,14,44,5,FALSE
react-lazyload,2.0.0,2.0.1,26,5,178,12,190,11,TRUE
react-lazyload,2.2.5,2.2.6,43,2,35,29,64,5,TRUE
react-lazyload,2.0.0-beta.3,2.0.0-beta.4,22,2,10,10,20,2,FALSE
react-lazyload,1.6.0,1.6.1,19,3,83,61,144,8,FALSE
react-lazyload,1.6.1,1.6.2,20,7,186,264,450,27,FALSE
react-lazyload,1.5.0,1.6.0,18,5,201,39,240,11,FALSE
react-lazyload,1.1.0,1.2.0,11,5,56,30,86,9,FALSE
react-lazyload,2.0.4,2.1.0,30,3,237,207,444,17,TRUE
react-lazyload,1.0.0,1.1.0,10,5,97,72,169,18,FALSE
react-lazyload,2.0.0-beta1,2.0.0-beta2,24,1,7,6,13,3,FALSE
react-lazyload,2.0.0-beta2,2.0.0,25,42,1824,1187,3011,134,FALSE
react-lazyload,0.2.3,0.2.4,8,1,4,3,7,1,FALSE
react-lazyload,1.4.0,1.4.1,16,3,6,4,10,5,FALSE
react-lazyload,1.4.1,1.5.0,17,7,456,674,1130,34,FALSE
react-lazyload,1.3.2,1.4.0,15,5,280,53,333,20,FALSE
react-lazyload,1.3.1,1.3.2,14,2,19,1,20,4,FALSE
react-lazyload,1.3.0,1.3.1,13,3,15,3,18,4,FALSE
react-lazyload,1.2.0,1.3.0,12,4,675,142,817,22,FALSE
react-lazyload,0.2.4,1.0.0,9,3,71,41,112,11,FALSE
react-lazyload,2.2.4,2.2.5,42,4,121,57,178,16,TRUE
react-lazyload,2.2.2,2.2.3,40,3,8,3,11,3,TRUE
react-lazyload,0.1.0,0.1.1,2,2,198,74,272,13,TRUE
react-lazyload,2.1.2,2.1.3,33,3,5,7,12,4,TRUE
react-spy-scroll,0.0.5,0.0.6,5,2,10,9,19,4,FALSE
react-spy-scroll,0.0.4,0.0.5,4,5,9,7,16,5,FALSE
react-spy-scroll,0.0.7,0.1.0,7,9,15,11,26,11,FALSE
react-spy-scroll,0.0.6,0.0.7,6,8,177,66,243,18,FALSE
react-spy-scroll,0.0.1,0.0.2,1,2,4,4,8,2,FALSE
react-spy-scroll,0.0.3,0.0.4,3,6,73,21,94,11,FALSE
react-spy-scroll,0.0.2,0.0.3,2,36,1080,313,1393,106,FALSE
react-spy-scroll,0.2.0,0.2.1,10,46,272,172,444,69,FALSE
react-spy-scroll,0.1.0,0.1.1,8,4,17,23,40,7,FALSE
react-spy-scroll,0.1.1,0.2.0,9,3,45,11,56,5,FALSE
react-spy-scroll,0.0.6,0.0.7,6,8,177,66,243,18,TRUE
react-spy-scroll,0.0.1,0.0.2,1,2,4,4,8,2,TRUE
react-spy-scroll,0.0.3,0.0.4,3,6,73,21,94,11,TRUE
react-spy-scroll,0.1.1,0.2.0,9,3,45,11,56,5,TRUE
react-spy-scroll,0.0.7,0.1.0,7,9,15,11,26,11,TRUE
react-spy-scroll,0.0.2,0.0.3,2,36,1080,313,1393,106,TRUE
cantrip,0.1.0,0.1.1,1,11,1209,601,1810,29,FALSE
cantrip,0.1.1,0.1.2,2,31,1581,916,2497,71,FALSE
cantrip,0.1.2,0.1.3,3,5,233,82,315,17,FALSE
cantrip,0.1.3,0.1.4,4,2,5,2,7,2,FALSE
cantrip,0.1.0,0.1.1,1,11,1209,601,1810,29,TRUE
illa,4.0.1,4.0.2,1,2,8,4,12,6,FALSE
illa,5.0.0,5.0.1,3,2,6,6,12,6,TRUE
illa,5.0.2,6.0.0,5,3,70,48,118,15,TRUE
illa,4.0.2,5.0.0,2,2,2238,2820,5058,78,TRUE
illa,5.0.1,5.0.2,4,2,22,4,26,6,TRUE
illa,6.0.0,7.0.0,6,3,14,14,28,8,TRUE
illa,5.0.0,5.0.1,3,2,6,6,12,6,FALSE
illa,5.0.2,6.0.0,5,3,70,48,118,15,FALSE
illa,4.0.2,5.0.0,2,2,2238,2820,5058,78,FALSE
illa,5.0.1,5.0.2,4,2,22,4,26,6,FALSE
illa,6.0.0,7.0.0,6,3,14,14,28,8,FALSE
datavan,1.1.0,1.3.0,5,7,692,660,1352,19,FALSE
datavan,1.0.0,1.0.1,1,3,16,3,19,6,FALSE
datavan,1.0.1,1.0.2,2,2,438,404,842,28,FALSE
datavan,1.0.2,1.0.3,3,8,1268,422,1690,50,FALSE
datavan,1.0.3,1.1.0,4,2,650,549,1199,4,FALSE
datavan,1.6.0,1.7.0,14,4,222,176,398,14,FALSE
datavan,1.7.8,1.8.0,23,9,555,619,1174,30,FALSE
datavan,1.7.7,1.7.8,22,4,52,52,104,5,FALSE
datavan,1.7.6,1.7.7,21,6,81,58,139,14,FALSE
datavan,1.7.5,1.7.6,20,4,282,197,479,24,FALSE
datavan,1.7.4,1.7.5,19,2,35,7,42,3,FALSE
datavan,1.8.0,1.8.1,24,2,109,45,154,11,FALSE
datavan,1.8.1,1.8.2,25,7,91,69,160,11,FALSE
datavan,1.7.0,1.7.1,15,2,6,11,17,3,FALSE
datavan,1.4.0,1.4.1,8,2,84,92,176,8,FALSE
datavan,1.4.1,1.5.0,9,5,466,431,897,21,FALSE
datavan,1.5.1,1.5.2,11,2,27,21,48,3,FALSE
datavan,1.5.0,1.5.1,10,1,1,1,2,1,FALSE
datavan,1.5.3,1.6.0,13,4,81,78,159,11,FALSE
datavan,1.5.2,1.5.3,12,2,27,19,46,10,TRUE
datavan,1.3.1,1.4.0,7,2,262,248,510,9,FALSE
datavan,1.3.0,1.3.1,6,1,28,0,28,1,FALSE
datavan,1.7.3,1.7.4,18,3,165,158,323,4,FALSE
datavan,1.7.2,1.7.3,17,2,19,2,21,4,FALSE
datavan,1.7.1,1.7.2,16,2,49,11,60,6,FALSE
datavan,1.5.2,1.5.3,12,2,27,19,46,10,FALSE
datavan,1.6.0,1.7.0,14,4,222,176,398,14,TRUE
datavan,1.3.1,1.4.0,7,2,262,248,510,9,TRUE
datavan,1.7.3,1.7.4,18,3,165,158,323,4,TRUE
datavan,1.0.0,1.0.1,1,3,16,3,19,6,TRUE
deepword,1.2.0,1.2.1,26,2,18,12,30,3,FALSE
deepword,1.3.4,1.3.5,35,2,8,2,10,3,FALSE
deepword,1.4.0,1.4.1,37,2,9,3,12,4,FALSE
deepword,1.4.1,1.4.2,38,2,8,2,10,3,FALSE
deepword,1.4.2,1.4.3,39,2,8,2,10,3,FALSE
deepword,1.4.3,1.4.4,40,2,8,2,10,3,FALSE
deepword,1.4.4,1.4.5,41,2,8,2,10,3,FALSE
deepword,1.4.5,1.4.6,42,3,9,3,12,4,FALSE
deepword,1.4.6,1.4.7,43,2,8,2,10,3,FALSE
deepword,1.4.7,1.4.8,44,2,14,2,16,3,FALSE
deepword,1.4.8,1.4.9,45,2,9,4,13,3,FALSE
deepword,1.4.9,1.4.10,46,2,17,7,24,3,FALSE
deepword,1.3.3,1.3.4,34,5,14,5,19,6,FALSE
deepword,1.3.2,1.3.3,33,2,8,2,10,3,FALSE
deepword,1.2.4,1.3.0,30,2,29,5,34,4,FALSE
deepword,1.3.0,1.3.1,31,6,21,5,26,7,FALSE
deepword,1.2.2,1.2.3,28,6,18,7,25,8,FALSE
deepword,1.2.3,1.2.4,29,3,17,9,26,4,FALSE
deepword,1.3.5,1.4.0,36,6,129,12,141,12,FALSE
deepword,1.2.1,1.2.2,27,5,17,8,25,10,FALSE
deepword,1.3.1,1.3.2,32,2,12,6,18,7,FALSE
deepword,1.4.12,1.4.13,49,2,8,2,10,3,FALSE
deepword,1.4.10,1.4.11,47,2,8,2,10,3,FALSE
deepword,1.4.11,1.4.12,48,4,13,16,29,7,FALSE
deepword,1.1.3,1.1.4,22,3,14,3,17,4,FALSE
deepword,1.1.5,1.1.6,24,2,7,2,9,3,FALSE
deepword,1.1.4,1.1.5,23,2,8,2,10,3,FALSE
deepword,1.1.6,1.2.0,25,8,85,37,122,16,FALSE
deepword,1.1.1,1.1.2,20,5,31,13,44,7,FALSE
deepword,1.1.0,1.1.1,19,4,25,18,43,6,FALSE
deepword,1.1.2,1.1.3,21,2,33,21,54,8,FALSE
deepword,1.0.0,1.0.1,17,6,16,4,20,7,FALSE
deepword,1.0.1,1.1.0,18,5,64,18,82,7,FALSE
deepword,0.9.0,1.0.0,16,40,497,83,580,54,FALSE
deepword,0.2.1,0.3.0,3,1,0,3,3,1,FALSE
deepword,0.2.0,0.2.1,2,1,0,3,3,1,FALSE
deepword,0.1.0,0.2.0,1,17,553,254,807,46,FALSE
deepword,0.6.4,0.7.0,11,4,166,19,185,13,FALSE
deepword,0.6.3,0.6.4,10,11,219,75,294,26,FALSE
deepword,0.6.2,0.6.3,9,4,59,47,106,10,FALSE
deepword,0.3.0,0.4.0,4,8,178,1212,1390,17,FALSE
deepword,0.6.0,0.6.1,7,4,120,127,247,20,FALSE
deepword,0.7.0,0.7.1,12,15,42,31,73,21,FALSE
deepword,0.7.1,0.8.0,13,6,44,9,53,10,FALSE
deepword,0.4.0,0.5.0,5,4,63,23,86,14,FALSE
deepword,0.5.0,0.6.0,6,9,206,113,319,27,FALSE
deepword,1.4.7,1.4.8,44,2,14,2,16,3,TRUE
deepword,0.8.1,0.9.0,15,9,223,75,298,20,FALSE
deepword,0.8.0,0.8.1,14,2,9,1,10,3,FALSE
deepword,0.6.1,0.6.2,8,3,13,7,20,5,FALSE
deepword,0.5.0,0.6.0,6,9,206,113,319,27,TRUE
deepword,1.3.2,1.3.3,33,2,8,2,10,3,TRUE
deepword,0.7.1,0.8.0,13,6,44,9,53,10,TRUE
deepword,1.2.1,1.2.2,27,5,17,8,25,10,TRUE
deepword,1.4.11,1.4.12,48,4,13,16,29,7,TRUE
deepword,0.6.2,0.6.3,9,4,59,47,106,10,TRUE
deepword,1.2.2,1.2.3,28,6,18,7,25,8,TRUE
deepword,1.1.6,1.2.0,25,8,85,37,122,16,TRUE
deepword,1.4.12,1.4.13,49,2,8,2,10,3,TRUE
deepword,1.2.3,1.2.4,29,3,17,9,26,4,TRUE
deepword,1.3.1,1.3.2,32,2,12,6,18,7,TRUE
deepword,1.4.0,1.4.1,37,2,9,3,12,4,TRUE
deepword,1.1.1,1.1.2,20,5,31,13,44,7,TRUE
deepword,0.1.0,0.2.0,1,17,553,254,807,46,TRUE
deepword,1.3.3,1.3.4,34,5,14,5,19,6,TRUE
ssc-refer,0.1.8,0.1.9,7,3,24,9,33,5,FALSE
ssc-refer,0.1.9,0.1.10,8,3,8,4,12,5,FALSE
ssc-refer,0.1.1,0.1.2,1,2,2,2,4,2,FALSE
ssc-refer,0.1.2,0.1.3,2,15,1057,833,1890,64,FALSE
ssc-refer,0.1.3,0.1.4,3,3,2,96,98,4,FALSE
ssc-refer,0.1.4,0.1.6,4,9,57,46,103,14,FALSE
ssc-refer,0.1.6,0.1.7,5,3,69,34,103,7,FALSE
ssc-refer,0.1.7,0.1.8,6,3,31,7,38,5,FALSE
ssc-refer,0.1.28,0.1.29,25,2,2,3,5,2,FALSE
ssc-refer,0.1.22,0.1.25,21,5,25,20,45,10,FALSE
ssc-refer,0.1.21,0.1.22,20,2,2,7,9,3,FALSE
ssc-refer,0.1.20,0.1.21,19,2,2,2,4,2,FALSE
ssc-refer,0.1.27,0.1.28,24,4,7,7,14,4,FALSE
ssc-refer,0.1.26,0.1.27,23,2,23,27,50,2,FALSE
ssc-refer,0.1.25,0.1.26,22,3,20,7,27,4,FALSE
ssc-refer,0.1.12,0.1.13,11,4,247,43,290,16,FALSE
ssc-refer,0.1.13,0.1.14,12,6,4368,41,4409,24,FALSE
ssc-refer,0.1.10,0.1.11,9,8,780,266,1046,30,FALSE
ssc-refer,0.1.11,0.1.12,10,2,2,3,5,2,FALSE
ssc-refer,0.1.16,0.1.17,15,4,5,636,641,8,FALSE
ssc-refer,0.1.17,0.1.18,16,3,1,103,104,7,FALSE
ssc-refer,0.1.14,0.1.15,13,3,3,4,7,3,FALSE
ssc-refer,0.1.15,0.1.16,14,4,29,198,227,10,FALSE
ssc-refer,0.1.18,0.1.19,17,1,1,1,2,1,FALSE
ssc-refer,0.1.19,0.1.20,18,7,201,52,253,14,FALSE
ssc-refer,0.1.26,0.1.27,23,2,23,27,50,2,TRUE
ssc-refer,0.1.8,0.1.9,7,3,24,9,33,5,TRUE
ssc-refer,0.1.17,0.1.18,16,3,1,103,104,7,TRUE
ssc-refer,0.1.2,0.1.3,2,15,1057,833,1890,64,TRUE
ssc-refer,0.1.6,0.1.7,5,3,69,34,103,7,TRUE
ssc-refer,0.1.19,0.1.20,18,7,201,52,253,14,TRUE
ssc-refer,0.1.10,0.1.11,9,8,780,266,1046,30,TRUE
extendable-immutable,1.0.4,1.0.5,5,2,2,2,4,2,FALSE
extendable-immutable,1.0.5,1.0.6,6,2,20,2,22,2,FALSE
extendable-immutable,1.0.6,1.0.7,7,2,1,2,3,2,FALSE
extendable-immutable,1.0.7,1.0.8,8,2,4,3,7,2,FALSE
extendable-immutable,1.0.0,1.0.1,1,4,20,5,25,4,FALSE
extendable-immutable,1.0.1,1.0.2,2,2,2,1,3,2,FALSE
extendable-immutable,1.0.2,1.0.3,3,3,76,444,520,16,FALSE
extendable-immutable,1.0.3,1.0.4,4,2,2,2,4,2,FALSE
extendable-immutable,1.0.8,1.0.9,9,2,1,2,3,2,FALSE
extendable-immutable,1.0.9,1.0.10,10,2,2,1,3,2,FALSE
extendable-immutable,1.0.12,1.0.13,13,4,120,3,123,8,FALSE
extendable-immutable,1.0.13,1.1.0,14,3,49,9,58,4,FALSE
extendable-immutable,1.0.10,1.0.11,11,3,63,14,77,5,FALSE
extendable-immutable,1.0.11,1.0.12,12,2,22,7,29,3,FALSE
extendable-immutable,1.1.1,1.2.0,16,2,15,28,43,3,FALSE
extendable-immutable,1.3.2,1.3.3,21,7,3148,60,3208,10,FALSE
extendable-immutable,1.3.1,1.3.2,20,2,11,7,18,2,FALSE
extendable-immutable,1.3.0,1.3.1,19,10,17,11,28,11,FALSE
extendable-immutable,1.2.0,1.2.1,17,3,16,4,20,3,FALSE
extendable-immutable,1.2.1,1.3.0,18,6,31,29,60,8,FALSE
extendable-immutable,1.1.0,1.1.1,15,3,19,14,33,6,FALSE
extendable-immutable,1.3.0,1.3.1,19,10,17,11,28,11,TRUE
extendable-immutable,1.1.0,1.1.1,15,3,19,14,33,6,TRUE
extendable-immutable,1.2.1,1.3.0,18,6,31,29,60,8,TRUE
augur.js,1.0.4,1.0.5,385,1,2,2,4,1,FALSE
augur.js,1.0.5,1.0.6,386,3,5048,3934,8982,14,FALSE
augur.js,1.0.6,1.0.7,387,1,6,6,12,4,FALSE
augur.js,0.13.29,0.13.30,287,1,370,63,433,7,FALSE
augur.js,0.13.28,0.13.29,286,1,160,136,296,5,FALSE
augur.js,0.13.21,0.13.22,280,2,2686,1291,3977,8,FALSE
augur.js,0.13.20,0.13.21,279,1,55,6,61,5,FALSE
augur.js,3.13.15,3.13.16,856,3,2390,2893,5283,69,FALSE
augur.js,0.13.22,0.13.23,281,7,3242,3138,6380,44,FALSE
augur.js,0.13.25,0.13.26,283,1,629,599,1228,8,FALSE
augur.js,3.13.12,3.13.13,853,5,83290,22077,105367,17,FALSE
augur.js,3.13.11,3.13.12,852,1,13,13,26,4,FALSE
augur.js,0.13.26,0.13.27,284,1,184,179,363,5,FALSE
augur.js,1.0.2,1.0.3,383,1,14,106,120,5,FALSE
augur.js,3.13.10,3.13.11,851,1,247,32,279,6,FALSE
augur.js,1.0.3,1.0.4,384,5,1703,1555,3258,18,FALSE
augur.js,3.0.10,3.0.11,698,1,75,19,94,5,FALSE
augur.js,0.17.3,0.17.4,349,4,53,35,88,9,FALSE
augur.js,0.17.0,0.17.1,346,1,126,38,164,5,FALSE
augur.js,0.17.1,0.17.2,347,1,9,5,14,4,FALSE
augur.js,0.17.6,0.17.7,352,2,330,227,557,6,FALSE
augur.js,3.0.15,3.0.16,703,1,1081,521,1602,9,FALSE
augur.js,0.17.4,0.17.5,350,1,70172,64175,134347,4,FALSE
augur.js,3.0.17,3.0.18,705,1,769,685,1454,10,FALSE
augur.js,3.0.18,3.1.0,706,1,653,655,1308,9,FALSE
augur.js,0.17.8,0.18.0,354,1,3786,4041,7827,10,FALSE
augur.js,1.9.7,1.9.8,499,1,538,497,1035,14,FALSE
augur.js,2.8.9,2.8.10,647,1,131,95,226,5,FALSE
augur.js,2.8.8,2.8.9,646,1,33,3,36,3,FALSE
augur.js,2.8.7,2.8.8,645,1,66,24,90,5,FALSE
augur.js,2.8.6,2.8.7,644,1,24,16,40,5,FALSE
augur.js,2.8.5,2.8.6,643,1,43,38,81,4,FALSE
augur.js,2.8.4,2.8.5,642,1,42,24,66,5,FALSE
augur.js,2.8.3,2.8.4,641,1,890,22,912,6,FALSE
augur.js,2.8.2,2.8.3,640,2,20,13,33,6,FALSE
augur.js,2.8.1,2.8.2,639,1,14,14,28,5,FALSE
augur.js,2.8.0,2.8.1,638,1,7,7,14,5,FALSE
augur.js,1.9.11,1.9.12,503,7,227,177,404,15,FALSE
augur.js,1.9.10,1.9.11,502,1,99,35,134,5,FALSE
augur.js,1.9.13,1.9.14,505,1,29,21,50,5,FALSE
augur.js,1.9.12,1.9.13,504,1,60111,58932,119043,27,FALSE
augur.js,3.13.16,3.14.0,857,6,10566,2848,13414,35,FALSE
augur.js,1.9.15,1.9.16,507,5,389,297,686,12,FALSE
augur.js,0.13.23,0.13.25,282,2,55131,60172,115303,22,FALSE
augur.js,1.9.14,1.9.15,506,4,10,10,20,7,FALSE
augur.js,3.13.14,3.13.15,855,4,183,351,534,10,FALSE
augur.js,1.9.17,1.9.18,509,2,52432,53408,105840,12,FALSE
augur.js,3.11.5,3.11.6,832,7,1223,145,1368,20,FALSE
augur.js,3.11.4,3.11.5,831,5,128338,124687,253025,33,FALSE
augur.js,3.11.6,3.12.0,833,4,653,680,1333,20,FALSE
augur.js,3.11.1,3.11.2,828,2,73,200,273,9,FALSE
augur.js,3.11.0,3.11.1,827,7,901,243,1144,22,FALSE
augur.js,3.11.3,3.11.4,830,7,1874,1674,3548,16,FALSE
augur.js,3.11.2,3.11.3,829,17,1538,941,2479,32,FALSE
augur.js,1.9.19,1.9.20,511,2,24597,16525,41122,10,FALSE
augur.js,0.13.27,0.13.28,285,1,301,224,525,7,FALSE
augur.js,3.13.9,3.13.10,850,17,28159,28948,57107,47,FALSE
augur.js,3.13.8,3.13.9,849,1,2568,2457,5025,7,FALSE
augur.js,3.13.7,3.13.8,848,1,5,5,10,4,FALSE
augur.js,3.13.6,3.13.7,847,8,16024,19366,35390,23,FALSE
augur.js,3.13.5,3.13.6,846,2,127,28,155,7,FALSE
augur.js,3.13.4,3.13.5,845,6,982,190,1172,15,FALSE
augur.js,3.13.3,3.13.4,844,1,278,446,724,9,FALSE
augur.js,3.13.2,3.13.3,843,2,107,86,193,6,FALSE
augur.js,3.13.1,3.13.2,842,1,124,175,299,10,FALSE
augur.js,3.13.0,3.13.1,841,7,128744,123453,252197,37,FALSE
augur.js,0.15.12,0.15.13,332,1,50,32,82,5,FALSE
augur.js,0.15.13,0.15.14,333,1,14,28,42,3,FALSE
augur.js,2.0.7,2.0.8,548,1,9,7,16,5,FALSE
augur.js,2.0.6,2.0.7,547,1,24,24,48,5,FALSE
augur.js,2.0.5,2.0.6,546,1,35,15,50,5,FALSE
augur.js,2.0.3,2.0.5,545,2,248,117,365,13,FALSE
augur.js,1.9.29,1.9.30,521,2,21221,3486,24707,9,FALSE
augur.js,2.0.1,2.0.2,543,1,17,19,36,8,FALSE
augur.js,2.0.0,2.0.1,542,1,9,9,18,5,FALSE
augur.js,1.9.24,1.9.25,516,1,114,119,233,5,FALSE
augur.js,1.9.25,1.9.26,517,2,218,60,278,7,FALSE
augur.js,1.9.26,1.9.27,518,5,10418,15490,25908,13,FALSE
augur.js,1.9.27,1.9.28,519,3,410,302,712,14,FALSE
augur.js,1.9.20,1.9.21,512,2,48901,53145,102046,6,FALSE
augur.js,1.9.21,1.9.22,513,3,944,423,1367,15,FALSE
augur.js,2.0.9,2.0.10,550,1,17,17,34,5,FALSE
augur.js,2.0.8,2.0.9,549,1,10,10,20,4,FALSE
augur.js,2.2.5,2.2.6,584,1,6,6,12,5,FALSE
augur.js,2.2.4,2.2.5,583,1,9,23,32,5,FALSE
augur.js,2.2.7,2.2.8,586,3,6276,9591,15867,17,FALSE
augur.js,2.2.6,2.2.7,585,1,5408,8687,14095,5,FALSE
augur.js,2.2.1,2.2.2,580,1,5338,8557,13895,6,FALSE
augur.js,2.2.0,2.2.1,579,1,43,43,86,4,FALSE
augur.js,2.2.3,2.2.4,582,4,9272,5951,15223,10,FALSE
augur.js,2.2.2,2.2.3,581,2,4544,5011,9555,9,FALSE
augur.js,1.8.12,1.9.0,491,2,2364,2191,4555,15,FALSE
augur.js,2.2.8,2.2.9,587,1,39,43,82,5,FALSE
augur.js,1.8.10,1.8.11,489,4,72021,81176,153197,77,FALSE
augur.js,1.8.11,1.8.12,490,1,98,68,166,5,FALSE
augur.js,3.15.9,4.0.0,876,84,315587,310415,626002,1109,FALSE
augur.js,0.17.2,0.17.3,348,2,98,76,174,7,FALSE
augur.js,3.0.11,3.0.12,699,1,7,5,12,5,FALSE
augur.js,3.15.1,3.15.2,868,3,78,114,192,7,FALSE
augur.js,3.15.0,3.15.1,867,2,80,88,168,7,FALSE
augur.js,3.15.3,3.15.4,870,8,7095,1179,8274,15,FALSE
augur.js,3.15.2,3.15.3,869,1,42,42,84,4,FALSE
augur.js,3.15.5,3.15.6,872,1,33,28,61,3,FALSE
augur.js,3.0.12,3.0.13,700,1,139,36,175,5,FALSE
augur.js,3.15.7,3.15.8,874,25,72569,75097,147666,360,FALSE
augur.js,3.15.6,3.15.7,873,1,38,26,64,4,FALSE
augur.js,3.0.13,3.0.14,701,1,78,20,98,6,FALSE
augur.js,3.0.14,3.0.15,702,2,545,352,897,7,FALSE
augur.js,0.17.7,0.17.8,353,1,57998,80496,138494,5,FALSE
augur.js,3.5.11,3.5.12,765,1,40,30,70,5,FALSE
augur.js,3.5.10,3.5.11,764,1,5,5,10,3,FALSE
augur.js,2.4.9,2.4.10,605,1,7,7,14,5,FALSE
augur.js,2.4.8,2.4.9,604,1,40,24,64,5,FALSE
augur.js,2.4.3,2.4.4,599,2,5419,8653,14072,8,FALSE
augur.js,2.4.2,2.4.3,598,1,9192,5890,15082,7,FALSE
augur.js,2.4.1,2.4.2,597,1,6,6,12,4,FALSE
augur.js,2.4.0,2.4.1,596,1,179,45,224,6,FALSE
augur.js,2.4.7,2.4.8,603,6,11377,7472,18849,39,FALSE
augur.js,2.4.6,2.4.7,602,1,9524,6250,15774,5,FALSE
augur.js,2.4.5,2.4.6,601,1,9,9,18,4,FALSE
augur.js,2.4.4,2.4.5,600,1,22,24,46,5,FALSE
augur.js,2.6.9,2.7.0,627,1,12,12,24,6,FALSE
augur.js,2.6.8,2.6.9,626,1,9523,6243,15766,5,FALSE
augur.js,1.6.9,1.7.0,469,1,41,31,72,4,FALSE
augur.js,2.6.1,2.6.2,619,1,60,37,97,5,FALSE
augur.js,2.6.0,2.6.1,618,3,117,177,294,8,FALSE
augur.js,2.6.3,2.6.4,621,1,43,21,64,6,FALSE
augur.js,2.6.2,2.6.3,620,1,17,21,38,5,FALSE
augur.js,2.6.5,2.6.6,623,2,77,14,91,8,FALSE
augur.js,2.6.4,2.6.5,622,1,32,22,54,5,FALSE
augur.js,2.6.7,2.6.8,625,1,84,64,148,6,FALSE
augur.js,2.6.6,2.6.7,624,1,22,22,44,5,FALSE
augur.js,3.6.3,3.6.4,771,2,140,99,239,7,FALSE
augur.js,3.0.16,3.0.17,704,1,663,411,1074,8,FALSE
augur.js,2.4.12,2.5.0,608,1,6164,9379,15543,6,FALSE
augur.js,2.4.11,2.4.12,607,1,7,7,14,5,FALSE
augur.js,2.4.10,2.4.11,606,1,7,7,14,5,FALSE
augur.js,1.3.13,1.3.14,425,2,51396,58039,109435,8,FALSE
augur.js,1.3.12,1.3.13,424,8,215319,223107,438426,25,FALSE
augur.js,1.3.11,1.3.12,423,1,598,1002,1600,8,FALSE
augur.js,1.3.10,1.3.11,422,1,4,4,8,4,FALSE
augur.js,1.3.17,1.3.18,429,2,67,173,240,7,FALSE
augur.js,1.3.16,1.3.17,428,1,372,511,883,6,FALSE
augur.js,1.3.15,1.3.16,427,1,532,524,1056,5,FALSE
augur.js,2.0.18,2.1.0,559,4,9248,5922,15170,12,FALSE
augur.js,2.0.17,2.0.18,558,1,5562,8689,14251,6,FALSE
augur.js,2.0.16,2.0.17,557,1,21,21,42,6,FALSE
augur.js,2.0.15,2.0.16,556,1,6,6,12,4,FALSE
augur.js,1.3.18,1.3.19,430,3,70,51,121,7,FALSE
augur.js,2.0.13,2.0.14,554,2,461,266,727,11,FALSE
augur.js,2.0.12,2.0.13,553,1,45,25,70,5,FALSE
augur.js,2.0.11,2.0.12,552,2,177,159,336,9,FALSE
augur.js,2.0.10,2.0.11,551,1,10,10,20,5,FALSE
augur.js,3.1.3,3.1.4,710,2,233,281,514,9,FALSE
augur.js,3.1.2,3.1.3,709,1,7,7,14,4,FALSE
augur.js,3.1.1,3.1.2,708,1,360,248,608,11,FALSE
augur.js,3.1.0,3.1.1,707,2,30,25,55,6,FALSE
augur.js,3.1.7,3.1.8,714,2,67,59,126,7,FALSE
augur.js,3.1.6,3.1.7,713,1,113,43,156,5,FALSE
augur.js,3.1.5,3.1.6,712,1,416,375,791,11,FALSE
augur.js,3.1.4,3.1.5,711,1,10,10,20,4,FALSE
augur.js,3.1.9,3.1.10,716,4,5253,16587,21840,76,FALSE
augur.js,3.1.8,3.1.9,715,8,19141,7774,26915,84,FALSE
augur.js,0.16.10,0.17.0,345,1,83,1096,1179,5,FALSE
augur.js,1.5.11,1.5.12,458,1,465,673,1138,9,FALSE
augur.js,1.5.10,1.5.11,457,1,46,40,86,6,FALSE
augur.js,1.5.12,1.6.0,459,7,105356,104098,209454,29,FALSE
augur.js,2.8.10,2.9.0,648,1,435,1214,1649,9,FALSE
augur.js,3.8.10,3.8.11,797,18,2732,1989,4721,35,FALSE
augur.js,3.8.11,3.9.0,798,8,3284,1926,5210,23,FALSE
augur.js,0.13.36,0.13.37,294,1,109,123,232,8,FALSE
augur.js,0.13.37,0.13.38,295,1,261,577,838,7,FALSE
augur.js,0.13.34,0.13.35,292,8,440,333,773,24,FALSE
augur.js,0.13.35,0.13.36,293,2,672,1322,1994,13,FALSE
augur.js,0.13.32,0.13.33,290,1,115,74,189,5,FALSE
augur.js,0.13.33,0.13.34,291,4,13455,7806,21261,26,FALSE
augur.js,0.13.30,0.13.31,288,2,82,77,159,6,FALSE
augur.js,0.13.31,0.13.32,289,1,85,39,124,5,FALSE
augur.js,0.13.38,0.14.0,296,3,232,116,348,11,FALSE
augur.js,3.5.9,3.5.10,763,6,1532,430,1962,20,FALSE
augur.js,3.5.8,3.5.9,762,1,50,88,138,5,FALSE
augur.js,3.5.7,3.5.8,761,1,43,17,60,4,FALSE
augur.js,3.5.6,3.5.7,760,1,646,27,673,4,FALSE
augur.js,3.5.5,3.5.6,759,1,53,81,134,5,FALSE
augur.js,3.5.4,3.5.5,758,1,10,6,16,5,FALSE
augur.js,3.5.3,3.5.4,757,1,15,11,26,6,FALSE
augur.js,3.5.2,3.5.3,756,1,280,217,497,6,FALSE
augur.js,3.5.1,3.5.2,755,1,18,18,36,6,FALSE
augur.js,3.5.0,3.5.1,754,1,12,12,24,5,FALSE
augur.js,3.7.8,3.8.0,786,8,836,530,1366,17,FALSE
augur.js,3.7.5,3.7.6,783,1,21,21,42,5,FALSE
augur.js,3.7.4,3.7.5,782,1,79,75,154,4,FALSE
augur.js,3.7.7,3.7.8,785,1,41,39,80,5,FALSE
augur.js,3.7.6,3.7.7,784,2,902,16,918,5,FALSE
augur.js,3.7.1,3.7.2,779,1,34,28,62,14,FALSE
augur.js,3.7.0,3.7.1,778,9,60392,59813,120205,194,FALSE
augur.js,3.7.3,3.7.4,781,1,163,251,414,6,FALSE
augur.js,3.7.2,3.7.3,780,1,6,6,12,5,FALSE
augur.js,1.3.20,1.3.21,432,1,84,80,164,7,FALSE
augur.js,1.3.21,1.4.0,433,1,6100,5082,11182,36,FALSE
augur.js,1.6.4,1.6.5,464,16,29178,17169,46347,67,FALSE
augur.js,0.13.14,0.13.15,274,2,18,23,41,6,FALSE
augur.js,0.13.15,0.13.17,275,5,1442,1075,2517,21,FALSE
augur.js,2.11.6,2.11.7,682,1,87,17,104,5,FALSE
augur.js,0.13.17,0.13.18,276,1,54,46,100,4,FALSE
augur.js,2.11.7,2.11.8,683,1,274,113,387,7,FALSE
augur.js,0.13.10,0.13.11,271,1,45,43,88,7,FALSE
augur.js,0.13.11,0.13.12,272,1,76,90,166,4,FALSE
augur.js,0.13.12,0.13.14,273,1,40,1437,1477,5,FALSE
augur.js,0.17.5,0.17.6,351,2,1076,185,1261,7,FALSE
augur.js,0.14.5,0.14.6,302,1,301,296,597,9,FALSE
augur.js,0.14.4,0.14.5,301,4,275,1760,2035,21,FALSE
augur.js,0.14.7,0.14.8,304,3,229,37,266,7,FALSE
augur.js,1.9.38,1.9.39,530,2,20,48,68,7,FALSE
augur.js,0.14.1,0.14.2,298,1,115,52,167,5,FALSE
augur.js,0.14.0,0.14.1,297,2,102,150,252,6,FALSE
augur.js,0.14.3,0.14.4,300,1,261,88,349,7,FALSE
augur.js,0.14.2,0.14.3,299,1,34,46,80,5,FALSE
augur.js,1.9.33,1.9.34,525,1,34,20,54,5,FALSE
augur.js,1.9.32,1.9.33,524,1,33,34,67,8,FALSE
augur.js,1.9.31,1.9.32,523,1,4660,13904,18564,7,FALSE
augur.js,1.9.30,1.9.31,522,1,10,5,15,5,FALSE
augur.js,1.9.37,1.9.38,529,1,219,64,283,6,FALSE
augur.js,1.9.36,1.9.37,528,1,476,6618,7094,7,FALSE
augur.js,1.9.35,1.9.36,527,3,160,202,362,10,FALSE
augur.js,1.9.34,1.9.35,526,1,1,1,2,1,FALSE
augur.js,3.9.9,3.9.10,808,1,6,5,11,4,FALSE
augur.js,3.9.8,3.9.9,807,1,74,54,128,4,FALSE
augur.js,3.9.3,3.9.4,802,3,90,84,174,8,FALSE
augur.js,3.9.2,3.9.3,801,1,14,9,23,5,FALSE
augur.js,3.9.1,3.9.2,800,2,1603,1599,3202,6,FALSE
augur.js,3.9.0,3.9.1,799,4,6255,3964,10219,22,FALSE
augur.js,3.9.7,3.9.8,806,1,36,40,76,7,FALSE
augur.js,3.9.6,3.9.7,805,4,92,90,182,9,FALSE
augur.js,3.9.5,3.9.6,804,1,42,42,84,4,FALSE
augur.js,2.7.9,2.8.0,637,7,12002,5583,17585,19,FALSE
augur.js,3.3.1,3.3.2,735,2,234,125,359,8,FALSE
augur.js,3.3.0,3.3.1,734,7,1137,690,1827,25,FALSE
augur.js,3.3.3,3.3.4,737,2,174,266,440,16,FALSE
augur.js,3.3.2,3.3.3,736,2,150,95,245,11,FALSE
augur.js,3.3.5,3.3.6,739,1,13,11,24,5,FALSE
augur.js,3.3.4,3.3.5,738,3,45,185,230,14,FALSE
augur.js,3.3.7,3.3.8,741,2,336,51,387,10,FALSE
augur.js,3.3.6,3.3.7,740,1,44,23,67,5,FALSE
augur.js,3.3.9,3.4.0,743,6,1776,569,2345,13,FALSE
augur.js,3.3.8,3.3.9,742,4,5587,8675,14262,10,FALSE
augur.js,2.11.9,2.11.10,685,2,5,5,10,5,FALSE
augur.js,1.9.39,1.9.40,531,1,601,709,1310,8,FALSE
augur.js,0.14.6,0.14.7,303,3,369,36,405,11,FALSE
augur.js,1.9.48,1.9.49,540,1,66537,62628,129165,10,FALSE
augur.js,1.9.49,2.0.0,541,1,6,6,12,4,FALSE
augur.js,1.9.46,1.9.47,538,1,23,46,69,5,FALSE
augur.js,1.9.47,1.9.48,539,1,49217,53098,102315,4,FALSE
augur.js,1.9.44,1.9.45,536,2,85,41,126,9,FALSE
augur.js,1.9.45,1.9.46,537,2,211,40,251,9,FALSE
augur.js,1.9.42,1.9.43,534,1,57,53,110,5,FALSE
augur.js,1.9.43,1.9.44,535,1,8,6,14,5,FALSE
augur.js,1.9.40,1.9.41,532,1,21,21,42,5,FALSE
augur.js,1.9.41,1.9.42,533,1,226,221,447,6,FALSE
augur.js,3.15.8,3.15.9,875,16,23658,20716,44374,85,FALSE
augur.js,1.8.8,1.8.9,487,1,369,403,772,13,FALSE
augur.js,1.8.9,1.8.10,488,1,34,24,58,6,FALSE
augur.js,1.8.4,1.8.5,483,4,60995,69220,130215,16,FALSE
augur.js,1.8.5,1.8.6,484,4,170623,141629,312252,21,FALSE
augur.js,1.8.6,1.8.7,485,1,59712,58458,118170,4,FALSE
augur.js,1.8.7,1.8.8,486,1,10,8,18,5,FALSE
augur.js,1.8.0,1.8.1,479,2,1363,1021,2384,18,FALSE
augur.js,1.8.1,1.8.2,480,4,78458,74552,153010,22,FALSE
augur.js,1.8.2,1.8.3,481,7,104571,118269,222840,66,FALSE
augur.js,1.8.3,1.8.4,482,8,148083,157761,305844,66,FALSE
augur.js,1.4.0,1.4.1,434,1,44,49,93,8,FALSE
augur.js,1.4.1,1.4.2,435,2,12,7,19,6,FALSE
augur.js,1.4.2,1.4.3,436,5,44714,53004,97718,13,FALSE
augur.js,1.4.3,1.4.4,437,3,109826,109732,219558,14,FALSE
augur.js,1.4.4,1.4.5,438,1,239,147,386,10,FALSE
augur.js,1.4.5,1.4.6,439,1,429,519,948,14,FALSE
augur.js,1.4.6,1.4.7,440,3,358,361,719,10,FALSE
augur.js,1.4.7,1.4.8,441,1,49,37,86,3,FALSE
augur.js,1.4.8,1.4.9,442,1,11,12,23,4,FALSE
augur.js,1.4.9,1.4.10,443,1,83,53,136,4,FALSE
augur.js,1.3.14,1.3.15,426,2,65332,58630,123962,6,FALSE
augur.js,0.14.8,0.14.9,305,2,265,247,512,8,FALSE
augur.js,1.2.6,1.2.7,408,1,16,16,32,3,FALSE
augur.js,1.2.7,1.2.8,409,1,7,6,13,4,FALSE
augur.js,1.2.4,1.2.5,406,3,1415,8162,9577,20,FALSE
augur.js,1.2.5,1.2.6,407,1,94,54,148,4,FALSE
augur.js,1.2.2,1.2.3,404,1,128,379,507,5,FALSE
augur.js,1.2.3,1.2.4,405,2,250,207,457,8,FALSE
augur.js,1.2.0,1.2.1,402,1,71,67,138,5,FALSE
augur.js,1.2.1,1.2.2,403,1,1036,7870,8906,9,FALSE
augur.js,1.3.19,1.3.20,431,1,1027,109,1136,10,FALSE
augur.js,1.2.8,1.2.9,410,1,476,275,751,6,FALSE
augur.js,1.2.9,1.3.0,411,2,238,236,474,5,FALSE
augur.js,2.10.9,2.10.10,674,5,214,31,245,12,FALSE
augur.js,2.0.14,2.0.15,555,2,60,46,106,7,FALSE
augur.js,2.11.10,2.11.11,686,3,55,30,85,8,FALSE
augur.js,2.11.11,3.0.0,687,1,354,685,1039,18,FALSE
augur.js,2.10.2,2.10.4,668,3,9822,6530,16352,11,FALSE
augur.js,2.10.1,2.10.2,667,1,13,13,26,6,FALSE
augur.js,2.10.0,2.10.1,666,1,20,18,38,5,FALSE
augur.js,2.10.7,2.10.8,672,1,100,65,165,7,FALSE
augur.js,2.10.6,2.10.7,671,1,56,30,86,5,FALSE
augur.js,2.10.5,2.10.6,670,1,65,33,98,5,FALSE
augur.js,2.10.4,2.10.5,669,1,10,19,29,5,FALSE
augur.js,1.3.0,1.3.1,412,8,169176,177285,346461,26,FALSE
augur.js,3.9.4,3.9.5,803,1,5,5,10,4,FALSE
augur.js,1.0.10,1.0.11,391,1,14,15,29,3,FALSE
augur.js,2.9.14,2.9.15,663,1,111,93,204,6,FALSE
augur.js,2.9.15,2.9.16,664,1,5369,8541,13910,6,FALSE
augur.js,2.9.16,2.10.0,665,5,65389,63534,128923,27,FALSE
augur.js,1.0.7,1.0.8,388,1,7610,801,8411,6,FALSE
augur.js,1.0.0,1.0.1,381,2,604,616,1220,8,FALSE
augur.js,1.0.1,1.0.2,382,1,85,80,165,6,FALSE
augur.js,2.9.12,2.9.13,661,2,75,111,186,10,FALSE
augur.js,2.9.13,2.9.14,662,4,2746,2440,5186,24,FALSE
augur.js,0.18.11,0.19.0,365,2,4500,3064,7564,12,FALSE
augur.js,1.0.8,1.0.9,389,1,48,38,86,4,FALSE
augur.js,1.0.9,1.0.10,390,1,116,47,163,4,FALSE
augur.js,0.18.10,0.18.11,364,1,33,86,119,6,FALSE
augur.js,1.0.11,1.1.0,392,1,1765,1519,3284,13,FALSE
augur.js,3.10.8,3.11.0,826,13,3183,2375,5558,32,FALSE
augur.js,0.15.10,0.15.11,330,1,877,518,1395,4,FALSE
augur.js,0.15.11,0.15.12,331,1,520,230,750,8,FALSE
augur.js,0.15.14,0.16.0,334,2,349,62,411,7,FALSE
augur.js,3.10.0,3.10.1,818,2,1430,378,1808,10,FALSE
augur.js,3.10.1,3.10.2,819,1,2067,2062,4129,11,FALSE
augur.js,3.10.2,3.10.3,820,9,1432,1138,2570,16,FALSE
augur.js,3.10.3,3.10.4,821,1,6,6,12,4,FALSE
augur.js,3.10.4,3.10.5,822,1,12,12,24,5,FALSE
augur.js,3.10.5,3.10.6,823,4,56403,55714,112117,33,FALSE
augur.js,3.10.6,3.10.7,824,2,451,36,487,9,FALSE
augur.js,3.10.7,3.10.8,825,1,21,35,56,6,FALSE
augur.js,1.6.2,1.6.3,462,5,105813,105570,211383,25,FALSE
augur.js,1.6.3,1.6.4,463,4,157,137,294,11,FALSE
augur.js,1.6.0,1.6.1,460,1,243,852,1095,6,FALSE
augur.js,1.6.1,1.6.2,461,2,445,447,892,13,FALSE
augur.js,1.6.6,1.6.7,466,1,7,7,14,5,FALSE
augur.js,1.6.7,1.6.8,467,1,65,56,121,9,FALSE
augur.js,0.14.22,0.15.0,319,2,190,112,302,10,FALSE
augur.js,1.6.5,1.6.6,465,2,208,226,434,13,FALSE
augur.js,3.12.2,3.12.3,836,2,42,36,78,8,FALSE
augur.js,3.12.3,3.12.4,837,1,910,781,1691,10,FALSE
augur.js,1.6.8,1.6.9,468,2,59,40,99,7,FALSE
augur.js,3.12.1,3.12.2,835,1,55,51,106,5,FALSE
augur.js,3.12.6,3.13.0,840,27,5101,2176,7277,55,FALSE
augur.js,3.12.4,3.12.5,838,8,55081,55491,110572,25,FALSE
augur.js,3.12.5,3.12.6,839,1,7,7,14,5,FALSE
augur.js,0.18.9,0.18.10,363,2,79981,120920,200901,4,FALSE
augur.js,0.18.8,0.18.9,362,1,613,831,1444,6,FALSE
augur.js,0.18.1,0.18.2,356,1,23,29,52,4,FALSE
augur.js,0.18.0,0.18.1,355,1,50935,43449,94384,6,FALSE
augur.js,0.18.3,0.18.5,358,3,56514,64593,121107,7,FALSE
augur.js,0.18.2,0.18.3,357,1,4,1,5,1,FALSE
augur.js,0.18.5,0.18.6,359,2,25,22,47,5,FALSE
augur.js,0.18.7,0.18.8,361,1,857,651,1508,6,FALSE
augur.js,0.18.6,0.18.7,360,3,804,327,1131,8,FALSE
augur.js,2.1.18,2.2.0,578,1,9348,5918,15266,6,FALSE
augur.js,2.1.14,2.1.15,574,1,3,3,6,3,FALSE
augur.js,2.1.15,2.1.16,575,1,5,5,10,2,FALSE
augur.js,2.1.16,2.1.17,576,1,4,4,8,3,FALSE
augur.js,2.1.17,2.1.18,577,1,6,4,10,3,FALSE
augur.js,2.1.10,2.1.11,570,1,17,17,34,4,FALSE
augur.js,2.1.11,2.1.12,571,1,54,43,97,5,FALSE
augur.js,2.1.12,2.1.13,572,5,6698,9430,16128,41,FALSE
augur.js,2.1.13,2.1.14,573,1,3,3,6,3,FALSE
augur.js,1.4.12,1.5.0,446,13,118604,96327,214931,155,FALSE
augur.js,1.4.10,1.4.11,444,11,97308,99216,196524,130,FALSE
augur.js,1.4.11,1.4.12,445,1,3,3,6,2,FALSE
augur.js,0.14.9,0.14.10,306,1,16,11,27,3,FALSE
augur.js,1.9.16,1.9.17,508,5,677,282,959,15,FALSE
augur.js,3.14.4,3.14.5,862,1,72,46,118,5,FALSE
augur.js,3.14.5,3.14.6,863,1,42,42,84,4,FALSE
augur.js,3.14.6,3.14.7,864,6,529,1133,1662,17,FALSE
augur.js,3.14.7,3.14.8,865,2,10263,10780,21043,12,FALSE
augur.js,3.14.0,3.14.1,858,1,47,47,94,4,FALSE
augur.js,3.14.1,3.14.2,859,1,39,25,64,4,FALSE
augur.js,3.14.2,3.14.3,860,2,9,7,16,5,FALSE
augur.js,3.14.3,3.14.4,861,1,6246,6224,12470,5,FALSE
augur.js,3.14.8,3.15.0,866,2,1202,2135,3337,68,FALSE
augur.js,0.16.7,0.16.8,342,1,4,4,8,4,FALSE
augur.js,0.16.6,0.16.7,341,1,4,4,8,4,FALSE
augur.js,0.16.5,0.16.6,340,5,1503,63,1566,13,FALSE
augur.js,0.16.4,0.16.5,339,1,78,38,116,5,FALSE
augur.js,0.16.3,0.16.4,338,2,947,620,1567,8,FALSE
augur.js,0.16.2,0.16.3,337,4,875,2145,3020,11,FALSE
augur.js,0.16.1,0.16.2,336,1,53,50,103,6,FALSE
augur.js,0.16.0,0.16.1,335,1,591,106,697,5,FALSE
augur.js,0.16.9,0.16.10,344,1,14,14,28,4,FALSE
augur.js,0.16.8,0.16.9,343,1,19,39,58,5,FALSE
augur.js,1.9.18,1.9.19,510,1,60241,58887,119128,11,FALSE
augur.js,2.9.2,2.9.3,651,1,141,38,179,6,FALSE
augur.js,2.9.3,2.9.4,652,1,49,29,78,6,FALSE
augur.js,2.9.0,2.9.1,649,1,9,9,18,5,FALSE
augur.js,2.9.1,2.9.2,650,1,10,9,19,4,FALSE
augur.js,2.9.6,2.9.7,655,1,2,1,3,1,FALSE
augur.js,2.9.7,2.9.8,656,2,64,55,119,10,FALSE
augur.js,2.9.4,2.9.5,653,2,41,662,703,9,FALSE
augur.js,2.9.5,2.9.6,654,10,71730,66920,138650,44,FALSE
augur.js,2.9.8,2.9.9,657,1,264,166,430,8,FALSE
augur.js,2.9.9,2.9.10,658,1,10,10,20,6,FALSE
augur.js,2.1.8,2.1.9,568,1,9,9,18,4,FALSE
augur.js,2.1.9,2.1.10,569,1,8,8,16,4,FALSE
augur.js,2.1.2,2.1.3,562,1,24,20,44,6,FALSE
augur.js,2.1.3,2.1.4,563,1,120,83,203,10,FALSE
augur.js,2.1.0,2.1.1,560,4,177682,180684,358366,10,FALSE
augur.js,2.1.1,2.1.2,561,6,5322,8472,13794,15,FALSE
augur.js,2.1.6,2.1.7,566,1,9,9,18,4,FALSE
augur.js,2.1.7,2.1.8,567,1,8,8,16,4,FALSE
augur.js,2.1.4,2.1.5,564,1,9519,6251,15770,5,FALSE
augur.js,2.1.5,2.1.6,565,2,6016,9186,15202,8,FALSE
augur.js,2.3.0,2.3.1,590,1,18,12,30,5,FALSE
augur.js,2.3.1,2.3.2,591,1,766,666,1432,7,FALSE
augur.js,2.3.2,2.3.4,592,3,157,79,236,23,FALSE
augur.js,2.3.4,2.3.5,593,1,9543,6266,15809,16,FALSE
augur.js,2.3.5,2.3.6,594,1,5570,8697,14267,17,FALSE
augur.js,2.3.6,2.4.0,595,1,1933,1814,3747,19,FALSE
augur.js,0.13.18,0.13.19,277,1,151,43,194,5,FALSE
augur.js,0.13.19,0.13.20,278,1,359,6,365,5,FALSE
augur.js,2.5.8,2.6.0,617,2,14383,14327,28710,15,FALSE
augur.js,2.5.6,2.5.7,615,1,114,92,206,5,FALSE
augur.js,2.5.7,2.5.8,616,1,21,17,38,5,FALSE
augur.js,2.5.4,2.5.5,613,1,9517,6241,15758,5,FALSE
augur.js,2.5.5,2.5.6,614,1,9,9,18,4,FALSE
augur.js,2.5.2,2.5.3,611,2,15062,14967,30029,15,FALSE
augur.js,2.5.3,2.5.4,612,1,5400,8676,14076,4,FALSE
augur.js,2.5.0,2.5.1,609,1,35,31,66,5,FALSE
augur.js,2.5.1,2.5.2,610,1,31,29,60,6,FALSE
augur.js,3.1.13,3.1.14,720,1,398,403,801,7,FALSE
augur.js,3.1.12,3.1.13,719,3,1017,90,1107,9,FALSE
augur.js,3.1.11,3.1.12,718,2,10,10,20,6,FALSE
augur.js,3.1.10,3.1.11,717,1,490,891,1381,10,FALSE
augur.js,2.7.8,2.7.9,636,1,117,44,161,6,FALSE
augur.js,3.1.16,3.2.0,723,7,3032,1508,4540,34,FALSE
augur.js,3.1.15,3.1.16,722,1,5,5,10,4,FALSE
augur.js,3.1.14,3.1.15,721,1,66,84,150,6,FALSE
augur.js,2.7.4,2.7.5,632,1,295,11,306,5,FALSE
augur.js,2.7.5,2.7.6,633,1,982,269,1251,6,FALSE
augur.js,2.7.6,2.7.7,634,1,109,63,172,8,FALSE
augur.js,2.7.7,2.7.8,635,1,21,15,36,5,FALSE
augur.js,2.7.0,2.7.1,628,1,22,17,39,4,FALSE
augur.js,2.7.1,2.7.2,629,1,39,23,62,4,FALSE
augur.js,2.7.2,2.7.3,630,1,1,1,2,1,FALSE
augur.js,2.7.3,2.7.4,631,2,7675,9266,16941,22,FALSE
augur.js,1.9.28,1.9.29,520,1,28,110,138,6,FALSE
augur.js,2.0.2,2.0.3,544,2,55,51,106,6,FALSE
augur.js,0.19.14,1.0.0,380,6,52609,62124,114733,79,FALSE
augur.js,0.19.12,0.19.13,378,1,193,179,372,4,FALSE
augur.js,0.19.13,0.19.14,379,11,8205,29967,38172,68,FALSE
augur.js,0.19.10,0.19.11,376,1,69,66,135,5,FALSE
augur.js,0.19.11,0.19.12,377,1,2,2,4,1,FALSE
augur.js,1.9.22,1.9.23,514,1,26,26,52,5,FALSE
augur.js,1.9.23,1.9.24,515,2,10148,15359,25507,6,FALSE
augur.js,0.14.11,0.14.12,308,1,35,23,58,6,FALSE
augur.js,0.14.10,0.14.11,307,2,154,128,282,7,FALSE
augur.js,0.14.13,0.14.14,310,1,10,8,18,4,FALSE
augur.js,0.14.12,0.14.13,309,1,25,14,39,7,FALSE
augur.js,0.14.15,0.14.16,312,1,16,10,26,4,FALSE
augur.js,0.14.14,0.14.15,311,1,2,4,6,4,FALSE
augur.js,0.14.17,0.14.18,314,2,4,4,8,2,FALSE
augur.js,0.14.16,0.14.17,313,1,152,132,284,5,FALSE
augur.js,0.14.19,0.14.20,316,1,7,15,22,6,FALSE
augur.js,0.14.18,0.14.19,315,1,33,21,54,6,FALSE
augur.js,3.0.6,3.0.7,694,1,6,6,12,4,FALSE
augur.js,3.0.7,3.0.8,695,3,400,362,762,10,FALSE
augur.js,3.0.4,3.0.5,692,2,133,101,234,6,FALSE
augur.js,3.0.5,3.0.6,693,1,30,39,69,9,FALSE
augur.js,3.0.2,3.0.3,690,1,136,88,224,5,FALSE
augur.js,3.0.3,3.0.4,691,1,381,238,619,6,FALSE
augur.js,3.0.0,3.0.1,688,1,45,46,91,7,FALSE
augur.js,3.0.1,3.0.2,689,1,49,41,90,6,FALSE
augur.js,3.0.8,3.0.9,696,1,10,10,20,5,FALSE
augur.js,3.0.9,3.0.10,697,2,605,156,761,8,FALSE
augur.js,2.2.9,2.2.10,588,2,59,55,114,5,FALSE
augur.js,0.15.0,0.15.1,320,2,126,97,223,7,FALSE
augur.js,0.15.1,0.15.2,321,3,13100,8678,21778,12,FALSE
augur.js,0.15.2,0.15.3,322,1,39,42,81,6,FALSE
augur.js,0.15.3,0.15.4,323,1,217,93,310,9,FALSE
augur.js,0.15.4,0.15.5,324,1,128,99,227,5,FALSE
augur.js,0.15.5,0.15.6,325,1,18838,480,19318,7,FALSE
augur.js,0.15.6,0.15.7,326,2,208,63,271,7,FALSE
augur.js,0.15.7,0.15.8,327,2,61,49,110,6,FALSE
augur.js,0.15.8,0.15.9,328,1,74,36,110,6,FALSE
augur.js,0.15.9,0.15.10,329,1,36,65,101,5,FALSE
augur.js,3.4.2,3.4.3,746,7,791,753,1544,22,FALSE
augur.js,3.4.3,3.4.4,747,6,466,946,1412,12,FALSE
augur.js,3.4.0,3.4.1,744,4,7273,9043,16316,27,FALSE
augur.js,3.4.1,3.4.2,745,7,677,275,952,18,FALSE
augur.js,3.4.6,3.4.7,750,3,1087,1567,2654,20,FALSE
augur.js,3.4.7,3.4.8,751,5,283,143,426,13,FALSE
augur.js,3.4.4,3.4.5,748,2,122,96,218,5,FALSE
augur.js,3.4.5,3.4.6,749,1,7,7,14,5,FALSE
augur.js,3.4.8,3.4.9,752,3,313,87,400,14,FALSE
augur.js,3.4.9,3.5.0,753,2,333,191,524,11,FALSE
augur.js,3.6.0,3.6.1,768,4,130,78,208,12,FALSE
augur.js,3.6.1,3.6.2,769,1,7,9,16,5,FALSE
augur.js,3.6.2,3.6.3,770,1,59,117,176,9,FALSE
augur.js,2.10.10,2.11.0,675,2,896,204,1100,8,FALSE
augur.js,3.6.4,3.6.5,772,1,62,44,106,4,FALSE
augur.js,3.6.5,3.6.6,773,5,1251,395,1646,26,FALSE
augur.js,3.6.6,3.6.7,774,13,7490,748,8238,57,FALSE
augur.js,3.6.7,3.6.8,775,4,420,370,790,16,FALSE
augur.js,3.6.8,3.6.9,776,9,2382,1644,4026,25,FALSE
augur.js,3.6.9,3.7.0,777,1,79,57,136,6,FALSE
augur.js,3.15.4,3.15.5,871,1,51,46,97,4,FALSE
augur.js,3.5.13,3.6.0,767,3,273,131,404,10,FALSE
augur.js,1.9.9,1.9.10,501,4,4257,8108,12365,40,FALSE
augur.js,1.9.8,1.9.9,500,8,95903,97750,193653,21,FALSE
augur.js,2.11.4,2.11.5,680,1,7,7,14,5,FALSE
augur.js,2.11.5,2.11.6,681,1,7,7,14,5,FALSE
augur.js,2.11.2,2.11.3,678,2,446,119,565,9,FALSE
augur.js,2.11.3,2.11.4,679,1,42,26,68,5,FALSE
augur.js,2.11.0,2.11.1,676,1,203,91,294,7,FALSE
augur.js,2.11.1,2.11.2,677,1,436,90,526,7,FALSE
augur.js,1.9.1,1.9.2,493,1,110,944,1054,6,FALSE
augur.js,1.9.0,1.9.1,492,3,33,23,56,10,FALSE
augur.js,1.9.3,1.9.4,495,1,59364,62095,121459,10,FALSE
augur.js,1.9.2,1.9.3,494,4,45568,42467,88035,26,FALSE
augur.js,1.9.5,1.9.6,497,1,379,342,721,7,FALSE
augur.js,1.9.4,1.9.5,496,1,5,5,10,4,FALSE
augur.js,2.11.8,2.11.9,684,3,994,960,1954,8,FALSE
augur.js,1.9.6,1.9.7,498,1,227,218,445,6,FALSE
augur.js,1.5.9,1.5.10,456,2,47137,49876,97013,13,FALSE
augur.js,1.5.8,1.5.9,455,1,14,20,34,7,FALSE
augur.js,1.5.5,1.5.6,452,1,44,44,88,4,FALSE
augur.js,1.5.4,1.5.5,451,4,60096,59710,119806,45,FALSE
augur.js,1.5.7,1.5.8,454,1,30,30,60,5,FALSE
augur.js,1.5.6,1.5.7,453,3,721,496,1217,13,FALSE
augur.js,1.5.1,1.5.2,448,4,47060,53512,100572,8,FALSE
augur.js,1.5.0,1.5.1,447,1,26671,34928,61599,4,FALSE
augur.js,1.5.3,1.5.4,450,1,136,124,260,7,FALSE
augur.js,1.5.2,1.5.3,449,3,107085,113239,220324,36,FALSE
augur.js,1.3.3,1.3.4,415,2,232,189,421,11,FALSE
augur.js,1.3.2,1.3.3,414,2,64822,56978,121800,13,FALSE
augur.js,1.3.1,1.3.2,413,1,25,34,59,6,FALSE
augur.js,2.10.8,2.10.9,673,2,738,69,807,9,FALSE
augur.js,1.3.7,1.3.8,419,1,505,96,601,5,FALSE
augur.js,1.3.6,1.3.7,418,4,1295,460,1755,27,FALSE
augur.js,1.3.5,1.3.6,417,10,51617,57873,109490,23,FALSE
augur.js,1.3.4,1.3.5,416,1,100,141,241,5,FALSE
augur.js,1.3.9,1.3.10,421,1,195,121,316,4,FALSE
augur.js,1.3.8,1.3.9,420,1,9,9,18,4,FALSE
augur.js,2.9.10,2.9.11,659,1,1953,2021,3974,7,FALSE
augur.js,3.12.0,3.12.1,834,5,1599,842,2441,32,FALSE
augur.js,2.9.11,2.9.12,660,1,233,132,365,10,FALSE
augur.js,0.14.20,0.14.21,317,1,62,70,132,4,FALSE
augur.js,1.1.1,1.1.2,394,3,343,377,720,8,FALSE
augur.js,1.1.0,1.1.1,393,2,52263,64191,116454,12,FALSE
augur.js,1.1.3,1.1.4,396,1,895,7551,8446,8,FALSE
augur.js,1.1.2,1.1.3,395,2,577,516,1093,13,FALSE
augur.js,1.1.5,1.1.6,398,1,13,13,26,5,FALSE
augur.js,1.1.4,1.1.5,397,1,28,28,56,7,FALSE
augur.js,1.1.7,1.1.9,400,3,72720,59714,132434,31,FALSE
augur.js,1.1.6,1.1.7,399,1,8206,684,8890,7,FALSE
augur.js,1.1.9,1.2.0,401,4,1245,433,1678,15,FALSE
augur.js,0.14.21,0.14.22,318,1,10,10,20,6,FALSE
augur.js,2.2.10,2.3.0,589,1,21,13,34,5,FALSE
augur.js,3.5.12,3.5.13,766,10,1711,924,2635,19,FALSE
augur.js,1.7.8,1.8.0,478,1,254,184,438,8,FALSE
augur.js,1.7.7,1.7.8,477,3,771,663,1434,23,FALSE
augur.js,1.7.6,1.7.7,476,6,139895,139253,279148,34,FALSE
augur.js,1.7.5,1.7.6,475,1,135,25,160,5,FALSE
augur.js,1.7.4,1.7.5,474,4,558,571,1129,11,FALSE
augur.js,1.7.3,1.7.4,473,1,13,145,158,7,FALSE
augur.js,1.7.2,1.7.3,472,6,60991,60091,121082,31,FALSE
augur.js,1.7.1,1.7.2,471,13,230973,244457,475430,64,FALSE
augur.js,1.7.0,1.7.1,470,8,242984,240585,483569,65,FALSE
augur.js,0.19.4,0.19.5,370,1,492,834,1326,9,FALSE
augur.js,0.19.5,0.19.6,371,6,1075,933,2008,23,FALSE
augur.js,0.19.6,0.19.7,372,1,144,216,360,9,FALSE
augur.js,0.19.7,0.19.8,373,1,744,714,1458,9,FALSE
augur.js,0.19.0,0.19.1,366,2,8059,188,8247,11,FALSE
augur.js,0.19.1,0.19.2,367,1,517,87,604,4,FALSE
augur.js,0.19.2,0.19.3,368,2,4420,16403,20823,6,FALSE
augur.js,0.19.3,0.19.4,369,2,1504,741,2245,15,FALSE
augur.js,0.19.8,0.19.9,374,2,408,607,1015,9,FALSE
augur.js,0.19.9,0.19.10,375,1,301,481,782,23,FALSE
augur.js,3.13.13,3.13.14,854,10,117972,117933,235905,34,FALSE
augur.js,3.8.8,3.8.9,795,17,25333,92256,117589,45,FALSE
augur.js,3.8.9,3.8.10,796,1,5,5,10,4,FALSE
augur.js,3.8.6,3.8.7,793,4,75142,1826,76968,31,FALSE
augur.js,3.8.7,3.8.8,794,6,25606,90792,116398,31,FALSE
augur.js,3.8.4,3.8.5,791,1,75,36,111,5,FALSE
augur.js,3.8.5,3.8.6,792,1,69933,174,70107,6,FALSE
augur.js,3.8.2,3.8.3,789,1,372,19,391,6,FALSE
augur.js,3.8.3,3.8.4,790,1,173,19,192,6,FALSE
augur.js,3.8.0,3.8.1,787,18,4582,6125,10707,32,FALSE
augur.js,3.8.1,3.8.2,788,7,3600,5989,9589,29,FALSE
augur.js,3.9.19,3.10.0,817,7,1236,453,1689,16,FALSE
augur.js,3.9.18,3.9.19,816,7,375,211,586,12,FALSE
augur.js,3.9.13,3.9.14,812,2,502,368,870,7,FALSE
augur.js,3.9.12,3.9.13,811,5,1045,569,1614,34,FALSE
augur.js,3.9.11,3.9.12,810,13,693,171,864,43,FALSE
augur.js,3.9.10,3.9.11,809,4,638,171,809,8,FALSE
augur.js,3.9.16,3.9.18,815,2,427,378,805,7,FALSE
augur.js,3.9.15,3.9.16,814,3,2552,1067,3619,22,FALSE
augur.js,3.9.14,3.9.15,813,1,30,18,48,6,FALSE
augur.js,3.2.4,3.2.5,728,1,9,9,18,4,FALSE
augur.js,3.2.5,3.2.6,729,2,85,47,132,10,FALSE
augur.js,3.2.6,3.2.7,730,1,10,9,19,5,FALSE
augur.js,3.2.7,3.2.8,731,1,9,9,18,4,FALSE
augur.js,3.2.0,3.2.1,724,1,125,221,346,11,FALSE
augur.js,3.2.1,3.2.2,725,8,826,455,1281,36,FALSE
augur.js,3.2.2,3.2.3,726,3,847,243,1090,20,FALSE
augur.js,3.2.3,3.2.4,727,1,7,7,14,5,FALSE
augur.js,3.2.8,3.2.9,732,4,189,68,257,11,FALSE
augur.js,3.2.9,3.3.0,733,2,748,506,1254,8,FALSE
augur.js,0.10.3,0.10.4,214,3,658,397,1055,15,FALSE
augur.js,0.10.4,0.10.5,215,1,13992,1826,15818,18,FALSE
augur.js,0.8.24,0.8.25,168,3,283,348,631,16,FALSE
augur.js,0.8.25,0.8.26,169,14,25677,13454,39131,107,FALSE
augur.js,0.8.26,0.8.27,170,2,49,39,88,6,FALSE
augur.js,0.12.19,0.12.20,256,1,23,11,34,3,FALSE
augur.js,0.12.18,0.12.19,255,1,40,25,65,5,FALSE
augur.js,0.12.13,0.12.14,250,1,205,217,422,6,FALSE
augur.js,0.12.12,0.12.13,249,1,22,23,45,7,FALSE
augur.js,0.12.11,0.12.12,248,1,40,26,66,6,FALSE
augur.js,0.12.10,0.12.11,247,1,22,22,44,4,FALSE
augur.js,0.12.17,0.12.18,254,1,182,88,270,8,FALSE
augur.js,0.12.16,0.12.17,253,2,53,50,103,7,FALSE
augur.js,0.12.15,0.12.16,252,1,89,33,122,9,FALSE
augur.js,0.12.14,0.12.15,251,2,282,179,461,11,FALSE
augur.js,0.10.11,0.11.0,222,1,78155,78138,156293,4,FALSE
augur.js,0.10.10,0.10.11,221,3,65314,67116,132430,14,FALSE
augur.js,0.1.34,0.1.35,34,1,145,130,275,3,FALSE
augur.js,0.1.35,0.2.0,35,1,395,372,767,6,FALSE
augur.js,0.1.30,0.1.31,30,3,1573,980,2553,11,FALSE
augur.js,0.1.31,0.1.32,31,4,343,335,678,11,FALSE
augur.js,0.1.32,0.1.33,32,1,293,209,502,5,FALSE
augur.js,0.1.33,0.1.34,33,2,796,464,1260,5,FALSE
augur.js,0.4.10,0.5.0,89,2,349,325,674,11,FALSE
augur.js,0.12.22,0.12.23,259,1,87,39,126,5,FALSE
augur.js,0.8.17,0.8.18,161,4,19,17,36,11,FALSE
augur.js,0.7.24,0.8.0,144,4,5305,4686,9991,88,FALSE
augur.js,0.7.21,0.7.22,141,4,4693,4626,9319,60,FALSE
augur.js,0.7.20,0.7.21,140,1,198,82,280,3,FALSE
augur.js,0.7.23,0.7.24,143,1,24,261,285,19,FALSE
augur.js,0.6.19,0.6.20,112,2,74,117,191,11,FALSE
augur.js,0.6.18,0.6.19,111,1,22,26,48,3,FALSE
augur.js,0.6.13,0.6.14,106,2,122,93,215,8,FALSE
augur.js,0.6.11,0.6.13,105,9,928,614,1542,57,FALSE
augur.js,0.6.10,0.6.11,104,4,589,424,1013,17,FALSE
augur.js,0.6.17,0.6.18,110,1,20,12,32,4,FALSE
augur.js,0.6.16,0.6.17,109,1,91,90,181,4,FALSE
augur.js,0.6.15,0.6.16,108,1,42,58,100,8,FALSE
augur.js,0.6.14,0.6.15,107,1,8,8,16,4,FALSE
augur.js,0.1.8,0.1.9,9,1,1,1,2,1,FALSE
augur.js,0.1.9,0.1.10,10,4,20,6,26,4,FALSE
augur.js,0.1.0,0.1.1,1,2,9,6,15,3,FALSE
augur.js,0.1.1,0.1.2,2,2,121,81,202,5,FALSE
augur.js,0.1.2,0.1.3,3,2,7,3,10,3,FALSE
augur.js,0.1.3,0.1.4,4,1,138,77,215,4,FALSE
augur.js,0.1.4,0.1.5,5,1,6,3,9,3,FALSE
augur.js,0.1.5,0.1.6,6,1,1,1,2,1,FALSE
augur.js,0.1.6,0.1.7,7,2,236,112,348,6,FALSE
augur.js,0.1.7,0.1.8,8,5,158,71,229,15,FALSE
augur.js,0.7.8,0.7.9,128,6,1293,1499,2792,67,FALSE
augur.js,0.7.9,0.7.10,129,2,379,348,727,11,FALSE
augur.js,0.7.6,0.7.7,126,2,87,88,175,5,FALSE
augur.js,0.7.7,0.7.8,127,2,94,61,155,7,FALSE
augur.js,0.7.4,0.7.5,124,1,1,2,3,1,FALSE
augur.js,0.7.5,0.7.6,125,1,122,121,243,3,FALSE
augur.js,0.7.2,0.7.3,122,2,39,39,78,2,FALSE
augur.js,0.7.3,0.7.4,123,1,212,221,433,4,FALSE
augur.js,0.7.0,0.7.1,120,1,12,5,17,2,FALSE
augur.js,0.7.1,0.7.2,121,2,343,297,640,6,FALSE
augur.js,0.3.32,0.4.0,80,1,1,1,2,1,FALSE
augur.js,0.3.30,0.3.31,78,1,1,1,2,1,FALSE
augur.js,0.3.31,0.3.32,79,1,1,1,2,1,FALSE
augur.js,0.5.4,0.5.5,93,1,44,44,88,3,FALSE
augur.js,0.5.5,0.5.6,94,1,46,19,65,6,FALSE
augur.js,0.5.6,0.5.7,95,1,5,5,10,4,FALSE
augur.js,0.5.7,0.6.3,96,11,307,265,572,17,FALSE
augur.js,0.5.0,0.5.1,90,1,128,93,221,8,FALSE
augur.js,0.5.1,0.5.3,91,2,524,397,921,20,FALSE
augur.js,0.5.3,0.5.4,92,1,365,231,596,11,FALSE
augur.js,0.9.0,0.9.1,172,3,10,11,21,4,FALSE
augur.js,0.9.1,0.9.2,173,2,886,786,1672,13,FALSE
augur.js,0.9.2,0.9.3,174,1,47,47,94,6,FALSE
augur.js,0.9.3,0.9.4,175,1,139,137,276,5,FALSE
augur.js,0.9.4,0.9.5,176,1,9,5,14,4,FALSE
augur.js,0.9.5,0.9.6,177,1,7,6,13,4,FALSE
augur.js,0.9.6,0.9.7,178,4,101,283,384,12,FALSE
augur.js,0.9.7,0.9.8,179,4,52159,369,52528,25,FALSE
augur.js,0.9.8,0.9.9,180,1,109,76,185,4,FALSE
augur.js,0.9.9,0.9.10,181,1,10,6,16,4,FALSE
augur.js,0.3.8,0.3.9,61,1,1,1,2,1,FALSE
augur.js,0.3.9,0.3.10,62,1,1,1,2,1,FALSE
augur.js,0.16.10,0.17.0,345,1,83,1096,1179,5,TRUE
augur.js,0.3.2,0.3.3,55,1,1,1,2,1,FALSE
augur.js,0.3.3,0.3.4,56,1,1,1,2,1,FALSE
augur.js,0.3.0,0.3.1,53,1,1,1,2,1,FALSE
augur.js,0.3.1,0.3.2,54,1,1,1,2,1,FALSE
augur.js,0.3.6,0.3.7,59,1,1,1,2,1,FALSE
augur.js,0.3.4,0.3.5,57,1,1,1,2,1,FALSE
augur.js,0.8.13,0.8.14,157,5,48,312,360,15,FALSE
augur.js,0.1.29,0.1.30,29,1,157,129,286,4,FALSE
augur.js,0.1.28,0.1.29,28,2,119,105,224,4,FALSE
augur.js,0.1.23,0.1.25,24,1,80,80,160,2,FALSE
augur.js,0.1.22,0.1.23,23,1,121,112,233,3,FALSE
augur.js,0.1.21,0.1.22,22,1,50,31,81,1,FALSE
augur.js,0.1.20,0.1.21,21,1,339,196,535,4,FALSE
augur.js,0.1.27,0.1.28,27,2,126,117,243,3,FALSE
augur.js,0.1.26,0.1.27,26,1,99,53,152,2,FALSE
augur.js,0.1.25,0.1.26,25,1,44,13,57,3,FALSE
augur.js,0.6.22,0.6.23,115,2,193,153,346,5,FALSE
augur.js,0.6.23,0.6.24,116,1,341,215,556,6,FALSE
augur.js,0.6.20,0.6.21,113,4,626,537,1163,16,FALSE
augur.js,0.6.21,0.6.22,114,1,164,163,327,3,FALSE
augur.js,0.6.26,0.7.0,119,2,575,380,955,70,FALSE
augur.js,0.6.24,0.6.25,117,1,31,41,72,4,FALSE
augur.js,0.6.25,0.6.26,118,1,520,509,1029,9,FALSE
augur.js,0.9.34,0.9.35,206,1,1014,1014,2028,18,FALSE
augur.js,0.9.35,0.9.36,207,14,589,456,1045,32,FALSE
augur.js,0.9.36,0.9.37,208,1,85,150,235,5,FALSE
augur.js,0.9.37,0.9.38,209,1,144,125,269,6,FALSE
augur.js,0.9.30,0.9.31,202,1,105,11,116,5,FALSE
augur.js,0.9.31,0.9.32,203,2,47,32,79,9,FALSE
augur.js,0.9.32,0.9.33,204,1,567,275,842,6,FALSE
augur.js,0.9.33,0.9.34,205,1,366,504,870,8,FALSE
augur.js,0.9.38,0.10.0,210,5,141754,140517,282271,24,FALSE
augur.js,0.7.18,0.7.19,138,1,71,83,154,3,FALSE
augur.js,0.7.19,0.7.20,139,2,138,277,415,10,FALSE
augur.js,0.7.10,0.7.11,130,1,101,99,200,5,FALSE
augur.js,0.2.16,0.3.0,52,1,1,1,2,1,FALSE
augur.js,0.2.15,0.2.16,51,1,1,1,2,1,FALSE
augur.js,0.7.13,0.7.14,133,2,1177,793,1970,42,FALSE
augur.js,0.7.14,0.7.15,134,1,15,15,30,5,FALSE
augur.js,0.7.15,0.7.16,135,1,193,186,379,4,FALSE
augur.js,0.7.16,0.7.17,136,1,2,2,4,1,FALSE
augur.js,0.13.1,0.13.2,262,2,860,4703,5563,12,FALSE
augur.js,0.10.1,0.10.2,212,3,91316,63890,155206,9,FALSE
augur.js,0.10.0,0.10.1,211,1,54323,53712,108035,19,FALSE
augur.js,0.10.2,0.10.3,213,1,3463,2862,6325,9,FALSE
augur.js,0.10.5,0.10.6,216,15,181540,179435,360975,94,FALSE
augur.js,0.10.7,0.10.8,218,1,4,4,8,4,FALSE
augur.js,0.10.6,0.10.7,217,1,73751,86894,160645,10,FALSE
augur.js,0.10.9,0.10.10,220,1,80052,79420,159472,8,FALSE
augur.js,0.10.8,0.10.9,219,3,58,50,108,7,FALSE
augur.js,0.12.3,0.12.4,240,10,90676,145008,235684,27,FALSE
augur.js,0.12.2,0.12.3,239,1,96,54,150,6,FALSE
augur.js,0.12.1,0.12.2,238,1,18,78,96,6,TRUE
augur.js,0.12.0,0.12.1,237,2,593,151,744,8,FALSE
augur.js,0.12.5,0.12.6,242,1,353,288,641,9,FALSE
augur.js,0.7.11,0.7.12,131,1,138,133,271,4,FALSE
augur.js,0.7.12,0.7.13,132,1,291,306,597,4,FALSE
augur.js,0.2.12,0.2.13,48,1,1,1,2,1,FALSE
augur.js,0.7.17,0.7.18,137,1,424,256,680,10,FALSE
augur.js,0.1.12,0.1.13,13,1,5,5,10,2,FALSE
augur.js,0.1.13,0.1.14,14,2,25,27,52,5,FALSE
augur.js,0.1.10,0.1.11,11,4,645,331,976,13,FALSE
augur.js,0.1.16,0.1.17,17,1,144,69,213,6,FALSE
augur.js,0.1.17,0.1.18,18,3,448,457,905,9,FALSE
augur.js,0.1.14,0.1.15,15,10,1237,777,2014,20,FALSE
augur.js,0.1.15,0.1.16,16,2,745,197,942,9,FALSE
augur.js,0.1.18,0.1.19,19,1,55,51,106,4,FALSE
augur.js,0.3.21,0.3.22,74,1,1,1,2,1,FALSE
augur.js,0.3.20,0.3.21,73,1,1,1,2,1,FALSE
augur.js,0.3.23,0.3.29,76,1,1,1,2,1,FALSE
augur.js,0.3.22,0.3.23,75,1,1,1,2,1,FALSE
augur.js,0.3.29,0.3.30,77,1,1,1,2,1,FALSE
augur.js,0.8.19,0.8.20,163,1,69,61,130,6,FALSE
augur.js,0.8.18,0.8.19,162,4,27847,1422,29269,77,FALSE
augur.js,0.8.15,0.8.16,159,7,1402,897,2299,73,FALSE
augur.js,0.8.14,0.8.15,158,2,869,408,1277,30,FALSE
augur.js,0.8.16,0.8.17,160,10,2932,1148,4080,68,FALSE
augur.js,0.8.12,0.8.13,156,1,8,5,13,5,FALSE
augur.js,0.13.9,0.13.10,270,1,7642,4970,12612,8,FALSE
augur.js,0.12.7,0.12.8,244,2,481,256,737,12,FALSE
augur.js,0.16.2,0.16.3,337,4,875,2145,3020,11,TRUE
augur.js,0.2.5,0.2.6,41,1,1,1,2,1,FALSE
augur.js,0.9.12,0.9.13,184,1,2,2,4,1,FALSE
augur.js,0.2.4,0.2.5,40,1,186,103,289,4,FALSE
augur.js,0.3.7,0.3.8,60,1,1,1,2,1,FALSE
augur.js,0.3.5,0.3.6,58,1,1,1,2,1,FALSE
augur.js,0.9.23,0.9.24,195,1,75815,75740,151555,4,FALSE
augur.js,0.9.22,0.9.23,194,5,148613,120458,269071,21,FALSE
augur.js,0.9.21,0.9.22,193,2,53165,53135,106300,9,FALSE
augur.js,0.9.20,0.9.21,192,2,19791,18284,38075,17,FALSE
augur.js,0.9.27,0.9.28,199,1,74,44,118,4,FALSE
augur.js,0.9.26,0.9.27,198,2,412,368,780,10,FALSE
augur.js,0.9.25,0.9.26,197,6,269,287,556,24,FALSE
augur.js,0.9.24,0.9.25,196,1,44,51,95,6,FALSE
augur.js,0.6.3,0.6.4,97,1,45,50,95,3,FALSE
augur.js,0.9.29,0.9.30,201,3,68,89,157,8,FALSE
augur.js,0.9.28,0.9.29,200,2,477,415,892,13,FALSE
augur.js,0.6.7,0.6.8,101,2,40,40,80,2,FALSE
augur.js,0.6.6,0.6.7,100,1,48,48,96,4,FALSE
augur.js,0.6.5,0.6.6,99,4,315,185,500,22,FALSE
augur.js,0.6.4,0.6.5,98,1,340,289,629,9,FALSE
augur.js,0.4.9,0.4.10,88,5,6594,2751,9345,61,FALSE
augur.js,0.4.8,0.4.9,87,1,1,1,2,1,FALSE
augur.js,0.4.1,0.4.4,82,1,1,1,2,1,FALSE
augur.js,0.4.0,0.4.1,81,1,1,1,2,1,FALSE
augur.js,0.4.5,0.4.6,84,1,1,1,2,1,FALSE
augur.js,0.4.4,0.4.5,83,1,1,1,2,1,FALSE
augur.js,0.4.7,0.4.8,86,1,1,1,2,1,FALSE
augur.js,0.4.6,0.4.7,85,1,1,1,2,1,FALSE
augur.js,0.13.0,0.13.1,261,1,37,33,70,4,FALSE
augur.js,0.8.9,0.8.10,153,1,97,98,195,8,FALSE
augur.js,0.8.5,0.8.6,150,1,264,209,473,12,FALSE
augur.js,0.8.4,0.8.5,149,2,1198,1122,2320,25,FALSE
augur.js,0.8.7,0.8.9,152,2,292,267,559,50,FALSE
augur.js,0.8.6,0.8.7,151,1,10,9,19,6,FALSE
augur.js,0.8.1,0.8.2,146,3,523,401,924,21,FALSE
augur.js,0.8.0,0.8.1,145,12,866,870,1736,90,FALSE
augur.js,0.8.3,0.8.4,148,3,1421,1421,2842,14,FALSE
augur.js,0.8.2,0.8.3,147,1,1221,1086,2307,14,FALSE
augur.js,0.3.10,0.3.11,63,1,1,1,2,1,FALSE
augur.js,0.3.12,0.3.13,65,1,1,1,2,1,FALSE
augur.js,0.2.7,0.2.8,43,1,1,1,2,1,FALSE
augur.js,0.2.6,0.2.7,42,1,1,1,2,1,FALSE
augur.js,0.2.3,0.2.4,39,1,1674,1614,3288,9,FALSE
augur.js,0.2.2,0.2.3,38,1,148,105,253,5,FALSE
augur.js,0.2.1,0.2.2,37,1,3,3,6,3,FALSE
augur.js,0.2.0,0.2.1,36,1,53,39,92,5,FALSE
augur.js,0.2.9,0.2.10,45,1,1,1,2,1,FALSE
augur.js,0.1.19,0.1.20,20,1,238,139,377,5,FALSE
augur.js,0.2.14,0.2.15,50,1,1,1,2,1,FALSE
augur.js,0.3.18,0.3.19,71,1,1,1,2,1,FALSE
augur.js,0.3.19,0.3.20,72,1,1,1,2,1,FALSE
augur.js,0.3.14,0.3.15,67,1,1,1,2,1,FALSE
augur.js,0.3.15,0.3.16,68,1,1,1,2,1,FALSE
augur.js,0.3.16,0.3.17,69,1,1,1,2,1,FALSE
augur.js,0.3.17,0.3.18,70,1,1,1,2,1,FALSE
augur.js,0.3.11,0.3.12,64,1,1,1,2,1,FALSE
augur.js,0.12.6,0.12.7,243,1,51141,59653,110794,14,FALSE
augur.js,0.2.13,0.2.14,49,1,1,1,2,1,FALSE
augur.js,0.12.4,0.12.5,241,5,107638,98848,206486,10,FALSE
augur.js,0.2.8,0.2.9,44,1,1,1,2,1,FALSE
augur.js,0.7.22,0.7.23,142,1,1,1,2,1,FALSE
augur.js,0.12.9,0.12.10,246,1,68,55,123,6,FALSE
augur.js,0.12.8,0.12.9,245,1,391,576,967,8,FALSE
augur.js,0.8.20,0.8.21,164,3,363,343,706,16,FALSE
augur.js,0.8.21,0.8.22,165,1,46,41,87,9,FALSE
augur.js,0.8.22,0.8.23,166,1,7,13,20,1,FALSE
augur.js,0.8.23,0.8.24,167,3,175,183,358,18,FALSE
augur.js,0.9.18,0.9.19,190,4,26121,26141,52262,38,FALSE
augur.js,0.11.12,0.11.13,235,1,952,860,1812,11,FALSE
augur.js,0.11.13,0.12.0,236,3,1571,1299,2870,9,FALSE
augur.js,0.11.10,0.11.11,233,1,441,205,646,8,TRUE
augur.js,0.11.11,0.11.12,234,2,91,111,202,11,FALSE
augur.js,0.9.10,0.9.11,182,1,1642,3982,5624,27,FALSE
augur.js,0.9.11,0.9.12,183,4,38746,35650,74396,42,FALSE
augur.js,0.9.16,0.9.17,188,1,238,55,293,8,FALSE
augur.js,0.9.17,0.9.18,189,5,2382,1317,3699,33,FALSE
augur.js,0.9.14,0.9.15,186,4,100,136,236,12,FALSE
augur.js,0.9.15,0.9.16,187,1,5469,5365,10834,8,FALSE
augur.js,0.2.11,0.2.12,47,1,1,1,2,1,FALSE
augur.js,0.8.27,0.9.0,171,3,862,1046,1908,23,FALSE
augur.js,0.2.10,0.2.11,46,1,1,1,2,1,FALSE
augur.js,0.9.19,0.9.20,191,1,8,6,14,4,FALSE
augur.js,0.6.9,0.6.10,103,3,360,184,544,10,FALSE
augur.js,0.3.13,0.3.14,66,1,1,1,2,1,FALSE
augur.js,0.12.23,0.13.0,260,1,2758,1821,4579,11,FALSE
augur.js,0.12.20,0.12.21,257,2,15828,11995,27823,6,FALSE
augur.js,0.12.21,0.12.22,258,2,418,88,506,11,FALSE
augur.js,0.9.13,0.9.14,185,1,20069,22482,42551,5,FALSE
augur.js,0.11.8,0.11.9,231,1,23,5,28,4,FALSE
augur.js,0.11.9,0.11.10,232,1,16,13,29,5,FALSE
augur.js,0.11.4,0.11.5,227,2,2724,2754,5478,13,FALSE
augur.js,0.11.5,0.11.6,228,3,2960,339,3299,9,TRUE
augur.js,0.11.6,0.11.7,229,1,67,42,109,5,FALSE
augur.js,0.11.7,0.11.8,230,1,61,51,112,4,FALSE
augur.js,0.11.0,0.11.1,223,1,640,168,808,7,FALSE
augur.js,0.11.1,0.11.2,224,3,51919,30061,81980,14,FALSE
augur.js,0.11.2,0.11.3,225,1,95962,102352,198314,12,FALSE
augur.js,0.11.3,0.11.4,226,3,157143,88861,246004,11,FALSE
augur.js,0.13.8,0.13.9,269,2,91,99,190,5,FALSE
augur.js,0.13.6,0.13.7,267,2,119053,108849,227902,7,FALSE
augur.js,0.13.7,0.13.8,268,1,46,34,80,4,FALSE
augur.js,0.13.4,0.13.5,265,4,350,189,539,19,FALSE
augur.js,0.13.5,0.13.6,266,4,644,417,1061,13,FALSE
augur.js,0.13.2,0.13.3,263,3,25303,26564,51867,26,FALSE
augur.js,0.13.3,0.13.4,264,3,61706,54015,115721,11,FALSE
augur.js,0.1.11,0.1.12,12,1,32,22,54,3,FALSE
augur.js,0.6.8,0.6.9,102,2,37,37,74,2,FALSE
augur.js,0.8.11,0.8.12,155,2,33,37,70,9,FALSE
augur.js,0.8.10,0.8.11,154,1,55,31,86,9,FALSE
augur.js,0.12.1,0.12.2,238,1,18,78,96,6,FALSE
augur.js,0.11.10,0.11.11,233,1,441,205,646,8,FALSE
augur.js,0.11.5,0.11.6,228,3,2960,339,3299,9,FALSE
augur.js,0.12.5,0.12.6,242,1,353,288,641,9,TRUE
augur.js,0.13.5,0.13.6,266,4,644,417,1061,13,TRUE
augur.js,0.13.30,0.13.31,288,2,82,77,159,6,TRUE
augur.js,0.12.20,0.12.21,257,2,15828,11995,27823,6,TRUE
augur.js,0.8.15,0.8.16,159,7,1402,897,2299,73,TRUE
augur.js,0.8.14,0.8.15,158,2,869,408,1277,30,TRUE
augur.js,0.13.4,0.13.5,265,4,350,189,539,19,TRUE
augur.js,0.8.25,0.8.26,169,14,25677,13454,39131,107,TRUE
augur.js,0.7.5,0.7.6,125,1,122,121,243,3,TRUE
augur.js,0.18.0,0.18.1,355,1,50935,43449,94384,6,TRUE
augur.js,0.13.28,0.13.29,286,1,160,136,296,5,TRUE
augur.js,0.13.31,0.13.32,289,1,85,39,124,5,TRUE
augur.js,0.9.33,0.9.34,205,1,366,504,870,8,TRUE
augur.js,0.14.12,0.14.13,309,1,25,14,39,7,TRUE
augur.js,0.10.4,0.10.5,215,1,13992,1826,15818,18,TRUE
augur.js,0.9.8,0.9.9,180,1,109,76,185,4,TRUE
augur.js,0.13.15,0.13.17,275,5,1442,1075,2517,21,TRUE
augur.js,3.8.6,3.8.7,793,4,75142,1826,76968,31,TRUE
augur.js,0.3.5,0.3.6,58,1,1,1,2,1,TRUE
augur.js,0.5.1,0.5.3,91,2,524,397,921,20,TRUE
augur.js,0.9.35,0.9.36,207,14,589,456,1045,32,TRUE
augur.js,1.0.7,1.0.8,388,1,7610,801,8411,6,TRUE
augur.js,0.2.9,0.2.10,45,1,1,1,2,1,TRUE
augur.js,0.13.17,0.13.18,276,1,54,46,100,4,TRUE
augur.js,0.9.16,0.9.17,188,1,238,55,293,8,TRUE
augur.js,2.0.13,2.0.14,554,2,461,266,727,11,TRUE
augur.js,0.15.0,0.15.1,320,2,126,97,223,7,TRUE
augur.js,0.13.33,0.13.34,291,4,13455,7806,21261,26,TRUE
augur.js,1.4.6,1.4.7,440,3,358,361,719,10,TRUE
augur.js,0.9.38,0.10.0,210,5,141754,140517,282271,24,TRUE
augur.js,0.9.25,0.9.26,197,6,269,287,556,24,TRUE
augur.js,0.4.9,0.4.10,88,5,6594,2751,9345,61,TRUE
augur.js,0.9.15,0.9.16,187,1,5469,5365,10834,8,TRUE
augur.js,0.13.35,0.13.36,293,2,672,1322,1994,13,TRUE
augur.js,0.8.7,0.8.9,152,2,292,267,559,50,TRUE
augur.js,0.8.1,0.8.2,146,3,523,401,924,21,TRUE
augur.js,3.13.16,3.14.0,857,6,10566,2848,13414,35,TRUE
augur.js,0.13.34,0.13.35,292,8,440,333,773,24,TRUE
augur.js,0.13.11,0.13.12,272,1,76,90,166,4,TRUE
augur.js,1.8.2,1.8.3,481,7,104571,118269,222840,66,TRUE
augur.js,0.15.14,0.16.0,334,2,349,62,411,7,TRUE
augur.js,0.16.3,0.16.4,338,2,947,620,1567,8,TRUE
augur.js,0.16.0,0.16.1,335,1,591,106,697,5,TRUE
augur.js,2.1.4,2.1.5,564,1,9519,6251,15770,5,TRUE
augur.js,2.11.2,2.11.3,678,2,446,119,565,9,TRUE
augur.js,1.3.5,1.3.6,417,10,51617,57873,109490,23,TRUE
augur.js,1.4.12,1.5.0,446,13,118604,96327,214931,155,TRUE
augur.js,1.4.10,1.4.11,444,11,97308,99216,196524,130,TRUE
augur.js,3.0.15,3.0.16,703,1,1081,521,1602,9,TRUE
augur.js,1.6.1,1.6.2,461,2,445,447,892,13,TRUE
augur.js,3.14.6,3.14.7,864,6,529,1133,1662,17,TRUE
augur.js,2.7.2,2.7.3,630,1,1,1,2,1,TRUE
augur.js,1.9.27,1.9.28,519,3,410,302,712,14,TRUE
augur.js,1.9.35,1.9.36,527,3,160,202,362,10,TRUE
augur.js,3.13.14,3.13.15,855,4,183,351,534,10,TRUE
augur.js,3.13.7,3.13.8,848,1,5,5,10,4,TRUE
augur.js,3.13.6,3.13.7,847,8,16024,19366,35390,23,TRUE
augur.js,3.15.3,3.15.4,870,8,7095,1179,8274,15,TRUE
augur.js,3.15.2,3.15.3,869,1,42,42,84,4,TRUE
augur.js,2.0.11,2.0.12,552,2,177,159,336,9,TRUE
augur.js,1.5.12,1.6.0,459,7,105356,104098,209454,29,TRUE
augur.js,1.4.2,1.4.3,436,5,44714,53004,97718,13,TRUE
augur.js,3.14.8,3.15.0,866,2,1202,2135,3337,68,TRUE
augur.js,3.1.16,3.2.0,723,7,3032,1508,4540,34,TRUE
augur.js,2.11.1,2.11.2,677,1,436,90,526,7,TRUE
augur.js,3.13.13,3.13.14,854,10,117972,117933,235905,34,TRUE
augur.js,2.8.7,2.8.8,645,1,66,24,90,5,TRUE
augur.js,0.17.7,0.17.8,353,1,57998,80496,138494,5,TRUE
augur.js,3.0.16,3.0.17,704,1,663,411,1074,8,TRUE
augur.js,2.7.9,2.8.0,637,7,12002,5583,17585,19,TRUE
augur.js,3.10.2,3.10.3,820,9,1432,1138,2570,16,TRUE
augur.js,1.9.14,1.9.15,506,4,10,10,20,7,TRUE
augur.js,1.7.1,1.7.2,471,13,230973,244457,475430,64,TRUE
augur.js,0.3.9,0.3.10,62,1,1,1,2,1,TRUE
augur.js,0.3.2,0.3.3,55,1,1,1,2,1,TRUE
augur.js,0.3.11,0.3.12,64,1,1,1,2,1,TRUE
augur.js,0.8.23,0.8.24,167,3,175,183,358,18,TRUE
augur.js,0.9.6,0.9.7,178,4,101,283,384,12,TRUE
augur.js,0.9.26,0.9.27,198,2,412,368,780,10,TRUE
augur.js,0.8.10,0.8.11,154,1,55,31,86,9,TRUE
augur.js,0.7.1,0.7.2,121,2,343,297,640,6,TRUE
augur.js,1.8.10,1.8.11,489,4,72021,81176,153197,77,TRUE
augur.js,0.14.3,0.14.4,300,1,261,88,349,7,TRUE
augur.js,0.12.4,0.12.5,241,5,107638,98848,206486,10,TRUE
augur.js,3.12.3,3.12.4,837,1,910,781,1691,10,TRUE
augur.js,3.12.6,3.13.0,840,27,5101,2176,7277,55,TRUE
augur.js,0.9.13,0.9.14,185,1,20069,22482,42551,5,TRUE
augur.js,0.8.11,0.8.12,155,2,33,37,70,9,TRUE
react-i18next,3.1.2,4.0.0,41,2,9,5,14,6,FALSE
react-i18next,3.1.1,3.1.2,40,2,7,4,11,5,FALSE
react-i18next,3.1.0,3.1.1,39,9,35,18,53,13,FALSE
react-i18next,3.0.0,3.1.0,38,7,32,18,50,16,FALSE
react-i18next,2.0.0,2.0.1,31,4,32,9,41,7,FALSE
react-i18next,2.2.1,2.2.2,35,3,41,31,72,5,FALSE
react-i18next,2.2.0,2.2.1,34,13,47751,51,47802,95,FALSE
react-i18next,2.2.3,3.0.0,37,6,164,128,292,26,FALSE
react-i18next,2.2.2,2.2.3,36,2,5,5,10,5,FALSE
react-i18next,2.1.0,2.2.0,33,2,49,11,60,10,FALSE
react-i18next,4.0.0,4.1.0,42,23,6557,119,6676,63,FALSE
react-i18next,2.0.1,2.1.0,32,2,9,4,13,5,FALSE
react-i18next,1.6.2,1.6.3,23,2,7,4,11,5,FALSE
react-i18next,1.6.3,1.7.0,24,19,489,87,576,46,FALSE
react-i18next,1.6.0,1.6.1,21,12,16,10,26,14,FALSE
react-i18next,1.6.1,1.6.2,22,2,9,6,15,6,FALSE
react-i18next,1.9.0,1.10.0,27,4,9,6,15,7,FALSE
react-i18next,1.8.0,1.9.0,26,10,668,542,1210,26,FALSE
react-i18next,1.7.0,1.8.0,25,4,539,519,1058,9,FALSE
react-i18next,1.11.0,2.0.0,30,3,54,16,70,7,FALSE
react-i18next,1.10.0,1.10.1,28,8,14,11,25,11,FALSE
react-i18next,1.10.1,1.11.0,29,8,50,19,69,16,FALSE
react-i18next,1.1.0,1.2.0,9,3,353,138,491,11,FALSE
react-i18next,1.0.0,1.0.1,7,4,22,19,41,6,FALSE
react-i18next,1.0.1,1.1.0,8,5,9,2,11,5,FALSE
react-i18next,1.4.0,1.4.1,14,6,110,11,121,9,FALSE
react-i18next,1.4.1,1.4.2,15,4,19,17,36,6,FALSE
react-i18next,1.4.2,1.5.0,16,2,113,81,194,8,FALSE
react-i18next,1.5.1,1.5.2,18,3,17,11,28,6,FALSE
react-i18next,1.5.0,1.5.1,17,4,23,27,50,5,FALSE
react-i18next,1.5.3,1.6.0,20,5,9500,7876,17376,14,FALSE
react-i18next,1.5.2,1.5.3,19,32,84,65,149,42,FALSE
react-i18next,1.3.1,1.4.0,13,9,507,2311,2818,18,FALSE
react-i18next,1.3.0,1.3.1,12,19,26656,26239,52895,34,FALSE
react-i18next,1.2.0,1.2.1,10,4,33,18,51,10,FALSE
react-i18next,1.2.1,1.3.0,11,20,5672,1572,7244,33,FALSE
react-i18next,0.1.0,1.0.0,6,10,23005,622,23627,30,FALSE
react-i18next,0.0.3,0.0.4,4,2,6,4,10,4,FALSE
react-i18next,0.0.2,0.0.3,3,4,1098,28,1126,39,FALSE
react-i18next,1.6.0,1.6.1,21,12,16,10,26,14,TRUE
react-i18next,0.0.4,0.1.0,5,3,195,11,206,16,FALSE
react-i18next,1.2.1,1.3.0,11,20,5672,1572,7244,33,TRUE
react-i18next,0.0.1,0.0.2,2,1,80,3,83,4,FALSE
react-i18next,0.0.0,0.0.1,1,1,80,3,83,4,FALSE
react-i18next,4.0.0,4.1.0,42,23,6557,119,6676,63,TRUE
react-i18next,1.3.0,1.3.1,12,19,26656,26239,52895,34,TRUE
react-i18next,1.1.0,1.2.0,9,3,353,138,491,11,TRUE
awayjs-lite,5.0.0,5.0.1,1,2,6,4,10,2,FALSE
awayjs-lite,5.0.1,5.0.2,2,2,10,1,11,3,FALSE
awayjs-lite,5.0.2,5.0.3,3,2,18,1,19,2,FALSE
awayjs-lite,5.0.3,5.0.4,4,2,235,237,472,22,FALSE
awayjs-lite,5.0.1,5.0.2,2,2,10,1,11,3,TRUE
awayjs-lite,5.0.2,5.0.3,3,2,18,1,19,2,TRUE
awayjs-lite,5.0.3,5.0.4,4,2,235,237,472,22,TRUE
bloody-tester,0.1.1,0.1.2,1,2,2,2,4,2,FALSE
bloody-tester,0.1.2,0.1.3,2,2,17,2,19,4,FALSE
bloody-tester,0.1.3,0.1.4,3,2,1,3,4,2,FALSE
bloody-tester,0.1.4,0.1.5,4,4,80,16,96,10,FALSE
bloody-tester,0.1.5,0.1.6,5,2,43,43,86,6,FALSE
bloody-tester,0.1.6,0.1.7,6,2,23,5,28,3,FALSE
bloody-tester,0.1.1,0.1.2,1,2,2,2,4,2,TRUE
jasmine-http-server-spy,0.0.5,0.0.6,5,1,15,2,17,2,FALSE
jasmine-http-server-spy,0.0.4,0.0.5,4,1,83,8,91,4,FALSE
jasmine-http-server-spy,0.0.7,0.1.0,7,2,134,52,186,7,FALSE
jasmine-http-server-spy,0.0.6,0.0.7,6,3,66,6,72,6,FALSE
jasmine-http-server-spy,0.0.1,0.0.2,1,1,6,2,8,2,FALSE
jasmine-http-server-spy,0.0.3,0.0.4,3,1,15,16,31,3,FALSE
jasmine-http-server-spy,0.0.2,0.0.3,2,2,362,245,607,9,FALSE
jasmine-http-server-spy,0.3.0,0.3.1,12,4,84,6,90,8,FALSE
jasmine-http-server-spy,0.2.0,0.3.0,11,11,219,65,284,21,FALSE
jasmine-http-server-spy,0.1.0,0.1.1,8,10,6081,111,6192,34,FALSE
jasmine-http-server-spy,0.1.1,0.1.2,9,3,9,7,16,4,FALSE
jasmine-http-server-spy,0.1.2,0.2.0,10,2,34,6,40,6,FALSE
jasmine-http-server-spy,0.3.0,0.3.1,12,4,84,6,90,8,TRUE
jasmine-http-server-spy,0.1.2,0.2.0,10,2,34,6,40,6,TRUE
jasmine-http-server-spy,0.0.3,0.0.4,3,1,15,16,31,3,TRUE
react-native-conditional-stylesheet,2.0.0,2.0.1,4,2,38,48,86,2,FALSE
react-native-conditional-stylesheet,2.0.0,2.0.1,4,2,38,48,86,2,TRUE
vrdom,0.1.0,0.1.1,3,6,132,84,216,59,FALSE
vrdom,0.1.1,0.1.2,4,3,15,6,21,5,FALSE
vrdom,0.1.2,0.1.4,5,12,1115,11323,12438,191,FALSE
vrdom,0.1.4,0.1.5,6,2,23,12,35,10,FALSE
vrdom,0.1.5,0.1.7,7,5,90,49,139,38,FALSE
vrdom,0.0.3,0.1.0,2,4,6559,3163,9722,83,FALSE
vrdom,0.0.2,0.0.3,1,3,26,18,44,3,FALSE
vrdom,0.1.4,0.1.5,6,2,23,12,35,10,TRUE
vrdom,0.1.2,0.1.4,5,12,1115,11323,12438,191,TRUE
panels-runtime,0.5.0-rc1,0.5.0,4,1,54,25,79,7,FALSE
panels-runtime,0.1.0,0.2.0,1,5,273,39,312,23,FALSE
panels-runtime,0.3.0,0.5.0-rc1,3,1,54,25,79,7,FALSE
panels-runtime,0.2.0,0.3.0,2,1,65,13,78,8,FALSE
panels-runtime,0.2.0,0.3.0,2,1,65,13,78,8,TRUE
panels-runtime,0.5.0-rc1,0.5.0,4,1,54,25,79,7,TRUE
panels-runtime,0.3.0,0.5.0-rc1,3,1,54,25,79,7,TRUE
poi-plugin-battle-detail,1.3.0,1.3.1,3,2,8,5,13,5,FALSE
poi-plugin-battle-detail,1.2.4,1.3.0,2,6,32,26,58,8,FALSE
poi-plugin-battle-detail,1.2.3,1.2.4,1,4,44,14,58,11,FALSE
poi-plugin-battle-detail,3.1.3,3.2.0,74,9,349,1012,1361,26,FALSE
poi-plugin-battle-detail,3.1.2,3.1.3,73,1,2,2,4,2,FALSE
poi-plugin-battle-detail,3.1.1,3.1.2,72,2,20,19,39,2,FALSE
poi-plugin-battle-detail,3.1.0,3.1.1,71,2,3,8,11,2,FALSE
poi-plugin-battle-detail,3.0.2,3.0.3,60,10,44,29,73,11,FALSE
poi-plugin-battle-detail,3.0.3,3.0.4,61,2,7,5,12,3,FALSE
poi-plugin-battle-detail,3.0.0,3.0.1,58,1,585,54,639,13,FALSE
poi-plugin-battle-detail,3.0.7,3.0.8,65,2,7,3,10,2,FALSE
poi-plugin-battle-detail,3.0.0-beta.0,3.0.0-beta.1,56,2,9,3,12,2,FALSE
poi-plugin-battle-detail,3.0.0-beta.1,3.0.0,57,4,172,119,291,17,FALSE
poi-plugin-battle-detail,3.0.8,3.0.9,66,3,4,4,8,4,FALSE
poi-plugin-battle-detail,3.0.9,3.0.10,67,3,12,7,19,8,FALSE
poi-plugin-battle-detail,2.6.6-beta.0,3.0.0-beta.0,55,9,1465,1340,2805,33,FALSE
poi-plugin-battle-detail,3.0.10,3.1.0-beta.0,68,3,126,68,194,9,FALSE
poi-plugin-battle-detail,3.3.0,3.3.1,77,1,0,1,1,1,FALSE
poi-plugin-battle-detail,3.0.1,3.0.2,59,2,5,8,13,4,FALSE
poi-plugin-battle-detail,3.1.0-beta.1,3.1.0,70,3,13,10,23,3,FALSE
poi-plugin-battle-detail,3.1.0-beta.0,3.1.0-beta.1,69,2,34,29,63,3,FALSE
poi-plugin-battle-detail,3.6.0-beta.2,3.6.0-beta.3,87,1,1,1,2,1,FALSE
poi-plugin-battle-detail,3.6.0-beta.3,3.6.0,88,2,5,7,12,3,FALSE
poi-plugin-battle-detail,3.6.0-beta.0,3.6.0-beta.1,85,1,9,9,18,6,FALSE
poi-plugin-battle-detail,3.6.0-beta.1,3.6.0-beta.2,86,1,14,8,22,1,FALSE
poi-plugin-battle-detail,3.0.4,3.0.5,62,3,26,27,53,5,FALSE
poi-plugin-battle-detail,3.3.1,3.3.2,78,2,15,20,35,4,FALSE
poi-plugin-battle-detail,3.0.5,3.0.6,63,2,3,2,5,2,FALSE
poi-plugin-battle-detail,3.4.0-beta.0,3.4.0,80,2,14,7,21,8,FALSE
poi-plugin-battle-detail,3.4.2,3.5.0,83,12,166,68,234,23,FALSE
poi-plugin-battle-detail,3.4.0,3.4.1,81,2,6,6,12,6,FALSE
poi-plugin-battle-detail,3.4.1,3.4.2,82,1,2,2,4,2,FALSE
poi-plugin-battle-detail,2.6.3,2.6.4,52,3,20,6,26,10,FALSE
poi-plugin-battle-detail,2.6.2,2.6.3,51,5,24,14,38,10,FALSE
poi-plugin-battle-detail,2.6.5,2.6.6-beta.0,54,2,72,22,94,4,FALSE
poi-plugin-battle-detail,2.6.4,2.6.5,53,4,71,69,140,8,FALSE
poi-plugin-battle-detail,3.5.0,3.6.0-beta.0,84,7,439,145,584,24,FALSE
poi-plugin-battle-detail,3.6.0,3.6.1,89,2,2,1,3,2,FALSE
poi-plugin-battle-detail,3.6.1,3.6.2,90,3,5,8,13,6,FALSE
poi-plugin-battle-detail,3.6.2,3.6.3,91,3,3,6,9,3,FALSE
poi-plugin-battle-detail,3.3.2,3.4.0-beta.0,79,7,549,558,1107,13,FALSE
poi-plugin-battle-detail,3.2.0,3.2.1,75,4,9,90,99,9,FALSE
poi-plugin-battle-detail,3.2.1,3.3.0,76,5,64,31,95,8,FALSE
poi-plugin-battle-detail,3.6.3,3.6.4,92,3,17,2,19,4,FALSE
poi-plugin-battle-detail,3.0.6,3.0.7,64,2,2,1,3,2,FALSE
poi-plugin-battle-detail,2.6.0-beta.0,2.6.0,48,2,8,12,20,2,FALSE
poi-plugin-battle-detail,2.6.1,2.6.2,50,11,236,153,389,19,FALSE
poi-plugin-battle-detail,2.6.0,2.6.1,49,3,6,7,13,5,FALSE
poi-plugin-battle-detail,2.4.1,2.5.0,43,3,44,7,51,5,FALSE
poi-plugin-battle-detail,2.4.0,2.4.1,42,1,1,1,2,1,FALSE
poi-plugin-battle-detail,2.5.2,2.5.3,46,1,585,54,639,13,FALSE
poi-plugin-battle-detail,2.5.0,2.5.1,44,3,12,4,16,5,FALSE
poi-plugin-battle-detail,2.5.1,2.5.2,45,2,34,28,62,3,FALSE
poi-plugin-battle-detail,2.2.1,2.3.0-beta.0,38,8,282,646,928,18,FALSE
poi-plugin-battle-detail,2.2.0,2.2.1,37,1,1,1,2,1,FALSE
poi-plugin-battle-detail,2.0.3,2.1.0-beta.0,32,4,111,68,179,13,FALSE
poi-plugin-battle-detail,2.1.0,2.2.0-beta.0,35,9,409,260,669,32,FALSE
poi-plugin-battle-detail,2.0.2,2.0.3,31,5,263,45,308,12,FALSE
poi-plugin-battle-detail,2.0.1,2.0.2,30,2,8,8,16,4,FALSE
poi-plugin-battle-detail,2.1.0-beta.0,2.1.0-beta.1,33,1,26,2,28,6,FALSE
poi-plugin-battle-detail,2.1.0-beta.1,2.1.0,34,2,3,3,6,2,FALSE
poi-plugin-battle-detail,2.3.0-beta.0,2.3.0,39,1,1,1,2,1,FALSE
poi-plugin-battle-detail,2.3.0,2.4.0-beta.0,40,2,70,5,75,4,FALSE
poi-plugin-battle-detail,2.2.0-beta.0,2.2.0,36,1,1,1,2,1,FALSE
poi-plugin-battle-detail,2.5.3,2.6.0-beta.0,47,13,429,354,783,30,FALSE
poi-plugin-battle-detail,2.4.0-beta.0,2.4.0,41,3,30,17,47,5,FALSE
poi-plugin-battle-detail,2.6.2,2.6.3,51,5,24,14,38,10,TRUE
poi-plugin-battle-detail,2.1.0-beta.1,2.1.0,34,2,3,3,6,2,TRUE
poi-plugin-battle-detail,2.6.3,2.6.4,52,3,20,6,26,10,TRUE
inspectpack,1.1.1,1.2.0,13,7,1514,884,2398,26,FALSE
inspectpack,1.1.0,1.1.1,12,6,243,153,396,12,FALSE
inspectpack,1.0.0,1.1.0,11,26,56505,52397,108902,161,FALSE
inspectpack,0.3.0,0.4.0,5,2,493,26,519,11,FALSE
inspectpack,0.6.0,0.6.1,9,3,95,86,181,15,FALSE
inspectpack,0.1.0,0.1.1,2,3,134,51,185,8,FALSE
inspectpack,0.2.0,0.3.0,4,3,672,52,724,16,FALSE
inspectpack,0.4.1,0.5.0,7,2,258,11,269,11,FALSE
inspectpack,0.1.1,0.2.0,3,3,1462,596,2058,20,FALSE
inspectpack,0.6.1,1.0.0,10,8,2429,23,2452,21,TRUE
inspectpack,0.5.0,0.6.0,8,2,521,6,527,8,FALSE
inspectpack,0.4.0,0.4.1,6,3,116,24,140,4,FALSE
inspectpack,0.6.1,1.0.0,10,8,2429,23,2452,21,FALSE
inspectpack,1.1.1,1.2.0,13,7,1514,884,2398,26,TRUE
inspectpack,0.0.1,0.1.0,1,3,1796,60,1856,20,FALSE
inspectpack,0.1.1,0.2.0,3,3,1462,596,2058,20,TRUE
inspectpack,1.1.0,1.1.1,12,6,243,153,396,12,TRUE
redis-koa-app,0.9.1,0.9.2,12,1,1,1,2,1,FALSE
redis-koa-app,0.9.2,0.9.3,13,1,2,2,4,1,FALSE
redis-koa-app,0.9.3,0.9.4,14,1,2,2,4,1,FALSE
redis-koa-app,0.8.9,0.9.1,11,1,5,2,7,2,FALSE
redis-koa-app,0.8.8,0.8.9,10,1,3,3,6,2,FALSE
redis-koa-app,0.9.6,0.9.8,17,1,2,2,4,1,FALSE
redis-koa-app,0.8.5,0.8.6,7,1,5,17,22,3,FALSE
redis-koa-app,0.8.4,0.8.5,6,1,2,2,4,2,FALSE
redis-koa-app,0.8.7,0.8.8,9,1,2,2,4,2,FALSE
redis-koa-app,0.8.6,0.8.7,8,1,12,2,14,2,FALSE
redis-koa-app,0.8.1,0.8.2,3,1,13,3,16,2,FALSE
redis-koa-app,0.7.15,0.8.0,1,1,7,9,16,2,FALSE
redis-koa-app,0.8.3,0.8.4,5,1,3,2,5,2,FALSE
redis-koa-app,0.8.2,0.8.3,4,1,21,6,27,2,FALSE
redis-koa-app,0.9.8,0.9.9,18,1,2,2,4,1,FALSE
redis-koa-app,0.8.0,0.8.1,2,1,81,40,121,3,FALSE
redis-koa-app,0.9.9,0.9.10,19,1,2,2,4,1,FALSE
redis-koa-app,0.9.4,0.9.5,15,1,2,2,4,1,FALSE
redis-koa-app,0.9.10,0.9.11,20,1,2,2,4,1,FALSE
redis-koa-app,0.9.5,0.9.6,16,1,2,2,4,1,FALSE
redis-koa-app,0.8.5,0.8.6,7,1,5,17,22,3,TRUE
redis-koa-app,0.8.0,0.8.1,2,1,81,40,121,3,TRUE
redis-koa-app,0.8.7,0.8.8,9,1,2,2,4,2,TRUE
ngmeta,1.0.0,1.1.0,1,12,1729,1112,2841,90,FALSE
ngmeta,1.0.0,1.1.0,1,12,1729,1112,2841,90,TRUE
md-to-couch,0.0.1,0.0.2,1,2,28,9,37,4,FALSE
md-to-couch,0.0.3,0.1.0,3,2,63,23,86,4,FALSE
md-to-couch,0.0.2,0.0.3,2,1,30,19,49,4,FALSE
md-to-couch,0.3.0,0.3.1,7,1,17,6,23,5,FALSE
md-to-couch,0.3.1,0.4.0,8,1,9,5,14,3,FALSE
md-to-couch,0.2.1,0.3.0,6,1,9,7,16,3,FALSE
md-to-couch,0.2.0,0.2.1,5,1,15,3,18,4,FALSE
md-to-couch,0.1.0,0.2.0,4,1,51,29,80,3,FALSE
md-to-couch,0.4.0,0.5.0,9,1,25,15,40,4,FALSE
md-to-couch,0.2.1,0.3.0,6,1,9,7,16,3,TRUE
react-tagsinput,1.1.0,1.2.0,14,3,137,16,153,11,FALSE
react-tagsinput,1.0.0,1.0.1,11,2,3,3,6,4,FALSE
react-tagsinput,1.0.1,1.0.2,12,1,17,10,27,5,FALSE
react-tagsinput,1.0.2,1.1.0,13,3,274,35,309,10,FALSE
react-tagsinput,0.2.6,0.3.0,7,2,310,63,373,9,FALSE
react-tagsinput,0.2.5,0.2.6,6,1,14,6,20,6,FALSE
react-tagsinput,0.2.4,0.2.5,5,1,95,4,99,5,FALSE
react-tagsinput,0.2.3,0.2.4,4,1,11,6,17,3,FALSE
react-tagsinput,0.2.2,0.2.3,3,1,20,10,30,4,FALSE
react-tagsinput,0.2.1,0.2.2,2,2,12,8,20,4,FALSE
react-tagsinput,0.1.2,0.2.1,1,12,449,175,624,34,FALSE
react-tagsinput,0.3.2,1.0.0,10,1,325,196,521,8,FALSE
react-tagsinput,0.3.0,0.3.1,8,2,92,14,106,10,FALSE
react-tagsinput,0.3.1,0.3.2,9,2,5,5,10,3,FALSE
react-tagsinput,1.3.5,1.3.6,21,3,85,26,111,10,FALSE
react-tagsinput,1.3.3,1.3.4,19,4,84,46,130,9,FALSE
react-tagsinput,1.3.2,1.3.3,18,1,75,41,116,4,FALSE
react-tagsinput,1.3.1,1.3.2,17,1,31,12,43,5,FALSE
react-tagsinput,1.3.0,1.3.1,16,1,34,7,41,6,FALSE
react-tagsinput,1.3.7,1.3.8,23,4,111,21,132,9,FALSE
react-tagsinput,1.3.6,1.3.7,22,3,38,3,41,9,FALSE
react-tagsinput,1.2.0,1.3.0,15,1,219,32,251,8,FALSE
react-tagsinput,1.3.4,1.3.5,20,1,103,2,105,6,FALSE
react-tagsinput,3.14.0,3.14.1,71,4,846,2658,3504,16,FALSE
react-tagsinput,3.14.1,3.14.2,72,1,625,1502,2127,5,FALSE
react-tagsinput,3.14.2,3.14.3,73,2,54,13,67,9,FALSE
react-tagsinput,3.14.3,3.15.0,74,2,57,5,62,9,FALSE
react-tagsinput,3.16.0,3.16.1,77,1,28,62,90,5,FALSE
react-tagsinput,3.10.0,3.11.0,61,4,128,45,173,12,FALSE
react-tagsinput,3.15.0,3.15.1,75,3,10,14,24,5,FALSE
react-tagsinput,3.11.0,3.12.0,62,3,135,32,167,9,FALSE
react-tagsinput,3.13.6,3.14.0,70,2,20920,19200,40120,17,FALSE
react-tagsinput,3.13.5,3.13.6,69,5,18,10,28,9,FALSE
react-tagsinput,3.13.4,3.13.5,68,2,15,3,18,5,FALSE
react-tagsinput,3.13.3,3.13.4,67,3,35,6,41,8,FALSE
react-tagsinput,3.13.2,3.13.3,66,1,14649,14604,29253,6,FALSE
react-tagsinput,3.13.1,3.13.2,65,2,3040,2755,5795,12,FALSE
react-tagsinput,3.13.0,3.13.1,64,3,54,3,57,6,FALSE
react-tagsinput,3.9.1,3.10.0,60,1,6587,6865,13452,9,FALSE
react-tagsinput,3.9.0,3.9.1,59,1,20531,20406,40937,7,FALSE
react-tagsinput,3.8.2,3.9.0,58,1,25772,65,25837,10,FALSE
react-tagsinput,3.12.0,3.13.0,63,2,2534,2059,4593,10,FALSE
react-tagsinput,3.8.0,3.8.1,56,1,34,6,40,5,FALSE
react-tagsinput,3.8.1,3.8.2,57,3,60,15,75,9,FALSE
react-tagsinput,3.15.1,3.16.0,76,2,109,10,119,9,FALSE
react-tagsinput,3.7.1,3.7.2,53,2,90,35,125,5,FALSE
react-tagsinput,3.7.3,3.8.0,55,3,134,13,147,10,FALSE
react-tagsinput,3.7.2,3.7.3,54,3,11,4,15,5,FALSE
react-tagsinput,3.13.3,3.13.4,67,3,35,6,41,8,TRUE
react-tagsinput,3.1.0,3.2.0,41,5,86,25,111,12,FALSE
react-tagsinput,3.0.2,3.0.3,39,1,71,14,85,6,TRUE
react-tagsinput,3.0.3,3.1.0,40,5,114,3,117,11,FALSE
react-tagsinput,3.0.0,3.0.1,37,2,15,10,25,7,FALSE
react-tagsinput,3.0.1,3.0.2,38,1,50,5,55,6,FALSE
react-tagsinput,3.6.1,3.6.2,50,1,58,11,69,7,FALSE
react-tagsinput,3.8.2,3.9.0,58,1,25772,65,25837,10,TRUE
react-tagsinput,3.4.0,3.4.1,45,2,11,6,17,4,FALSE
react-tagsinput,3.4.1,3.5.0,46,2,11,6,17,4,FALSE
react-tagsinput,3.5.1,3.6.0,48,4,361,147,508,19,FALSE
react-tagsinput,3.5.0,3.5.1,47,1,2,1,3,1,FALSE
react-tagsinput,3.6.0,3.6.1,49,1,17,4,21,6,FALSE
react-tagsinput,3.3.0,3.4.0,44,3,94,77,171,5,FALSE
react-tagsinput,3.6.2,3.7.0,51,2,47,9,56,7,FALSE
react-tagsinput,3.2.0,3.2.1,42,5,51,34,85,9,FALSE
react-tagsinput,3.2.1,3.3.0,43,3,94,52,146,12,FALSE
react-tagsinput,3.7.0,3.7.1,52,4,173,87,260,9,FALSE
react-tagsinput,2.0.1,3.0.0,36,3,571,1701,2272,18,FALSE
react-tagsinput,2.0.0,2.0.1,35,2,13,3,16,5,FALSE
react-tagsinput,3.0.2,3.0.3,39,1,71,14,85,6,FALSE
react-tagsinput,1.4.0,1.4.1,26,2,13,2,15,6,FALSE
react-tagsinput,1.4.1,1.4.2,27,4,26,3,29,6,FALSE
react-tagsinput,1.4.2,1.4.3,28,1,24,2,26,6,FALSE
react-tagsinput,1.4.3,1.4.4,29,3,25,3,28,8,FALSE
react-tagsinput,1.4.4,1.4.5,30,1,38,3,41,6,FALSE
react-tagsinput,1.4.5,1.4.6,31,1,11,5,16,5,FALSE
react-tagsinput,1.4.6,1.4.7,32,2,15,2,17,5,FALSE
react-tagsinput,1.5.0-beta1,2.0.0,34,10,140,46,186,32,FALSE
react-tagsinput,1.3.9,1.4.0,25,8,141,7,148,11,FALSE
react-tagsinput,1.3.8,1.3.9,24,1,7,3,10,3,FALSE
react-tagsinput,1.4.1,1.4.2,27,4,26,3,29,6,TRUE
react-tagsinput,1.4.3,1.4.4,29,3,25,3,28,8,TRUE
react-tagsinput,3.15.1,3.16.0,76,2,109,10,119,9,TRUE
react-tagsinput,3.10.0,3.11.0,61,4,128,45,173,12,TRUE
react-tagsinput,3.16.0,3.16.1,77,1,28,62,90,5,TRUE
react-tagsinput,3.7.0,3.7.1,52,4,173,87,260,9,TRUE
briskly-router,0.3.1,0.3.2,4,4,23,3,26,7,FALSE
briskly-router,0.11.0,0.11.1,31,3,39,42,81,4,FALSE
briskly-router,0.11.2,0.12.0,33,12,228,2004,2232,38,FALSE
briskly-router,0.2.0,0.3.0,2,5,159,14,173,6,FALSE
briskly-router,0.10.1,0.10.2,27,2,2,2,4,2,FALSE
briskly-router,0.10.0,0.10.1,26,2,3,3,6,2,FALSE
briskly-router,0.10.3,0.10.4,29,6,44,69,113,26,FALSE
briskly-router,0.10.2,0.10.3,28,2,16,4,20,2,FALSE
briskly-router,0.10.4,0.11.0,30,4,95,85,180,18,FALSE
briskly-router,0.3.2,0.3.3,5,8,90,94,184,17,FALSE
briskly-router,0.3.3,0.4.0,6,8,92,13,105,14,FALSE
briskly-router,0.3.0,0.3.1,3,4,66,1,67,8,FALSE
briskly-router,0.6.0,0.6.1,12,2,4,4,8,2,FALSE
briskly-router,0.7.2,0.8.0,16,4,5,28,33,7,FALSE
briskly-router,0.11.1,0.11.2,32,2,41,37,78,3,FALSE
briskly-router,0.7.0,0.7.1,14,4,64,25,89,8,FALSE
briskly-router,0.7.1,0.7.2,15,2,1,3,4,3,FALSE
briskly-router,0.4.1,0.4.2,8,2,14,3,17,2,FALSE
briskly-router,0.4.0,0.4.1,7,2,6,1,7,2,FALSE
briskly-router,0.4.3,0.5.0,10,5,60,13,73,7,FALSE
briskly-router,0.4.2,0.4.3,9,6,82,24,106,8,FALSE
briskly-router,0.5.0,0.6.0,11,12,209,20,229,18,FALSE
briskly-router,0.9.0,0.9.1,21,3,10,10,20,6,FALSE
briskly-router,0.9.1,0.9.2,22,2,6,1,7,3,FALSE
briskly-router,0.9.2,0.9.3,23,2,6,6,12,2,FALSE
briskly-router,0.9.3,0.9.4,24,2,17,14,31,3,FALSE
briskly-router,0.9.4,0.10.0,25,2,14,1,15,4,FALSE
briskly-router,0.8.1,0.8.2,18,3,137,133,270,22,FALSE
briskly-router,0.8.0,0.8.1,17,2,2,2,4,2,FALSE
briskly-router,0.8.3,0.9.0,20,7,1415,636,2051,46,FALSE
briskly-router,0.8.2,0.8.3,19,1,1,0,1,1,FALSE
briskly-router,0.6.1,0.7.0,13,22,638,67,705,49,FALSE
briskly-router,0.1.0-pre,0.2.0,1,113,2705,1092,3797,246,FALSE
briskly-router,0.11.0,0.11.1,31,3,39,42,81,4,TRUE
briskly-router,0.11.2,0.12.0,33,12,228,2004,2232,38,TRUE
briskly-router,0.2.0,0.3.0,2,5,159,14,173,6,TRUE
briskly-router,0.10.1,0.10.2,27,2,2,2,4,2,TRUE
briskly-router,0.10.0,0.10.1,26,2,3,3,6,2,TRUE
briskly-router,0.10.3,0.10.4,29,6,44,69,113,26,TRUE
briskly-router,0.10.2,0.10.3,28,2,16,4,20,2,TRUE
briskly-router,0.3.3,0.4.0,6,8,92,13,105,14,TRUE
briskly-router,0.11.1,0.11.2,32,2,41,37,78,3,TRUE
briskly-router,0.4.3,0.5.0,10,5,60,13,73,7,TRUE
briskly-router,0.5.0,0.6.0,11,12,209,20,229,18,TRUE
briskly-router,0.9.2,0.9.3,23,2,6,6,12,2,TRUE
briskly-router,0.1.0-pre,0.2.0,1,113,2705,1092,3797,246,TRUE
briskly-router,0.6.1,0.7.0,13,22,638,67,705,49,TRUE
tinper-neoui-polyfill,3.1.3,3.1.4,7,2,6,6,12,4,FALSE
tinper-neoui-polyfill,3.1.2,3.1.3,6,2,9,4,13,4,FALSE
tinper-neoui-polyfill,3.1.1,3.1.2,5,1,6,1,7,2,FALSE
tinper-neoui-polyfill,3.1.7,3.1.8,11,1,3,3,6,2,FALSE
tinper-neoui-polyfill,3.1.6,3.1.7,10,2,6,6,12,4,FALSE
tinper-neoui-polyfill,3.1.5,3.1.6,9,2,6,6,12,4,FALSE
tinper-neoui-polyfill,3.1.4,3.1.5,8,2,6,6,12,4,FALSE
tinper-neoui-polyfill,3.1.9,3.1.12,13,4,9,4,13,5,FALSE
tinper-neoui-polyfill,3.1.8,3.1.9,12,4,44,3,47,7,FALSE
tinper-neoui-polyfill,0.1.0,0.1.1,3,1,1,1,2,1,FALSE
tinper-neoui-polyfill,0.1.1,3.1.1,4,5,122,32,154,6,FALSE
tinper-neoui-polyfill,0.0.1,0.0.2,1,1,1,2,3,1,FALSE
tinper-neoui-polyfill,0.0.2,0.1.0,2,1,1,1,2,1,FALSE
tinper-neoui-polyfill,3.1.22,3.1.23,23,2,42,1,43,3,FALSE
tinper-neoui-polyfill,3.1.23,3.1.25,24,3,81,40,121,9,FALSE
tinper-neoui-polyfill,3.1.21,3.1.22,22,1,6,1,7,2,FALSE
tinper-neoui-polyfill,3.1.26,3.2.0,26,3,89,930,1019,15,FALSE
tinper-neoui-polyfill,3.1.25,3.1.26,25,3,30,245,275,13,FALSE
tinper-neoui-polyfill,3.1.13,3.1.14,15,2,12,2,14,4,FALSE
tinper-neoui-polyfill,3.1.12,3.1.13,14,2,9,4,13,4,FALSE
tinper-neoui-polyfill,3.1.17,3.1.18,19,1,6,1,7,2,FALSE
tinper-neoui-polyfill,3.1.16,3.1.17,18,3,38,10,48,9,FALSE
tinper-neoui-polyfill,3.1.15,3.1.16,17,3,35,13,48,9,FALSE
tinper-neoui-polyfill,3.1.14,3.1.15,16,2,12,2,14,4,FALSE
tinper-neoui-polyfill,3.1.19,3.1.21,21,3,13,3,16,5,FALSE
tinper-neoui-polyfill,3.1.18,3.1.19,20,2,12,2,14,4,FALSE
tinper-neoui-polyfill,3.2.0,3.2.1,27,4,14,4,18,6,FALSE
tinper-neoui-polyfill,3.1.2,3.1.3,6,2,9,4,13,4,TRUE
tinper-neoui-polyfill,3.1.3,3.1.4,7,2,6,6,12,4,TRUE
tinper-neoui-polyfill,3.1.15,3.1.16,17,3,35,13,48,9,TRUE
scroll-behavior,0.9.0,0.9.1,17,3,13,69,82,11,FALSE
scroll-behavior,0.9.1,0.9.2,18,3,1,19,20,3,FALSE
scroll-behavior,0.9.2,0.9.3,19,6,183,75,258,16,FALSE
scroll-behavior,0.8.1,0.8.2,15,3,3,3,6,3,FALSE
scroll-behavior,0.8.0,0.8.1,14,5,5,5,10,5,FALSE
scroll-behavior,0.8.2,0.9.0,16,3,851,867,1718,33,FALSE
scroll-behavior,0.3.1,0.3.2,5,8,303,165,468,22,FALSE
scroll-behavior,0.3.2,0.3.3,6,5,11,11,22,5,FALSE
scroll-behavior,0.3.3,0.3.4,7,5,71,51,122,15,FALSE
scroll-behavior,0.3.0,0.3.1,4,7,15,13,28,9,FALSE
scroll-behavior,0.6.0,0.6.1,11,9,37,63,100,13,FALSE
scroll-behavior,0.3.4,0.4.0,8,7,264,94,358,28,FALSE
scroll-behavior,0.2.0,0.3.0,3,12,366,238,604,37,FALSE
scroll-behavior,0.4.0,0.5.0,9,9,831,727,1558,37,FALSE
scroll-behavior,0.5.0,0.6.0,10,5,1015,1725,2740,61,FALSE
scroll-behavior,0.6.1,0.7.0,12,9,317,203,520,21,FALSE
scroll-behavior,0.7.0,0.8.0,13,33,1736,1212,2948,89,FALSE
scroll-behavior,0.1.0,0.2.0,2,20,1073,260,1333,69,FALSE
scroll-behavior,0.9.2,0.9.3,19,6,183,75,258,16,TRUE
scroll-behavior,0.2.0,0.3.0,3,12,366,238,604,37,TRUE
scroll-behavior,0.7.0,0.8.0,13,33,1736,1212,2948,89,TRUE
scroll-behavior,0.5.0,0.6.0,10,5,1015,1725,2740,61,TRUE
scroll-behavior,0.6.1,0.7.0,12,9,317,203,520,21,TRUE
scroll-behavior,0.1.0,0.2.0,2,20,1073,260,1333,69,TRUE
fluxtuate-react,0.0.55,0.0.56,49,1,7,7,14,3,FALSE
fluxtuate-react,0.0.13,0.0.14,11,1,2,2,4,1,FALSE
fluxtuate-react,0.0.12,0.0.13,10,1,2,2,4,1,FALSE
fluxtuate-react,0.0.15,0.0.16,13,1,2,2,4,1,FALSE
fluxtuate-react,0.0.14,0.0.15,12,2,108,3,111,7,FALSE
fluxtuate-react,0.0.17,0.0.18,15,1,2,2,4,2,FALSE
fluxtuate-react,0.0.16,0.0.17,14,1,2,2,4,2,FALSE
fluxtuate-react,0.0.11,0.0.12,9,1,2,2,4,1,FALSE
fluxtuate-react,0.0.10,0.0.11,8,1,2,2,4,1,FALSE
fluxtuate-react,0.0.39,0.0.40,37,2,4,4,8,2,FALSE
fluxtuate-react,0.0.38,0.0.39,36,1,2,2,4,1,FALSE
fluxtuate-react,0.0.37,0.0.38,35,1,2,2,4,2,FALSE
fluxtuate-react,0.0.36,0.0.37,34,1,5,4,9,2,FALSE
fluxtuate-react,0.0.35,0.0.36,33,2,89,31,120,8,FALSE
fluxtuate-react,0.0.34,0.0.35,32,2,4,4,8,2,FALSE
fluxtuate-react,0.0.33,0.0.34,31,1,3,3,6,2,FALSE
fluxtuate-react,0.0.18,0.0.19,16,1,2,2,4,1,FALSE
fluxtuate-react,0.0.31,0.0.32,29,1,2,2,4,1,FALSE
fluxtuate-react,0.0.30,0.0.31,28,1,2,2,4,1,FALSE
fluxtuate-react,0.0.5,0.0.6,3,2,4,4,8,2,FALSE
fluxtuate-react,0.0.4,0.0.5,2,1,2,2,4,1,FALSE
fluxtuate-react,0.0.7,0.0.8,5,1,2,2,4,1,FALSE
fluxtuate-react,0.0.6,0.0.7,4,1,2,2,4,1,FALSE
fluxtuate-react,0.0.2,0.0.4,1,1,1,1,2,1,FALSE
fluxtuate-react,0.0.19,0.0.20,17,1,2,2,4,1,FALSE
fluxtuate-react,0.0.9,0.0.10,7,1,2,2,4,1,FALSE
fluxtuate-react,0.0.8,0.0.9,6,1,2,2,4,1,FALSE
fluxtuate-react,0.0.54,0.0.55,48,1,4,3,7,3,FALSE
fluxtuate-react,0.0.53,0.0.54,47,1,1,2,3,1,FALSE
fluxtuate-react,0.0.57,0.0.58,51,2,5,4,9,4,FALSE
fluxtuate-react,0.0.56,0.0.57,50,1,135,7,142,5,FALSE
fluxtuate-react,0.0.50,0.0.51,44,1,2,2,4,1,FALSE
fluxtuate-react,0.0.29,0.0.30,27,1,2,2,4,1,FALSE
fluxtuate-react,0.0.20,0.0.21,18,1,2,2,4,1,FALSE
fluxtuate-react,0.0.21,0.0.22,19,1,2,2,4,1,FALSE
fluxtuate-react,0.0.22,0.0.23,20,1,69,28,97,6,FALSE
fluxtuate-react,0.0.23,0.0.24,21,1,3,2,5,2,FALSE
fluxtuate-react,0.0.24,0.0.25,22,1,2,2,4,2,FALSE
fluxtuate-react,0.0.25,0.0.26,23,2,4,4,8,2,FALSE
fluxtuate-react,0.0.26,0.0.27,24,1,2,2,4,1,FALSE
fluxtuate-react,0.0.27,0.0.28,25,1,2,2,4,2,FALSE
fluxtuate-react,0.0.28,0.0.29,26,2,4,4,8,2,FALSE
fluxtuate-react,0.0.43,0.0.44,41,1,2,2,4,1,FALSE
fluxtuate-react,0.0.40,0.0.41,38,2,4,4,8,2,FALSE
fluxtuate-react,0.0.41,0.0.42,39,1,2,2,4,2,FALSE
fluxtuate-react,0.0.44,0.0.45,42,1,2,2,4,1,FALSE
fluxtuate-react,0.0.45,0.0.50,43,1,2,2,4,2,FALSE
fluxtuate-react,0.0.42,0.0.43,40,2,4,4,8,2,FALSE
fluxtuate-react,0.0.58,0.0.59,52,1,2,2,4,2,FALSE
fluxtuate-react,0.0.32,0.0.33,30,1,2,2,4,2,FALSE
fluxtuate-react,0.0.52,0.0.53,46,1,2,2,4,2,FALSE
fluxtuate-react,0.0.51,0.0.52,45,2,4,4,8,2,FALSE
fluxtuate-react,0.0.51,0.0.52,45,2,4,4,8,2,TRUE
fluxtuate-react,0.0.40,0.0.41,38,2,4,4,8,2,TRUE
fluxtuate-react,0.0.13,0.0.14,11,1,2,2,4,1,TRUE
hal-serializer,0.1.0,0.1.1,1,3,11,7,18,5,FALSE
hal-serializer,0.1.1,1.0.0,2,4,271,110,381,9,FALSE
hal-serializer,0.1.1,1.0.0,2,4,271,110,381,9,TRUE
mobx-component,0.2.2,0.2.3,8,2,218,13,231,12,FALSE
mobx-component,0.2.1,0.2.2,7,2,2,2,4,2,FALSE
mobx-component,0.2.0,0.2.1,6,2,99,7,106,7,FALSE
mobx-component,0.1.0,0.1.1,1,2,4,4,8,2,FALSE
mobx-component,0.1.1,0.1.2,2,1,2,3,5,1,FALSE
mobx-component,0.1.2,0.1.3,3,3,9,9,18,3,FALSE
mobx-component,0.1.3,0.1.4,4,3,8,43,51,6,FALSE
mobx-component,0.1.4,0.2.0,5,8,101,90,191,11,FALSE
mobx-component,0.2.0,0.2.1,6,2,99,7,106,7,TRUE
mobx-component,0.1.4,0.2.0,5,8,101,90,191,11,TRUE
redux-autoform-bootstrap-ui,1.1.1,1.1.2,6,6,37,10,47,7,FALSE
redux-autoform-bootstrap-ui,1.1.0,1.1.1,5,4,24,24,48,26,FALSE
redux-autoform-bootstrap-ui,1.1.3,1.2.0-beta,8,24,796,279,1075,109,FALSE
redux-autoform-bootstrap-ui,1.1.2,1.1.3,7,1,3,3,6,2,FALSE
redux-autoform-bootstrap-ui,1.7.1-experimental,1.8.0-experimental,35,20,5425,106,5531,41,FALSE
redux-autoform-bootstrap-ui,1.0.2,1.0.3,3,5,100,43,143,17,FALSE
redux-autoform-bootstrap-ui,1.0.3,1.1.0,4,1,2,2,4,1,FALSE
redux-autoform-bootstrap-ui,1.6.4-experimental,1.6.5-experimental,23,3,490,31,521,12,FALSE
redux-autoform-bootstrap-ui,1.6.11-experimental,1.6.12-experimental,30,6,321,63,384,19,FALSE
redux-autoform-bootstrap-ui,1.6.10-experimental,1.6.11-experimental,29,2,3,3,6,3,FALSE
redux-autoform-bootstrap-ui,1.6.1-experimental,1.6.2-experimental,20,1,2,2,4,1,FALSE
redux-autoform-bootstrap-ui,1.6.12-experimental,1.6.13-experimental,31,1,1,1,2,1,FALSE
redux-autoform-bootstrap-ui,1.6.2-experimental,1.6.3-experimental,21,3,3,3,6,3,FALSE
redux-autoform-bootstrap-ui,1.4.2-experimental,1.4.3-experimental,14,4,28,47,75,11,FALSE
redux-autoform-bootstrap-ui,1.4.3-experimental,1.4.5-experimental,15,6,142,27,169,9,FALSE
redux-autoform-bootstrap-ui,1.6.0,1.6.1-experimental,19,2,158,99,257,14,FALSE
redux-autoform-bootstrap-ui,1.6.5-experimental,1.6.6-experimental,24,2,26,2,28,4,FALSE
redux-autoform-bootstrap-ui,1.6.13-experimental,1.6.14-experimental,32,3,20,9,29,3,FALSE
redux-autoform-bootstrap-ui,1.4.0,1.4.1,12,2,41,5,46,2,FALSE
redux-autoform-bootstrap-ui,1.6.7-experimental,1.6.8-experimental,26,6,198,142,340,13,FALSE
redux-autoform-bootstrap-ui,1.4.1,1.4.2-experimental,13,23,593,165,758,42,FALSE
redux-autoform-bootstrap-ui,1.7.0-experimental,1.7.1-experimental,34,1,2,2,4,1,FALSE
redux-autoform-bootstrap-ui,1.5.0,1.6.0,18,19,553,212,765,46,FALSE
redux-autoform-bootstrap-ui,1.6.8-experimental,1.6.9-experimental,27,6,836,122,958,30,FALSE
redux-autoform-bootstrap-ui,1.4.5-experimental,1.4.6-experimental,16,1,1,1,2,1,FALSE
redux-autoform-bootstrap-ui,1.3.0,1.4.0,11,51,1765,490,2255,105,FALSE
redux-autoform-bootstrap-ui,1.2.0,1.3.0,10,1,2,2,4,1,FALSE
redux-autoform-bootstrap-ui,1.6.6-experimental,1.6.7-experimental,25,3,77,40,117,9,FALSE
redux-autoform-bootstrap-ui,1.8.0-experimental,1.8.1-experimental,36,2,3,3,6,2,FALSE
redux-autoform-bootstrap-ui,1.2.0-beta,1.2.0,9,8,162,268,430,13,FALSE
redux-autoform-bootstrap-ui,1.6.9-experimental,1.6.10-experimental,28,3,4,4,8,3,FALSE
redux-autoform-bootstrap-ui,1.6.3-experimental,1.6.4-experimental,22,1,2,2,4,1,FALSE
redux-autoform-bootstrap-ui,1.6.14-experimental,1.7.0-experimental,33,9,622,429,1051,72,FALSE
redux-autoform-bootstrap-ui,1.1.1,1.1.2,6,6,37,10,47,7,TRUE
redux-autoform-bootstrap-ui,1.0.0,1.0.1,1,9,118,74,192,17,TRUE
redux-autoform-bootstrap-ui,1.0.1,1.0.2,2,40,4263,560,4823,193,TRUE
redux-autoform-bootstrap-ui,1.0.0,1.0.1,1,9,118,74,192,17,FALSE
redux-autoform-bootstrap-ui,1.0.1,1.0.2,2,40,4263,560,4823,193,FALSE
redux-autoform-bootstrap-ui,1.6.14-experimental,1.7.0-experimental,33,9,622,429,1051,72,TRUE
redux-autoform-bootstrap-ui,1.4.1,1.4.2-experimental,13,23,593,165,758,42,TRUE
redux-autoform-bootstrap-ui,1.3.0,1.4.0,11,51,1765,490,2255,105,TRUE
redux-autoform-bootstrap-ui,1.4.2-experimental,1.4.3-experimental,14,4,28,47,75,11,TRUE
redux-autoform-bootstrap-ui,1.5.0,1.6.0,18,19,553,212,765,46,TRUE
flare-gun,0.6.0,0.6.1,26,2,31,3,34,4,FALSE
flare-gun,0.2.4,0.3.0,9,1,24,9,33,3,FALSE
flare-gun,0.2.3,0.2.4,8,2,29,2,31,4,FALSE
flare-gun,0.6.5,0.6.6,31,2,69,2,71,4,FALSE
flare-gun,0.2.1,0.2.2,6,1,13,5,18,3,FALSE
flare-gun,0.2.0,0.2.1,5,2,18,6,24,4,FALSE
flare-gun,0.1.0,0.1.1,1,1,76,22,98,4,FALSE
flare-gun,0.1.1,0.1.2,2,2,2,2,4,3,FALSE
flare-gun,0.1.2,0.1.3,3,3,119,18,137,6,FALSE
flare-gun,0.1.3,0.2.0,4,1,44,43,87,3,FALSE
flare-gun,0.3.2,0.3.3,12,1,28,8,36,3,FALSE
flare-gun,0.3.3,0.3.4,13,1,116,58,174,2,FALSE
flare-gun,0.3.0,0.3.1,10,1,84,85,169,2,FALSE
flare-gun,0.3.1,0.3.2,11,1,28,1,29,3,FALSE
flare-gun,0.6.7,0.6.8,33,2,45,8,53,3,FALSE
flare-gun,0.6.6,0.6.7,32,2,2,2,4,2,FALSE
flare-gun,0.3.4,0.4.0,14,2,98,44,142,7,FALSE
flare-gun,0.6.4,0.6.5,30,2,2,2,4,2,FALSE
flare-gun,0.5.8,0.6.0,25,8,253,293,546,18,FALSE
flare-gun,0.4.1,0.5.0,16,2,3,2,5,3,FALSE
flare-gun,0.4.0,0.4.1,15,1,35,16,51,3,FALSE
flare-gun,0.5.6,0.5.7,23,2,3,1,4,2,FALSE
flare-gun,0.5.7,0.5.8,24,4,43,21,64,7,FALSE
flare-gun,0.5.0,0.5.1,17,2,58,2,60,8,FALSE
flare-gun,0.5.1,0.5.2,18,3,135,21,156,7,FALSE
flare-gun,0.5.2,0.5.3,19,3,57,52,109,4,FALSE
flare-gun,0.5.3,0.5.4,20,2,62,21,83,4,FALSE
flare-gun,0.5.4,0.5.5,21,2,2,2,4,2,FALSE
flare-gun,0.5.5,0.5.6,22,2,7,3,10,3,FALSE
flare-gun,0.6.3,0.6.4,29,2,2,8,10,2,FALSE
flare-gun,0.6.2,0.6.3,28,2,7,7,14,2,FALSE
flare-gun,0.6.1,0.6.2,27,3,18,5,23,4,FALSE
flare-gun,0.2.2,0.2.3,7,1,14,2,16,3,FALSE
flare-gun,0.6.6,0.6.7,32,2,2,2,4,2,TRUE
flare-gun,0.6.1,0.6.2,27,3,18,5,23,4,TRUE
flare-gun,0.6.0,0.6.1,26,2,31,3,34,4,TRUE
wx,0.0.24,0.0.25,23,1,3,2,5,2,FALSE
wx,0.0.25,0.0.26,24,4,107,85,192,5,FALSE
wx,0.0.26,0.0.27,25,1,3,2,5,2,FALSE
wx,0.0.27,0.0.28,26,6,437,37,474,9,FALSE
wx,0.0.28,0.0.29,27,1,2,2,4,2,FALSE
wx,0.0.29,0.0.30,28,1,14,16,30,5,FALSE
wx,0.0.35,0.0.36,34,1,1,4,5,2,FALSE
wx,0.0.34,0.0.35,33,2,2,0,2,2,FALSE
wx,0.0.33,0.0.34,32,1,1,1,2,1,FALSE
wx,0.0.32,0.0.33,31,5,19,22,41,7,FALSE
wx,0.0.31,0.0.32,30,1,3,2,5,2,FALSE
wx,0.0.30,0.0.31,29,1,3,1,4,2,FALSE
wx,0.0.15,0.0.16,14,6,51,35,86,10,FALSE
wx,0.0.14,0.0.15,13,7,39,34,73,9,FALSE
wx,0.0.17,0.0.18,16,1,4,1,5,2,FALSE
wx,0.0.16,0.0.17,15,4,74,42,116,5,FALSE
wx,0.0.11,0.0.12,10,1,3,2,5,2,FALSE
wx,0.0.10,0.0.11,9,1,3,2,5,2,FALSE
wx,0.0.13,0.0.14,12,20,573,323,896,30,FALSE
wx,0.0.12,0.0.13,11,6,35447,26,35473,93,FALSE
wx,0.0.19,0.0.20,18,2,20,8,28,4,FALSE
wx,0.0.18,0.0.19,17,2,8,8,16,2,FALSE
wx,0.0.5,0.0.6,5,1,3,2,5,2,FALSE
wx,0.0.4,0.0.5,4,1,3,2,5,2,FALSE
wx,0.0.7,0.0.8,7,1,3,2,5,2,FALSE
wx,0.0.6,0.0.7,6,1,3,2,5,2,FALSE
wx,0.0.1,0.0.2,1,1,3,2,5,2,FALSE
wx,0.0.3,0.0.4,3,1,3,2,5,2,FALSE
wx,0.0.2,0.0.3,2,1,3,2,5,2,FALSE
wx,0.0.8,0.0.10,8,1,3,2,5,2,FALSE
wx,0.0.20,0.0.21,19,6,127,70,197,15,FALSE
wx,0.0.21,0.0.22,20,1,3,2,5,2,FALSE
wx,0.0.22,0.0.23,21,1,3,2,5,2,FALSE
wx,0.0.23,0.0.24,22,8,275,150,425,10,FALSE
wx,0.0.10,0.0.11,9,1,3,2,5,2,TRUE
wx,0.0.34,0.0.35,33,2,2,0,2,2,TRUE
wx,0.0.17,0.0.18,16,1,4,1,5,2,TRUE
wx,0.0.8,0.0.10,8,1,3,2,5,2,TRUE
wx,0.0.7,0.0.8,7,1,3,2,5,2,TRUE
react-simple-scroll,0.0.1,0.0.2,1,1,1,1,2,1,FALSE
react-simple-scroll,0.0.3,1.0.0,3,2,574,3,577,11,FALSE
react-simple-scroll,0.0.2,0.0.3,2,1,1,1,2,1,FALSE
react-simple-scroll,0.0.3,1.0.0,3,2,574,3,577,11,TRUE
js-utility-belt,1.0.0,1.0.1,1,3,67,1,68,5,FALSE
js-utility-belt,1.0.1,1.0.2,2,3,25,27,52,5,FALSE
js-utility-belt,1.0.2,1.0.3,3,2,2,1,3,2,FALSE
js-utility-belt,1.0.3,1.0.4,4,2,13,6,19,2,FALSE
js-utility-belt,1.4.0,1.4.1,13,3,27,10,37,3,FALSE
js-utility-belt,1.1.0,1.2.0,7,3,5,7,12,9,FALSE
js-utility-belt,1.4.2,1.4.3,15,2,3,3,6,2,FALSE
js-utility-belt,1.4.3,1.4.4,16,2,1,2,3,2,FALSE
js-utility-belt,1.4.4,1.4.6,17,5,17,18,35,7,FALSE
js-utility-belt,1.4.6,1.5.0,18,2,6,2,8,3,FALSE
js-utility-belt,1.0.5,1.1.0,6,5,37,41,78,5,FALSE
js-utility-belt,1.2.1,1.2.2,9,2,2,2,4,2,FALSE
js-utility-belt,1.3.1,1.4.0,12,4,169,1,170,10,FALSE
js-utility-belt,1.3.0,1.3.1,11,4,5,7,12,5,FALSE
js-utility-belt,1.2.2,1.3.0,10,9,241,45,286,16,FALSE
js-utility-belt,1.2.0,1.2.1,8,2,3,4,7,5,FALSE
js-utility-belt,1.4.1,1.4.2,14,2,4,1,5,2,FALSE
js-utility-belt,1.0.4,1.0.5,5,12,2115,1871,3986,120,TRUE
js-utility-belt,1.0.4,1.0.5,5,12,2115,1871,3986,120,FALSE
js-utility-belt,1.0.5,1.1.0,6,5,37,41,78,5,TRUE
js-utility-belt,1.3.1,1.4.0,12,4,169,1,170,10,TRUE
js-utility-belt,1.2.2,1.3.0,10,9,241,45,286,16,TRUE
js-utility-belt,1.4.2,1.4.3,15,2,3,3,6,2,TRUE
js-utility-belt,1.4.4,1.4.6,17,5,17,18,35,7,TRUE
js-utility-belt,1.3.0,1.3.1,11,4,5,7,12,5,TRUE
pelias-wof-admin-lookup,1.1.1,1.1.2,5,3,215,95,310,13,FALSE
pelias-wof-admin-lookup,1.1.0,1.1.1,4,2,2,2,4,2,FALSE
pelias-wof-admin-lookup,1.1.3,1.1.4,7,4,4,4,8,4,FALSE
pelias-wof-admin-lookup,1.1.2,1.1.3,6,9,371,238,609,21,FALSE
pelias-wof-admin-lookup,1.0.0,1.0.1,1,4,123,27,150,7,FALSE
pelias-wof-admin-lookup,1.0.1,1.0.2,2,6,437,9,446,13,FALSE
pelias-wof-admin-lookup,1.0.2,1.1.0,3,4,210,90,300,11,FALSE
pelias-wof-admin-lookup,2.0.0,2.1.0,16,7,16,5,21,9,FALSE
pelias-wof-admin-lookup,3.1.1,3.1.2,33,4,1501,241,1742,33,FALSE
pelias-wof-admin-lookup,3.1.3,3.2.0,35,14,628,900,1528,39,FALSE
pelias-wof-admin-lookup,3.1.0,3.1.1,32,3,3,3,6,3,FALSE
pelias-wof-admin-lookup,2.2.0,2.3.0,18,7,26,22,48,7,FALSE
pelias-wof-admin-lookup,1.1.5,1.2.0,9,8,366,221,587,20,FALSE
pelias-wof-admin-lookup,2.1.0,2.2.0,17,20,84,34,118,24,FALSE
pelias-wof-admin-lookup,3.5.0,3.5.1,40,6,6,6,12,6,FALSE
pelias-wof-admin-lookup,1.1.4,1.1.5,8,6,46,16,62,10,FALSE
pelias-wof-admin-lookup,3.3.1,3.4.0,38,5,13,15,28,6,FALSE
pelias-wof-admin-lookup,3.0.0,3.1.0,31,4,4,4,8,4,FALSE
pelias-wof-admin-lookup,2.8.1,2.8.2,26,4,11,3,14,4,FALSE
pelias-wof-admin-lookup,1.6.0,2.0.0,15,9,247,75,322,13,FALSE
pelias-wof-admin-lookup,2.11.0,3.0.0,30,17,50504,1474,51978,95,FALSE
pelias-wof-admin-lookup,3.2.0,3.3.0,36,2,23992,7934,31926,16,FALSE
pelias-wof-admin-lookup,1.4.0,1.5.0,13,2,2,2,4,2,FALSE
pelias-wof-admin-lookup,2.3.0,2.3.1,19,2,2,2,4,2,FALSE
pelias-wof-admin-lookup,2.3.1,2.4.0,20,5,8,4,12,6,FALSE
pelias-wof-admin-lookup,1.5.0,1.6.0,14,6,119,59,178,17,FALSE
pelias-wof-admin-lookup,1.3.0,1.4.0,12,7,15,23,38,7,FALSE
pelias-wof-admin-lookup,1.2.0,1.2.1,10,3,7,7,14,3,FALSE
pelias-wof-admin-lookup,1.2.1,1.3.0,11,3,3,3,6,3,FALSE
pelias-wof-admin-lookup,2.4.0,2.5.0,21,1,44,3,47,2,FALSE
pelias-wof-admin-lookup,2.5.0,2.6.0,22,8,8,8,16,8,FALSE
pelias-wof-admin-lookup,2.9.0,2.10.0,28,6,715,199,914,33,FALSE
pelias-wof-admin-lookup,2.6.0,2.7.0,23,4,4,4,8,4,FALSE
pelias-wof-admin-lookup,2.10.0,2.11.0,29,2,2,2,4,2,FALSE
pelias-wof-admin-lookup,2.7.0,2.8.0,24,2,2,2,4,2,FALSE
pelias-wof-admin-lookup,2.8.2,2.9.0,27,5,5,5,10,5,FALSE
pelias-wof-admin-lookup,3.5.1,3.6.0,41,12,387,61247,61634,39,FALSE
pelias-wof-admin-lookup,2.8.0,2.8.1,25,6,136,514,650,22,FALSE
pelias-wof-admin-lookup,3.6.0,3.7.0,42,1,44,3,47,2,FALSE
pelias-wof-admin-lookup,3.3.0,3.3.1,37,6,12,14,26,7,FALSE
pelias-wof-admin-lookup,3.1.2,3.1.3,34,2,2,2,4,2,FALSE
pelias-wof-admin-lookup,3.4.0,3.5.0,39,4,94,6,100,8,FALSE
pelias-wof-admin-lookup,1.5.0,1.6.0,14,6,119,59,178,17,TRUE
pelias-wof-admin-lookup,2.7.0,2.8.0,24,2,2,2,4,2,TRUE
pelias-wof-admin-lookup,2.8.0,2.8.1,25,6,136,514,650,22,TRUE
pelias-wof-admin-lookup,3.5.0,3.5.1,40,6,6,6,12,6,TRUE
transcript-model,0.3.0,0.4.0,4,4,1457,127,1584,9,FALSE
transcript-model,0.2.1,0.3.0,3,3,20,525,545,4,FALSE
transcript-model,0.2.0,0.2.1,2,2,16,6,22,2,FALSE
transcript-model,0.1.0,0.2.0,1,7,39,6,45,9,FALSE
transcript-model,0.4.0,0.4.1,5,2,2,2,4,2,FALSE
transcript-model,0.1.0,0.2.0,1,7,39,6,45,9,TRUE
textlint-rule-max-ten,1.1.1,1.2.0,4,3,66,73,139,5,FALSE
textlint-rule-max-ten,1.2.0,1.2.1,5,2,50,18,68,5,FALSE
textlint-rule-max-ten,1.2.1,1.2.2,6,2,38,31,69,2,FALSE
textlint-rule-max-ten,1.1.0,1.1.1,3,2,5,3,8,3,FALSE
textlint-rule-max-ten,1.0.1,1.0.2,1,2,12,312,324,6,FALSE
textlint-rule-max-ten,1.0.2,1.1.0,2,4,145,39,184,7,FALSE
textlint-rule-max-ten,2.0.0,2.0.1,8,5,91,35,126,7,FALSE
textlint-rule-max-ten,1.2.2,2.0.0,7,10,205,115,320,19,FALSE
textlint-rule-max-ten,2.0.2,2.0.3,10,3,5,5,10,4,FALSE
textlint-rule-max-ten,2.0.1,2.0.2,9,6,66,39,105,12,FALSE
textlint-rule-max-ten,1.0.2,1.1.0,2,4,145,39,184,7,TRUE
bootstrap-components,1.1.55,1.1.56,63,1,1,1,2,1,FALSE
bootstrap-components,1.1.53,1.1.54,61,1,1,1,2,1,FALSE
bootstrap-components,1.1.47,1.1.48,57,2,775,1419,2194,18,FALSE
bootstrap-components,1.1.60,1.1.63,68,2,180,188,368,15,FALSE
bootstrap-components,1.1.54,1.1.55,62,1,1,1,2,1,FALSE
bootstrap-components,1.1.57,1.1.58,65,1,1,1,2,1,FALSE
bootstrap-components,1.1.56,1.1.57,64,1,61,62,123,5,FALSE
bootstrap-components,1.1.64,1.1.65,70,1,1,1,2,1,FALSE
bootstrap-components,1.1.65,1.1.66,71,1,1,1,2,1,FALSE
bootstrap-components,1.1.63,1.1.64,69,1,1,1,2,1,FALSE
bootstrap-components,1.1.49,1.1.50,59,1,2817,694,3511,18,FALSE
bootstrap-components,1.1.59,1.1.60,67,1,1,1,2,1,FALSE
bootstrap-components,1.1.58,1.1.59,66,1,1,1,2,1,FALSE
bootstrap-components,1.1.48,1.1.49,58,1,1,1,2,1,FALSE
bootstrap-components,1.1.50,1.1.53,60,1,1,1,2,1,FALSE
bootstrap-components,1.1.9,1.1.10,19,1,1,1,2,1,FALSE
bootstrap-components,1.1.8,1.1.9,18,1,1,1,2,1,FALSE
bootstrap-components,1.1.11,1.1.12,21,1,1,1,2,1,FALSE
bootstrap-components,1.1.10,1.1.11,20,1,1,1,2,1,FALSE
bootstrap-components,1.1.13,1.1.14,23,1,1,1,2,1,FALSE
bootstrap-components,1.1.12,1.1.13,22,1,1,1,2,1,FALSE
bootstrap-components,1.1.33,1.1.34,43,1,1,1,2,1,FALSE
bootstrap-components,1.1.32,1.1.33,42,1,71,15,86,4,FALSE
bootstrap-components,1.1.26,1.1.27,36,1,1,1,2,1,FALSE
bootstrap-components,1.1.27,1.1.28,37,1,83,15,98,7,FALSE
bootstrap-components,1.1.37,1.1.38,47,1,1,1,2,1,FALSE
bootstrap-components,1.1.36,1.1.37,46,1,1,1,2,1,FALSE
bootstrap-components,1.1.35,1.1.36,45,1,1,1,2,1,FALSE
bootstrap-components,1.1.34,1.1.35,44,1,1,1,2,1,FALSE
bootstrap-components,1.1.39,1.1.40,49,1,1,1,2,1,FALSE
bootstrap-components,1.1.38,1.1.39,48,2,885,237,1122,6,FALSE
bootstrap-components,1.1.28,1.1.29,38,1,1,1,2,1,FALSE
bootstrap-components,1.1.31,1.1.32,41,1,1,1,2,1,FALSE
bootstrap-components,1.1.29,1.1.30,39,1,1,1,2,1,FALSE
bootstrap-components,1.1.44,1.1.45,54,1,1,1,2,1,FALSE
bootstrap-components,1.1.30,1.1.31,40,1,1,1,2,1,FALSE
bootstrap-components,1.1.42,1.1.43,52,1,1,1,2,1,FALSE
bootstrap-components,1.1.45,1.1.46,55,1,1,1,2,1,FALSE
bootstrap-components,1.1.40,1.1.41,50,1,1,1,2,1,FALSE
bootstrap-components,1.1.41,1.1.42,51,1,1,1,2,1,FALSE
bootstrap-components,1.1.43,1.1.44,53,1,1,1,2,1,FALSE
bootstrap-components,1.1.252,1.1.253,258,1,1,1,2,1,FALSE
bootstrap-components,1.1.253,1.1.254,259,3,64,10,74,5,FALSE
bootstrap-components,1.1.250,1.1.251,256,1,1,1,2,1,FALSE
bootstrap-components,1.1.251,1.1.252,257,1,23,3,26,2,FALSE
bootstrap-components,1.1.256,1.1.257,262,1,1,1,2,1,FALSE
bootstrap-components,1.1.257,1.1.258,263,1,1,1,2,1,FALSE
bootstrap-components,1.1.254,1.1.255,260,1,1,1,2,1,FALSE
bootstrap-components,1.1.255,1.1.256,261,1,1,1,2,1,FALSE
bootstrap-components,1.1.187,1.1.188,193,1,1,1,2,1,FALSE
bootstrap-components,1.1.258,1.1.259,264,2,192,135,327,4,FALSE
bootstrap-components,1.1.259,1.1.260,265,1,1,1,2,1,FALSE
bootstrap-components,1.1.176,1.1.177,182,1,1,1,2,1,FALSE
bootstrap-components,1.1.168,1.1.169,174,1,1,1,2,1,FALSE
bootstrap-components,1.1.169,1.1.170,175,1,1,1,2,1,FALSE
bootstrap-components,1.1.164,1.1.165,170,1,1,1,2,1,FALSE
bootstrap-components,1.1.165,1.1.166,171,1,115,22,137,8,TRUE
bootstrap-components,1.1.166,1.1.167,172,1,1,1,2,1,FALSE
bootstrap-components,1.1.167,1.1.168,173,1,1,1,2,1,FALSE
bootstrap-components,1.1.160,1.1.161,166,1,1,1,2,1,FALSE
bootstrap-components,1.1.161,1.1.162,167,1,1,1,2,1,FALSE
bootstrap-components,1.1.162,1.1.163,168,1,1,1,2,1,FALSE
bootstrap-components,1.1.163,1.1.164,169,1,1,1,2,1,FALSE
bootstrap-components,1.1.126,1.1.127,132,1,1,1,2,1,FALSE
bootstrap-components,1.1.267,1.1.268,273,1,1,1,2,1,FALSE
bootstrap-components,1.1.266,1.1.267,272,2,10,5,15,4,FALSE
bootstrap-components,1.1.229,1.1.230,235,2,11,3,14,3,FALSE
bootstrap-components,1.1.156,1.1.157,162,1,1,1,2,1,FALSE
bootstrap-components,1.1.185,1.1.186,191,1,1,1,2,1,FALSE
bootstrap-components,1.1.159,1.1.160,165,1,1,1,2,1,FALSE
bootstrap-components,1.1.158,1.1.159,164,1,1,1,2,1,FALSE
bootstrap-components,1.1.225,1.1.226,231,1,1,1,2,1,FALSE
bootstrap-components,1.1.224,1.1.225,230,1,1,1,2,1,FALSE
bootstrap-components,1.1.223,1.1.224,229,1,1,1,2,1,FALSE
bootstrap-components,1.1.222,1.1.223,228,1,1,1,2,1,FALSE
bootstrap-components,1.1.221,1.1.222,227,1,1,1,2,1,FALSE
bootstrap-components,1.1.220,1.1.221,226,1,1,1,2,1,FALSE
bootstrap-components,1.1.151,1.1.152,157,1,1,1,2,1,FALSE
bootstrap-components,1.1.150,1.1.151,156,1,1,1,2,1,FALSE
bootstrap-components,1.1.153,1.1.154,159,1,1,1,2,1,FALSE
bootstrap-components,1.1.152,1.1.153,158,1,1,1,2,1,FALSE
bootstrap-components,1.1.155,1.1.156,161,1,1,1,2,1,FALSE
bootstrap-components,1.1.154,1.1.155,160,1,1,1,2,1,FALSE
bootstrap-components,1.1.157,1.1.158,163,1,1,1,2,1,FALSE
bootstrap-components,1.1.228,1.1.229,234,4,212,198,410,8,FALSE
bootstrap-components,1.1.146,1.1.147,152,1,1,1,2,1,FALSE
bootstrap-components,1.1.147,1.1.148,153,1,1,1,2,1,FALSE
bootstrap-components,1.1.144,1.1.145,150,1,1,1,2,1,FALSE
bootstrap-components,1.1.145,1.1.146,151,1,1,1,2,1,FALSE
bootstrap-components,1.1.142,1.1.143,148,1,1,1,2,1,FALSE
bootstrap-components,1.1.143,1.1.144,149,1,1,1,2,1,FALSE
bootstrap-components,1.1.140,1.1.141,146,1,1,1,2,1,FALSE
bootstrap-components,1.1.141,1.1.142,147,1,1,1,2,1,FALSE
bootstrap-components,1.1.148,1.1.149,154,1,1,1,2,1,FALSE
bootstrap-components,1.1.149,1.1.150,155,1,1,1,2,1,FALSE
bootstrap-components,1.1.234,1.1.235,240,1,1,1,2,1,FALSE
bootstrap-components,1.1.235,1.1.236,241,1,34,2,36,2,FALSE
bootstrap-components,1.1.236,1.1.237,242,1,1,1,2,1,FALSE
bootstrap-components,1.1.237,1.1.238,243,1,1,1,2,1,FALSE
bootstrap-components,1.1.230,1.1.231,236,1,1,1,2,1,FALSE
bootstrap-components,1.1.231,1.1.232,237,1,1,1,2,1,FALSE
bootstrap-components,1.1.232,1.1.233,238,1,58,1,59,2,FALSE
bootstrap-components,1.1.233,1.1.234,239,1,3,3,6,2,FALSE
bootstrap-components,1.1.238,1.1.239,244,1,1,1,2,1,FALSE
bootstrap-components,1.1.239,1.1.240,245,1,1,1,2,1,FALSE
bootstrap-components,1.1.139,1.1.140,145,1,1,1,2,1,FALSE
bootstrap-components,1.1.133,1.1.134,139,1,1,1,2,1,FALSE
bootstrap-components,1.1.132,1.1.133,138,1,158,67,225,10,FALSE
bootstrap-components,1.1.131,1.1.132,137,1,1,1,2,1,FALSE
bootstrap-components,1.1.130,1.1.131,136,1,1,1,2,1,FALSE
bootstrap-components,1.1.137,1.1.138,143,2,34,18,52,11,FALSE
bootstrap-components,1.1.136,1.1.137,142,2,31,14,45,7,FALSE
bootstrap-components,1.1.135,1.1.136,141,5,1174,549,1723,21,FALSE
bootstrap-components,1.1.134,1.1.135,140,1,1,1,2,1,FALSE
bootstrap-components,1.1.281,1.1.282,287,1,1,1,2,1,FALSE
bootstrap-components,1.1.280,1.1.281,286,1,1,1,2,1,FALSE
bootstrap-components,1.1.283,1.1.284,289,1,1,1,2,1,FALSE
bootstrap-components,1.1.282,1.1.283,288,1,42,3,45,6,FALSE
bootstrap-components,1.1.201,1.1.202,207,1,1,1,2,1,FALSE
bootstrap-components,1.1.200,1.1.201,206,1,1,1,2,1,FALSE
bootstrap-components,1.1.203,1.1.204,209,1,1,1,2,1,FALSE
bootstrap-components,1.1.202,1.1.203,208,1,1,1,2,1,FALSE
bootstrap-components,1.1.205,1.1.206,211,1,1,1,2,1,FALSE
bootstrap-components,1.1.204,1.1.205,210,1,1,1,2,1,FALSE
bootstrap-components,1.1.207,1.1.208,213,1,1,1,2,1,FALSE
bootstrap-components,1.1.206,1.1.207,212,1,1,1,2,1,FALSE
bootstrap-components,1.1.209,1.1.210,215,1,1,1,2,1,FALSE
bootstrap-components,1.1.208,1.1.209,214,1,1,1,2,1,FALSE
bootstrap-components,1.1.120,1.1.121,126,1,1,1,2,1,FALSE
bootstrap-components,1.1.121,1.1.122,127,1,1,1,2,1,FALSE
bootstrap-components,1.1.122,1.1.123,128,1,1,1,2,1,FALSE
bootstrap-components,1.1.123,1.1.124,129,2,274,49,323,14,FALSE
bootstrap-components,1.1.124,1.1.125,130,7,25,19,44,9,FALSE
bootstrap-components,1.1.125,1.1.126,131,1,1,1,2,1,FALSE
bootstrap-components,1.1.138,1.1.139,144,1,1,1,2,1,FALSE
bootstrap-components,1.1.127,1.1.128,133,1,1,1,2,1,FALSE
bootstrap-components,1.1.128,1.1.129,134,1,1,1,2,1,FALSE
bootstrap-components,1.1.129,1.1.130,135,1,1,1,2,1,FALSE
bootstrap-components,1.1.178,1.1.179,184,1,21,18,39,3,FALSE
bootstrap-components,1.1.177,1.1.178,183,1,1,1,2,1,FALSE
bootstrap-components,1.1.218,1.1.219,224,1,92,7,99,6,FALSE
bootstrap-components,1.1.219,1.1.220,225,1,36,2,38,2,FALSE
bootstrap-components,1.1.216,1.1.217,222,1,1,1,2,1,FALSE
bootstrap-components,1.1.217,1.1.218,223,1,1,1,2,1,FALSE
bootstrap-components,1.1.214,1.1.215,220,1,1,1,2,1,FALSE
bootstrap-components,1.1.215,1.1.216,221,1,1,1,2,1,FALSE
bootstrap-components,1.1.212,1.1.213,218,1,30,5,35,3,FALSE
bootstrap-components,1.1.213,1.1.214,219,1,1,1,2,1,FALSE
bootstrap-components,1.1.210,1.1.211,216,1,1,1,2,1,FALSE
bootstrap-components,1.1.211,1.1.212,217,1,1,1,2,1,FALSE
bootstrap-components,1.1.172,1.1.173,178,1,1,1,2,1,FALSE
bootstrap-components,1.1.67,1.1.68,73,4,78,21,99,6,FALSE
bootstrap-components,1.1.68,1.1.69,74,1,1,1,2,1,FALSE
bootstrap-components,1.1.69,1.1.70,75,2,15,14,29,4,FALSE
bootstrap-components,1.1.119,1.1.120,125,1,1,1,2,1,FALSE
bootstrap-components,1.1.118,1.1.119,124,1,1,1,2,1,FALSE
bootstrap-components,1.1.115,1.1.116,121,1,1,1,2,1,FALSE
bootstrap-components,1.1.114,1.1.115,120,1,1,1,2,1,FALSE
bootstrap-components,1.1.117,1.1.118,123,1,1,1,2,1,FALSE
bootstrap-components,1.1.116,1.1.117,122,1,1,1,2,1,FALSE
bootstrap-components,1.1.111,1.1.112,117,1,1,1,2,1,FALSE
bootstrap-components,1.1.110,1.1.111,116,1,1,1,2,1,FALSE
bootstrap-components,1.1.113,1.1.114,119,1,1,1,2,1,FALSE
bootstrap-components,1.1.112,1.1.113,118,1,1,1,2,1,FALSE
bootstrap-components,1.1.195,1.1.196,201,1,1,1,2,1,FALSE
bootstrap-components,1.1.194,1.1.195,200,1,33,1,34,2,FALSE
bootstrap-components,1.1.197,1.1.198,203,1,1,1,2,1,FALSE
bootstrap-components,1.1.196,1.1.197,202,1,1,1,2,1,FALSE
bootstrap-components,1.1.191,1.1.192,197,1,1,1,2,1,FALSE
bootstrap-components,1.1.190,1.1.191,196,1,1,1,2,1,FALSE
bootstrap-components,1.1.193,1.1.194,199,1,1,1,2,1,FALSE
bootstrap-components,1.1.192,1.1.193,198,1,1,1,2,1,FALSE
bootstrap-components,1.1.263,1.1.264,269,1,1,1,2,1,FALSE
bootstrap-components,1.1.262,1.1.263,268,1,1,1,2,1,FALSE
bootstrap-components,1.1.261,1.1.262,267,1,1,1,2,1,FALSE
bootstrap-components,1.1.260,1.1.261,266,1,30,2,32,2,FALSE
bootstrap-components,1.1.199,1.1.200,205,1,1,1,2,1,FALSE
bootstrap-components,1.1.198,1.1.199,204,1,1,1,2,1,FALSE
bootstrap-components,1.1.265,1.1.266,271,2,124,32,156,10,FALSE
bootstrap-components,1.1.264,1.1.265,270,1,45,2,47,5,FALSE
bootstrap-components,1.1.278,1.1.279,284,1,1,1,2,1,FALSE
bootstrap-components,1.1.279,1.1.280,285,1,1,1,2,1,FALSE
bootstrap-components,1.1.180,1.1.181,186,1,1,1,2,1,FALSE
bootstrap-components,1.1.182,1.1.183,188,1,1,1,2,1,FALSE
bootstrap-components,1.1.181,1.1.182,187,1,1,1,2,1,FALSE
bootstrap-components,1.1.79,1.1.80,85,1,1,1,2,1,FALSE
bootstrap-components,1.1.78,1.1.79,84,1,1,1,2,1,FALSE
bootstrap-components,1.1.77,1.1.78,83,1,1,1,2,1,FALSE
bootstrap-components,1.1.76,1.1.77,82,1,1,1,2,1,FALSE
bootstrap-components,1.1.75,1.1.76,81,2,363,329,692,12,FALSE
bootstrap-components,1.1.74,1.1.75,80,1,1,1,2,1,FALSE
bootstrap-components,1.1.73,1.1.74,79,1,1,1,2,1,FALSE
bootstrap-components,1.1.72,1.1.73,78,1,1,1,2,1,FALSE
bootstrap-components,1.1.71,1.1.72,77,1,1,1,2,1,FALSE
bootstrap-components,1.1.70,1.1.71,76,1,1,1,2,1,FALSE
bootstrap-components,1.1.108,1.1.109,114,1,1,1,2,1,FALSE
bootstrap-components,1.1.109,1.1.110,115,1,1,1,2,1,FALSE
bootstrap-components,1.1.184,1.1.185,190,1,1,1,2,1,FALSE
bootstrap-components,1.1.102,1.1.103,108,1,1,1,2,1,FALSE
bootstrap-components,1.1.103,1.1.104,109,1,1,1,2,1,FALSE
bootstrap-components,1.1.100,1.1.101,106,1,1,1,2,1,FALSE
bootstrap-components,1.1.101,1.1.102,107,1,1,1,2,1,FALSE
bootstrap-components,1.1.106,1.1.107,112,1,1,1,2,1,FALSE
bootstrap-components,1.1.107,1.1.108,113,1,1,1,2,1,FALSE
bootstrap-components,1.1.104,1.1.105,110,1,1,1,2,1,FALSE
bootstrap-components,1.1.105,1.1.106,111,1,1,1,2,1,FALSE
bootstrap-components,1.1.82,1.1.83,88,1,1,1,2,1,FALSE
bootstrap-components,1.1.83,1.1.84,89,1,1,1,2,1,FALSE
bootstrap-components,1.1.80,1.1.81,86,1,1,1,2,1,FALSE
bootstrap-components,1.1.81,1.1.82,87,1,1,1,2,1,FALSE
bootstrap-components,1.1.86,1.1.87,92,1,1,1,2,1,FALSE
bootstrap-components,1.1.87,1.1.88,93,1,1,1,2,1,FALSE
bootstrap-components,1.1.84,1.1.85,90,1,1,1,2,1,FALSE
bootstrap-components,1.1.85,1.1.86,91,1,1,1,2,1,FALSE
bootstrap-components,1.1.270,1.1.271,276,1,1,1,2,1,FALSE
bootstrap-components,1.1.271,1.1.272,277,1,1,1,2,1,FALSE
bootstrap-components,1.1.188,1.1.189,194,1,1,1,2,1,FALSE
bootstrap-components,1.1.89,1.1.90,95,1,1,1,2,1,FALSE
bootstrap-components,1.1.274,1.1.275,280,1,1,1,2,1,FALSE
bootstrap-components,1.1.272,1.1.273,278,1,1,1,2,1,FALSE
bootstrap-components,1.1.88,1.1.89,94,1,1,1,2,1,FALSE
bootstrap-components,1.1.277,1.1.278,283,1,1,1,2,1,FALSE
bootstrap-components,1.1.189,1.1.190,195,1,31,4,35,3,FALSE
bootstrap-components,1.1.273,1.1.274,279,1,1,1,2,1,FALSE
bootstrap-components,1.1.275,1.1.276,281,1,1,1,2,1,FALSE
bootstrap-components,1.1.276,1.1.277,282,1,1,1,2,1,FALSE
bootstrap-components,1.1.179,1.1.180,185,1,1,1,2,1,FALSE
bootstrap-components,1.1.245,1.1.246,251,2,28,3,31,3,FALSE
bootstrap-components,1.1.244,1.1.245,250,1,75,2,77,5,FALSE
bootstrap-components,1.1.247,1.1.248,253,1,1,1,2,1,FALSE
bootstrap-components,1.1.246,1.1.247,252,2,4,4,8,3,FALSE
bootstrap-components,1.1.241,1.1.242,247,1,1,1,2,1,FALSE
bootstrap-components,1.1.240,1.1.241,246,1,1,1,2,1,FALSE
bootstrap-components,1.1.243,1.1.244,249,1,1,1,2,1,FALSE
bootstrap-components,1.1.242,1.1.243,248,1,1,1,2,1,FALSE
bootstrap-components,1.1.249,1.1.250,255,1,1,1,2,1,FALSE
bootstrap-components,1.1.248,1.1.249,254,1,1,1,2,1,FALSE
bootstrap-components,1.1.91,1.1.92,97,1,1,1,2,1,FALSE
bootstrap-components,1.1.90,1.1.91,96,1,1,1,2,1,FALSE
bootstrap-components,1.1.93,1.1.94,99,1,1,1,2,1,FALSE
bootstrap-components,1.1.92,1.1.93,98,1,1,1,2,1,FALSE
bootstrap-components,1.1.95,1.1.96,101,1,1,1,2,1,FALSE
bootstrap-components,1.1.94,1.1.95,100,1,1,1,2,1,FALSE
bootstrap-components,1.1.97,1.1.98,103,1,1,1,2,1,FALSE
bootstrap-components,1.1.96,1.1.97,102,1,1,1,2,1,FALSE
bootstrap-components,1.1.99,1.1.100,105,1,1,1,2,1,FALSE
bootstrap-components,1.1.98,1.1.99,104,1,1,1,2,1,FALSE
bootstrap-components,1.1.175,1.1.176,181,1,16,33,49,6,FALSE
bootstrap-components,1.1.174,1.1.175,180,1,1,1,2,1,FALSE
bootstrap-components,1.1.173,1.1.174,179,1,1,1,2,1,FALSE
bootstrap-components,1.1.183,1.1.184,189,1,1,1,2,1,FALSE
bootstrap-components,1.1.171,1.1.172,177,1,1,1,2,1,FALSE
bootstrap-components,1.1.170,1.1.171,176,1,1,1,2,1,FALSE
bootstrap-components,1.1.227,1.1.228,233,1,1,1,2,1,FALSE
bootstrap-components,1.1.226,1.1.227,232,1,1,1,2,1,FALSE
bootstrap-components,1.1.186,1.1.187,192,1,1,1,2,1,FALSE
bootstrap-components,1.1.269,1.1.270,275,2,94,14,108,4,FALSE
bootstrap-components,1.1.268,1.1.269,274,1,1,1,2,1,FALSE
bootstrap-components,1.1.165,1.1.166,171,1,115,22,137,8,FALSE
bootstrap-components,1.1.24,1.1.25,34,1,1,1,2,1,FALSE
bootstrap-components,1.1.25,1.1.26,35,1,1,1,2,1,FALSE
bootstrap-components,1.1.20,1.1.21,30,1,1,1,2,1,FALSE
bootstrap-components,1.1.21,1.1.22,31,1,1,1,2,1,FALSE
bootstrap-components,1.1.22,1.1.23,32,1,1,1,2,1,FALSE
bootstrap-components,1.1.23,1.1.24,33,1,1,1,2,1,FALSE
bootstrap-components,1.1.19,1.1.20,29,1,1,1,2,1,FALSE
bootstrap-components,1.1.18,1.1.19,28,1,1,1,2,1,FALSE
bootstrap-components,1.1.15,1.1.16,25,1,1,1,2,1,FALSE
bootstrap-components,1.1.17,1.1.18,27,1,1,1,2,1,FALSE
bootstrap-components,1.1.16,1.1.17,26,1,1,1,2,1,FALSE
bootstrap-components,1.1.66,1.1.67,72,5,1046,741,1787,54,FALSE
bootstrap-components,1.0.4,1.0.5,5,6,6883,1356,8239,20,FALSE
bootstrap-components,1.0.5,1.0.6,6,1,4,2,6,3,FALSE
bootstrap-components,1.0.6,1.0.7,7,1,6,5,11,3,FALSE
bootstrap-components,1.0.7,1.0.8,8,1,5,10,15,3,FALSE
bootstrap-components,1.0.8,1.1.0,9,1,1,1,2,1,FALSE
bootstrap-components,1.1.46,1.1.47,56,4,276,107,383,26,FALSE
bootstrap-components,1.1.1,1.1.2,11,1,1,1,2,1,FALSE
bootstrap-components,1.1.0,1.1.1,10,1,1,1,2,1,FALSE
bootstrap-components,1.1.3,1.1.4,13,1,1,1,2,1,FALSE
bootstrap-components,1.1.2,1.1.3,12,1,1,1,2,1,FALSE
bootstrap-components,1.1.5,1.1.6,15,1,1,1,2,1,FALSE
bootstrap-components,1.1.4,1.1.5,14,1,110,99,209,9,FALSE
bootstrap-components,1.1.7,1.1.8,17,11,988,394,1382,47,FALSE
bootstrap-components,1.1.6,1.1.7,16,1,1,1,2,1,FALSE
bootstrap-components,1.1.14,1.1.15,24,1,362,177,539,16,FALSE
bootstrap-components,1.1.136,1.1.137,142,2,31,14,45,7,TRUE
react-document-title,1.0.4,2.0.0,9,4,28,31,59,7,FALSE
react-document-title,1.0.0,1.0.1,5,5,12,12,24,6,FALSE
react-document-title,1.0.1,1.0.2,6,7,48,77,125,10,FALSE
react-document-title,2.0.1,2.0.2,11,5,16,4,20,7,FALSE
react-document-title,2.0.0,2.0.1,10,3,3,3,6,3,FALSE
react-document-title,1.0.3,1.0.4,8,2,2,2,4,2,FALSE
react-document-title,1.0.2,1.0.3,7,10,55,12,67,10,FALSE
react-document-title,0.1.3,1.0.0,4,5,72,192,264,9,FALSE
react-document-title,0.1.2,0.1.3,3,7,83,68,151,12,FALSE
react-document-title,2.0.2,2.0.3,12,7,78,67,145,16,FALSE
react-document-title,2.0.2,2.0.3,12,7,78,67,145,16,TRUE
react-document-title,0.1.2,0.1.3,3,7,83,68,151,12,TRUE
redux-detector,0.6.0-0,0.6.0-1,5,3,856,2122,2978,26,FALSE
redux-detector,0.5.1,0.5.2,2,6,208,62,270,24,FALSE
redux-detector,0.5.2,0.5.3,3,2,14,4,18,4,FALSE
redux-detector,0.5.3,0.6.0-0,4,5,1353,381,1734,61,FALSE
redux-detector,0.6.0-0,0.6.0-1,5,3,856,2122,2978,26,TRUE
redux-detector,0.5.0,0.5.1,1,22,4072,1278,5350,131,FALSE
react-day-picker,0.1.1,0.1.2,2,9,60,21,81,9,FALSE
react-day-picker,0.3.1,0.3.2,13,4,39,17,56,5,FALSE
react-day-picker,0.1.4,0.1.5,5,9,153,57,210,24,FALSE
react-day-picker,0.3.2,0.3.3,14,2,19,10,29,2,FALSE
react-day-picker,0.3.3,0.3.4,15,19,132,105,237,25,FALSE
react-day-picker,0.3.0,0.3.1,12,2,7,6,13,2,FALSE
react-day-picker,0.6.0,0.7.0,19,7,118,77,195,9,FALSE
react-day-picker,0.1.8,0.1.9,9,8,46,42,88,8,FALSE
react-day-picker,0.1.9,0.2.0,10,16,270,346,616,16,FALSE
react-day-picker,0.3.4,0.4.0,16,9,161,153,314,11,FALSE
react-day-picker,0.2.0,0.3.0,11,11,53,30,83,9,FALSE
react-day-picker,0.1.0,0.1.1,1,3,6,6,12,3,FALSE
react-day-picker,0.4.0,0.5.0,17,6,42,31,73,8,FALSE
react-day-picker,0.1.2,0.1.3,3,6,9,6,15,6,FALSE
react-day-picker,0.1.3,0.1.4,4,1,8,8,16,6,FALSE
react-day-picker,0.5.0,0.6.0,18,7,151,87,238,12,FALSE
react-day-picker,0.1.5,0.1.6,6,9,12,408,420,12,FALSE
react-day-picker,0.1.6,0.1.7,7,4,6,6,12,4,FALSE
react-day-picker,0.1.7,0.1.8,8,2,444,4,448,8,FALSE
react-day-picker,5.5.1,5.5.2,82,59,2006,1559,3565,81,FALSE
react-day-picker,5.5.0,5.5.1,81,7,13,10,23,13,FALSE
react-day-picker,5.5.2,5.5.3,83,2,6296,11520,17816,17,FALSE
react-day-picker,5.4.0,5.4.1,77,15,880,667,1547,23,FALSE
react-day-picker,5.4.1,5.4.2,78,15,276,180,456,21,FALSE
react-day-picker,5.4.2,5.4.3,79,27,799,458,1257,53,FALSE
react-day-picker,5.4.3,5.5.0,80,60,10222,2050,12272,202,TRUE
react-day-picker,5.2.2,5.2.3,74,8,1512,950,2462,25,FALSE
react-day-picker,5.2.3,5.3.0,75,52,1432,528,1960,110,FALSE
react-day-picker,5.2.1,5.2.2,73,19,9332,4677,14009,155,FALSE
react-day-picker,5.3.0,5.4.0,76,54,3600,3259,6859,127,FALSE
react-day-picker,2.4.0,2.4.1,61,1,3,3,6,3,FALSE
react-day-picker,2.0.3,2.1.0,53,18,403,108,511,59,FALSE
react-day-picker,2.0.2,2.0.3,52,4,22,5,27,7,FALSE
react-day-picker,2.0.1,2.0.2,51,18,343,231,574,37,FALSE
react-day-picker,2.0.0,2.0.1,50,46,4847,4645,9492,174,FALSE
react-day-picker,2.3.0,2.3.1,57,2,4,4,8,3,FALSE
react-day-picker,2.3.1,2.3.2,58,12,99,83,182,31,FALSE
react-day-picker,2.3.2,2.3.3,59,7,101,44,145,18,FALSE
react-day-picker,2.3.3,2.4.0,60,20,499,348,847,52,FALSE
react-day-picker,1.3.1,1.3.2,47,46,2316,2210,4526,94,FALSE
react-day-picker,1.3.0,1.3.1,46,16,909,500,1409,28,FALSE
react-day-picker,2.2.0,2.3.0,56,24,310,134,444,48,FALSE
react-day-picker,2.1.0,2.1.1,54,8,61,56,117,18,FALSE
react-day-picker,2.0.0-beta,2.0.0,49,23,1186,2810,3996,63,FALSE
react-day-picker,2.1.1,2.2.0,55,19,441,290,731,77,FALSE
react-day-picker,3.1.1,4.0.0,67,30,13210,2268,15478,99,FALSE
react-day-picker,3.1.0,3.1.1,66,6,29,25,54,18,FALSE
react-day-picker,3.0.0,3.0.1,64,6,24,19,43,11,FALSE
react-day-picker,3.0.1,3.1.0,65,15,632,210,842,57,FALSE
react-day-picker,5.4.3,5.5.0,80,60,10222,2050,12272,202,FALSE
react-day-picker,4.0.0,5.0.0,68,20,1164,613,1777,121,FALSE
react-day-picker,5.2.0,5.2.1,72,23,4344,2302,6646,88,FALSE
react-day-picker,2.5.0,3.0.0,63,18,67,126,193,27,FALSE
react-day-picker,5.0.0,5.1.1,69,34,3084,2096,5180,109,FALSE
react-day-picker,5.1.1,5.1.2,70,25,4421,426,4847,91,FALSE
react-day-picker,5.1.2,5.2.0,71,19,534,152,686,51,FALSE
react-day-picker,1.0.4,1.0.5,32,31,1060,906,1966,84,TRUE
react-day-picker,1.0.5,1.0.6,33,12,70,272,342,22,FALSE
react-day-picker,1.0.6,1.0.7,34,8,95,93,188,15,FALSE
react-day-picker,1.0.7,1.0.8,35,6,15,14,29,8,FALSE
react-day-picker,1.0.0,1.0.1,28,4,6,5,11,4,FALSE
react-day-picker,1.0.1,1.0.2,29,16,125,59,184,19,FALSE
react-day-picker,1.0.2,1.0.3,30,7,154,47,201,12,TRUE
react-day-picker,1.0.3,1.0.4,31,10,373,81,454,18,FALSE
react-day-picker,1.0.8,1.0.9,36,2,5,5,10,3,FALSE
react-day-picker,1.1.2,1.1.3,41,2,10,4,14,2,FALSE
react-day-picker,1.0.10,1.1.0,38,29,2791,1454,4245,132,FALSE
react-day-picker,1.1.5,1.2.0,44,56,922,465,1387,99,FALSE
react-day-picker,1.1.1,1.1.2,40,20,2333,327,2660,41,FALSE
react-day-picker,1.0.9,1.0.10,37,5,6,10,16,5,FALSE
react-day-picker,1.3.0,1.3.1,46,16,909,500,1409,28,TRUE
react-day-picker,1.2.0,1.3.0,45,66,1838,1206,3044,165,FALSE
react-day-picker,1.1.4,1.1.5,43,6,68,7,75,8,FALSE
react-day-picker,2.4.1,2.5.0,62,42,1355,758,2113,122,FALSE
react-day-picker,1.1.0,1.1.1,39,31,2987,5815,8802,195,FALSE
react-day-picker,1.1.3,1.1.4,42,15,118,121,239,43,FALSE
react-day-picker,1.0.4,1.0.5,32,31,1060,906,1966,84,FALSE
react-day-picker,1.0.2,1.0.3,30,7,154,47,201,12,FALSE
react-day-picker,2.5.0,3.0.0,63,18,67,126,193,27,TRUE
react-day-picker,0.7.2,0.8.0,22,12,303,129,432,21,FALSE
react-day-picker,0.7.0,0.7.1,20,8,62,42,104,8,FALSE
react-day-picker,0.7.1,0.7.2,21,3,33,35,68,5,FALSE
react-day-picker,4.0.0,5.0.0,68,20,1164,613,1777,121,TRUE
react-day-picker,0.8.1,0.8.2,24,10,107,103,210,14,FALSE
react-day-picker,0.8.0,0.8.1,23,9,519,399,918,23,FALSE
react-day-picker,0.8.3,0.8.4,26,13,934,532,1466,46,FALSE
react-day-picker,0.8.2,0.8.3,25,4,18,20,38,4,FALSE
react-day-picker,5.1.1,5.1.2,70,25,4421,426,4847,91,TRUE
react-day-picker,5.4.0,5.4.1,77,15,880,667,1547,23,TRUE
react-day-picker,5.2.2,5.2.3,74,8,1512,950,2462,25,TRUE
react-day-picker,0.3.3,0.3.4,15,19,132,105,237,25,TRUE
react-day-picker,1.0.3,1.0.4,31,10,373,81,454,18,TRUE
react-day-picker,1.1.1,1.1.2,40,20,2333,327,2660,41,TRUE
react-day-picker,0.8.4,1.0.0,27,34,8521,3101,11622,195,FALSE
react-day-picker,0.8.1,0.8.2,24,10,107,103,210,14,TRUE
react-day-picker,5.4.1,5.4.2,78,15,276,180,456,21,TRUE
react-day-picker,5.5.1,5.5.2,82,59,2006,1559,3565,81,TRUE
react-day-picker,5.5.0,5.5.1,81,7,13,10,23,13,TRUE
react-day-picker,5.4.2,5.4.3,79,27,799,458,1257,53,TRUE
react-day-picker,5.3.0,5.4.0,76,54,3600,3259,6859,127,TRUE
react-day-picker,1.0.9,1.0.10,37,5,6,10,16,5,TRUE
react-day-picker,1.1.3,1.1.4,42,15,118,121,239,43,TRUE
react-day-picker,5.2.0,5.2.1,72,23,4344,2302,6646,88,TRUE
react-day-picker,0.7.1,0.7.2,21,3,33,35,68,5,TRUE
react-day-picker,0.8.0,0.8.1,23,9,519,399,918,23,TRUE
react-day-picker,1.0.10,1.1.0,38,29,2791,1454,4245,132,TRUE
react-day-picker,0.7.2,0.8.0,22,12,303,129,432,21,TRUE
react-day-picker,1.1.4,1.1.5,43,6,68,7,75,8,TRUE
isomorphic-cookie,1.0.0,1.0.1,4,2,7,4,11,2,FALSE
isomorphic-cookie,1.0.1,1.2.0,5,7,9,5,14,8,FALSE
isomorphic-cookie,1.2.0,1.2.1,6,2,3,1,4,2,FALSE
isomorphic-cookie,0.5.1,0.5.2,1,1,1,1,2,1,FALSE
isomorphic-cookie,0.5.2,0.5.3,2,1,1,1,2,1,FALSE
isomorphic-cookie,0.5.3,1.0.0,3,20,1157,254,1411,55,FALSE
isomorphic-cookie,1.0.1,1.2.0,5,7,9,5,14,8,TRUE
xdl,0.15.0,0.16.0,59,1,74,11,85,3,FALSE
xdl,36.1.0,37.0.0,108,7,35,9,44,8,FALSE
xdl,0.11.0,0.12.0,55,7,205,74,279,18,FALSE
xdl,29.2.0,29.3.0,94,4,54,16,70,5,FALSE
xdl,29.5.0,30.0.0,97,44,1147,384,1531,71,FALSE
xdl,38.0.0-beta.1,38.0.0-beta.2,113,1,731,2,733,4,FALSE
xdl,39.0.0,40.0.0,115,28,6440,1290,7730,107,FALSE
xdl,37.0.1,37.0.2,110,4,13,5,18,4,FALSE
xdl,28.0.0,29.0.0,91,16,488,211,699,23,FALSE
xdl,36.0.0,36.0.1,106,1,17,1,18,2,FALSE
xdl,41.0.0-rc.0,41.0.0,117,1,18,4,22,1,FALSE
xdl,34.0.0,35.0.0,104,4,69,40,109,7,FALSE
xdl,29.4.0,29.5.0,96,6,38,19,57,8,FALSE
xdl,0.14.0,0.15.0,58,8,101,47,148,8,FALSE
xdl,0.10.1,0.10.2,50,1,731,2,733,4,FALSE
xdl,0.10.0,0.10.1,49,1,731,2,733,4,FALSE
xdl,0.10.3,0.10.4,52,1,731,2,733,4,FALSE
xdl,0.10.2,0.10.3,51,1,11,5,16,4,FALSE
xdl,0.10.5,0.11.0,54,4,246,230,476,14,FALSE
xdl,0.10.4,0.10.5,53,1,4,2,6,1,FALSE
xdl,0.7.4,0.8.0,45,1,1,1,2,1,FALSE
xdl,0.6.0,0.7.0,41,10,90,37,127,12,FALSE
xdl,0.7.2,0.7.3,43,9,15,14,29,10,FALSE
xdl,0.7.3,0.7.4,44,5,337,51,388,21,FALSE
xdl,0.7.0,0.7.2,42,3,14,3,17,4,FALSE
xdl,0.17.2,0.17.3,63,1,1,1,2,1,FALSE
xdl,0.17.3,0.17.4,64,3,1069,18,1087,24,FALSE
xdl,0.17.0,0.17.1,61,1,731,2,733,4,FALSE
xdl,0.12.0,0.13.0,56,7,164,113,277,11,FALSE
xdl,0.20.0,0.21.0,70,12,193,89,282,17,FALSE
xdl,0.17.4,0.17.5,65,2,8,5,13,6,FALSE
xdl,0.17.5,0.18.0,66,9,237,62,299,20,FALSE
xdl,0.4.0,0.5.0,39,8,306,4654,4960,30,FALSE
xdl,0.23.1,0.24.0,76,6,46,37,83,8,FALSE
xdl,0.23.0,0.23.1,75,5,46,6,52,5,FALSE
xdl,33.0.0,34.0.0,103,3,29,12,41,5,FALSE
xdl,32.0.0,33.0.0,102,15,488,381,869,63,FALSE
xdl,0.13.0,0.14.0,57,8,64,28,92,13,FALSE
xdl,30.0.0,30.0.1,98,5,33,16,49,7,FALSE
xdl,0.9.0,0.10.0,48,4,664,52,716,19,FALSE
xdl,0.17.1,0.17.2,62,1,731,2,733,4,FALSE
xdl,36.0.1,36.1.0,107,8,26,14,40,12,FALSE
xdl,29.1.0,29.2.0,93,1,731,2,733,4,FALSE
xdl,0.19.1,0.20.0,69,2,20,11,31,4,FALSE
xdl,0.22.0,0.23.0,74,26,169,46,215,36,FALSE
xdl,0.21.1,0.21.2,72,2,12,5,17,3,FALSE
xdl,0.21.0,0.21.1,71,2,3,3,6,3,FALSE
xdl,29.0.0,29.1.0,92,2,17,2,19,4,FALSE
xdl,0.21.2,0.22.0,73,5,67,24,91,10,FALSE
xdl,0.8.1,0.9.0,47,6,101,11,112,9,FALSE
xdl,0.25.0,0.26.0,78,15,306,300,606,33,FALSE
xdl,0.8.0,0.8.1,46,1,731,2,733,4,FALSE
xdl,0.26.8,0.27.0,87,1,4,5,9,2,FALSE
xdl,31.1.0,32.0.0,101,6,28,22,50,6,FALSE
xdl,0.24.0,0.25.0,77,7,34,52,86,13,FALSE
xdl,29.3.0,29.4.0,95,11,267,517,784,25,FALSE
xdl,35.0.0,36.0.0,105,9,110,153,263,17,FALSE
xdl,37.0.0,37.0.1,109,1,12,1,13,2,FALSE
xdl,0.18.0,0.19.0,67,8,4572,146,4718,17,FALSE
xdl,0.26.1,0.26.2,80,3,32,56,88,8,FALSE
xdl,0.26.6,0.26.7,85,48,1047,460,1507,74,FALSE
xdl,0.26.7,0.26.8,86,1,731,2,733,4,FALSE
xdl,31.0.0,31.1.0,100,6,26,24,50,6,FALSE
xdl,0.26.5,0.26.6,84,9,28,29,57,12,FALSE
xdl,0.26.3,0.26.4,82,6,35,30,65,16,FALSE
xdl,0.26.4,0.26.5,83,1,731,2,733,4,FALSE
xdl,0.5.0,0.6.0,40,6,549,329,878,40,FALSE
xdl,38.0.0-beta.2,39.0.0,114,1,731,2,733,4,FALSE
xdl,0.19.0,0.19.1,68,15,915,4891,5806,45,FALSE
xdl,38.0.0-beta.0,38.0.0-beta.1,112,1,731,2,733,4,FALSE
xdl,0.16.0,0.17.0,60,9,188,41,229,15,FALSE
xdl,0.26.2,0.26.3,81,4,82,51,133,10,FALSE
xdl,30.0.1,31.0.0,99,9,74,51,125,11,FALSE
xdl,0.26.0,0.26.1,79,1,699,0,699,5,FALSE
xdl,40.0.0,41.0.0-rc.0,116,22,1108,293,1401,36,FALSE
xdl,0.27.0,0.27.1,88,13,10294,279,10573,125,FALSE
xdl,0.0.5,0.0.7,6,11,348,98,446,28,FALSE
xdl,0.0.4,0.0.5,5,2,5,3,8,2,FALSE
xdl,0.0.7,0.0.8,7,2,2,2,4,2,FALSE
xdl,0.0.3,0.0.4,4,4,48,25,73,10,FALSE
xdl,0.0.2,0.0.3,3,3,127,63,190,8,FALSE
xdl,0.0.9,0.0.10,9,2,2,3,5,3,FALSE
xdl,0.0.8,0.0.9,8,1,1,2,3,1,FALSE
xdl,0.0.1,0.0.2,2,2,138,22,160,9,FALSE
xdl,1.0.0,28.0.0,90,433,32374,16046,48420,1247,FALSE
xdl,0.3.0,0.4.0,38,8,632,411,1043,107,FALSE
xdl,0.0.12,0.0.13,12,4,102,42,144,9,FALSE
xdl,0.0.18,0.0.19,18,1,731,2,733,4,FALSE
xdl,0.0.15,0.0.16,15,2,27,3,30,5,FALSE
xdl,0.0.14,0.0.15,14,1,2,5,7,2,FALSE
xdl,0.0.17,0.0.18,17,2,50,63,113,5,FALSE
xdl,0.0.16,0.0.17,16,2,74,11,85,4,FALSE
xdl,0.0.11,0.0.12,11,2,4,3,7,4,FALSE
xdl,0.0.10,0.0.11,10,8,134,73,207,16,FALSE
xdl,0.0.13,0.0.14,13,2,3,2,5,3,FALSE
xdl,0.0.19,0.0.20,19,8,65,20,85,11,FALSE
xdl,0.0.20,0.0.21,20,1,10,5,15,2,FALSE
xdl,0.0.21,0.0.22,21,1,2,1,3,2,FALSE
xdl,0.0.22,0.0.23,22,1,3,1,4,2,FALSE
xdl,0.0.23,0.0.24,23,1,7,3,10,3,FALSE
xdl,0.0.24,0.0.26,24,3,6,6,12,4,FALSE
xdl,0.0.26,0.0.27,25,1,34,3,37,3,FALSE
xdl,0.0.27,0.0.28,26,2,8,5,13,3,FALSE
xdl,0.0.28,0.0.29,27,1,21,3,24,2,FALSE
xdl,0.0.29,0.0.30,28,1,1,1,2,2,FALSE
xdl,0.2.0,0.3.0,37,2,4431,6,4437,4,FALSE
xdl,0.1.0,0.1.1,35,1,731,2,733,4,FALSE
xdl,0.1.1,0.2.0,36,9,705,1214,1919,57,FALSE
xdl,0.0.35,0.1.0,34,15,1657,996,2653,132,FALSE
xdl,0.0.34,0.0.35,33,1,731,2,733,4,FALSE
xdl,0.0.33,0.0.34,32,1,731,2,733,4,FALSE
xdl,0.0.32,0.0.33,31,1,731,2,733,4,FALSE
xdl,0.0.31,0.0.32,30,1,4,3,7,2,FALSE
xdl,0.0.30,0.0.31,29,1,3,2,5,14,FALSE
xdl,37.0.0,37.0.1,109,1,12,1,13,2,TRUE
xdl,0.20.0,0.21.0,70,12,193,89,282,17,TRUE
xdl,28.0.0,29.0.0,91,16,488,211,699,23,TRUE
xdl,29.4.0,29.5.0,96,6,38,19,57,8,TRUE
xdl,0.22.0,0.23.0,74,26,169,46,215,36,TRUE
xdl,35.0.0,36.0.0,105,9,110,153,263,17,TRUE
xdl,0.27.0,0.27.1,88,13,10294,279,10573,125,TRUE
xdl,32.0.0,33.0.0,102,15,488,381,869,63,TRUE
xdl,37.0.1,37.0.2,110,4,13,5,18,4,TRUE
xdl,0.25.0,0.26.0,78,15,306,300,606,33,TRUE
xdl,0.0.15,0.0.16,15,2,27,3,30,5,TRUE
xdl,0.0.17,0.0.18,17,2,50,63,113,5,TRUE
xdl,0.14.0,0.15.0,58,8,101,47,148,8,TRUE
xdl,0.0.24,0.0.26,24,3,6,6,12,4,TRUE
xdl,0.0.27,0.0.28,26,2,8,5,13,3,TRUE
xdl,0.10.4,0.10.5,53,1,4,2,6,1,TRUE
xdl,29.0.0,29.1.0,92,2,17,2,19,4,TRUE
xdl,39.0.0,40.0.0,115,28,6440,1290,7730,107,TRUE
xdl,33.0.0,34.0.0,103,3,29,12,41,5,TRUE
xdl,0.12.0,0.13.0,56,7,164,113,277,11,TRUE
xdl,36.1.0,37.0.0,108,7,35,9,44,8,TRUE
xdl,29.5.0,30.0.0,97,44,1147,384,1531,71,TRUE
xdl,30.0.0,30.0.1,98,5,33,16,49,7,TRUE
xdl,36.0.1,36.1.0,107,8,26,14,40,12,TRUE
xdl,29.3.0,29.4.0,95,11,267,517,784,25,TRUE
xdl,0.26.6,0.26.7,85,48,1047,460,1507,74,TRUE
xdl,0.1.1,0.2.0,36,9,705,1214,1919,57,TRUE
xdl,0.15.0,0.16.0,59,1,74,11,85,3,TRUE
xdl,31.0.0,31.1.0,100,6,26,24,50,6,TRUE
prismjs-package,0.6.0,0.6.1,6,1,3,3,6,3,FALSE
prismjs-package,0.7.29,0.7.30,51,2,6,6,12,2,FALSE
prismjs-package,0.7.28,0.7.29,50,2,6,6,12,2,FALSE
prismjs-package,0.7.25,0.7.26,47,2,55,6,61,4,FALSE
prismjs-package,0.6.7,0.6.8,13,2,2,2,4,2,TRUE
prismjs-package,0.7.27,0.7.28,49,2,8,8,16,3,FALSE
prismjs-package,0.7.26,0.7.27,48,3,246,74,320,5,FALSE
prismjs-package,0.7.21,0.7.22,43,2,2,2,4,2,FALSE
prismjs-package,0.7.20,0.7.21,42,2,8,4,12,3,FALSE
prismjs-package,0.7.23,0.7.24,45,2,11,11,22,3,FALSE
prismjs-package,0.7.22,0.7.23,44,2,5,5,10,2,FALSE
prismjs-package,0.6.5,0.6.6,11,3,155,8,163,4,FALSE
prismjs-package,0.6.4,0.6.5,10,6,47,52,99,9,TRUE
prismjs-package,0.6.9,0.6.10,15,2,5,5,10,2,FALSE
prismjs-package,0.6.8,0.6.9,14,3,14,6,20,3,FALSE
prismjs-package,0.7.8,0.7.9,30,3,6,6,12,4,FALSE
prismjs-package,0.7.9,0.7.10,31,5,82,38,120,6,FALSE
prismjs-package,0.6.3,0.6.4,9,3,12,5,17,9,FALSE
prismjs-package,0.7.7,0.7.8,29,3,6,6,12,3,FALSE
prismjs-package,0.7.4,0.7.5,26,3,20,4,24,3,FALSE
prismjs-package,0.7.5,0.7.6,27,5,11,10,21,6,FALSE
prismjs-package,0.7.2,0.7.3,24,28,89,33,122,30,TRUE
prismjs-package,0.6.6,0.6.7,12,3,5,19,24,4,FALSE
prismjs-package,0.7.0,0.7.1,22,24,35,145,180,28,TRUE
prismjs-package,0.7.1,0.7.2,23,11,11,11,22,11,TRUE
prismjs-package,0.7.24,0.7.25,46,4,61,57,118,6,FALSE
prismjs-package,0.7.18,0.7.19,40,3,20,13,33,3,FALSE
prismjs-package,0.7.19,0.7.20,41,2,120,15,135,4,FALSE
prismjs-package,0.7.10,0.7.11,32,2,146,7,153,4,FALSE
prismjs-package,0.7.11,0.7.12,33,4,89,13,102,7,FALSE
prismjs-package,0.7.12,0.7.13,34,2,4,31,35,2,FALSE
prismjs-package,0.7.13,0.7.14,35,3,9,26,35,4,FALSE
prismjs-package,0.7.14,0.7.15,36,6,18,14,32,7,FALSE
prismjs-package,0.7.15,0.7.16,37,3,38,11,49,4,FALSE
prismjs-package,0.7.16,0.7.17,38,4,565,510,1075,11,FALSE
prismjs-package,0.7.17,0.7.18,39,5,173,167,340,10,FALSE
prismjs-package,0.7.3,0.7.4,25,23,87,35,122,24,FALSE
prismjs-package,0.7.6,0.7.7,28,3,5,5,10,3,FALSE
prismjs-package,0.6.2,0.6.3,8,3,10,5,15,3,FALSE
prismjs-package,0.6.13,0.6.14,19,11,78,40,118,12,TRUE
prismjs-package,0.6.12,0.6.13,18,28,46,43,89,36,FALSE
prismjs-package,0.6.11,0.6.12,17,7,13,13,26,7,FALSE
prismjs-package,0.6.10,0.6.11,16,2,8,8,16,2,TRUE
prismjs-package,0.6.1,0.6.2,7,1,20,4,24,3,FALSE
prismjs-package,0.6.15,0.7.0,21,38,58,43,101,39,FALSE
prismjs-package,0.6.14,0.6.15,20,18,18,18,36,18,TRUE
prismjs-package,0.6.7,0.6.8,13,2,2,2,4,2,FALSE
prismjs-package,0.6.4,0.6.5,10,6,47,52,99,9,FALSE
prismjs-package,0.6.13,0.6.14,19,11,78,40,118,12,FALSE
prismjs-package,0.6.10,0.6.11,16,2,8,8,16,2,FALSE
prismjs-package,0.6.14,0.6.15,20,18,18,18,36,18,FALSE
prismjs-package,0.6.6,0.6.7,12,3,5,19,24,4,TRUE
prismjs-package,0.2.0,0.3.0,2,4,1319,6070,7389,8,FALSE
prismjs-package,0.1.0,0.2.0,1,2,3950,3930,7880,6,FALSE
prismjs-package,0.7.2,0.7.3,24,28,89,33,122,30,FALSE
prismjs-package,0.7.0,0.7.1,22,24,35,145,180,28,FALSE
prismjs-package,0.7.1,0.7.2,23,11,11,11,22,11,FALSE
prismjs-package,0.4.0,0.5.0,4,2,7030,33,7063,11,FALSE
prismjs-package,0.5.0,0.6.0,5,4,1284,258,1542,22,FALSE
prismjs-package,0.3.0,0.4.0,3,4,40,12,52,5,FALSE
prismjs-package,0.6.9,0.6.10,15,2,5,5,10,2,TRUE
prismjs-package,0.6.2,0.6.3,8,3,10,5,15,3,TRUE
prismjs-package,0.6.12,0.6.13,18,28,46,43,89,36,TRUE
prismjs-package,0.6.11,0.6.12,17,7,13,13,26,7,TRUE
prismjs-package,0.6.3,0.6.4,9,3,12,5,17,9,TRUE
prismjs-package,0.6.8,0.6.9,14,3,14,6,20,3,TRUE
prismjs-package,0.7.25,0.7.26,47,2,55,6,61,4,TRUE
prismjs-package,0.7.23,0.7.24,45,2,11,11,22,3,TRUE
prismjs-package,0.7.22,0.7.23,44,2,5,5,10,2,TRUE
prismjs-package,0.6.5,0.6.6,11,3,155,8,163,4,TRUE
prismjs-package,0.7.3,0.7.4,25,23,87,35,122,24,TRUE
prismjs-package,0.7.6,0.7.7,28,3,5,5,10,3,TRUE
react-drag-and-drop,2.0.2,2.1.0,6,6,57,22,79,9,FALSE
react-drag-and-drop,2.0.1,2.0.2,5,5,60,24,84,9,FALSE
react-drag-and-drop,2.0.0,2.0.1,4,2,14,6,20,4,FALSE
react-drag-and-drop,2.3.0,2.4.0,9,6,143,56,199,11,FALSE
react-drag-and-drop,2.2.0,2.3.0,8,8,6667,67,6734,15,FALSE
react-drag-and-drop,2.1.0,2.2.0,7,4,53,26,79,10,FALSE
react-drag-and-drop,1.1.0,2.0.0,3,4,18,9,27,7,FALSE
react-drag-and-drop,1.0.0,1.0.1,1,3,50,8,58,8,FALSE
react-drag-and-drop,1.0.1,1.1.0,2,6,69,5,74,8,FALSE
react-drag-and-drop,2.1.0,2.2.0,7,4,53,26,79,10,TRUE
react-drag-and-drop,1.1.0,2.0.0,3,4,18,9,27,7,TRUE
react-fuzzy-search,0.2.8,0.3.0,17,5,67,19971,20038,7,FALSE
react-fuzzy-search,0.3.0,0.4.0,18,5,21907,20739,42646,13,FALSE
react-fuzzy-search,0.1.5,0.1.6,6,2,3,3,6,3,FALSE
react-fuzzy-search,0.2.7,0.2.8,16,4,41738,1155,42893,17,FALSE
react-fuzzy-search,0.2.6,0.2.7,15,2,88,3,91,5,FALSE
react-fuzzy-search,0.2.5,0.2.6,14,5,142,72,214,8,FALSE
react-fuzzy-search,0.2.4,0.2.5,13,2,37,11,48,3,FALSE
react-fuzzy-search,0.2.3,0.2.4,12,2,125,65,190,4,FALSE
react-fuzzy-search,0.2.2,0.2.3,11,4,141,69,210,6,FALSE
react-fuzzy-search,0.2.1,0.2.2,10,1,1,1,2,1,FALSE
react-fuzzy-search,0.2.0,0.2.1,9,3,242,437,679,7,FALSE
react-fuzzy-search,0.1.0,0.1.1,1,2,22,8,30,3,FALSE
react-fuzzy-search,0.1.1,0.1.2,2,1,1,1,2,1,FALSE
react-fuzzy-search,0.1.2,0.1.3,3,1,1,1,2,1,FALSE
react-fuzzy-search,0.1.3,0.1.4,4,2,52,66,118,3,FALSE
react-fuzzy-search,0.1.4,0.1.5,5,2,23,149,172,4,FALSE
react-fuzzy-search,0.1.6,0.1.7,7,2,1,91,92,4,FALSE
react-fuzzy-search,0.1.7,0.2.0,8,1,232,212,444,2,FALSE
react-fuzzy-search,0.1.7,0.2.0,8,1,232,212,444,2,TRUE
react-fuzzy-search,0.2.8,0.3.0,17,5,67,19971,20038,7,TRUE
react-fuzzy-search,0.2.5,0.2.6,14,5,142,72,214,8,TRUE
metalsmith-downloader,0.1.0,0.1.1,1,1,49,20,69,2,FALSE
metalsmith-downloader,0.1.1,0.1.2,2,6,227,171,398,6,FALSE
metalsmith-downloader,0.1.2,0.2.0,3,6,223,132,355,10,FALSE
metalsmith-downloader,0.2.0,0.2.1,4,2,15,3,18,2,FALSE
metalsmith-downloader,0.1.2,0.2.0,3,6,223,132,355,10,TRUE
metalsmith-downloader,0.1.1,0.1.2,2,6,227,171,398,6,TRUE
lego-data,1.0.5,1.0.6,6,4,514,259,773,16,FALSE
lego-data,1.0.6,1.0.7,7,1,4,4,8,3,FALSE
lego-data,1.0.7,1.0.8,8,3,34,270,304,6,FALSE
lego-data,1.0.4,1.0.5,5,1,4663,5,4668,15,TRUE
lego-data,1.0.3,1.0.4,4,1,4,2,6,2,FALSE
lego-data,1.0.4,1.0.5,5,1,4663,5,4668,15,FALSE
dog-client,1.0.0,1.0.1,1,2,163,1,164,9,FALSE
dog-client,2.0.2,2.1.0,6,6,66,46,112,13,FALSE
dog-client,2.0.1,2.0.2,5,2,10,25,35,4,FALSE
dog-client,2.0.0,2.0.1,4,2,3,3,6,3,FALSE
dog-client,2.1.2,2.1.3,9,2,6,12,18,3,FALSE
dog-client,1.0.2,2.0.0,3,3,112,58,170,9,FALSE
dog-client,2.1.1,2.1.2,8,2,6,3,9,2,FALSE
dog-client,2.1.0,2.1.1,7,1,1885,22,1907,4,FALSE
dog-client,1.0.1,1.0.2,2,2,5,5,10,2,FALSE
dog-client,2.2.1,2.3.0,14,2,9,1,10,2,FALSE
dog-client,2.2.0,2.2.1,13,4,11,2,13,4,FALSE
dog-client,2.1.3,2.1.4,10,2,80,228,308,3,FALSE
dog-client,2.1.4,2.1.5,11,2,11,12,23,4,FALSE
dog-client,2.1.5,2.2.0,12,1,79,16,95,3,FALSE
dog-client,2.3.0,3.2.0,15,2,110,19,129,6,FALSE
dog-client,3.2.4,3.2.5,20,2,35,52,87,5,TRUE
dog-client,3.2.5,3.2.6,21,2,16,16,32,2,TRUE
dog-client,3.2.0,3.2.1,16,2,2,2,4,2,FALSE
dog-client,3.2.1,3.2.2,17,3,2,6,8,3,FALSE
dog-client,3.2.2,3.2.3,18,2,9,6,15,3,TRUE
dog-client,3.2.3,3.2.4,19,2,5,3,8,2,TRUE
dog-client,3.2.4,3.2.5,20,2,35,52,87,5,FALSE
dog-client,3.2.5,3.2.6,21,2,16,16,32,2,FALSE
dog-client,3.2.2,3.2.3,18,2,9,6,15,3,FALSE
dog-client,3.2.3,3.2.4,19,2,5,3,8,2,FALSE
flavor-builder,1.1.1,1.2.0,32,27,456,83,539,31,FALSE
flavor-builder,1.1.0,1.1.1,31,6,35,39,74,9,FALSE
flavor-builder,0.6.0,0.6.1,13,2,3,2,5,3,FALSE
flavor-builder,1.0.0,1.1.0,30,7,183,22,205,10,FALSE
flavor-builder,0.6.6,0.7.0,19,2,12,8,20,3,FALSE
flavor-builder,0.6.5,0.6.6,18,2,3,3,6,2,FALSE
flavor-builder,0.2.0,0.3.0,3,2,5,28,33,5,FALSE
flavor-builder,0.6.4,0.6.5,17,2,9,12,21,2,FALSE
flavor-builder,0.0.1,0.0.2,1,2,14,7,21,2,FALSE
flavor-builder,0.0.2,0.2.0,2,5,257,187,444,10,FALSE
flavor-builder,0.3.2,0.3.3,6,2,87,88,175,2,FALSE
flavor-builder,0.3.3,0.4.0,7,4,44,34,78,4,FALSE
flavor-builder,0.3.0,0.3.1,4,5,15,12,27,9,FALSE
flavor-builder,0.3.1,0.3.2,5,2,6,6,12,2,FALSE
flavor-builder,0.7.2,0.7.3,22,2,15,4,19,3,FALSE
flavor-builder,0.7.3,0.7.4,23,5,49,10,59,6,FALSE
flavor-builder,0.7.0,0.7.1,20,2,1,2,3,2,FALSE
flavor-builder,0.7.1,0.7.2,21,2,5,5,10,2,FALSE
flavor-builder,0.4.0,0.5.0,8,3,48,52,100,4,FALSE
flavor-builder,0.5.0,0.5.1,9,9,751,824,1575,24,FALSE
flavor-builder,0.5.1,0.5.2,10,2,2,2,4,2,FALSE
flavor-builder,0.5.2,0.5.3,11,2,1,2,3,2,FALSE
flavor-builder,0.5.3,0.6.0,12,5,607,614,1221,14,FALSE
flavor-builder,1.4.0,1.4.1,40,3,38,18,56,5,FALSE
flavor-builder,1.4.1,1.4.2,41,2,7,2,9,3,FALSE
flavor-builder,1.4.2,1.4.3,42,3,390,391,781,5,FALSE
flavor-builder,1.4.3,1.4.4,43,2,7,2,9,3,FALSE
flavor-builder,0.8.1,0.8.2,26,27,354,533,887,43,FALSE
flavor-builder,0.8.0,0.8.1,25,3,3,2,5,3,FALSE
flavor-builder,0.8.3,0.8.4,28,2,16,5,21,3,FALSE
flavor-builder,0.8.2,0.8.3,27,27,586,304,890,48,FALSE
flavor-builder,1.3.2,1.4.0,39,8,122,56,178,12,FALSE
flavor-builder,1.3.1,1.3.2,38,2,7,2,9,3,FALSE
flavor-builder,1.3.0,1.3.1,37,3,311,391,702,6,FALSE
flavor-builder,1.2.2,1.2.3,35,13,2699,43,2742,16,FALSE
flavor-builder,1.2.3,1.3.0,36,25,638,537,1175,31,FALSE
flavor-builder,1.2.0,1.2.1,33,2,11,1,12,3,FALSE
flavor-builder,1.2.1,1.2.2,34,2,8,3,11,3,FALSE
flavor-builder,0.6.3,0.6.4,16,2,4,2,6,2,FALSE
flavor-builder,0.6.2,0.6.3,15,1,2,1,3,2,FALSE
flavor-builder,0.6.1,0.6.2,14,5,167,112,279,12,FALSE
flavor-builder,0.7.4,0.8.0,24,1,1,1,2,1,FALSE
flavor-builder,1.1.1,1.2.0,32,27,456,83,539,31,TRUE
copy-props,1.1.0,1.2.0,4,2,1120,203,1323,7,FALSE
copy-props,1.0.0,1.0.1,1,3,74,74,148,5,FALSE
copy-props,1.0.1,1.0.2,2,2,10,2,12,5,FALSE
copy-props,1.0.2,1.1.0,3,4,1607,314,1921,16,FALSE
copy-props,1.2.0,1.3.0,5,2,830,2142,2972,10,FALSE
copy-props,1.4.0,1.4.1,7,2,135,31,166,8,FALSE
copy-props,1.4.1,1.4.2,8,2,643,9141,9784,11,FALSE
copy-props,1.4.2,1.5.2,9,4,383,48,431,13,FALSE
copy-props,2.0.0,2.0.1,12,2,4,4,8,4,FALSE
copy-props,1.5.2,1.6.0,10,3,95,27,122,8,FALSE
copy-props,1.6.0,2.0.0,11,2,521,274,795,10,FALSE
copy-props,1.3.0,1.4.0,6,2,9833,1324,11157,15,FALSE
copy-props,1.5.2,1.6.0,10,3,95,27,122,8,TRUE
copy-props,1.3.0,1.4.0,6,2,9833,1324,11157,15,TRUE
copy-props,1.4.2,1.5.2,9,4,383,48,431,13,TRUE
xo-acl-resolver,0.0.0,0.1.0,2,5,12,8,20,5,FALSE
xo-acl-resolver,0.0.0-0,0.0.0,1,2,3,3,6,2,FALSE
xo-acl-resolver,0.2.2,0.2.3,6,2,2,2,4,2,FALSE
xo-acl-resolver,0.2.1,0.2.2,5,9,12,45,57,12,FALSE
xo-acl-resolver,0.2.0,0.2.1,4,2,3,1,4,2,FALSE
xo-acl-resolver,0.1.0,0.2.0,3,4,34,7,41,4,FALSE
xo-acl-resolver,0.0.0-0,0.0.0,1,2,3,3,6,2,TRUE
react-week-scheduler,0.1.11,0.1.12,12,1,5,11,16,4,FALSE
react-week-scheduler,0.1.0,0.1.1,1,2,7,12,19,5,FALSE
react-week-scheduler,0.1.1,0.1.2,2,1,1,1,2,1,FALSE
react-week-scheduler,0.1.2,0.1.3,3,1,1,1,2,1,FALSE
react-week-scheduler,0.1.3,0.1.4,4,1,1,1,2,1,FALSE
react-week-scheduler,0.1.4,0.1.5,5,1,1,1,2,1,FALSE
react-week-scheduler,0.1.5,0.1.6,6,1,1,1,2,1,FALSE
react-week-scheduler,0.1.6,0.1.7,7,1,1,1,2,1,FALSE
react-week-scheduler,0.1.10,0.1.11,11,7,674149,900,675049,15925,FALSE
react-week-scheduler,0.1.8,0.1.9,9,3,584,39,623,12,FALSE
react-week-scheduler,0.1.9,0.1.10,10,1,65669,121218,186887,2256,FALSE
react-week-scheduler,0.1.7,0.1.8,8,1,1,1,2,1,FALSE
react-week-scheduler,0.1.11,0.1.12,12,1,5,11,16,4,TRUE
quark-gui,0.4.11,0.4.12,30,3,642,678,1320,56,FALSE
quark-gui,0.4.10,0.4.11,29,1,286,279,565,7,TRUE
quark-gui,0.4.13,0.4.14,32,4,15,17,32,27,FALSE
quark-gui,0.4.12,0.4.13,31,5,127,91,218,17,FALSE
quark-gui,0.4.15,0.4.16,34,6,139,104,243,34,TRUE
quark-gui,0.4.14,0.4.15,33,4,73,64,137,9,TRUE
quark-gui,0.4.17,0.4.18,36,10,200,52,252,41,TRUE
quark-gui,0.4.16,0.4.17,35,5,391,71,462,36,TRUE
quark-gui,0.4.19,0.4.20,38,2,7,7,14,7,TRUE
quark-gui,0.4.18,0.4.19,37,5,135,251,386,80,TRUE
quark-gui,0.4.20,0.5.0,39,13,2835,482,3317,85,TRUE
quark-gui,0.5.0,0.5.1,40,4,127,16,143,20,FALSE
quark-gui,0.5.1,0.5.2,41,4,41,13,54,17,FALSE
quark-gui,0.5.2,0.5.3,42,2,22,9,31,7,FALSE
quark-gui,0.4.9,0.4.10,28,4,204,192,396,28,FALSE
quark-gui,0.4.8,0.4.9,27,4,141,134,275,28,FALSE
quark-gui,0.3.18,0.3.19,16,4,421,2711,3132,37,FALSE
quark-gui,0.3.19,0.3.20,17,3,16,25,41,27,FALSE
quark-gui,0.3.14,0.3.15,12,7,93,34,127,31,FALSE
quark-gui,0.3.15,0.3.16,13,1,8,7,15,3,FALSE
quark-gui,0.3.16,0.3.17,14,1,4,4,8,3,FALSE
quark-gui,0.3.17,0.3.18,15,6,258,200,458,27,FALSE
quark-gui,0.4.5,0.4.6,24,7,43,1324,1367,203,FALSE
quark-gui,0.4.4,0.4.5,23,5,226,498,724,56,FALSE
quark-gui,0.4.7,0.4.8,26,2,74,56,130,12,FALSE
quark-gui,0.4.6,0.4.7,25,1,54,54,108,54,FALSE
quark-gui,0.4.10,0.4.11,29,1,286,279,565,7,FALSE
quark-gui,0.4.15,0.4.16,34,6,139,104,243,34,FALSE
quark-gui,0.4.14,0.4.15,33,4,73,64,137,9,FALSE
quark-gui,0.4.17,0.4.18,36,10,200,52,252,41,FALSE
quark-gui,0.4.16,0.4.17,35,5,391,71,462,36,FALSE
quark-gui,0.4.19,0.4.20,38,2,7,7,14,7,FALSE
quark-gui,0.4.18,0.4.19,37,5,135,251,386,80,FALSE
quark-gui,0.4.1,0.4.2,20,6,525,64,589,34,FALSE
quark-gui,0.4.0,0.4.1,19,1,4,5,9,3,FALSE
quark-gui,0.4.3,0.4.4,22,1,7,5,12,5,FALSE
quark-gui,0.4.2,0.4.3,21,11,3835,316,4151,185,FALSE
quark-gui,0.3.10,0.3.11,8,2,40,6,46,4,FALSE
quark-gui,0.3.11,0.3.12,9,2,79,36,115,7,FALSE
quark-gui,0.3.20,0.4.0,18,38,2590,1825,4415,158,FALSE
quark-gui,0.3.12,0.3.13,10,5,47,39,86,19,FALSE
quark-gui,0.3.13,0.3.14,11,3,21,5,26,10,FALSE
quark-gui,0.4.20,0.5.0,39,13,2835,482,3317,85,FALSE
quark-gui,0.5.4,0.5.5,44,8,85,94,179,15,FALSE
quark-gui,0.5.14,0.5.15,54,5,60,38,98,12,FALSE
quark-gui,0.5.12,0.5.13,52,3,22,10,32,10,FALSE
quark-gui,0.5.13,0.5.14,53,5,128,16,144,16,FALSE
quark-gui,0.5.10,0.5.11,50,6,170,21,191,16,FALSE
quark-gui,0.5.11,0.5.12,51,8,223,90,313,18,FALSE
quark-gui,0.3.8,0.3.9,6,2,16,3,19,4,FALSE
quark-gui,0.3.9,0.3.10,7,4,31,5,36,5,FALSE
quark-gui,0.3.3,0.3.4,1,2,34,33,67,29,FALSE
quark-gui,0.3.6,0.3.7,4,3,13,5,18,3,FALSE
quark-gui,0.3.7,0.3.8,5,1,28,5,33,6,FALSE
quark-gui,0.3.4,0.3.5,2,2,14,1,15,3,FALSE
quark-gui,0.3.5,0.3.6,3,3,68,13,81,5,FALSE
quark-gui,0.5.8,0.5.9,48,3,33,37,70,21,FALSE
quark-gui,0.5.9,0.5.10,49,5,45,32,77,9,FALSE
quark-gui,0.5.5,0.5.6,45,3,33,30,63,7,FALSE
quark-gui,0.5.6,0.5.7,46,6,83,33,116,19,FALSE
quark-gui,0.5.3,0.5.4,43,9,131,122,253,34,FALSE
quark-gui,0.5.7,0.5.8,47,2,20,8,28,9,FALSE
quark-gui,0.4.0,0.4.1,19,1,4,5,9,3,TRUE
quark-gui,0.3.18,0.3.19,16,4,421,2711,3132,37,TRUE
quark-gui,0.3.17,0.3.18,15,6,258,200,458,27,TRUE
quark-gui,0.4.5,0.4.6,24,7,43,1324,1367,203,TRUE
quark-gui,0.5.4,0.5.5,44,8,85,94,179,15,TRUE
quark-gui,0.5.5,0.5.6,45,3,33,30,63,7,TRUE
quark-gui,0.5.8,0.5.9,48,3,33,37,70,21,TRUE
quark-gui,0.5.14,0.5.15,54,5,60,38,98,12,TRUE
quark-gui,0.5.13,0.5.14,53,5,128,16,144,16,TRUE
quark-gui,0.5.11,0.5.12,51,8,223,90,313,18,TRUE
quark-gui,0.4.8,0.4.9,27,4,141,134,275,28,TRUE
quark-gui,0.4.1,0.4.2,20,6,525,64,589,34,TRUE
quark-gui,0.5.6,0.5.7,46,6,83,33,116,19,TRUE
quark-gui,0.5.9,0.5.10,49,5,45,32,77,9,TRUE
quark-gui,0.4.4,0.4.5,23,5,226,498,724,56,TRUE
jshs2,0.2.7,0.2.8,8,4,1663,676,2339,19,FALSE
jshs2,0.2.8,0.2.9,9,7,48,6,54,11,FALSE
jshs2,0.3.0,0.3.1,14,1,10719,3,10722,4,FALSE
jshs2,0.3.1,0.4.0,15,2,1493,2208,3701,41,FALSE
jshs2,0.2.12,0.3.0,13,3,140192,2750,142942,56,FALSE
jshs2,0.2.11,0.2.12,12,2,424,466,890,16,FALSE
jshs2,0.2.10,0.2.11,11,4,851,470,1321,31,FALSE
jshs2,0.0.15,0.1.0,1,5,177,5,182,5,FALSE
jshs2,0.4.1,0.4.2,17,1,10946,237,11183,8,FALSE
jshs2,0.4.0,0.4.1,16,2,19,14,33,3,FALSE
jshs2,0.1.0,0.1.1,2,2,20208,620,20828,18,TRUE
jshs2,0.1.1,0.1.2,3,1,45,9,54,2,FALSE
jshs2,0.1.2,0.1.3,4,2,24,3,27,2,FALSE
jshs2,0.1.3,0.1.4,5,1,28,11,39,2,FALSE
jshs2,0.1.4,0.1.5,6,2,97,106,203,6,TRUE
jshs2,0.1.5,0.2.7,7,24,22865,12370,35235,146,FALSE
jshs2,0.2.9,0.2.10,10,2,194,114,308,20,FALSE
jshs2,0.1.0,0.1.1,2,2,20208,620,20828,18,FALSE
jshs2,0.1.4,0.1.5,6,2,97,106,203,6,FALSE
cooking-cli,1.0.4,1.0.5,7,3,12,7,19,5,FALSE
cooking-cli,1.0.5,1.0.6,8,2,13,9,22,5,FALSE
cooking-cli,1.0.6,1.0.7,9,2,8,4,12,4,FALSE
cooking-cli,1.0.7,1.0.8,10,2,11,7,18,6,FALSE
cooking-cli,1.0.0,1.0.1,3,3,10,6,16,7,FALSE
cooking-cli,1.0.1,1.0.2,4,8,271,49,320,20,FALSE
cooking-cli,1.0.2,1.0.3,5,2,8,5,13,5,FALSE
cooking-cli,1.0.3,1.0.4,6,3,16,10,26,8,FALSE
cooking-cli,1.0.8,1.0.9,11,2,9,5,14,5,FALSE
cooking-cli,1.0.9,1.0.10,12,2,10,6,16,5,FALSE
cooking-cli,1.1.2,1.1.3,17,2,10,6,16,6,FALSE
cooking-cli,1.1.4,1.2.0,19,4,72,28,100,14,FALSE
cooking-cli,1.2.10,1.2.11,30,4,21,8,29,8,FALSE
cooking-cli,1.1.1,1.1.2,16,7,193,36,229,21,TRUE
cooking-cli,1.0.10,1.0.11,13,3,34,16,50,8,FALSE
cooking-cli,1.0.11,1.1.0,14,2,24,21,45,8,FALSE
cooking-cli,1.4.0,1.4.1,36,2,11,9,20,9,FALSE
cooking-cli,1.2.11,1.2.12,31,3,20,10,30,7,FALSE
cooking-cli,1.2.12,1.3.0,32,2,53,4,57,7,FALSE
cooking-cli,1.5.1,1.5.2,39,3,9,4,13,6,FALSE
cooking-cli,1.5.0,1.5.1,38,3,7,6,13,4,FALSE
cooking-cli,1.5.2,1.5.3,40,6,14,8,22,7,FALSE
cooking-cli,1.2.6,1.2.7,26,2,8,5,13,5,FALSE
cooking-cli,1.2.7,1.2.8,27,2,13,6,19,6,FALSE
cooking-cli,1.2.4,1.2.5,24,2,34,22,56,9,FALSE
cooking-cli,1.2.5,1.2.6,25,3,27,18,45,10,FALSE
cooking-cli,1.0.0-rc.3,1.0.0,2,10,223,43,266,26,FALSE
cooking-cli,1.0.0-rc.2,1.0.0-rc.3,1,8,769,839,1608,92,FALSE
cooking-cli,1.2.0,1.2.1,20,4,40,11,51,11,FALSE
cooking-cli,1.2.1,1.2.2,21,4,65,8,73,11,FALSE
cooking-cli,1.2.8,1.2.9,28,2,14,12,26,6,FALSE
cooking-cli,1.2.9,1.2.10,29,1,8,5,13,5,FALSE
cooking-cli,1.1.0,1.1.1,15,4,22,22,44,11,FALSE
cooking-cli,1.3.2,1.4.0,35,3,16,18,34,11,FALSE
cooking-cli,1.3.1,1.3.2,34,2,8,5,13,5,FALSE
cooking-cli,1.3.0,1.3.1,33,2,17,12,29,6,FALSE
cooking-cli,1.4.1,1.5.0,37,4,34,10,44,8,FALSE
cooking-cli,1.2.2,1.2.3,22,2,24,7,31,7,FALSE
cooking-cli,1.1.3,1.1.4,18,5,14,16,30,11,FALSE
cooking-cli,1.2.3,1.2.4,23,5,25,21,46,13,FALSE
cooking-cli,1.1.1,1.1.2,16,7,193,36,229,21,FALSE
cooking-cli,1.2.0,1.2.1,20,4,40,11,51,11,TRUE
cooking-cli,1.0.0-rc.2,1.0.0-rc.3,1,8,769,839,1608,92,TRUE
cooking-cli,1.5.2,1.5.3,40,6,14,8,22,7,TRUE
cooking-cli,1.2.6,1.2.7,26,2,8,5,13,5,TRUE
cooking-cli,1.3.0,1.3.1,33,2,17,12,29,6,TRUE
cooking-cli,1.0.4,1.0.5,7,3,12,7,19,5,TRUE
cooking-cli,1.4.0,1.4.1,36,2,11,9,20,9,TRUE
formsy-react-components,0.6.3,0.6.4,17,3,151,11,162,5,FALSE
formsy-react-components,0.6.2,0.6.3,16,6,209,144,353,22,FALSE
formsy-react-components,0.6.1,0.6.2,15,15,59,30,89,38,FALSE
formsy-react-components,0.6.0,0.6.1,14,2,1,2,3,2,FALSE
formsy-react-components,0.6.6,0.7.0,20,14,126,80,206,35,FALSE
formsy-react-components,0.6.5,0.6.6,19,2,5,3,8,3,FALSE
formsy-react-components,0.6.4,0.6.5,18,10,155,45,200,17,FALSE
formsy-react-components,0.10.0,0.10.1,26,1,1,1,2,1,FALSE
formsy-react-components,0.8.1,0.9.0,24,8,616,149,765,43,FALSE
formsy-react-components,0.9.0,0.10.0,25,61,4419,5251,9670,249,FALSE
formsy-react-components,0.7.0,0.7.1,21,5,38,45,83,7,FALSE
formsy-react-components,0.8.0,0.8.1,23,3,139,20,159,16,FALSE
formsy-react-components,0.7.1,0.8.0,22,36,4729,2341,7070,169,FALSE
formsy-react-components,0.5.0,0.6.0,13,7,144,63,207,26,FALSE
formsy-react-components,0.2.1,0.3.0,9,5,143,65,208,28,FALSE
formsy-react-components,0.2.0,0.2.1,8,4,75,25,100,6,FALSE
formsy-react-components,0.1.2,0.1.3,4,4,14,5,19,4,FALSE
formsy-react-components,0.1.3,0.1.4,5,10,106,29,135,12,FALSE
formsy-react-components,0.1.4,0.1.5,6,2,2,2,4,2,FALSE
formsy-react-components,0.1.5,0.2.0,7,5,175,3,178,9,FALSE
formsy-react-components,0.3.0,0.4.0,10,15,656,342,998,45,FALSE
formsy-react-components,0.4.1,0.5.0,12,11,172,85,257,45,FALSE
formsy-react-components,0.4.0,0.4.1,11,10,21,18,39,11,FALSE
formsy-react-components,0.6.3,0.6.4,17,3,151,11,162,5,TRUE
formsy-react-components,0.1.0,0.1.1,2,2,521,4,525,11,FALSE
formsy-react-components,0.0.0,0.1.0,1,2,5,9,14,4,FALSE
formsy-react-components,0.1.1,0.1.2,3,9,25,854,879,18,FALSE
formsy-react-components,0.8.1,0.9.0,24,8,616,149,765,43,TRUE
formsy-react-components,0.7.0,0.7.1,21,5,38,45,83,7,TRUE
pagination-window,1.0.0,1.0.1,1,2,19,12,31,3,TRUE
pagination-window,1.0.0,1.0.1,1,2,19,12,31,3,FALSE
react-telephone-input,2.0.7,2.1.7,30,6,465,684,1149,8,FALSE
react-telephone-input,3.1.3,3.2.3,36,3,689,3975,4664,5,FALSE
react-telephone-input,2.0.5,2.0.6,28,1,6,6,12,6,FALSE
react-telephone-input,2.0.4,2.0.5,27,2,15946,15997,31943,9,FALSE
react-telephone-input,1.0.0,1.0.1,1,2,28598,17,28615,5,FALSE
react-telephone-input,2.0.1,2.0.2,24,1,7,67,74,4,FALSE
react-telephone-input,2.0.0,2.0.1,23,1,1,1,2,1,FALSE
react-telephone-input,1.3.4,1.3.5,19,1,20,20,40,5,FALSE
react-telephone-input,3.0.3,3.1.3,35,2,11868,12022,23890,13,FALSE
react-telephone-input,2.0.3,2.0.4,26,2,128,114,242,6,FALSE
react-telephone-input,3.0.2,3.0.3,34,1,2,2,4,2,FALSE
react-telephone-input,2.1.7,3.0.0,31,3,2001,1794,3795,17,FALSE
react-telephone-input,2.0.2,2.0.3,25,3,34,27,61,9,FALSE
react-telephone-input,4.0.0,4.0.1,56,2,2,1,3,2,FALSE
react-telephone-input,3.0.0,3.0.1,32,2,5,71,76,4,FALSE
react-telephone-input,3.0.1,3.0.2,33,1,2,2,4,2,FALSE
react-telephone-input,2.0.6,2.0.7,29,1,6,12,18,6,FALSE
react-telephone-input,3.6.3,3.7.0,47,1,1597,1375,2972,5,FALSE
react-telephone-input,1.2.0,1.2.1,5,10,937,904,1841,15,FALSE
react-telephone-input,1.2.6,1.2.7,11,2,592,5,597,6,FALSE
react-telephone-input,1.2.7,1.2.8,12,7,15,15,30,7,FALSE
react-telephone-input,1.3.1,1.3.2,16,3,4,3,7,3,FALSE
react-telephone-input,1.3.0,1.3.1,15,3,5,12,17,3,FALSE
react-telephone-input,1.2.2,1.2.3,7,2,41035,89,41124,18,FALSE
react-telephone-input,1.2.3,1.2.4,8,3,131,718,849,17,FALSE
react-telephone-input,1.3.5,1.3.6,20,1,1,1,2,1,FALSE
react-telephone-input,1.2.1,1.2.2,6,1,5,847,852,2,FALSE
react-telephone-input,3.8.6,4.0.0,55,19,17113,602,17715,47,FALSE
react-telephone-input,3.8.4,3.8.5,53,1,1,1,2,1,FALSE
react-telephone-input,3.8.5,3.8.6,54,1,1,1,2,1,FALSE
react-telephone-input,3.8.3,3.8.4,52,1,12306,12564,24870,4,FALSE
react-telephone-input,1.2.8,1.2.9,13,1,2,2,4,2,FALSE
react-telephone-input,1.2.9,1.3.0,14,1,2,2,4,2,FALSE
react-telephone-input,1.3.3,1.3.4,18,6,111,71,182,18,FALSE
react-telephone-input,3.4.6,3.5.0,42,3,6542,5160,11702,10,FALSE
react-telephone-input,3.6.0,3.6.1,44,1,23,85,108,5,FALSE
react-telephone-input,3.4.4,3.4.5,40,4,115,21,136,9,FALSE
react-telephone-input,1.3.2,1.3.3,17,8,7887,8599,16486,13,FALSE
react-telephone-input,3.4.5,3.4.6,41,9,142,34,176,13,FALSE
react-telephone-input,1.2.4,1.2.5,9,2,654,443,1097,10,FALSE
react-telephone-input,3.5.0,3.6.0,43,11,1762,1070,2832,20,FALSE
react-telephone-input,3.2.4,3.3.4,38,8,28146,27594,55740,26,FALSE
react-telephone-input,3.6.1,3.6.2,45,1,39,11,50,5,FALSE
react-telephone-input,3.6.2,3.6.3,46,1,19,6,25,3,FALSE
react-telephone-input,1.2.5,1.2.6,10,1,2,4,6,2,FALSE
react-telephone-input,3.3.4,3.4.4,39,2,15717,15940,31657,10,FALSE
react-telephone-input,3.2.3,3.2.4,37,3,32321,32468,64789,15,FALSE
react-telephone-input,1.3.7,2.0.0,22,1,114,31,145,6,TRUE
react-telephone-input,3.7.2,3.7.3,50,1,22,20,42,4,FALSE
react-telephone-input,3.7.1,3.7.2,49,6,2001,1457,3458,15,FALSE
react-telephone-input,3.7.0,3.7.1,48,2,110,153,263,10,FALSE
react-telephone-input,3.7.3,3.8.3,51,12,206,134,340,19,FALSE
react-telephone-input,1.3.6,1.3.7,21,1,1,3,4,2,FALSE
react-telephone-input,1.3.7,2.0.0,22,1,114,31,145,6,FALSE
react-telephone-input,1.1.0,1.2.0,4,14,3305,29506,32811,30,FALSE
react-telephone-input,1.2.5,1.2.6,10,1,2,4,6,2,TRUE
react-telephone-input,1.0.2,1.1.0,3,22,28858,232,29090,48,FALSE
react-telephone-input,1.0.1,1.0.2,2,4,8,6,14,5,FALSE
react-telephone-input,1.3.0,1.3.1,15,3,5,12,17,3,TRUE
react-telephone-input,1.2.8,1.2.9,13,1,2,2,4,2,TRUE
react-telephone-input,3.7.3,3.8.3,51,12,206,134,340,19,TRUE
react-telephone-input,1.2.3,1.2.4,8,3,131,718,849,17,TRUE
merlin.js,1.0.4,1.0.5,25,2,19,15,34,7,FALSE
merlin.js,1.0.5,1.0.6-beta,26,5,120,11308,11428,18,FALSE
merlin.js,1.0.6,1.0.7,28,2,13485,20,13505,13,FALSE
merlin.js,1.0.7,1.1.1,29,6,565,212,777,30,FALSE
merlin.js,1.0.3,1.0.4,24,3,127,119,246,9,FALSE
merlin.js,0.8.0,1.0.3,23,8,1079,456,1535,41,FALSE
merlin.js,1.1.2,1.2.0,31,3,10181,9885,20066,10,FALSE
merlin.js,1.1.1,1.1.2,30,2,13,10,23,9,FALSE
merlin.js,1.2.0,1.3.0,32,3,107,49,156,10,FALSE
merlin.js,1.0.6-beta,1.0.6,27,3,131,11336,11467,21,FALSE
merlin.js,1.3.0,1.4.0,33,5,950,686,1636,16,FALSE
merlin.js,0.4.0,0.4.1,1,4,62,36,98,8,FALSE
merlin.js,1.3.0,1.4.0,33,5,950,686,1636,16,TRUE
merlin.js,0.5.10,0.6.0,14,1,816,641,1457,8,FALSE
merlin.js,0.6.3,0.6.4,18,3,76,30,106,17,FALSE
merlin.js,0.6.2,0.6.3,17,1,291,213,504,12,FALSE
merlin.js,0.6.1,0.6.2,16,1,132,48,180,10,TRUE
merlin.js,0.6.0,0.6.1,15,2,99,63,162,20,FALSE
merlin.js,0.6.4,0.7.0-beta,19,12,17898,6728,24626,65,FALSE
merlin.js,0.5.8,0.5.9,12,1,11,8,19,8,FALSE
merlin.js,0.5.9,0.5.10,13,1,71,35,106,8,FALSE
merlin.js,0.5.4,0.5.5,8,2,87,9,96,11,TRUE
merlin.js,0.5.6,0.5.7,10,2,95,9,104,11,TRUE
merlin.js,0.5.7,0.5.8,11,1,83,4,87,9,FALSE
merlin.js,0.5.0,0.5.1,4,2,188,19,207,10,FALSE
merlin.js,0.5.1,0.5.2,5,2,22,4,26,8,TRUE
merlin.js,0.5.2,0.5.3,6,3,263,248,511,21,FALSE
merlin.js,0.5.3,0.5.4,7,3,47,5,52,10,FALSE
merlin.js,0.4.1,0.4.3,2,9,793,580,1373,33,FALSE
merlin.js,0.7.0-beta.2,0.7.0,21,1,7,4,11,5,FALSE
merlin.js,0.5.5,0.5.6,9,4,204,19,223,17,TRUE
merlin.js,0.4.3,0.5.0,3,2,27,23,50,10,FALSE
merlin.js,0.7.0-beta,0.7.0-beta.2,20,2,22,14,36,9,FALSE
merlin.js,0.6.1,0.6.2,16,1,132,48,180,10,FALSE
merlin.js,0.7.0,0.8.0,22,54,13718,9707,23425,252,FALSE
merlin.js,0.5.1,0.5.2,5,2,22,4,26,8,FALSE
merlin.js,0.5.4,0.5.5,8,2,87,9,96,11,FALSE
merlin.js,0.5.5,0.5.6,9,4,204,19,223,17,FALSE
merlin.js,0.5.6,0.5.7,10,2,95,9,104,11,FALSE
merlin.js,0.7.0,0.8.0,22,54,13718,9707,23425,252,TRUE
merlin.js,1.2.0,1.3.0,32,3,107,49,156,10,TRUE
typer-js,2.0.7,2.0.8,12,2,10,9,19,2,FALSE
typer-js,2.0.6,2.0.7,11,1,11,9,20,4,FALSE
typer-js,2.0.5,2.0.6,10,1,2,0,2,1,FALSE
typer-js,2.0.4,2.0.5,9,2,7,4,11,4,FALSE
typer-js,1.0.0,1.0.1,1,1,6,5,11,2,FALSE
typer-js,1.0.1,1.0.2,2,1,9,3,12,3,FALSE
typer-js,2.0.1,2.0.2,6,1,6,5,11,2,FALSE
typer-js,2.0.0,2.0.1,5,1,6,5,11,2,FALSE
typer-js,2.0.8,2.1.0,13,1,6,30,36,3,TRUE
typer-js,2.2.4,2.3.0,22,3,135,206,341,6,FALSE
typer-js,2.2.1,2.2.2,19,1,17,31,48,3,FALSE
typer-js,2.2.0,2.2.1,18,1,4,16,20,1,FALSE
typer-js,2.2.3,2.2.4,21,1,2,4,6,1,FALSE
typer-js,2.2.2,2.2.3,20,2,5,4,9,4,FALSE
typer-js,2.1.2,2.1.3,16,1,1,1,2,1,FALSE
typer-js,2.1.3,2.2.0,17,2,69,21,90,4,FALSE
typer-js,2.1.0,2.1.1,14,1,1,1,2,1,FALSE
typer-js,2.1.1,2.1.2,15,1,125,232,357,7,FALSE
typer-js,2.0.3,2.0.4,8,1,6,5,11,2,FALSE
typer-js,2.0.2,2.0.3,7,3,7,7,14,5,FALSE
typer-js,1.0.2,1.0.3,3,1,8,3,11,3,FALSE
typer-js,1.0.3,2.0.0,4,12,627,202,829,30,FALSE
typer-js,2.4.4,2.5.0,30,2,118,49,167,7,FALSE
typer-js,2.3.0,2.3.1,23,1,17,3,20,1,FALSE
typer-js,2.3.1,2.3.2,24,2,124,111,235,7,FALSE
typer-js,2.3.2,2.4.0,25,1,22,14,36,5,FALSE
typer-js,2.4.3,2.4.4,29,1,2,2,4,2,FALSE
typer-js,2.4.2,2.4.3,28,1,11,7,18,2,FALSE
typer-js,2.4.1,2.4.2,27,1,44,51,95,2,FALSE
typer-js,2.4.0,2.4.1,26,1,1,0,1,1,FALSE
typer-js,2.5.0,2.5.1,31,2,11,10,21,4,FALSE
typer-js,2.5.1,2.5.2,32,1,3,1,4,2,FALSE
typer-js,2.0.4,2.0.5,9,2,7,4,11,4,TRUE
typer-js,2.0.8,2.1.0,13,1,6,30,36,3,FALSE
typer-js,2.5.1,2.5.2,32,1,3,1,4,2,TRUE
sweb,0.1.0,0.2.0,1,7,229,111,340,17,FALSE
sweb,0.2.0,0.3.0,2,6,310,145,455,17,FALSE
sweb,0.1.0,0.2.0,1,7,229,111,340,17,TRUE
rest-methods,1.0.4,1.0.5,15,3,17,11,28,6,FALSE
rest-methods,1.0.5,1.0.6,16,3,29,28,57,5,FALSE
rest-methods,1.0.6,1.0.7,17,3,6,5,11,3,FALSE
rest-methods,1.0.7,1.0.8,18,3,317,317,634,16,FALSE
rest-methods,1.0.0,1.0.1,11,2,2,2,4,2,FALSE
rest-methods,1.0.1,1.0.2,12,4,131,49,180,4,FALSE
rest-methods,1.0.2,1.0.3,13,2,127,27,154,2,FALSE
rest-methods,1.0.3,1.0.4,14,2,4,2,6,2,FALSE
rest-methods,1.0.8,1.0.9,19,6,52,34,86,12,FALSE
rest-methods,1.0.9,1.0.10,20,7,367,147,514,22,FALSE
rest-methods,0.0.11,0.0.12,9,2,30,9,39,4,FALSE
rest-methods,0.0.10,0.0.11,8,2,437,190,627,15,FALSE
rest-methods,0.0.12,1.0.0,10,1,1,1,2,1,FALSE
rest-methods,0.0.5,0.0.6,3,3,21,14,35,4,FALSE
rest-methods,0.0.4,0.0.5,2,2,6,8,14,3,FALSE
rest-methods,0.0.7,0.0.8,5,2,5,5,10,4,FALSE
rest-methods,0.0.6,0.0.7,4,2,11,11,22,2,FALSE
rest-methods,0.0.3,0.0.4,1,2,2,2,4,2,FALSE
rest-methods,0.0.9,0.0.10,7,2,3,3,6,2,FALSE
rest-methods,0.0.8,0.0.9,6,3,7,7,14,5,FALSE
rest-methods,1.0.16,1.0.18,26,6,15,9,24,10,FALSE
rest-methods,1.0.14,1.0.15,24,4,8,14,22,5,FALSE
rest-methods,1.0.15,1.0.16,25,9,338,350,688,25,FALSE
rest-methods,1.0.12,1.0.14,23,13,95,34,129,18,FALSE
rest-methods,1.0.10,1.0.11,21,7,388,148,536,25,FALSE
rest-methods,1.0.11,1.0.12,22,4,108,26,134,12,FALSE
rest-methods,1.0.18,1.0.19,27,2,3,2,5,2,FALSE
rest-methods,1.0.19,1.0.20,28,3,8,382,390,3,FALSE
rest-methods,1.0.8,1.0.9,19,6,52,34,86,12,TRUE
rest-methods,1.0.1,1.0.2,12,4,131,49,180,4,TRUE
rest-methods,0.0.10,0.0.11,8,2,437,190,627,15,TRUE
rest-methods,1.0.19,1.0.20,28,3,8,382,390,3,TRUE
rest-methods,0.0.11,0.0.12,9,2,30,9,39,4,TRUE
rest-methods,1.0.14,1.0.15,24,4,8,14,22,5,TRUE
rest-methods,1.0.16,1.0.18,26,6,15,9,24,10,TRUE
real-executable-path,1.0.0,1.0.1,2,1,19,15,34,2,FALSE
real-executable-path,1.0.1,2.0.0,3,4,22,33,55,10,FALSE
real-executable-path,0.0.0,1.0.0,1,1,19,15,34,2,FALSE
real-executable-path,1.0.1,2.0.0,3,4,22,33,55,10,TRUE
real-executable-path,0.0.0,1.0.0,1,1,19,15,34,2,TRUE
generator-mljs-packages,1.0.4,1.0.5,5,2,3,4,7,3,FALSE
generator-mljs-packages,1.0.5,1.0.6,6,2,11,8,19,13,FALSE
generator-mljs-packages,1.0.6,1.0.7,7,2,1,4,5,2,FALSE
generator-mljs-packages,1.0.7,1.0.8,8,2,5,1,6,2,FALSE
generator-mljs-packages,1.0.0,1.0.1,1,3,29,3,32,3,FALSE
generator-mljs-packages,1.0.1,1.0.2,2,2,8,1,9,2,FALSE
generator-mljs-packages,1.0.2,1.0.3,3,1,4,11,15,6,FALSE
generator-mljs-packages,1.0.3,1.0.4,4,2,3,5,8,5,FALSE
generator-mljs-packages,1.0.8,1.0.9,9,2,5,2,7,2,FALSE
generator-mljs-packages,1.0.9,1.0.10,10,2,7,5,12,13,FALSE
generator-mljs-packages,1.6.0,1.7.0,20,2,27,5,32,6,FALSE
generator-mljs-packages,1.0.12,1.1.0,13,1,9,2,11,2,FALSE
generator-mljs-packages,1.0.10,1.0.11,11,2,4,4,8,3,FALSE
generator-mljs-packages,1.0.11,1.0.12,12,3,4,8,12,12,FALSE
generator-mljs-packages,1.9.1,1.9.2,25,3,13,3,16,4,FALSE
generator-mljs-packages,1.9.0,1.9.1,24,2,20,18,38,6,FALSE
generator-mljs-packages,1.9.3,1.9.4,27,3,11,17,28,4,FALSE
generator-mljs-packages,1.9.2,1.9.3,26,2,20,3,23,5,FALSE
generator-mljs-packages,1.8.0,1.8.1,22,3,24,5,29,5,FALSE
generator-mljs-packages,1.7.0,1.8.0,21,2,32,5,37,10,FALSE
generator-mljs-packages,1.4.0,1.4.1,17,4,17,6,23,5,FALSE
generator-mljs-packages,1.4.1,1.5.0,18,3,24,3,27,4,FALSE
generator-mljs-packages,1.5.0,1.6.0,19,2,12,2,14,3,FALSE
generator-mljs-packages,1.3.0,1.4.0,16,3,20,6,26,8,FALSE
generator-mljs-packages,1.2.0,1.3.0,15,3,16,44,60,5,FALSE
generator-mljs-packages,1.1.0,1.2.0,14,14,121,36,157,19,FALSE
generator-mljs-packages,1.8.1,1.9.0,23,3,55,16,71,12,FALSE
generator-mljs-packages,1.1.0,1.2.0,14,14,121,36,157,19,TRUE
generator-mljs-packages,1.0.6,1.0.7,7,2,1,4,5,2,TRUE
generator-mljs-packages,1.9.1,1.9.2,25,3,13,3,16,4,TRUE
generator-mljs-packages,1.5.0,1.6.0,19,2,12,2,14,3,TRUE
get-processor-ids-from-stylelint-options,0.0.1,0.0.2,2,1,331,0,331,9,FALSE
get-processor-ids-from-stylelint-options,0.0.0,0.0.1,1,1,331,0,331,9,FALSE
get-processor-ids-from-stylelint-options,0.0.2,0.0.3,3,1,331,0,331,9,FALSE
get-processor-ids-from-stylelint-options,0.0.3,1.0.0,4,1,331,0,331,9,FALSE
get-processor-ids-from-stylelint-options,0.0.3,1.0.0,4,1,331,0,331,9,TRUE
backbeam-lambda,0.0.3,0.1.0,3,1,1655,1134,2789,31,FALSE
backbeam-lambda,0.0.2,0.0.3,2,2,60,4,64,5,FALSE
backbeam-lambda,0.1.8,0.1.9,12,3,502,458,960,29,FALSE
backbeam-lambda,0.1.9,0.1.10,13,1,5,5,10,4,FALSE
backbeam-lambda,0.1.0,0.1.1,4,1,5,1,6,2,FALSE
backbeam-lambda,0.1.1,0.1.2,5,1,11,53,64,5,FALSE
backbeam-lambda,0.1.2,0.1.3,6,1,8,2,10,2,FALSE
backbeam-lambda,0.1.3,0.1.4,7,1,5,3,8,2,FALSE
backbeam-lambda,0.1.4,0.1.5,8,1,2,2,4,1,FALSE
backbeam-lambda,0.1.5,0.1.6,9,1,92,30,122,5,FALSE
backbeam-lambda,0.1.6,0.1.7,10,2,20,21,41,3,FALSE
backbeam-lambda,0.1.7,0.1.8,11,3,244,29,273,9,FALSE
backbeam-lambda,0.0.1,0.0.2,1,1,54,17,71,2,FALSE
backbeam-lambda,0.1.2,0.1.3,6,1,8,2,10,2,TRUE
backbeam-lambda,0.0.2,0.0.3,2,2,60,4,64,5,TRUE
backbeam-lambda,0.1.8,0.1.9,12,3,502,458,960,29,TRUE
backbeam-lambda,0.1.5,0.1.6,9,1,92,30,122,5,TRUE
backbeam-lambda,0.1.7,0.1.8,11,3,244,29,273,9,TRUE
zooid-ui,1.0.4,1.1.0,4,4,120,32,152,13,FALSE
zooid-ui,1.1.0,1.2.0,5,6,143,16,159,9,FALSE
zooid-ui,6.0.0,7.0.0,21,4,25,56,81,8,TRUE
zooid-ui,1.0.1,1.0.2,1,2,2,2,4,2,FALSE
zooid-ui,1.0.2,1.0.3,2,2,6,5,11,3,FALSE
zooid-ui,1.0.3,1.0.4,3,1,84,10,94,5,FALSE
zooid-ui,8.0.0,8.0.2,23,6,44,17,61,12,FALSE
zooid-ui,8.0.2,8.0.3,24,1,2,2,4,2,FALSE
zooid-ui,4.0.1,4.0.3,11,4,252,95,347,21,FALSE
zooid-ui,4.0.0,4.0.1,10,1,2,2,4,2,FALSE
zooid-ui,4.0.3,4.1.0,12,2,76,11,87,7,FALSE
zooid-ui,4.1.0,4.2.0,13,1,2,2,4,2,FALSE
zooid-ui,3.0.0,4.0.0,9,7,244,31,275,22,FALSE
zooid-ui,2.0.0,3.0.0,8,7,89,67,156,19,FALSE
zooid-ui,5.2.0,6.0.0,20,1,1,2,3,2,FALSE
zooid-ui,1.3.0,2.0.0,7,7,1130,206,1336,48,FALSE
zooid-ui,1.2.0,1.3.0,6,2,176,5,181,7,FALSE
zooid-ui,5.0.0,5.0.1,15,1,39,2,41,3,FALSE
zooid-ui,5.0.1,5.1.0,16,1,32,12,44,3,FALSE
zooid-ui,7.0.0,8.0.0,22,1,1,39,40,5,FALSE
zooid-ui,5.1.1,5.1.2,18,2,57,27,84,5,FALSE
zooid-ui,5.1.0,5.1.1,17,1,28,7,35,3,FALSE
zooid-ui,5.1.2,5.2.0,19,1,159,25,184,2,FALSE
zooid-ui,4.2.0,5.0.0,14,1,13,91,104,9,FALSE
zooid-ui,6.0.0,7.0.0,21,4,25,56,81,8,FALSE
zooid-ui,8.0.0,8.0.2,23,6,44,17,61,12,TRUE
zooid-ui,5.1.0,5.1.1,17,1,28,7,35,3,TRUE
zooid-ui,1.0.4,1.1.0,4,4,120,32,152,13,TRUE
zooid-ui,2.0.0,3.0.0,8,7,89,67,156,19,TRUE
zooid-ui,5.0.1,5.1.0,16,1,32,12,44,3,TRUE
zooid-ui,1.1.0,1.2.0,5,6,143,16,159,9,TRUE
zooid-ui,8.0.2,8.0.3,24,1,2,2,4,2,TRUE
rollator,0.2.0,0.2.1,6,2,15,3,18,4,FALSE
rollator,0.1.0,0.1.1,1,1,1,0,1,1,FALSE
rollator,0.1.1,0.1.2,2,2,4,4,8,2,FALSE
rollator,0.1.2,0.1.3,3,2,3,2,5,2,FALSE
rollator,0.1.3,0.1.4,4,3,22,25,47,5,FALSE
rollator,0.1.4,0.2.0,5,3,29,15,44,3,FALSE
rollator,0.1.4,0.2.0,5,3,29,15,44,3,TRUE
rollator,0.2.0,0.2.1,6,2,15,3,18,4,TRUE
safe-framework,0.0.39,0.0.40,38,3,3,4,7,4,FALSE
safe-framework,0.0.38,0.0.39,37,2,4,4,8,3,FALSE
safe-framework,0.0.15,0.0.16,15,5,960,1156,2116,64,FALSE
safe-framework,0.0.14,0.0.15,14,2,479,54,533,32,FALSE
safe-framework,0.0.17,0.0.18,17,3,181,40,221,15,FALSE
safe-framework,0.0.16,0.0.17,16,3,133,148,281,21,FALSE
safe-framework,0.0.11,0.0.12,11,2,12,6,18,4,FALSE
safe-framework,0.0.10,0.0.11,10,6,174,153,327,26,FALSE
safe-framework,0.0.13,0.0.14,13,2,15,4,19,4,FALSE
safe-framework,0.0.12,0.0.13,12,3,44,17,61,6,FALSE
safe-framework,0.0.37,0.0.38,36,2,5,3,8,3,FALSE
safe-framework,0.0.36,0.0.37,35,2,1187,2,1189,6,FALSE
safe-framework,0.0.35,0.0.36,34,2,72,69,141,9,FALSE
safe-framework,0.0.34,0.0.35,33,5,206,754,960,34,FALSE
safe-framework,0.0.19,0.0.20,19,3,609,75,684,15,FALSE
safe-framework,0.0.18,0.0.19,18,4,153,142,295,9,FALSE
safe-framework,0.0.31,0.0.32,30,2,7,2,9,6,FALSE
safe-framework,0.0.30,0.0.31,29,2,16,5,21,5,FALSE
safe-framework,0.0.5,0.0.6,5,1,32,32,64,14,FALSE
safe-framework,0.0.4,0.0.5,4,1,7,7,14,4,FALSE
safe-framework,0.0.7,0.0.8,7,8,620,122,742,64,FALSE
safe-framework,0.0.6,0.0.7,6,14,2063,9112,11175,155,FALSE
safe-framework,0.0.33,0.0.34,32,3,757,20,777,22,FALSE
safe-framework,0.0.9,0.0.10,9,4,150,54,204,12,FALSE
safe-framework,0.0.8,0.0.9,8,3,83,2,85,10,FALSE
safe-framework,0.0.32,0.0.33,31,2,5,16,21,5,FALSE
safe-framework,0.0.20,0.0.21,20,2,234,26,260,11,FALSE
safe-framework,0.0.21,0.0.22,21,2,58,43,101,8,FALSE
safe-framework,0.0.22,0.0.23,22,3,53,11,64,5,FALSE
safe-framework,0.0.23,0.0.24,23,2,58,55,113,4,TRUE
safe-framework,0.0.24,0.0.25,24,4,224,49,273,13,TRUE
safe-framework,0.0.25,0.0.26,25,2,6,2,8,3,FALSE
safe-framework,0.0.26,0.0.27,26,3,112,40,152,6,FALSE
safe-framework,0.0.27,0.0.28,27,5,327,230,557,47,FALSE
safe-framework,0.0.28,0.0.30,28,4,77,23,100,13,FALSE
safe-framework,0.0.43,0.0.44,42,2,13,5,18,5,FALSE
safe-framework,0.0.40,0.0.41,39,4,47,189,236,9,FALSE
safe-framework,0.0.41,0.0.42,40,4,46,16,62,5,FALSE
safe-framework,0.0.44,0.0.45,43,4,86,30,116,14,FALSE
safe-framework,0.0.42,0.0.43,41,3,49,16,65,7,FALSE
safe-framework,0.0.1,0.0.2,1,2,85801,5686,91487,111,FALSE
safe-framework,0.0.33,0.0.34,32,3,757,20,777,22,TRUE
safe-framework,0.0.21,0.0.22,21,2,58,43,101,8,TRUE
safe-framework,0.0.23,0.0.24,23,2,58,55,113,4,FALSE
safe-framework,0.0.24,0.0.25,24,4,224,49,273,13,FALSE
safe-framework,0.0.3,0.0.4,3,1,5988,83734,89722,10,FALSE
safe-framework,0.0.2,0.0.3,2,1,6,4,10,2,FALSE
safe-framework,0.0.40,0.0.41,39,4,47,189,236,9,TRUE
safe-framework,0.0.11,0.0.12,11,2,12,6,18,4,TRUE
safe-framework,0.0.43,0.0.44,42,2,13,5,18,5,TRUE
safe-framework,0.0.16,0.0.17,16,3,133,148,281,21,TRUE
safe-framework,0.0.9,0.0.10,9,4,150,54,204,12,TRUE
quik,0.2.2,0.2.3,16,2,16,10,26,3,FALSE
quik,0.2.1,0.2.2,15,11,34,45,79,13,FALSE
quik,0.9.0,0.10.0,32,1,20,1,21,2,FALSE
quik,0.10.0,0.11.0,33,2,32,2,34,5,FALSE
quik,0.4.10,0.5.0,25,1,175,111,286,5,FALSE
quik,0.7.2,0.8.0,30,4,875,843,1718,53,FALSE
quik,0.6.0,0.7.0,27,15,65,56,121,23,FALSE
quik,0.11.0,0.11.1,34,1,1,1,2,1,FALSE
quik,0.11.1,0.11.2,35,9,6595,161,6756,44,TRUE
quik,0.7.0,0.7.1,28,1,1,2,3,2,FALSE
quik,0.7.1,0.7.2,29,1,175,111,286,5,FALSE
quik,0.4.9,0.4.10,24,6,23,15,38,5,FALSE
quik,0.4.8,0.4.9,23,9,233,117,350,16,FALSE
quik,0.8.0,0.9.0,31,4,23,10,33,5,FALSE
quik,0.4.5,0.4.6,21,10,62,29,91,10,FALSE
quik,0.5.0,0.6.0,26,1,42,13,55,2,FALSE
quik,0.4.4,0.4.5,20,9,37,25,62,9,FALSE
quik,0.4.6,0.4.8,22,8,175,79,254,27,FALSE
quik,0.1.8,0.1.9,9,2,25,21,46,3,FALSE
quik,0.1.9,0.1.10,10,7,43,38,81,10,FALSE
quik,0.2.3,0.3.3,17,21,630,579,1209,80,FALSE
quik,0.2.0,0.2.1,14,31,470,230,700,56,FALSE
quik,0.1.0,0.1.1,1,2,75,21,96,10,FALSE
quik,0.1.1,0.1.2,2,2,2,94,96,2,FALSE
quik,0.1.2,0.1.3,3,3,46,39,85,16,FALSE
quik,0.1.3,0.1.4,4,4,34,31,65,7,FALSE
quik,0.1.4,0.1.5,5,5,93,35,128,7,FALSE
quik,0.1.5,0.1.6,6,13,338,189,527,41,FALSE
quik,0.1.6,0.1.7,7,15,234,60,294,24,FALSE
quik,0.1.7,0.1.8,8,16,403,188,591,32,FALSE
quik,0.3.3,0.4.3,18,8,81,94,175,13,FALSE
quik,0.4.3,0.4.4,19,9,92,43,135,15,FALSE
quik,0.1.12,0.2.0,13,24,467,189,656,46,FALSE
quik,0.1.10,0.1.11,11,8,109,79,188,19,FALSE
quik,0.1.11,0.1.12,12,2,5,3,8,3,FALSE
quik,0.11.1,0.11.2,35,9,6595,161,6756,44,FALSE
quik,0.1.5,0.1.6,6,13,338,189,527,41,TRUE
quik,0.4.3,0.4.4,19,9,92,43,135,15,TRUE
quik,0.2.3,0.3.3,17,21,630,579,1209,80,TRUE
quik,0.2.0,0.2.1,14,31,470,230,700,56,TRUE
quik,0.3.3,0.4.3,18,8,81,94,175,13,TRUE
quik,0.4.6,0.4.8,22,8,175,79,254,27,TRUE
quik,0.7.2,0.8.0,30,4,875,843,1718,53,TRUE
quik,0.4.9,0.4.10,24,6,23,15,38,5,TRUE
quik,0.4.8,0.4.9,23,9,233,117,350,16,TRUE
chimp,0.42.0,0.43.0,127,3,70,40,110,6,FALSE
chimp,0.31.0,0.31.1,98,6,68,8,76,12,FALSE
chimp,0.31.1,0.32.0,99,18,2024,846,2870,121,FALSE
chimp,0.37.0,0.37.1,109,4,16,16,32,5,FALSE
chimp,0.37.1,0.38.0,110,6,221,202,423,38,FALSE
chimp,0.36.1,0.37.0,108,13,330,3902,4232,83,FALSE
chimp,0.36.0,0.36.1,107,10,46,3769,3815,56,FALSE
chimp,0.40.6,0.40.7,122,6,24,7,31,7,FALSE
chimp,0.40.7,0.41.0,123,7,139,84,223,18,FALSE
chimp,0.40.4,0.40.5,120,19,76,39,115,19,FALSE
chimp,0.40.5,0.40.6,121,3,16,4,20,5,FALSE
chimp,0.40.2,0.40.3,118,2,2,1,3,2,FALSE
chimp,0.40.3,0.40.4,119,2,1,2,3,2,FALSE
chimp,0.40.0,0.40.1,116,3,7,1,8,3,FALSE
chimp,0.40.1,0.40.2,117,2,7,2,9,3,FALSE
chimp,0.43.0,0.44.0,128,5,110,58,168,13,FALSE
chimp,0.35.0,0.36.0,106,32,478,3940,4418,104,FALSE
chimp,0.34.1,0.35.0,105,15,778,136,914,41,FALSE
chimp,0.34.0,0.34.1,104,8,288,50,338,29,FALSE
chimp,0.38.0,0.39.0,111,8,20,32,52,12,FALSE
chimp,0.28.0,0.28.1,91,2,58,14,72,4,FALSE
chimp,0.39.4,0.40.0,115,4,74,24,98,8,FALSE
chimp,0.39.3,0.39.4,114,6,13,7,20,6,FALSE
chimp,0.39.0,0.39.1,112,7,76,15,91,9,FALSE
chimp,0.39.1,0.39.3,113,2,7,4,11,2,FALSE
chimp,0.32.1,0.33.0,101,1,44,9,53,4,FALSE
chimp,0.32.0,0.32.1,100,3,139,28,167,14,FALSE
chimp,0.47.2,0.48.0,135,57,4431,826,5257,233,FALSE
chimp,0.41.2,0.42.0,126,32,623,163,786,83,FALSE
chimp,0.41.1,0.41.2,125,25,327,175,502,40,FALSE
chimp,0.41.0,0.41.1,124,5,48,2,50,7,FALSE
chimp,0.29.1,0.30.0,95,11,202,101,303,37,FALSE
chimp,0.29.0,0.29.1,94,2,35,6,41,8,FALSE
chimp,0.46.0,0.47.0,132,12,339,123,462,28,FALSE
chimp,0.26.0,0.27.0,89,6,939,775,1714,89,FALSE
chimp,0.47.1,0.47.2,134,11,77,27,104,28,FALSE
chimp,0.28.1,0.28.2,92,6,59,26,85,7,FALSE
chimp,0.28.2,0.29.0,93,7,60,13,73,12,FALSE
chimp,0.27.0,0.28.0,90,17,1271,1096,2367,51,FALSE
chimp,0.44.0,0.45.0,129,4,8,2,10,4,FALSE
chimp,0.45.1,0.46.0,131,9,200,40,240,22,FALSE
chimp,0.45.0,0.45.1,130,4,14,2,16,4,FALSE
chimp,0.33.0,0.33.1,102,1,5,0,5,1,FALSE
chimp,0.33.1,0.34.0,103,10,1191,492,1683,65,FALSE
chimp,0.47.0,0.47.1,133,5,26,6,32,6,FALSE
chimp,0.26.0-rc.0,0.26.0,88,7,45,27,72,12,FALSE
chimp,0.30.1,0.31.0,97,18,1008,570,1578,84,FALSE
chimp,0.30.0,0.30.1,96,27,9122,5098,14220,251,FALSE
chimp,0.48.0,0.49.0,136,4,34,5,39,4,FALSE
chimp,0.39.0,0.39.1,112,7,76,15,91,9,TRUE
chimp,0.34.0,0.34.1,104,8,288,50,338,29,TRUE
chimp,0.12.10,0.13.0,35,19,885,1307,2192,60,FALSE
chimp,0.17.2,0.18.0,67,2,9,3,12,2,FALSE
chimp,0.17.0,0.17.1,65,5,18,9,27,7,FALSE
chimp,0.17.1,0.17.2,66,3,3,3,6,3,FALSE
chimp,0.25.1,0.26.0-rc.0,87,53,1734,1515,3249,236,FALSE
chimp,0.25.0,0.25.1,86,3,425,51,476,16,FALSE
chimp,0.21.0,0.22.0,78,1,6,1,7,2,FALSE
chimp,0.18.0,0.19.0,68,24,2320,448,2768,90,FALSE
chimp,0.19.4,0.19.5,72,16,187,309,496,61,FALSE
chimp,0.15.4,0.16.0,55,8,67,9,76,9,FALSE
chimp,0.16.7,0.16.8,63,1,5,0,5,1,FALSE
chimp,0.16.6,0.16.7,62,1,5,0,5,1,FALSE
chimp,0.16.5,0.16.6,61,2,4,2,6,2,FALSE
chimp,0.16.3,0.16.5-rc.1,59,2,12,4,16,5,FALSE
chimp,0.16.2,0.16.3,58,1,5,0,5,1,FALSE
chimp,0.16.1,0.16.2,57,1,5,0,5,1,FALSE
chimp,0.16.0,0.16.1,56,2,21,10,31,4,FALSE
chimp,0.23.0,0.24.0,83,7,494,149,643,21,FALSE
chimp,0.15.0,0.15.1,48,6,66,14,80,6,FALSE
chimp,0.15.1,0.15.2,49,1,5,0,5,1,FALSE
chimp,0.15.2,0.15.3-rc.1,50,1,5,0,5,1,FALSE
chimp,0.15.3,0.15.4,54,2,16,1,17,2,FALSE
chimp,0.22.2,0.22.3,81,9,38,14,52,12,FALSE
chimp,0.22.3,0.23.0,82,3,80,6,86,9,FALSE
chimp,0.22.0,0.22.1,79,12,271,3771,4042,57,FALSE
chimp,0.22.1,0.22.2,80,12,121,127,248,27,FALSE
chimp,0.15.0-rc.7,0.15.0,47,2,15,15,30,2,FALSE
chimp,0.15.0-rc.6,0.15.0-rc.7,46,5,49,20,69,6,FALSE
chimp,0.7.14,0.7.15,14,5,116,92,208,6,FALSE
chimp,0.11.0,0.12.0,24,18,646,80,726,39,FALSE
chimp,0.20.0,0.20.1,74,8,467,180,647,27,FALSE
chimp,0.20.1,0.20.2,75,5,34,26,60,5,FALSE
chimp,0.20.2,0.20.3,76,15,5336,636,5972,109,FALSE
chimp,0.20.3,0.21.0,77,10,63,41,104,12,FALSE
chimp,0.13.0,0.14.0,36,4,30,22,52,6,FALSE
chimp,0.14.1,0.14.2,38,1,5,0,5,1,FALSE
chimp,0.14.0,0.14.1,37,4,22,14,36,7,FALSE
chimp,0.14.2,0.14.3,39,7,16,12,28,8,FALSE
chimp,0.7.10,0.7.11,10,2,7,7,14,3,FALSE
chimp,0.7.11,0.7.12,11,5,229,96,325,17,FALSE
chimp,0.7.12,0.7.13,12,9,941,606,1547,35,FALSE
chimp,0.7.13,0.7.14,13,2,3,4,7,2,FALSE
chimp,0.8.1,0.8.2,18,2,7,1,8,3,FALSE
chimp,0.7.15,0.7.16,15,4,4,2,6,2,FALSE
chimp,0.7.16,0.7.17,16,5,70,8,78,5,FALSE
chimp,0.8.2,0.8.3,19,2,9,9,18,3,FALSE
chimp,0.16.5-rc.1,0.16.5,60,1,5,0,5,1,FALSE
chimp,0.10.1,0.11.0,23,18,585,623,1208,37,FALSE
chimp,0.10.0,0.10.1,22,3,534,196,730,17,FALSE
chimp,0.15.3-rc.1,0.15.3-rc.2,51,1,5,0,5,1,FALSE
chimp,0.7.8,0.7.9,8,4,56,14,70,7,FALSE
chimp,0.7.9,0.7.10,9,3,29,7,36,4,FALSE
chimp,0.7.6,0.7.8,7,5,19,139,158,8,FALSE
chimp,0.7.4,0.7.5,5,1,5,0,5,1,FALSE
chimp,0.7.5,0.7.6,6,2,150,9,159,6,FALSE
chimp,0.7.2,0.7.3,3,3,70,10,80,12,FALSE
chimp,0.7.3,0.7.4,4,3,94,55,149,11,FALSE
chimp,0.7.0,0.7.1,1,4,6414,789,7203,68,FALSE
chimp,0.7.1,0.7.2,2,2,6,6,12,2,FALSE
chimp,0.12.3,0.12.4,28,3,6,5,11,3,FALSE
chimp,0.12.2,0.12.3,27,3,62,12,74,8,FALSE
chimp,0.12.1,0.12.2,26,1,5,0,5,1,FALSE
chimp,0.12.0,0.12.1,25,3,17,27,44,4,FALSE
chimp,0.12.7,0.12.8,32,5,36,14,50,5,FALSE
chimp,0.12.6,0.12.7,31,3,18,14,32,3,FALSE
chimp,0.12.5,0.12.6,30,3,2,1,3,2,FALSE
chimp,0.12.4,0.12.5,29,25,766,464,1230,50,FALSE
chimp,0.12.9,0.12.10,34,2,8,0,8,2,FALSE
chimp,0.12.8,0.12.9,33,4,14,32,46,4,FALSE
chimp,0.9.0,0.10.0,21,22,1128,499,1627,48,FALSE
chimp,0.19.5,0.20.0,73,1,17,17,34,3,FALSE
chimp,0.19.0,0.19.2,69,5,2536,14,2550,12,FALSE
chimp,0.19.2,0.19.3,70,4,98,77,175,9,FALSE
chimp,0.19.3,0.19.4,71,5,2613,24,2637,21,FALSE
chimp,0.24.0,0.24.1,84,2,9,3,12,3,FALSE
chimp,0.24.1,0.25.0,85,12,1297,3954,5251,94,FALSE
chimp,0.15.3-rc.3,0.15.3,53,1,5,0,5,1,FALSE
chimp,0.8.3,0.9.0,20,14,77,27,104,20,FALSE
chimp,0.7.17,0.8.1,17,2,47,7,54,4,FALSE
chimp,0.15.3-rc.2,0.15.3-rc.3,52,1,5,0,5,1,FALSE
chimp,0.44.0,0.45.0,129,4,8,2,10,4,TRUE
chimp,0.45.0,0.45.1,130,4,14,2,16,4,TRUE
chimp,0.15.0-rc.5,0.15.0-rc.6,45,1,5,0,5,1,FALSE
chimp,0.15.0-rc.4,0.15.0-rc.5,44,1,5,0,5,1,FALSE
chimp,0.15.0-rc.3,0.15.0-rc.4,43,1,5,0,5,1,FALSE
chimp,0.15.0-rc.2,0.15.0-rc.3,42,1,5,0,5,1,FALSE
chimp,0.15.0-rc.1,0.15.0-rc.2,41,1,5,0,5,1,FALSE
chimp,0.14.3,0.15.0-rc.1,40,9,32,11,43,11,TRUE
chimp,0.7.12,0.7.13,12,9,941,606,1547,35,TRUE
chimp,0.14.3,0.15.0-rc.1,40,9,32,11,43,11,FALSE
chimp,0.30.1,0.31.0,97,18,1008,570,1578,84,TRUE
chimp,0.15.4,0.16.0,55,8,67,9,76,9,TRUE
chimp,0.7.9,0.7.10,9,3,29,7,36,4,TRUE
chimp,0.19.0,0.19.2,69,5,2536,14,2550,12,TRUE
chimp,0.16.3,0.16.5-rc.1,59,2,12,4,16,5,TRUE
chimp,0.7.10,0.7.11,10,2,7,7,14,3,TRUE
chimp,0.9.0,0.10.0,21,22,1128,499,1627,48,TRUE
chimp,0.7.2,0.7.3,3,3,70,10,80,12,TRUE
chimp,0.17.0,0.17.1,65,5,18,9,27,7,TRUE
chimp,0.16.5,0.16.6,61,2,4,2,6,2,TRUE
chimp,0.15.3,0.15.4,54,2,16,1,17,2,TRUE
chimp,0.8.2,0.8.3,19,2,9,9,18,3,TRUE
jlangs-processor,1.0.4,1.0.5,4,1,2,2,4,1,FALSE
jlangs-processor,1.0.5,1.0.6,5,2,217,4,221,5,FALSE
jlangs-processor,1.0.6,1.0.7,6,1,3,3,6,3,FALSE
jlangs-processor,1.0.7,1.0.8,7,1,2,2,4,2,FALSE
jlangs-processor,1.0.0,1.0.1,1,2,61,11,72,6,FALSE
jlangs-processor,1.0.1,1.0.2,2,1,2,2,4,2,FALSE
jlangs-processor,1.0.2,1.0.4,3,2,76,89,165,8,FALSE
jlangs-processor,1.0.8,1.0.9,8,2,30,8,38,2,FALSE
jlangs-processor,1.0.9,1.0.10,9,2,4,3,7,2,TRUE
jlangs-processor,1.0.9,1.0.10,9,2,4,3,7,2,FALSE
bplus-index,0.0.3,0.0.4,3,3,115,66,181,5,FALSE
bplus-index,0.0.5,0.0.6,5,19,555,494,1049,27,FALSE
bplus-index,0.0.4,0.0.5,4,13,468,2924,3392,28,FALSE
bplus-index,0.0.2,0.0.3,2,9,2655,130,2785,16,FALSE
bplus-index,0.0.4,0.0.5,4,13,468,2924,3392,28,TRUE
bplus-index,0.0.2,0.0.3,2,9,2655,130,2785,16,TRUE
express-compilers,3.0.6,3.0.7,3,33,450,218,668,57,FALSE
express-compilers,3.0.7,3.0.8,4,1,2,3,5,1,FALSE
express-compilers,3.0.5,3.0.6,2,2,4,11,15,4,FALSE
express-compilers,3.0.8,3.0.9,5,1,3,2,5,1,FALSE
express-compilers,3.0.9,3.0.10,6,2,1,5,6,3,FALSE
express-compilers,3.0.10,3.0.11,7,1,6,3,9,2,FALSE
express-compilers,3.0.11,3.0.12,8,1,4,4,8,2,FALSE
express-compilers,3.0.12,3.0.13,9,2,18,7,25,4,FALSE
express-compilers,3.0.3,3.0.5,1,3,15,10,25,5,FALSE
express-compilers,3.0.12,3.0.13,9,2,18,7,25,4,TRUE
async-each-map,1.0.0,1.0.1,1,5,10,10,20,7,FALSE
async-each-map,1.0.1,1.0.2,2,9,110,73,183,10,FALSE
async-each-map,1.0.1,1.0.2,2,9,110,73,183,10,TRUE
barenode,0.2.2,0.3.0,2,1,23,18,41,4,FALSE
barenode,0.2.1,0.2.2,1,1,18,8,26,4,FALSE
barenode,0.3.0,0.4.0,3,1,13,47,60,5,TRUE
barenode,0.6.0,0.7.0,6,1,427,271,698,2,FALSE
barenode,0.4.0,0.5.0,4,1,17,20,37,7,FALSE
barenode,0.5.0,0.6.0,5,1,2319,7,2326,4,FALSE
barenode,0.3.0,0.4.0,3,1,13,47,60,5,FALSE
barenode,0.4.0,0.5.0,4,1,17,20,37,7,TRUE
barenode,0.5.0,0.6.0,5,1,2319,7,2326,4,TRUE
generator-teams,1.1.1,2.0.0-preview,6,4,58,27,85,10,FALSE
generator-teams,1.1.0,1.1.1,5,8,2993,1028,4021,99,FALSE
generator-teams,1.0.0,1.0.1,2,1,4,4,8,4,FALSE
generator-teams,1.0.1,1.0.2,3,1,30,12,42,8,FALSE
generator-teams,1.0.2,1.1.0,4,19,2610,1158,3768,115,FALSE
generator-teams,1.1.1,2.0.0-preview,6,4,58,27,85,10,TRUE
generator-teams,1.1.0,1.1.1,5,8,2993,1028,4021,99,TRUE
generator-teams,1.0.1,1.0.2,3,1,30,12,42,8,TRUE
generator-teams,1.0.2,1.1.0,4,19,2610,1158,3768,115,TRUE
bmqb-sms,0.0.5,0.0.6,5,2,14,8,22,5,FALSE
bmqb-sms,0.0.4,0.0.5,4,1,6,8,14,3,FALSE
bmqb-sms,0.0.7,0.0.8,7,1,5,5,10,2,FALSE
bmqb-sms,0.0.6,0.0.7,6,1,8,4,12,2,FALSE
bmqb-sms,0.0.1,0.0.2,1,1,2,0,2,1,FALSE
bmqb-sms,0.0.3,0.0.4,3,3,16,6,22,4,FALSE
bmqb-sms,0.0.2,0.0.3,2,1,2,0,2,1,FALSE
bmqb-sms,0.0.9,0.0.10,9,1,2,0,2,1,FALSE
bmqb-sms,0.0.8,0.0.9,8,1,2,0,2,1,FALSE
bmqb-sms,0.0.11,0.1.0,11,1,12,3,15,2,FALSE
bmqb-sms,0.0.10,0.0.11,10,1,20,17,37,2,FALSE
bmqb-sms,0.2.1,0.2.2,19,6,14,11,25,8,FALSE
bmqb-sms,0.2.0,0.2.1,18,4,10,8,18,4,FALSE
bmqb-sms,0.1.0,0.1.1,12,1,5,0,5,1,FALSE
bmqb-sms,0.1.1,0.1.2,13,1,2,0,2,1,FALSE
bmqb-sms,0.1.2,0.1.3,14,1,10,8,18,5,FALSE
bmqb-sms,0.1.3,0.1.4,15,2,9,5,14,4,FALSE
bmqb-sms,0.1.4,0.1.5,16,1,2,0,2,1,FALSE
bmqb-sms,0.1.5,0.2.0,17,6,753,179,932,46,FALSE
bmqb-sms,0.2.0,0.2.1,18,4,10,8,18,4,TRUE
bmqb-sms,0.0.7,0.0.8,7,1,5,5,10,2,TRUE
bmqb-sms,0.1.4,0.1.5,16,1,2,0,2,1,TRUE
bmqb-sms,0.1.3,0.1.4,15,2,9,5,14,4,TRUE
bmqb-sms,0.1.5,0.2.0,17,6,753,179,932,46,TRUE
ts-url-pattern,0.1.0,0.1.1,1,2,59,5,64,5,FALSE
ts-url-pattern,0.1.0,0.1.1,1,2,59,5,64,5,TRUE
showcar-pictures,1.0.4,1.0.5,5,2,21,2,23,5,FALSE
showcar-pictures,1.0.5,1.0.6,6,2,9,1,10,3,FALSE
showcar-pictures,1.0.6,1.0.7,7,4,43,20,63,11,FALSE
showcar-pictures,1.0.7,1.0.8,8,3,11,7,18,6,FALSE
showcar-pictures,1.0.0,1.0.1,1,4,184,123,307,10,FALSE
showcar-pictures,1.0.1,1.0.2,2,3,17,14,31,7,FALSE
showcar-pictures,1.0.2,1.0.3,3,7,145,92,237,23,FALSE
showcar-pictures,1.0.3,1.0.4,4,7,106,62,168,21,FALSE
showcar-pictures,1.3.4,1.3.5,33,3,860,5,865,19,FALSE
showcar-pictures,1.0.8,1.0.9,9,4,23,33,56,9,FALSE
showcar-pictures,1.0.9,1.0.10,10,4,51,38,89,8,FALSE
showcar-pictures,2.1.11,3.0.0,51,2,814,13,827,13,FALSE
showcar-pictures,2.1.8,2.1.9,48,1,225,23,248,12,FALSE
showcar-pictures,1.1.2,1.1.3,17,1,11,2,13,3,FALSE
showcar-pictures,1.3.5,1.3.6,34,1,54,17,71,8,FALSE
showcar-pictures,2.1.2,2.1.3,42,1,20,6,26,8,FALSE
showcar-pictures,2.1.3,2.1.4,43,1,229,24,253,11,FALSE
showcar-pictures,2.1.0,2.1.1,40,1,214,10,224,7,FALSE
showcar-pictures,2.1.1,2.1.2,41,12,31,228,259,19,FALSE
showcar-pictures,2.1.6,2.1.7,46,2,13,218,231,12,FALSE
showcar-pictures,2.1.7,2.1.8,47,2,4,4,8,4,FALSE
showcar-pictures,2.1.4,2.1.5,44,1,10,57,67,8,FALSE
showcar-pictures,2.0.2,2.1.0,39,2,524,218,742,34,FALSE
showcar-pictures,2.0.1,2.0.2,38,1,24,21,45,11,FALSE
showcar-pictures,2.0.0,2.0.1,37,1,690,830,1520,23,FALSE
showcar-pictures,3.0.0,3.0.1,52,2,11,8,19,8,FALSE
showcar-pictures,1.0.12,1.0.13,13,2,10,8,18,6,FALSE
showcar-pictures,1.0.13,1.1.0,14,3,809,564,1373,15,TRUE
showcar-pictures,1.0.10,1.0.11,11,2,9,8,17,4,FALSE
showcar-pictures,1.0.11,1.0.12,12,2,43,26,69,6,FALSE
showcar-pictures,1.1.5,1.2.0,20,3,204,134,338,18,FALSE
showcar-pictures,2.1.5,2.1.6,45,1,4,4,8,3,FALSE
showcar-pictures,1.1.1,1.1.2,16,1,15,10,25,7,FALSE
showcar-pictures,3.0.1,3.0.2,53,2,7,604,611,9,FALSE
showcar-pictures,1.2.6,1.2.7,26,1,230,197,427,6,FALSE
showcar-pictures,1.2.7,1.2.8,27,1,11,12,23,6,FALSE
showcar-pictures,1.2.4,1.2.5,24,1,12,1,13,3,FALSE
showcar-pictures,1.3.0,1.3.1,30,1,15,10,25,7,FALSE
showcar-pictures,1.2.2,1.2.4,23,2,14,9,23,8,FALSE
showcar-pictures,1.3.6,1.3.7,35,1,2,2,4,1,FALSE
showcar-pictures,1.2.0,1.2.1,21,1,44,52,96,11,FALSE
showcar-pictures,1.2.1,1.2.2,22,2,38,5,43,3,FALSE
showcar-pictures,1.1.4,1.1.5,19,1,8,5,13,6,FALSE
showcar-pictures,1.2.8,1.2.9,28,1,13,4,17,6,FALSE
showcar-pictures,1.2.9,1.3.0,29,2,27,4,31,8,FALSE
showcar-pictures,1.1.0,1.1.1,15,1,15,5,20,4,FALSE
showcar-pictures,1.3.3,1.3.4,32,1,36,13,49,9,FALSE
showcar-pictures,2.1.10,2.1.11,50,2,5,5,10,4,FALSE
showcar-pictures,1.3.1,1.3.3,31,2,17,6,23,6,FALSE
showcar-pictures,1.2.5,1.2.6,25,2,54,53,107,8,FALSE
showcar-pictures,1.3.7,2.0.0,36,2,603,1203,1806,21,FALSE
showcar-pictures,2.1.9,2.1.10,49,2,9,214,223,5,FALSE
showcar-pictures,1.1.3,1.1.4,18,1,8,7,15,5,FALSE
showcar-pictures,1.0.13,1.1.0,14,3,809,564,1373,15,FALSE
showcar-pictures,1.0.6,1.0.7,7,4,43,20,63,11,TRUE
showcar-pictures,2.0.2,2.1.0,39,2,524,218,742,34,TRUE
showcar-pictures,2.1.3,2.1.4,43,1,229,24,253,11,TRUE
showcar-pictures,1.3.6,1.3.7,35,1,2,2,4,1,TRUE
showcar-pictures,2.1.4,2.1.5,44,1,10,57,67,8,TRUE
showcar-pictures,2.1.10,2.1.11,50,2,5,5,10,4,TRUE
showcar-pictures,1.3.7,2.0.0,36,2,603,1203,1806,21,TRUE
showcar-pictures,2.1.8,2.1.9,48,1,225,23,248,12,TRUE
showcar-pictures,1.3.0,1.3.1,30,1,15,10,25,7,TRUE
showcar-pictures,1.0.12,1.0.13,13,2,10,8,18,6,TRUE
react-hoverintent,0.0.5,0.0.6,5,2,2,696,698,14,FALSE
react-hoverintent,0.0.4,0.0.5,4,1,2,568,570,17,FALSE
react-hoverintent,0.0.7,0.0.8,7,1,26,0,26,1,FALSE
react-hoverintent,0.0.6,0.0.7,6,2,8,7,15,2,FALSE
react-hoverintent,0.0.1,0.0.2,1,1,108,8,116,2,TRUE
react-hoverintent,0.0.3,0.0.4,3,1,1,1,2,1,FALSE
react-hoverintent,0.0.2,0.0.3,2,2,2,3,5,2,FALSE
react-hoverintent,0.0.1,0.0.2,1,1,108,8,116,2,FALSE
react-hoverintent,0.0.3,0.0.4,3,1,1,1,2,1,TRUE
react-bootstrap-timezone-picker,1.0.4,1.0.5,5,1,2,1,3,2,FALSE
react-bootstrap-timezone-picker,1.0.5,1.0.6-rc.1,6,6,618,415,1033,20,FALSE
react-bootstrap-timezone-picker,1.0.6,1.0.7,8,1,2,2,4,2,FALSE
react-bootstrap-timezone-picker,1.0.7,1.0.8,9,5,11,7,18,5,FALSE
react-bootstrap-timezone-picker,1.0.0,1.0.1,1,1,131,84,215,9,FALSE
react-bootstrap-timezone-picker,1.0.1,1.0.2,2,2,5,3,8,4,FALSE
react-bootstrap-timezone-picker,1.0.2,1.0.3,3,1,9,9,18,6,FALSE
react-bootstrap-timezone-picker,1.0.3,1.0.4,4,3,500,1312,1812,15,FALSE
react-bootstrap-timezone-picker,1.0.6-rc.1,1.0.6,7,4,11,4,15,4,FALSE
react-bootstrap-timezone-picker,1.0.8,1.0.9,10,1,1,1,2,1,FALSE
react-bootstrap-timezone-picker,1.0.9,1.0.10,11,3,5,5,10,3,FALSE
react-bootstrap-timezone-picker,1.0.10,1.0.11,12,2,7,5,12,3,FALSE
react-bootstrap-timezone-picker,1.0.3,1.0.4,4,3,500,1312,1812,15,TRUE
ng-test-utils,0.0.15,0.0.16,15,5,470,43,513,18,FALSE
ng-test-utils,0.0.14,0.0.15,14,14,870,429,1299,50,FALSE
ng-test-utils,0.0.17,0.0.18,17,2,3,1,4,2,FALSE
ng-test-utils,0.0.16,0.0.17,16,4,137,46,183,7,FALSE
ng-test-utils,0.0.18,0.0.19,18,10,35,34,69,13,FALSE
ng-test-utils,0.0.5,0.0.6,5,2,33,28,61,5,FALSE
ng-test-utils,0.0.4,0.0.5,4,1,12,2,14,3,FALSE
ng-test-utils,0.0.7,0.0.8,7,15,355,35,390,19,FALSE
ng-test-utils,0.0.6,0.0.7,6,11,874,603,1477,106,TRUE
ng-test-utils,0.0.1,0.0.2,1,20,949,185,1134,66,FALSE
ng-test-utils,0.0.3,0.0.4,3,5,96,195,291,27,TRUE
ng-test-utils,0.0.2,0.0.3,2,2,46,1,47,3,FALSE
ng-test-utils,0.0.9,0.0.10,9,3,67,10,77,7,FALSE
ng-test-utils,0.0.8,0.0.9,8,35,1683,1054,2737,116,FALSE
ng-test-utils,0.0.11,0.0.12,11,3,318,40,358,5,FALSE
ng-test-utils,0.0.10,0.0.11,10,4,80,18,98,8,TRUE
ng-test-utils,0.0.13,0.0.14,13,9,784,180,964,31,FALSE
ng-test-utils,0.0.12,0.0.13,12,2,11,3,14,4,FALSE
ng-test-utils,0.0.10,0.0.11,10,4,80,18,98,8,FALSE
ng-test-utils,0.0.3,0.0.4,3,5,96,195,291,27,FALSE
ng-test-utils,0.0.13,0.0.14,13,9,784,180,964,31,TRUE
ng-test-utils,0.0.18,0.0.19,18,10,35,34,69,13,TRUE
ng-test-utils,0.0.6,0.0.7,6,11,874,603,1477,106,FALSE
ng-test-utils,0.0.8,0.0.9,8,35,1683,1054,2737,116,TRUE
ng-test-utils,0.0.14,0.0.15,14,14,870,429,1299,50,TRUE
ng-test-utils,0.0.7,0.0.8,7,15,355,35,390,19,TRUE
mjml-section,2.0.7,2.0.8-beta.1,26,4,48,17,65,9,FALSE
mjml-section,2.0.6,2.0.7-beta.1,18,26,1063,760,1823,206,FALSE
mjml-section,2.0.5,2.0.6-beta.1,16,10,2137,521,2658,131,FALSE
mjml-section,2.0.4,2.0.5-beta.1,14,24,81,73,154,26,FALSE
mjml-section,2.0.3,2.0.4,13,49,8912,5483,14395,375,FALSE
mjml-section,2.0.2,2.0.3-beta.1,9,27,4957,1023,5980,231,FALSE
mjml-section,2.0.1,2.0.2,8,44,5433,1422,6855,308,FALSE
mjml-section,2.0.0,2.0.1,7,49,4069,1201,5270,235,FALSE
mjml-section,3.3.0-beta.5,3.3.0-beta.6,49,1,16,16,32,1,FALSE
mjml-section,3.3.3-beta.1,3.3.3-beta.2,56,1,16,16,32,1,FALSE
mjml-section,3.0.0-beta.1,3.0.0-beta.2,31,15,416,362,778,81,FALSE
mjml-section,2.0.9,2.0.10,29,28,515,301,816,137,FALSE
mjml-section,2.0.8,2.0.9,28,19,413,313,726,87,TRUE
mjml-section,2.0.5-beta.1,2.0.5,15,23,83,81,164,24,FALSE
mjml-section,3.1.1,3.2.0-beta.1,40,24,731,733,1464,122,FALSE
mjml-section,3.1.1-beta.3,3.1.1,39,22,2357,1569,3926,280,FALSE
mjml-section,2.0.0-beta.5,2.0.0-beta.6,5,17,216,204,420,27,FALSE
mjml-section,2.0.6-beta.1,2.0.6,17,12,145,113,258,36,FALSE
mjml-section,3.0.2,3.1.0-beta.1,36,22,1125,735,1860,85,FALSE
mjml-section,3.3.0-beta.6,3.3.0-beta.7,50,1,16,16,32,1,FALSE
mjml-section,2.0.3-beta.2,2.0.3-beta.3,11,1,16,16,32,1,FALSE
mjml-section,2.0.3-beta.3,2.0.3,12,30,3120,1787,4907,407,FALSE
mjml-section,2.0.3-beta.1,2.0.3-beta.2,10,1,16,16,32,1,FALSE
mjml-section,3.0.0,3.0.1,34,16,212,215,427,74,FALSE
mjml-section,2.0.0-beta.3,2.0.0-beta.4,3,22,381,378,759,56,FALSE
mjml-section,2.0.0-beta.2,2.0.0-beta.3,2,2,11,16,27,3,FALSE
mjml-section,2.0.0-beta.1,2.0.0-beta.2,1,2,32,18,50,4,FALSE
mjml-section,3.0.1,3.0.2,35,12,333,273,606,123,FALSE
mjml-section,2.0.0-beta.6,2.0.0,6,150,6729,5459,12188,513,FALSE
mjml-section,3.1.0-beta.1,3.1.0,37,41,3253,2024,5277,350,FALSE
mjml-section,2.0.0-beta.4,2.0.0-beta.5,4,19,109,117,226,51,FALSE
mjml-section,2.0.8-beta.1,2.0.8,27,7,1736,1196,2932,119,FALSE
mjml-section,2.0.7-beta.3,2.0.7-beta.4,21,1,1,0,1,1,FALSE
mjml-section,3.0.0-beta.2,3.0.0-beta.3,32,13,198,163,361,73,FALSE
mjml-section,3.0.0-beta.3,3.0.0,33,10,1633,1128,2761,136,FALSE
mjml-section,2.0.7-beta.2,2.0.7-beta.3,20,2,93,70,163,13,FALSE
mjml-section,3.3.0-beta.8,3.3.0,52,1,2261,435,2696,45,FALSE
mjml-section,2.0.7-beta.1,2.0.7-beta.2,19,8,268,249,517,68,FALSE
mjml-section,2.0.7-beta.6,2.0.7-beta.7,24,3,2577,747,3324,105,FALSE
mjml-section,2.0.7-beta.7,2.0.7,25,9,479,381,860,79,FALSE
mjml-section,2.0.7-beta.4,2.0.7-beta.5,22,1,1,0,1,1,FALSE
mjml-section,2.0.7-beta.5,2.0.7-beta.6,23,22,79,51,130,33,FALSE
mjml-section,3.3.0-beta.1,3.3.0-beta.2,45,1,16,16,32,1,FALSE
mjml-section,3.3.0-beta.3,3.3.0-beta.4,47,2,1527,757,2284,38,FALSE
mjml-section,3.3.0-beta.2,3.3.0-beta.3,46,1,16,16,32,1,FALSE
mjml-section,3.2.0-beta.2,3.2.0,42,10,338,272,610,67,FALSE
mjml-section,3.3.0-beta.4,3.3.0-beta.5,48,1,16,16,32,2,FALSE
mjml-section,3.3.0-beta.7,3.3.0-beta.8,51,1,16,16,32,1,FALSE
mjml-section,3.2.0-beta.1,3.2.0-beta.2,41,1,16,16,32,1,FALSE
mjml-section,3.3.1,3.3.2,54,1,16,16,32,1,FALSE
mjml-section,3.3.0,3.3.1,53,7,3912,690,4602,79,FALSE
mjml-section,3.3.2,3.3.3-beta.1,55,2,3794,2286,6080,63,FALSE
mjml-section,3.2.0,3.2.2,43,5,16000,7188,23188,180,FALSE
mjml-section,3.2.2,3.3.0-beta.1,44,1,16,16,32,1,FALSE
mjml-section,2.0.10,3.0.0-beta.1,30,26,709,402,1111,83,FALSE
mjml-section,2.0.2,2.0.3-beta.1,9,27,4957,1023,5980,231,TRUE
mjml-section,3.0.0-beta.1,3.0.0-beta.2,31,15,416,362,778,81,TRUE
mjml-section,2.0.8,2.0.9,28,19,413,313,726,87,FALSE
mjml-section,3.0.2,3.1.0-beta.1,36,22,1125,735,1860,85,TRUE
mjml-section,4.0.0-alpha.1,4.0.0-alpha.2,58,2,59,59,118,24,FALSE
mjml-section,3.0.0-beta.2,3.0.0-beta.3,32,13,198,163,361,73,TRUE
mjml-section,3.3.3-beta.2,4.0.0-alpha.1,57,13,14550,7666,22216,175,FALSE
hexlet_braingames,0.1.1,0.1.2,5,2,55,47,102,3,FALSE
hexlet_braingames,0.0.4,0.1.0,3,3,42,4,46,4,FALSE
hexlet_braingames,0.3.0,0.4.0,10,4,106,14,120,13,FALSE
hexlet_braingames,0.1.0,0.1.1,4,2,33,23,56,2,FALSE
hexlet_braingames,0.2.1,0.3.0,9,6,210,57,267,18,FALSE
hexlet_braingames,0.2.0,0.2.1,8,2,24,25,49,4,FALSE
hexlet_braingames,0.4.0,0.5.0,11,5,304,226,530,19,FALSE
hexlet_braingames,0.1.2,0.1.3,6,2,6,6,12,2,FALSE
hexlet_braingames,0.1.3,0.2.0,7,3,194,53,247,10,FALSE
hexlet_braingames,0.5.0,0.5.1,12,1,47,3,50,5,FALSE
hexlet_braingames,0.5.1,0.5.3,13,4,92,92,184,4,FALSE
hexlet_braingames,0.5.3,0.5.4,14,1,3,3,6,1,FALSE
hexlet_braingames,0.0.3,0.0.4,2,4,12,2,14,6,FALSE
hexlet_braingames,0.0.1,0.0.3,1,17,469251,469133,938384,10980,FALSE
hexlet_braingames,0.3.0,0.4.0,10,4,106,14,120,13,TRUE
hexlet_braingames,0.1.3,0.2.0,7,3,194,53,247,10,TRUE
hexlet_braingames,0.5.3,0.5.4,14,1,3,3,6,1,TRUE
aurelia-types-installer,0.1.8,0.1.9,15,4,44,32,76,7,FALSE
aurelia-types-installer,0.1.9,0.1.10,16,1,1,1,2,1,FALSE
aurelia-types-installer,0.2.4,0.2.5,22,1,464,4,468,14,FALSE
aurelia-types-installer,0.2.3,0.2.4,21,2,5,3,8,3,FALSE
aurelia-types-installer,0.2.2,0.2.3,20,1,2,2,4,2,FALSE
aurelia-types-installer,0.2.1,0.2.2,19,2,93,14,107,8,FALSE
aurelia-types-installer,0.2.0,0.2.1,18,4,110,503,613,33,FALSE
aurelia-types-installer,0.1.0,0.1.1,7,1,2,2,4,2,FALSE
aurelia-types-installer,0.1.1,0.1.2,8,1,2,2,4,2,FALSE
aurelia-types-installer,0.1.2,0.1.3,9,1,126,168,294,8,FALSE
aurelia-types-installer,0.1.3,0.1.4,10,1,6,6,12,6,FALSE
aurelia-types-installer,0.1.4,0.1.5,11,2,3,3,6,3,FALSE
aurelia-types-installer,0.1.5,0.1.6,12,2,109,110,219,6,FALSE
aurelia-types-installer,0.1.6,0.1.7,13,14,158,155,313,25,FALSE
aurelia-types-installer,0.1.7,0.1.8,14,4,40,96,136,12,FALSE
aurelia-types-installer,0.0.4,0.0.6,4,3,268,115,383,17,FALSE
aurelia-types-installer,0.0.7,0.1.0,6,11,31,18,49,12,FALSE
aurelia-types-installer,0.0.6,0.0.7,5,4,57,7,64,4,FALSE
aurelia-types-installer,0.0.1,0.0.2,1,3,53,27,80,8,FALSE
aurelia-types-installer,0.0.3,0.0.4,3,2,2,3,5,2,FALSE
aurelia-types-installer,0.0.2,0.0.3,2,2,33,29,62,3,FALSE
aurelia-types-installer,0.1.10,0.2.0,17,6,84,46,130,14,FALSE
aurelia-types-installer,0.0.7,0.1.0,6,11,31,18,49,12,TRUE
aurelia-types-installer,0.1.10,0.2.0,17,6,84,46,130,14,TRUE
aurelia-types-installer,0.2.0,0.2.1,18,4,110,503,613,33,TRUE
hxvux,1.0.4,1.0.5,4,1,1,1,2,1,FALSE
hxvux,1.0.5,1.0.6,5,5,8,8,16,6,FALSE
hxvux,1.0.6,1.0.7,6,10,19,23,42,11,FALSE
hxvux,1.0.7,1.0.8,7,2,27,33,60,9,FALSE
hxvux,1.0.2,1.0.4,3,1,31,177,208,10,FALSE
hxvux,1.0.8,1.0.9,8,4,10,10,20,6,FALSE
hxvux,1.0.9,1.0.10,9,2,9,7,16,3,FALSE
hxvux,1.0.10,1.0.11,10,2,15,10,25,5,FALSE
hxvux,1.0.0,1.0.1,1,1,1,1,2,1,FALSE
hxvux,1.0.1,1.0.2,2,1,1,1,2,1,FALSE
hxvux,1.0.6,1.0.7,6,10,19,23,42,11,TRUE
hxvux,1.0.10,1.0.11,10,2,15,10,25,5,TRUE
auth0-extension-tools,0.9.0,0.10.0,9,2,78,12,90,5,FALSE
auth0-extension-tools,0.10.0,0.11.0,10,1,3,3,6,3,FALSE
auth0-extension-tools,1.0.0,1.1.0,17,6,6213,219,6432,29,FALSE
auth0-extension-tools,0.14.0,0.15.0,14,5,933,88,1021,20,FALSE
auth0-extension-tools,1.1.0,1.2.0,18,3,189,51,240,10,FALSE
auth0-extension-tools,0.3.0,0.4.0,3,1,2,2,4,1,FALSE
auth0-extension-tools,0.6.0,0.7.0,6,2,4,3,7,3,FALSE
auth0-extension-tools,0.11.0,0.12.0,11,1,4,4,8,1,FALSE
auth0-extension-tools,0.8.0,0.9.0,8,2,29,7,36,4,FALSE
auth0-extension-tools,0.7.0,0.8.0,7,6,1808,49,1857,40,FALSE
auth0-extension-tools,0.12.0,0.13.0,12,1,37,18,55,2,FALSE
auth0-extension-tools,0.15.0,0.16.0,15,2,7,7,14,4,FALSE
auth0-extension-tools,1.2.0,1.2.1,19,1,46,3,49,4,FALSE
auth0-extension-tools,0.2.0,0.3.0,2,1,9,9,18,2,FALSE
auth0-extension-tools,0.1.0,0.2.0,1,1,17,20,37,3,FALSE
auth0-extension-tools,0.4.0,0.5.0,4,1,22,1,23,2,FALSE
auth0-extension-tools,0.5.0,0.6.0,5,1,2,1,3,1,FALSE
auth0-extension-tools,0.16.0,1.0.0,16,1,2,2,4,1,FALSE
auth0-extension-tools,0.13.0,0.14.0,13,1,30,2,32,7,FALSE
auth0-extension-tools,1.0.0,1.1.0,17,6,6213,219,6432,29,TRUE
auth0-extension-tools,0.9.0,0.10.0,9,2,78,12,90,5,TRUE
auth0-extension-tools,0.14.0,0.15.0,14,5,933,88,1021,20,TRUE
fauxflux,0.0.1,0.0.2,1,1,1,1,2,1,FALSE
fauxflux,0.0.3,0.0.4,3,1,1,1,2,1,FALSE
fauxflux,0.0.2,0.0.3,2,1,1,1,2,1,FALSE
fauxflux,0.0.5,0.0.6,5,1,1,1,2,1,FALSE
fauxflux,0.0.4,0.0.5,4,1,1,1,2,1,FALSE
fauxflux,0.0.7,0.1.0,7,1,3614,0,3614,12,FALSE
fauxflux,0.0.6,0.0.7,6,1,1,1,2,1,FALSE
fauxflux,0.1.8,0.1.9,16,1,157,3,160,3,FALSE
fauxflux,0.1.0,0.1.1,8,6,1042,474,1516,14,FALSE
fauxflux,0.1.1,0.1.2,9,1,22,14,36,4,FALSE
fauxflux,0.1.2,0.1.3,10,3,244,47,291,8,FALSE
fauxflux,0.1.3,0.1.4,11,2,65,6,71,3,FALSE
fauxflux,0.1.4,0.1.5,12,1,9,9,18,3,FALSE
fauxflux,0.1.5,0.1.6,13,1,2,2,4,1,FALSE
fauxflux,0.1.6,0.1.7,14,1,5,2,7,2,FALSE
fauxflux,0.1.7,0.1.8,15,1,2,2,4,2,FALSE
fauxflux,0.0.5,0.0.6,5,1,1,1,2,1,TRUE
fauxflux,0.1.5,0.1.6,13,1,2,2,4,1,TRUE
fauxflux,0.0.1,0.0.2,1,1,1,1,2,1,TRUE
fauxflux,0.0.3,0.0.4,3,1,1,1,2,1,TRUE
unist-util-inspect,1.1.0,2.0.0,2,2,273,78,351,8,FALSE
unist-util-inspect,1.0.0,1.1.0,1,3,122,23,145,10,FALSE
unist-util-inspect,4.0.0,4.1.0,5,11,453,782,1235,21,FALSE
unist-util-inspect,3.0.0,4.0.0,4,3,37,5,42,5,FALSE
unist-util-inspect,2.0.0,3.0.0,3,11,340,679,1019,30,FALSE
unist-util-inspect,2.0.0,3.0.0,3,11,340,679,1019,30,TRUE
unist-util-inspect,1.1.0,2.0.0,2,2,273,78,351,8,TRUE
redux-async-api,1.0.0,2.0.0,8,1,226,243,469,10,FALSE
redux-async-api,2.0.0,2.0.1,9,1,4,4,8,2,FALSE
redux-async-api,0.3.2,0.3.3,5,1,5,6,11,2,FALSE
redux-async-api,0.3.3,0.3.4,6,1,14,10,24,9,FALSE
redux-async-api,0.3.0,0.3.1,3,1,35,8086,8121,10,FALSE
redux-async-api,0.3.1,0.3.2,4,1,3,3,6,2,FALSE
redux-async-api,0.3.4,1.0.0,7,1,3,3,6,2,FALSE
redux-async-api,0.2.0,0.3.0,2,1,452,25,477,9,FALSE
redux-async-api,0.1.0,0.2.0,1,1,9,9,18,2,FALSE
redux-async-api,1.0.0,2.0.0,8,1,226,243,469,10,TRUE
redux-async-api,0.2.0,0.3.0,2,1,452,25,477,9,TRUE
redux-async-api,0.3.0,0.3.1,3,1,35,8086,8121,10,TRUE
redux-async-api,0.3.3,0.3.4,6,1,14,10,24,9,TRUE
license-pack,0.0.1,0.0.2,1,4,13,2,15,5,FALSE
license-pack,0.0.3,0.1.0,3,6,126,36,162,8,FALSE
license-pack,0.0.2,0.0.3,2,2,15,8,23,3,FALSE
license-pack,0.2.1,0.2.2,6,2,3,3,6,2,FALSE
license-pack,0.2.0,0.2.1,5,4,16,13,29,5,FALSE
license-pack,0.1.0,0.2.0,4,8,116,806,922,13,FALSE
license-pack,0.0.1,0.0.2,1,4,13,2,15,5,TRUE
license-pack,0.0.3,0.1.0,3,6,126,36,162,8,TRUE
bcycle,0.3.0,0.4.0,7,2,11,5,16,3,FALSE
bcycle,0.4.1,0.4.2,9,5,168,2685,2853,25,FALSE
bcycle,0.2.4,0.3.0,6,2,3,3,6,3,FALSE
bcycle,0.2.3,0.2.4,5,2,17,9,26,4,FALSE
bcycle,0.2.2,0.2.3,4,2,3,3,6,3,FALSE
bcycle,0.2.1,0.2.2,3,3,553,11,564,8,TRUE
bcycle,0.2.0,0.2.1,2,3,144,15,159,14,FALSE
bcycle,0.1.0,0.2.0,1,2,532,303,835,11,FALSE
bcycle,0.4.0,0.4.1,8,2,4,1,5,2,FALSE
bcycle,0.2.1,0.2.2,3,3,553,11,564,8,FALSE
httpify,1.0.0,2.0.0,10,3,8,31,39,5,TRUE
httpify,2.0.0,3.0.0,11,3,35,36,71,5,FALSE
httpify,0.3.0,0.3.1,6,2,8,8,16,2,FALSE
httpify,0.3.1,0.4.0,7,1,525,9,534,4,FALSE
httpify,0.2.3,0.3.0,5,1,210,617,827,7,FALSE
httpify,0.2.2,0.2.3,4,1,4,4,8,2,FALSE
httpify,0.2.1,0.2.2,3,1,3,3,6,1,FALSE
httpify,0.4.1,1.0.0,9,2,77,727,804,9,FALSE
httpify,0.4.0,0.4.1,8,1,552,20,572,4,FALSE
httpify,0.2.0,0.2.1,2,2,9,3,12,2,FALSE
httpify,1.0.0,2.0.0,10,3,8,31,39,5,FALSE
httpify,0.3.0,0.3.1,6,2,8,8,16,2,TRUE
httpify,0.0.0,0.2.0,1,3,768,11,779,14,FALSE
httpify,0.4.1,1.0.0,9,2,77,727,804,9,TRUE
lucid-router,1.4.0,1.5.0,36,2,3,7,10,3,FALSE
lucid-router,1.3.3,1.3.4,32,3,48,17,65,7,FALSE
lucid-router,1.3.2,1.3.3,31,2,3,3,6,3,FALSE
lucid-router,1.3.1,1.3.2,30,2,55,25,80,5,FALSE
lucid-router,1.3.0,1.3.1,29,2,37,12,49,3,FALSE
lucid-router,1.3.6,1.4.0,35,2,5,3,8,3,FALSE
lucid-router,1.3.5,1.3.6,34,3,12,12,24,9,FALSE
lucid-router,1.3.4,1.3.5,33,3,34,128,162,7,FALSE
lucid-router,1.1.1,1.1.2,6,1,16,3,19,3,FALSE
lucid-router,1.1.0,1.1.1,5,1,2,2,4,1,FALSE
lucid-router,1.1.3,1.1.4,8,2,10,6,16,3,FALSE
lucid-router,1.1.2,1.1.3,7,1,56,8,64,3,FALSE
lucid-router,1.0.0,1.1.0,4,5,22,29,51,7,FALSE
lucid-router,1.1.4,1.1.5,9,1,5,4,9,3,FALSE
lucid-router,1.1.7,1.1.8,12,2,17,9,26,3,FALSE
lucid-router,1.1.6,1.1.7,11,1,21,11,32,3,FALSE
lucid-router,1.1.9,1.1.10,14,2,13,8,21,3,FALSE
lucid-router,1.1.8,1.1.9,13,3,56,27,83,5,FALSE
lucid-router,1.2.0-0,1.2.0,25,5,147,7,154,12,FALSE
lucid-router,1.1.5,1.1.6,10,1,32,14,46,3,TRUE
lucid-router,0.0.1,0.0.2,1,2,302,25,327,6,FALSE
lucid-router,0.0.3,1.0.0,3,1,12,12,24,3,TRUE
lucid-router,0.0.2,0.0.3,2,1,1,1,2,1,FALSE
lucid-router,1.2.0,1.2.1,26,2,3,3,6,3,FALSE
lucid-router,1.2.1,1.2.2,27,7,613,178,791,47,FALSE
lucid-router,1.1.19,1.2.0-0,24,9,618,265,883,30,FALSE
lucid-router,1.1.18,1.1.19,23,2,8,1,9,3,FALSE
lucid-router,1.1.11,1.1.12,16,2,1,3,4,3,FALSE
lucid-router,1.1.10,1.1.11,15,2,33,6,39,3,FALSE
lucid-router,1.1.13,1.1.14,18,2,3,3,6,3,FALSE
lucid-router,1.1.12,1.1.13,17,2,27,11,38,3,FALSE
lucid-router,1.1.15,1.1.16,20,2,7,7,14,3,FALSE
lucid-router,1.1.14,1.1.15,19,2,15,3,18,3,FALSE
lucid-router,1.1.17,1.1.18,22,2,3,3,6,3,FALSE
lucid-router,1.1.16,1.1.17,21,2,3,1,4,3,FALSE
lucid-router,1.4.0,1.5.0,36,2,3,7,10,3,TRUE
vuejs-datatable,0.3.1,0.3.2,8,2,2,2,4,2,FALSE
vuejs-datatable,0.3.2,0.3.3,9,4,17,149,166,5,TRUE
vuejs-datatable,0.3.3,0.4.0,10,2,144,22,166,8,FALSE
vuejs-datatable,0.3.0,0.3.1,7,2,2041,102,2143,14,TRUE
vuejs-datatable,0.6.0,0.6.1,14,4,22,10,32,8,FALSE
vuejs-datatable,0.2.0,0.3.0,6,2,349,150,499,7,FALSE
vuejs-datatable,0.4.1,0.5.0,12,2,24,12,36,4,FALSE
vuejs-datatable,0.4.0,0.4.1,11,2,957,934,1891,6,FALSE
vuejs-datatable,0.5.0,0.6.0,13,2,51,17,68,8,FALSE
vuejs-datatable,0.1.4,0.1.5,4,2,15,5,20,4,FALSE
vuejs-datatable,0.1.5,0.2.0,5,2,12,8,20,5,FALSE
vuejs-datatable,0.3.2,0.3.3,9,4,17,149,166,5,FALSE
vuejs-datatable,0.3.0,0.3.1,7,2,2041,102,2143,14,FALSE
vuejs-datatable,0.9.0,0.10.0,19,4,115,30,145,11,FALSE
vuejs-datatable,0.8.1,0.9.0,18,5,2472,1635,4107,19,FALSE
vuejs-datatable,0.8.0,0.8.1,17,2,8,4,12,5,FALSE
vuejs-datatable,0.7.0,0.8.0,16,9,219,27,246,18,FALSE
vuejs-datatable,0.6.1,0.7.0,15,2,1594,6665,8259,18,FALSE
vue-i18n-manager,1.1.1,1.1.2,3,1,4,4,8,2,FALSE
vue-i18n-manager,1.1.0,1.1.1,2,3,3,4,7,3,FALSE
vue-i18n-manager,1.1.2,1.1.3,4,1,35,10,45,5,FALSE
vue-i18n-manager,1.0.0,1.1.0,1,2,253,11439,11692,10,FALSE
vue-i18n-manager,1.1.3,1.2.0,5,57,28695,23042,51737,195,FALSE
vue-i18n-manager,2.0.2,2.0.3,10,2,3,3,6,2,FALSE
vue-i18n-manager,2.0.1,2.0.2,9,2,3,3,6,2,FALSE
vue-i18n-manager,2.0.0,2.0.1,8,2,2,2,4,2,FALSE
vue-i18n-manager,3.0.0-beta.4,3.0.0,27,2,3,3,6,3,FALSE
vue-i18n-manager,3.0.0-beta.1,3.0.0-beta.2,24,6,51,481,532,18,FALSE
vue-i18n-manager,3.0.0-beta.2,3.0.0-beta.3,25,3,13,7,20,5,FALSE
vue-i18n-manager,3.0.0-beta.3,3.0.0-beta.4,26,2,31,2,33,3,FALSE
vue-i18n-manager,2.2.4,2.2.6,18,4,19,6,25,4,FALSE
vue-i18n-manager,2.2.7,2.2.8,20,3,16,8,24,6,FALSE
vue-i18n-manager,2.2.6,2.2.7,19,6,79,15,94,8,FALSE
vue-i18n-manager,2.2.1,2.2.2,15,3,11,16,27,6,FALSE
vue-i18n-manager,2.2.0,2.2.1,14,10,184,1882,2066,22,FALSE
vue-i18n-manager,2.2.3,2.2.4,17,3,19,10,29,3,FALSE
vue-i18n-manager,2.2.2,2.2.3,16,7,53,6,59,8,FALSE
vue-i18n-manager,2.0.3,2.0.4,11,3,3,3,6,3,FALSE
vue-i18n-manager,2.1.0,2.2.0,13,6,2174,299,2473,26,FALSE
vue-i18n-manager,2.2.9,2.2.10,22,3,8,7,15,3,FALSE
vue-i18n-manager,2.2.8,2.2.9,21,4,10,5,15,4,FALSE
vue-i18n-manager,3.0.3,3.0.4,31,3,32,20,52,10,FALSE
vue-i18n-manager,3.0.0,3.0.1,28,2,20,207,227,5,FALSE
vue-i18n-manager,3.0.1,3.0.2,29,4,609,94,703,19,FALSE
vue-i18n-manager,3.1.0,3.2.0,33,3,1099,1249,2348,10,FALSE
vue-i18n-manager,3.0.4,3.1.0,32,2,26,3,29,5,FALSE
vue-i18n-manager,2.2.10,3.0.0-beta.1,23,27,4129,2185,6314,155,FALSE
vue-i18n-manager,1.2.0,1.2.1,6,5,105,91,196,13,FALSE
vue-i18n-manager,1.2.1,2.0.0,7,18,1118,872,1990,63,FALSE
vue-i18n-manager,2.0.4,2.1.0,12,14,276,457,733,50,FALSE
vue-i18n-manager,3.2.4,3.3.0,38,2,18,4,22,2,FALSE
vue-i18n-manager,3.0.2,3.0.3,30,5,36,506,542,11,FALSE
vue-i18n-manager,3.2.0,3.2.1,34,3,22,15,37,4,FALSE
vue-i18n-manager,3.2.1,3.2.2,35,2,1,5,6,2,FALSE
vue-i18n-manager,3.2.2,3.2.3,36,2,6,6,12,2,FALSE
vue-i18n-manager,3.2.3,3.2.4,37,3,6,2,8,3,FALSE
vue-i18n-manager,3.0.4,3.1.0,32,2,26,3,29,5,TRUE
vue-i18n-manager,1.1.3,1.2.0,5,57,28695,23042,51737,195,TRUE
vue-i18n-manager,3.2.0,3.2.1,34,3,22,15,37,4,TRUE
vue-i18n-manager,3.2.1,3.2.2,35,2,1,5,6,2,TRUE
vue-i18n-manager,3.0.0-beta.3,3.0.0-beta.4,26,2,31,2,33,3,TRUE
vue-i18n-manager,3.0.2,3.0.3,30,5,36,506,542,11,TRUE
vue-i18n-manager,3.0.1,3.0.2,29,4,609,94,703,19,TRUE
vue-i18n-manager,3.0.3,3.0.4,31,3,32,20,52,10,TRUE
vue-i18n-manager,3.0.0,3.0.1,28,2,20,207,227,5,TRUE
vue-i18n-manager,2.0.1,2.0.2,9,2,3,3,6,2,TRUE
vue-i18n-manager,1.2.0,1.2.1,6,5,105,91,196,13,TRUE
vue-i18n-manager,2.1.0,2.2.0,13,6,2174,299,2473,26,TRUE
react-dropzone-component,0.1.2,0.2.0,1,4,21865,8,21873,6,FALSE
react-dropzone-component,0.2.0,0.2.1,2,2,2,2,4,2,FALSE
react-dropzone-component,2.0.0-beta1,2.0.0-beta2,38,1,11,581,592,1,FALSE
react-dropzone-component,2.0.0-beta2,2.0.0-beta3,39,1,28603,3979,32582,10,FALSE
react-dropzone-component,2.0.0-beta3,2.0.0,40,3,1343,25272,26615,11,FALSE
react-dropzone-component,1.0.4,1.1.0,31,4,17172,15069,32241,28,FALSE
react-dropzone-component,1.1.0,1.2.0,32,2,22,4,26,3,FALSE
react-dropzone-component,0.3.1,0.3.2,6,2,3,3,6,2,FALSE
react-dropzone-component,1.0.0,1.0.1,27,4,9,9,18,4,FALSE
react-dropzone-component,1.0.1,1.0.2,28,2,5,5,10,3,FALSE
react-dropzone-component,1.0.2,1.0.3,29,5,175,93,268,13,FALSE
react-dropzone-component,1.0.3,1.0.4,30,2,40,46,86,6,FALSE
react-dropzone-component,1.4.0,1.4.1,36,4,731,723,1454,7,FALSE
react-dropzone-component,0.3.2,0.4.0,7,3,41,1,42,5,FALSE
react-dropzone-component,0.6.2,0.6.3,19,4,209,71,280,13,FALSE
react-dropzone-component,0.6.1,0.6.2,18,4,12,8,20,5,FALSE
react-dropzone-component,0.6.0,0.6.1,17,6,36,82,118,17,FALSE
react-dropzone-component,0.7.0,0.8.0,22,4,394,280,674,8,FALSE
react-dropzone-component,0.6.4,0.7.0,21,3,35746,72,35818,16,FALSE
react-dropzone-component,0.9.1,1.0.0,26,5,24411,2617,27028,33,FALSE
react-dropzone-component,0.4.1,0.4.2,9,6,20,9,29,11,FALSE
react-dropzone-component,0.4.0,0.4.1,8,2,22,18,40,5,FALSE
react-dropzone-component,0.4.3,0.4.4,11,2,2,2,4,2,FALSE
react-dropzone-component,0.4.2,0.4.3,10,4,41,19,60,10,FALSE
react-dropzone-component,0.5.0,0.5.1,13,5,122,45,167,10,FALSE
react-dropzone-component,0.5.1,0.5.2,14,2,2,2,4,2,FALSE
react-dropzone-component,0.5.2,0.5.3,15,2,14,11,25,4,FALSE
react-dropzone-component,0.5.3,0.6.0,16,4,108,10,118,8,FALSE
react-dropzone-component,0.9.0,0.9.1,25,4,83,69,152,10,FALSE
react-dropzone-component,0.8.1,0.9.0,24,12,631,17918,18549,34,FALSE
react-dropzone-component,0.8.0,0.8.1,23,3,23,17,40,9,FALSE
react-dropzone-component,1.3.0,1.4.0,35,3,66,4,70,6,FALSE
react-dropzone-component,1.2.0,1.2.1,33,4,375,357,732,6,FALSE
react-dropzone-component,1.2.1,1.3.0,34,3,360,360,720,4,FALSE
react-dropzone-component,0.4.4,0.5.0,12,4,104,42,146,11,FALSE
react-dropzone-component,0.6.3,0.6.4,20,2,6,6,12,6,FALSE
react-dropzone-component,0.3.0,0.3.1,5,3,54,23,77,9,FALSE
react-dropzone-component,0.2.1,0.2.2,3,3,23,19835,19858,6,FALSE
react-dropzone-component,1.4.1,2.0.0-beta1,37,14,3038,4496,7534,51,FALSE
react-dropzone-component,0.2.2,0.3.0,4,2,956,696,1652,15,FALSE
react-dropzone-component,1.1.0,1.2.0,32,2,22,4,26,3,TRUE
react-dropzone-component,0.7.0,0.8.0,22,4,394,280,674,8,TRUE
react-dropzone-component,0.3.0,0.3.1,5,3,54,23,77,9,TRUE
react-dropzone-component,0.6.2,0.6.3,19,4,209,71,280,13,TRUE
react-dropzone-component,0.4.4,0.5.0,12,4,104,42,146,11,TRUE
tslint-formatter-vscode,1.0.0,1.0.1,1,3,5,5,10,4,FALSE
tslint-formatter-vscode,1.0.1,2.0.0,2,2,17,5,22,5,FALSE
tslint-formatter-vscode,2.0.0,2.1.0,3,2,10,3,13,4,TRUE
tslint-formatter-vscode,1.0.0,1.0.1,1,3,5,5,10,4,TRUE
tslint-formatter-vscode,1.0.1,2.0.0,2,2,17,5,22,5,TRUE
generator-babel-boilerplate,9.0.0,9.0.1,16,4,22,10,32,10,FALSE
generator-babel-boilerplate,8.0.0,9.0.0,15,23,84,72,156,29,FALSE
generator-babel-boilerplate,9.0.1,10.0.0,17,19,218,124,342,22,FALSE
generator-babel-boilerplate,10.0.0,10.0.1,18,4,16,4,20,6,FALSE
generator-babel-boilerplate,7.3.1,7.3.2,12,3,51,45,96,6,FALSE
generator-babel-boilerplate,7.3.0,7.3.1,11,3,14,4,18,6,FALSE
generator-babel-boilerplate,7.3.3,8.0.0,14,11,77,72,149,21,FALSE
generator-babel-boilerplate,7.3.2,7.3.3,13,3,28,2,30,8,FALSE
generator-babel-boilerplate,5.0.0,5.1.0,1,8,64,20,84,12,FALSE
generator-babel-boilerplate,6.0.2,7.0.0,6,16,168,126,294,26,FALSE
generator-babel-boilerplate,6.0.1,6.0.2,5,5,14,6,20,7,FALSE
generator-babel-boilerplate,6.0.0,6.0.1,4,3,7,3,10,4,FALSE
generator-babel-boilerplate,5.1.1,6.0.0,3,47,775,615,1390,113,FALSE
generator-babel-boilerplate,7.0.0,7.1.0,7,4,20,10,30,10,FALSE
generator-babel-boilerplate,7.1.0,7.2.0,8,5,18,4,22,8,FALSE
generator-babel-boilerplate,7.2.0,7.2.1,9,4,32,10,42,8,FALSE
generator-babel-boilerplate,7.2.1,7.3.0,10,27,241,203,444,46,FALSE
generator-babel-boilerplate,5.1.0,5.1.1,2,5,10,8,18,6,FALSE
generator-babel-boilerplate,7.1.0,7.2.0,8,5,18,4,22,8,TRUE
generator-babel-boilerplate,8.0.0,9.0.0,15,23,84,72,156,29,TRUE
reshow-app,0.1.8,0.1.9,29,1,47,36,83,4,TRUE
reshow-app,0.1.9,0.1.10,30,1,467,465,932,3,FALSE
reshow-app,0.1.0,0.1.1,21,1,1,1,2,1,FALSE
reshow-app,0.1.1,0.1.2,22,1,1,1,2,1,FALSE
reshow-app,0.1.2,0.1.3,23,1,1,1,2,1,FALSE
reshow-app,0.1.3,0.1.4,24,1,1,1,2,1,FALSE
reshow-app,0.1.4,0.1.5,25,3,217,191,408,14,FALSE
reshow-app,0.0.18,0.0.19,18,1,1,1,2,1,FALSE
reshow-app,0.1.6,0.1.7,27,2,58,47,105,4,FALSE
reshow-app,0.1.7,0.1.8,28,1,1,1,2,1,FALSE
reshow-app,0.0.19,0.0.20,19,1,47,38,85,4,FALSE
reshow-app,0.1.20,0.1.21,40,1,77,76,153,2,FALSE
reshow-app,0.1.5,0.1.6,26,1,1,1,2,1,FALSE
reshow-app,0.0.20,0.1.0,20,2,327,255,582,10,FALSE
reshow-app,0.1.12,0.1.13,33,6,509,500,1009,19,FALSE
reshow-app,0.1.13,0.1.14,34,3,50,44,94,9,FALSE
reshow-app,0.1.10,0.1.11,31,1,1,1,2,1,FALSE
reshow-app,0.1.11,0.1.12,32,1,1,1,2,1,FALSE
reshow-app,0.1.16,0.1.17,36,1,1,1,2,1,FALSE
reshow-app,0.1.17,0.1.18,37,2,65,48,113,12,TRUE
reshow-app,0.1.14,0.1.16,35,8,733,657,1390,31,FALSE
reshow-app,0.1.18,0.1.19,38,1,1,1,2,1,FALSE
reshow-app,0.1.19,0.1.20,39,3,840,832,1672,8,FALSE
reshow-app,0.1.17,0.1.18,37,2,65,48,113,12,FALSE
reshow-app,0.0.15,0.0.16,16,1,1,1,2,1,FALSE
reshow-app,0.0.16,0.0.18,17,1,26,35,61,5,FALSE
reshow-app,0.0.11,0.0.12,12,1,1,1,2,1,FALSE
reshow-app,0.0.10,0.0.11,11,1,6,5,11,2,FALSE
reshow-app,0.0.12,0.0.13,13,1,1,1,2,1,FALSE
reshow-app,0.0.5,0.0.6,6,1,1,1,2,1,FALSE
reshow-app,0.0.4,0.0.5,5,1,1,1,2,1,FALSE
reshow-app,0.0.7,0.0.8,8,1,1,1,2,1,FALSE
reshow-app,0.0.6,0.0.7,7,1,1,1,2,1,FALSE
reshow-app,0.0.1,0.0.2,2,1,1,1,2,1,FALSE
reshow-app,0.0.0,0.0.1,1,1,1,1,2,1,FALSE
reshow-app,0.0.3,0.0.4,4,1,1,1,2,1,FALSE
reshow-app,0.0.2,0.0.3,3,1,1,1,2,1,FALSE
reshow-app,0.0.9,0.0.10,10,1,2159,1,2160,13,FALSE
reshow-app,0.0.8,0.0.9,9,1,1,1,2,1,FALSE
reshow-app,0.1.8,0.1.9,29,1,47,36,83,4,FALSE
reshow-app,0.1.13,0.1.14,34,3,50,44,94,9,TRUE
reshow-app,0.0.14,0.0.15,15,1,1,1,2,1,FALSE
reshow-app,0.0.13,0.0.14,14,1,3,0,3,1,FALSE
moped-runtime,0.0.15,0.0.16,16,1,3052,0,3052,29,FALSE
moped-runtime,0.0.14,0.0.15,15,1,1,1,2,1,FALSE
moped-runtime,0.0.17,0.0.18,18,1,2,2,4,2,FALSE
moped-runtime,0.0.16,0.0.17,17,2,6,6,12,4,FALSE
moped-runtime,0.0.11,0.0.12,12,1,1,1,2,1,FALSE
moped-runtime,0.0.10,0.0.11,11,1,1,1,2,1,FALSE
moped-runtime,0.0.13,0.0.14,14,1,1,1,2,1,FALSE
moped-runtime,0.0.12,0.0.13,13,1,1,1,2,1,FALSE
moped-runtime,0.0.19,0.0.20,20,3,11,7,18,4,FALSE
moped-runtime,0.0.18,0.0.19,19,2,3,4,7,4,FALSE
moped-runtime,0.0.5,0.0.6,6,1,1,1,2,1,FALSE
moped-runtime,0.0.4,0.0.5,5,1,1,1,2,1,FALSE
moped-runtime,0.0.7,0.0.8,8,1,1,1,2,1,FALSE
moped-runtime,0.0.6,0.0.7,7,1,1,1,2,1,FALSE
moped-runtime,0.0.1,0.0.2,2,1,1,1,2,1,FALSE
moped-runtime,0.0.0,0.0.1,1,1,1,1,2,1,FALSE
moped-runtime,0.0.3,0.0.4,4,1,1,1,2,1,FALSE
moped-runtime,0.0.2,0.0.3,3,1,1,1,2,1,FALSE
moped-runtime,0.0.9,0.0.10,10,1,1,1,2,1,FALSE
moped-runtime,0.0.8,0.0.9,9,1,1,1,2,1,FALSE
moped-runtime,0.0.20,0.0.21,21,3,19,26,45,4,FALSE
moped-runtime,0.0.21,0.0.22,22,2,6,4,10,3,FALSE
moped-runtime,0.0.22,0.0.23,23,3,8,5,13,4,FALSE
moped-runtime,0.0.23,0.0.24,24,3,3,2,5,3,FALSE
moped-runtime,0.0.24,0.0.25,25,3,4,4,8,3,FALSE
moped-runtime,0.0.19,0.0.20,20,3,11,7,18,4,TRUE
on-update,1.3.1,2.0.0,9,2,5,5,10,2,FALSE
on-update,1.3.0,1.3.1,8,3,5,4,9,3,TRUE
on-update,1.2.2,1.3.0,7,2,4,4,8,2,FALSE
on-update,1.1.0,1.1.1,3,2,3,9,12,2,FALSE
on-update,1.0.1,1.0.2,1,7,118,28,146,8,FALSE
on-update,1.0.2,1.1.0,2,3,13,6,19,3,FALSE
on-update,1.2.0,1.2.1,5,3,4,2,6,3,FALSE
opensubtitles-api,3.1.1,3.2.0,10,2,9,19,28,2,FALSE
opensubtitles-api,3.1.0,3.1.1,9,2,6,3,9,3,FALSE
opensubtitles-api,3.0.0,3.1.0,8,3,28,12,40,4,FALSE
opensubtitles-api,3.3.0,3.4.0,12,7,54,61,115,7,FALSE
opensubtitles-api,4.0.0-rc1,4.0.0-rc2,16,4,18,18,36,6,FALSE
opensubtitles-api,3.4.0,3.4.1,13,2,4,4,8,2,FALSE
opensubtitles-api,3.5.0,4.0.0-rc1,15,12,1798,2288,4086,29,FALSE
opensubtitles-api,2.3.0,2.4.0,5,3,11,1,12,5,FALSE
opensubtitles-api,2.4.0,2.4.1,6,2,2,2,4,2,FALSE
opensubtitles-api,3.4.1,3.5.0,14,2,2,0,2,2,FALSE
opensubtitles-api,3.2.0,3.3.0,11,8,242,118,360,8,FALSE
opensubtitles-api,2.2.0,2.3.0,4,2,5,1,6,4,FALSE
opensubtitles-api,2.1.0,2.1.1,2,3,5,5,10,3,FALSE
opensubtitles-api,2.1.1,2.2.0,3,3,14,3,17,4,FALSE
opensubtitles-api,2.4.1,3.0.0,7,9,86,46,132,16,FALSE
opensubtitles-api,2.0.0,2.1.0,1,1,4,3,7,2,FALSE
opensubtitles-api,3.4.0,3.4.1,13,2,4,4,8,2,TRUE
opensubtitles-api,2.2.0,2.3.0,4,2,5,1,6,4,TRUE
ko-component-router,3.8.5,3.8.6,47,2,82,100,182,7,FALSE
ko-component-router,3.8.6,3.9.0,48,2,392,162,554,16,FALSE
ko-component-router,3.8.4,3.8.5,46,2,17,11,28,7,FALSE
ko-component-router,3.8.2,3.8.3,44,2,16,19,35,10,FALSE
ko-component-router,3.8.3,3.8.4,45,4,46,19,65,15,FALSE
ko-component-router,3.8.0,3.8.1,42,4,111,80,191,19,FALSE
ko-component-router,3.8.1,3.8.2,43,3,24,15,39,15,FALSE
ko-component-router,5.0.0-rc.3,5.0.0-rc.4,92,1,4,4,8,2,FALSE
ko-component-router,5.0.0-rc.2,5.0.0-rc.3,91,1,4,4,8,2,FALSE
ko-component-router,5.0.0-rc.1,5.0.0-rc.2,90,1,4,4,8,2,FALSE
ko-component-router,5.0.0-rc.6,5.0.0-rc.7,95,1,4,4,8,2,FALSE
ko-component-router,5.0.0-rc.5,5.0.0-rc.6,94,1,4,4,8,2,FALSE
ko-component-router,5.0.0-rc.4,5.0.0-rc.5,93,1,4,4,8,2,FALSE
ko-component-router,5.0.0-pre,5.0.0-rc.1,89,1,4,4,8,2,FALSE
ko-component-router,3.11.1,3.11.2,67,3,2978,225,3203,23,FALSE
ko-component-router,3.11.2,3.11.3,68,4,117,79,196,11,FALSE
ko-component-router,3.11.0,3.11.1,66,2,11,11,22,7,FALSE
ko-component-router,3.7.18,3.8.0,41,12,2978,1887,4865,113,FALSE
ko-component-router,3.7.15,3.7.16,38,1,4,4,8,2,FALSE
ko-component-router,3.7.14,3.7.15,37,2,8,8,16,8,FALSE
ko-component-router,3.7.17,3.7.18,40,4,63,51,114,19,FALSE
ko-component-router,3.7.16,3.7.17,39,8,931,198,1129,32,FALSE
ko-component-router,3.7.11,3.7.12,34,4,1296,129,1425,20,FALSE
ko-component-router,3.7.10,3.7.11,33,2,6,6,12,6,FALSE
ko-component-router,3.7.13,3.7.14,36,3,14,14,28,14,FALSE
ko-component-router,3.7.12,3.7.13,35,1,1,1,2,1,FALSE
ko-component-router,3.10.8,3.10.9,58,3,19,19,38,5,FALSE
ko-component-router,3.10.9,3.10.10,59,7,40,35,75,16,FALSE
ko-component-router,3.9.0,3.10.0,49,2,13,15,28,2,FALSE
ko-component-router,3.7.7,3.7.9,31,4,70,31,101,16,FALSE
ko-component-router,3.10.0,3.10.1,50,2,94,105,199,12,FALSE
ko-component-router,3.10.1,3.10.2,51,5,54,39,93,14,FALSE
ko-component-router,3.10.2,3.10.3,52,4,110,23,133,15,FALSE
ko-component-router,3.10.3,3.10.4,53,2,7,10,17,7,FALSE
ko-component-router,3.10.4,3.10.5,54,2,74,59,133,17,FALSE
ko-component-router,3.10.5,3.10.6,55,3,168,89,257,15,FALSE
ko-component-router,3.10.7,3.10.8,57,2,7,16,23,5,FALSE
ko-component-router,3.6.8,3.6.9,21,2,6,6,12,6,FALSE
ko-component-router,3.6.4,3.6.5,17,3,162,83,245,17,FALSE
ko-component-router,3.7.2,3.7.3,26,2,79,118,197,12,FALSE
ko-component-router,3.10.14,3.10.15,63,2,8,8,16,7,FALSE
ko-component-router,3.10.6,3.10.7,56,4,178,77,255,23,FALSE
ko-component-router,3.10.12,3.10.14,62,6,279,162,441,30,FALSE
ko-component-router,3.6.9,3.6.11,22,9,382,347,729,21,FALSE
ko-component-router,3.7.6,3.7.7,30,3,24,18,42,12,FALSE
ko-component-router,3.7.1,3.7.2,25,2,118,79,197,12,FALSE
ko-component-router,3.6.11,3.7.0,23,3,95,32,127,14,FALSE
ko-component-router,3.6.1,3.6.2,14,4,29,21,50,8,FALSE
ko-component-router,3.6.2,3.6.3,15,2,6,6,12,6,FALSE
ko-component-router,3.6.3,3.6.4,16,6,168,103,271,31,FALSE
ko-component-router,3.7.9,3.7.10,32,2,8,4,12,6,FALSE
ko-component-router,3.6.5,3.6.6,18,2,28,28,56,7,FALSE
ko-component-router,3.6.6,3.6.7,19,3,12,16,28,11,FALSE
ko-component-router,3.6.7,3.6.8,20,3,48,7,55,8,FALSE
ko-component-router,3.7.5,3.7.6,29,7,311,185,496,38,FALSE
ko-component-router,3.7.4,3.7.5,28,2,10,11,21,6,FALSE
ko-component-router,3.10.10,3.10.11,60,2,57,54,111,15,FALSE
ko-component-router,3.10.11,3.10.12,61,5,770,727,1497,37,FALSE
ko-component-router,3.10.16,3.11.0,65,2,102,42,144,9,FALSE
ko-component-router,3.7.0,3.7.1,24,2,6,4,10,6,FALSE
ko-component-router,3.7.3,3.7.4,27,2,114,74,188,12,FALSE
ko-component-router,3.10.15,3.10.16,64,2,38,39,77,11,FALSE
ko-component-router,1.0.4,1.0.5,4,1,248,262,510,5,TRUE
ko-component-router,1.0.1,1.0.2,1,2,91,55,146,6,FALSE
ko-component-router,1.0.2,1.0.3,2,1,53,52,105,9,FALSE
ko-component-router,1.0.3,1.0.4,3,2,13541,950,14491,6,FALSE
ko-component-router,4.3.0,4.3.1,82,2,2,4,6,2,FALSE
ko-component-router,4.3.1,4.4.0,83,4,72,46,118,9,FALSE
ko-component-router,3.0.2,3.0.3,12,2,8,7,15,7,FALSE
ko-component-router,3.0.3,3.6.1,13,41,1664,1010,2674,181,FALSE
ko-component-router,3.0.0,3.0.1,10,10,203,152,355,39,FALSE
ko-component-router,3.0.1,3.0.2,11,3,9,19,28,9,FALSE
ko-component-router,4.1.0,4.2.0,80,4,66,15,81,10,FALSE
ko-component-router,3.11.3,4.0.0-pre.6,69,5,333,7209,7542,22,FALSE
ko-component-router,4.0.0-pre.9,4.0.0-rc,73,1,4,4,8,2,FALSE
ko-component-router,4.0.0-pre.8,4.0.0-pre.9,72,1,4,4,8,2,FALSE
ko-component-router,4.0.0-pre.7,4.0.0-pre.8,71,1,4,4,8,2,FALSE
ko-component-router,4.0.0-pre.6,4.0.0-pre.7,70,1,4,4,8,2,FALSE
ko-component-router,4.0.1,4.1.0,79,5,55,38,93,9,FALSE
ko-component-router,4.0.0,4.0.1,78,6,114,87,201,9,FALSE
ko-component-router,4.0.0-rc.2,4.0.0-rc.3,75,1,4,4,8,2,FALSE
ko-component-router,4.0.0-rc.3,4.0.0-rc.4,76,1,4,4,8,2,FALSE
ko-component-router,4.0.0-rc.4,4.0.0,77,77,7376,13415,20791,285,FALSE
ko-component-router,3.7.18,3.8.0,41,12,2978,1887,4865,113,TRUE
ko-component-router,4.4.4,5.0.0-pre,88,12,757,466,1223,27,FALSE
ko-component-router,4.4.1,4.4.2,85,4,74,14,88,6,FALSE
ko-component-router,4.4.0,4.4.1,84,3,440,26,466,10,FALSE
ko-component-router,4.4.3,4.4.4,87,2,10,4,14,3,FALSE
ko-component-router,4.4.2,4.4.3,86,5,17,48,65,6,FALSE
ko-component-router,4.2.0,4.3.0,81,18,840,648,1488,39,FALSE
ko-component-router,4.0.0-rc,4.0.0-rc.2,74,1,4,4,8,2,FALSE
ko-component-router,1.0.4,1.0.5,4,1,248,262,510,5,FALSE
ko-component-router,4.0.0,4.0.1,78,6,114,87,201,9,TRUE
ko-component-router,4.0.0-rc.3,4.0.0-rc.4,76,1,4,4,8,2,TRUE
ko-component-router,4.0.0-pre.8,4.0.0-pre.9,72,1,4,4,8,2,TRUE
ko-component-router,3.11.1,3.11.2,67,3,2978,225,3203,23,TRUE
ko-component-router,3.10.7,3.10.8,57,2,7,16,23,5,TRUE
ko-component-router,2.1.0,2.1.1,7,2,1215,1080,2295,14,FALSE
ko-component-router,2.1.1,2.1.2,8,5,25,17,42,16,FALSE
ko-component-router,2.0.0,2.1.0,6,12,329,128,457,35,FALSE
ko-component-router,3.6.7,3.6.8,20,3,48,7,55,8,TRUE
ko-component-router,5.0.0-rc.3,5.0.0-rc.4,92,1,4,4,8,2,TRUE
ko-component-router,5.0.0-rc.2,5.0.0-rc.3,91,1,4,4,8,2,TRUE
ko-component-router,5.0.0-rc.1,5.0.0-rc.2,90,1,4,4,8,2,TRUE
ko-component-router,5.0.0-rc.6,5.0.0-rc.7,95,1,4,4,8,2,TRUE
ko-component-router,5.0.0-rc.5,5.0.0-rc.6,94,1,4,4,8,2,TRUE
ko-component-router,2.1.2,3.0.0,9,10,23617,2710,26327,121,FALSE
ko-component-router,4.2.0,4.3.0,81,18,840,648,1488,39,TRUE
ko-component-router,4.0.0-pre.7,4.0.0-pre.8,71,1,4,4,8,2,TRUE
ko-component-router,3.7.14,3.7.15,37,2,8,8,16,8,TRUE
ko-component-router,3.7.17,3.7.18,40,4,63,51,114,19,TRUE
ko-component-router,3.10.9,3.10.10,59,7,40,35,75,16,TRUE
ko-component-router,3.10.12,3.10.14,62,6,279,162,441,30,TRUE
ko-component-router,3.10.10,3.10.11,60,2,57,54,111,15,TRUE
ko-component-router,1.0.5,2.0.0,5,16,1578,18464,20042,72,FALSE
ko-component-router,1.0.3,1.0.4,3,2,13541,950,14491,6,TRUE
ko-component-router,4.0.0-pre.9,4.0.0-rc,73,1,4,4,8,2,TRUE
ko-component-router,4.0.0-rc,4.0.0-rc.2,74,1,4,4,8,2,TRUE
ko-component-router,2.1.1,2.1.2,8,5,25,17,42,16,TRUE
ko-component-router,4.4.1,4.4.2,85,4,74,14,88,6,TRUE
ko-component-router,4.3.0,4.3.1,82,2,2,4,6,2,TRUE
ko-component-router,3.10.1,3.10.2,51,5,54,39,93,14,TRUE
ko-component-router,3.10.6,3.10.7,56,4,178,77,255,23,TRUE
ko-component-router,2.1.2,3.0.0,9,10,23617,2710,26327,121,TRUE
ko-component-router,3.10.0,3.10.1,50,2,94,105,199,12,TRUE
ko-component-router,3.10.3,3.10.4,53,2,7,10,17,7,TRUE
ko-component-router,3.7.1,3.7.2,25,2,118,79,197,12,TRUE
ko-component-router,3.6.1,3.6.2,14,4,29,21,50,8,TRUE
ko-component-router,4.4.0,4.4.1,84,3,440,26,466,10,TRUE
jsdonk,0.4.20,0.5.0,40,16,59164,13192,72356,165,FALSE
jsdonk,0.2.3,0.3.0,15,2,147,20,167,12,FALSE
jsdonk,0.2.2,0.2.3,14,3,148,21,169,13,FALSE
jsdonk,0.2.1,0.2.2,13,2,29,13,42,3,FALSE
jsdonk,0.2.0,0.2.1,12,2,7,8,15,3,FALSE
jsdonk,0.1.2,0.1.3,6,2,341,1135,1476,27,FALSE
jsdonk,0.1.3,0.1.4,7,2,55,21,76,10,FALSE
jsdonk,0.1.4,0.1.5,8,2,6,6,12,3,FALSE
jsdonk,0.1.5,0.1.6,9,2,2,2,4,2,FALSE
jsdonk,0.1.6,0.1.7,10,2,65,85,150,14,FALSE
jsdonk,0.1.7,0.2.0,11,2,57,8,65,5,FALSE
jsdonk,0.3.2,0.3.3,18,8,23705,23415,47120,282,TRUE
jsdonk,0.3.3,0.3.4,19,5,896,101,997,68,FALSE
jsdonk,0.3.0,0.3.1,16,2,2,2,4,2,FALSE
jsdonk,0.3.1,0.3.2,17,2,1,5,6,2,FALSE
jsdonk,0.3.4,0.3.5,20,4,40,114,154,13,FALSE
jsdonk,0.3.5,0.4.0,21,5,13500,542,14042,100,FALSE
jsdonk,0.4.9,0.4.10,29,3,2130,1567,3697,4,FALSE
jsdonk,0.4.8,0.4.9,28,2,27,1,28,5,FALSE
jsdonk,0.4.1,0.4.2,23,2,21,5,26,3,FALSE
jsdonk,0.4.0,0.4.1,22,4,617,409,1026,35,FALSE
jsdonk,0.4.2,0.4.5,24,6,1134,239,1373,34,FALSE
jsdonk,0.4.7,0.4.8,27,7,122,72,194,33,FALSE
jsdonk,0.4.6,0.4.7,26,2,2557,36,2593,11,FALSE
jsdonk,0.4.11,0.4.12,31,3,736,377,1113,6,FALSE
jsdonk,0.4.10,0.4.11,30,2,220,20,240,13,FALSE
jsdonk,0.4.13,0.4.14,33,2,3,1,4,2,FALSE
jsdonk,0.4.12,0.4.13,32,6,91,175,266,13,FALSE
jsdonk,0.4.15,0.4.16,35,2,3,3,6,2,FALSE
jsdonk,0.4.14,0.4.15,34,2,2,1,3,2,FALSE
jsdonk,0.4.17,0.4.18,37,4,333,23,356,37,FALSE
jsdonk,0.4.16,0.4.17,36,2,2,2,4,2,FALSE
jsdonk,0.4.19,0.4.20,39,2,17,14,31,3,FALSE
jsdonk,0.4.18,0.4.19,38,8,189,78,267,38,FALSE
jsdonk,0.4.5,0.4.6,25,2,1,3,4,2,FALSE
jsdonk,0.1.0,0.1.1,4,2,7,876,883,18,FALSE
jsdonk,0.1.1,0.1.2,5,2,4,2,6,2,FALSE
jsdonk,0.3.2,0.3.3,18,8,23705,23415,47120,282,FALSE
jsdonk,0.0.1,0.0.2,2,2,355,183,538,29,FALSE
jsdonk,0.0.0,0.0.1,1,3,1430,14979,16409,87,FALSE
jsdonk,0.0.2,0.1.0,3,3,4527,17,4544,19,FALSE
jsdonk,0.4.2,0.4.5,24,6,1134,239,1373,34,TRUE
jsdonk,0.4.6,0.4.7,26,2,2557,36,2593,11,TRUE
babel-plugin-contracts,1.1.1,1.2.0,4,3,255,191,446,27,FALSE
babel-plugin-contracts,1.0.0,1.1.0,2,5,121,35,156,15,FALSE
babel-plugin-contracts,0.0.1,1.0.0,1,9,507,79,586,37,FALSE
babel-plugin-contracts,1.1.0,1.1.1,3,7,55,25,80,7,FALSE
babel-plugin-contracts,1.0.0,1.1.0,2,5,121,35,156,15,TRUE
babel-plugin-contracts,0.0.1,1.0.0,1,9,507,79,586,37,TRUE
react-jupyter-display-area,0.0.1,0.0.2,1,6,10,3,13,6,FALSE
react-jupyter-display-area,1.2.0,1.2.1,12,1,1,1,2,1,FALSE
react-jupyter-display-area,0.0.2,0.1.0,2,7,105,19,124,13,FALSE
react-jupyter-display-area,0.3.0,0.4.0,7,12,29,25,54,12,FALSE
react-jupyter-display-area,1.2.1,1.2.2,13,4,19,13,32,5,FALSE
react-jupyter-display-area,0.4.1,0.4.2,9,3,3,3,6,3,FALSE
react-jupyter-display-area,1.2.2,1.2.3,14,3,27,19,46,11,FALSE
react-jupyter-display-area,1.2.3,1.3.1,15,4,8,4,12,4,FALSE
react-jupyter-display-area,0.2.1,0.3.0,6,5,33,53,86,6,FALSE
react-jupyter-display-area,0.2.0,0.2.1,5,3,3,3,6,3,FALSE
react-jupyter-display-area,0.1.0,0.1.1,3,18,400,784,1184,36,FALSE
react-jupyter-display-area,0.1.1,0.2.0,4,3,22,98,120,9,FALSE
react-jupyter-display-area,0.4.2,1.0.0,10,4,4,4,8,4,FALSE
react-jupyter-display-area,0.4.0,0.4.1,8,3,5,5,10,3,FALSE
react-jupyter-display-area,1.0.0,1.2.0,11,12,218,47,265,25,FALSE
react-jupyter-display-area,0.4.0,0.4.1,8,3,5,5,10,3,TRUE
react-jupyter-display-area,0.0.1,0.0.2,1,6,10,3,13,6,TRUE
react-jupyter-display-area,0.2.1,0.3.0,6,5,33,53,86,6,TRUE
react-jupyter-display-area,1.2.3,1.3.1,15,4,8,4,12,4,TRUE
seneca,0.9.0,0.9.1,42,5,83,6,89,7,FALSE
seneca,1.1.0,1.2.0,47,10,69,1031,1100,20,FALSE
seneca,0.9.2,0.9.3,44,15,324,41,365,26,FALSE
seneca,3.1.0,3.2.0,55,17,2223,1394,3617,55,FALSE
seneca,1.0.0,1.1.0,46,45,2452,1254,3706,225,FALSE
seneca,3.0.0,3.1.0,54,36,1586,699,2285,84,FALSE
seneca,2.0.1,2.1.0,52,21,842,1177,2019,41,FALSE
seneca,0.9.1,0.9.2,43,11,79,30,109,20,FALSE
seneca,2.0.0,2.0.1,51,6,32,13,45,6,FALSE
seneca,0.8.0,0.9.0,41,81,6185,4787,10972,214,FALSE
seneca,0.9.3,1.0.0,45,34,1197,1097,2294,106,FALSE
seneca,1.3.0,1.4.0,49,20,666,395,1061,49,FALSE
seneca,3.2.0,3.2.1,56,3,3,3,6,3,FALSE
seneca,3.2.1,3.2.2,57,14,2456,1436,3892,82,FALSE
seneca,1.2.0,1.3.0,48,18,484,100,584,33,FALSE
seneca,3.2.2,3.3.0,58,16,1468,1180,2648,48,FALSE
seneca,2.1.0,3.0.0,53,151,7375,23945,31320,719,FALSE
seneca,1.4.0,2.0.0,50,8,45,11,56,18,FALSE
seneca,0.5.11,0.5.12,17,3,225,577,802,16,FALSE
seneca,0.5.10,0.5.11,16,4,73,27,100,11,FALSE
seneca,0.5.12,0.5.13,18,7,735,771,1506,38,FALSE
seneca,0.5.14,0.5.15,20,17,2437,2135,4572,105,FALSE
seneca,0.5.13,0.5.14,19,12,541,2397,2938,54,FALSE
seneca,0.5.8,0.5.9,14,17,1291,611,1902,57,FALSE
seneca,0.5.9,0.5.10,15,10,372,65,437,31,FALSE
seneca,0.5.4,0.5.5,10,5,92,70,162,8,FALSE
seneca,0.5.5,0.5.6,11,10,409,156,565,33,FALSE
seneca,0.5.6,0.5.7,12,3,92,32,124,8,FALSE
seneca,0.5.7,0.5.8,13,4,101,34,135,16,FALSE
seneca,0.5.0,0.5.1,6,8,521,152,673,26,FALSE
seneca,0.5.1,0.5.2,7,1,3,3,6,3,FALSE
seneca,0.5.2,0.5.3,8,12,1002,235,1237,45,FALSE
seneca,0.5.3,0.5.4,9,4,65,15,80,14,FALSE
seneca,0.0.1,0.4.1,1,50,10669,5384,16053,255,FALSE
seneca,0.4.4,0.5.0,5,26,5447,5106,10553,205,FALSE
seneca,0.4.1,0.4.2,2,33,7357,3069,10426,146,FALSE
seneca,0.4.3,0.4.4,4,1,1,1,2,1,FALSE
seneca,0.4.2,0.4.3,3,7,330,1043,1373,20,FALSE
seneca,0.7.0,0.7.1,38,5,26,9,35,9,FALSE
seneca,0.5.18,0.5.19,24,6,498,937,1435,26,FALSE
seneca,0.5.19,0.5.20,25,47,1698,1124,2822,133,FALSE
seneca,0.6.4,0.6.5,36,4,820,105,925,22,FALSE
seneca,0.6.3,0.6.4,35,11,466,253,719,25,FALSE
seneca,0.6.2,0.6.3,34,23,9343,2100,11443,182,FALSE
seneca,0.6.1,0.6.2,33,44,4633,2679,7312,116,FALSE
seneca,0.6.1-rc1,0.6.1-rc2,31,8,609,393,1002,19,FALSE
seneca,0.7.2,0.8.0,40,60,6031,4913,10944,283,FALSE
seneca,0.6.5,0.7.0,37,41,16379,57969,74348,608,FALSE
seneca,0.7.1,0.7.2,39,36,10516,26176,36692,362,FALSE
seneca,0.6.1-rc2,0.6.1,32,8,181,129,310,29,FALSE
seneca,0.5.21,0.6.0-rc2,27,68,5466,4219,9685,199,FALSE
seneca,0.5.20,0.5.21,26,17,1474,924,2398,37,FALSE
seneca,0.6.1-rc0,0.6.1-rc1,30,3,145,39,184,8,FALSE
seneca,0.6.0,0.6.1-rc0,29,20,205,178,383,33,FALSE
seneca,0.5.16,0.5.17,22,2,94,476,570,16,FALSE
seneca,0.5.17,0.5.18,23,46,5082,5899,10981,173,FALSE
seneca,0.5.15,0.5.16,21,33,8077,4995,13072,122,FALSE
seneca,1.1.0,1.2.0,47,10,69,1031,1100,20,TRUE
seneca,0.9.0,0.9.1,42,5,83,6,89,7,TRUE
seneca,0.9.2,0.9.3,44,15,324,41,365,26,TRUE
seneca,0.9.3,1.0.0,45,34,1197,1097,2294,106,TRUE
seneca,1.0.0,1.1.0,46,45,2452,1254,3706,225,TRUE
seneca,0.9.1,0.9.2,43,11,79,30,109,20,TRUE
seneca,1.3.0,1.4.0,49,20,666,395,1061,49,TRUE
seneca,1.2.0,1.3.0,48,18,484,100,584,33,TRUE
seneca,3.0.0,3.1.0,54,36,1586,699,2285,84,TRUE
jquery-click-flyout,0.0.5,0.0.6,5,2,22,10,32,6,FALSE
jquery-click-flyout,0.0.4,0.0.5,4,2,6,11,17,5,FALSE
jquery-click-flyout,0.0.1,0.0.2,1,3,31,42,73,7,FALSE
jquery-click-flyout,0.0.3,0.0.4,3,2,16,12,28,6,FALSE
jquery-click-flyout,0.0.2,0.0.3,2,2,7,9,16,5,FALSE
jquery-click-flyout,0.0.2,0.0.3,2,2,7,9,16,5,TRUE
ng2-webpack-scripts,0.3.2,0.3.3,9,1,2,2,4,1,FALSE
ng2-webpack-scripts,0.3.3,0.3.4,10,1,134,20,154,4,FALSE
ng2-webpack-scripts,0.3.0,0.3.1,7,1,9,8,17,3,FALSE
ng2-webpack-scripts,0.3.1,0.3.2,8,1,10,12,22,3,FALSE
ng2-webpack-scripts,0.2.1,0.3.0,6,2,150,51,201,15,FALSE
ng2-webpack-scripts,0.2.0,0.2.1,5,1,8,0,8,1,FALSE
ng2-webpack-scripts,0.1.0,0.1.1,1,3,87,63,150,8,FALSE
ng2-webpack-scripts,0.1.1,0.1.2,2,6,391,21,412,29,FALSE
ng2-webpack-scripts,0.1.2,0.1.3,3,3,5,1,6,3,FALSE
ng2-webpack-scripts,0.1.3,0.2.0,4,2,284,93,377,17,FALSE
ng2-webpack-scripts,0.3.3,0.3.4,10,1,134,20,154,4,TRUE
ng2-webpack-scripts,0.3.2,0.3.3,9,1,2,2,4,1,TRUE
ng2-webpack-scripts,0.3.1,0.3.2,8,1,10,12,22,3,TRUE
ng2-webpack-scripts,0.3.0,0.3.1,7,1,9,8,17,3,TRUE
ng2-webpack-scripts,0.2.1,0.3.0,6,2,150,51,201,15,TRUE
ng2-webpack-scripts,0.2.0,0.2.1,5,1,8,0,8,1,TRUE
ng2-webpack-scripts,0.1.0,0.1.1,1,3,87,63,150,8,TRUE
ng2-webpack-scripts,0.1.1,0.1.2,2,6,391,21,412,29,TRUE
ng2-webpack-scripts,0.1.2,0.1.3,3,3,5,1,6,3,TRUE
ng2-webpack-scripts,0.1.3,0.2.0,4,2,284,93,377,17,TRUE
functify,0.2.6,0.3.0,6,2,1532,2552,4084,10,FALSE
functify,0.3.0,0.3.1,7,1,50,113,163,4,FALSE
functify,0.2.5,0.2.6,5,4,2759,1496,4255,12,FALSE
functify,0.3.2,0.3.3,9,1,114,37,151,5,FALSE
functify,0.3.3,0.4.0,10,3,8,1509,1517,6,FALSE
functify,0.3.1,0.3.2,8,1,111,201,312,3,FALSE
functify,0.2.0,0.2.5,4,12,2456,557,3013,21,FALSE
functify,0.1.2,0.2.0,3,4,121,122,243,6,TRUE
functify,0.1.0,0.1.1,1,4,11,395,406,8,FALSE
functify,0.1.1,0.1.2,2,2,1215,4,1219,5,FALSE
functify,0.1.2,0.2.0,3,4,121,122,243,6,FALSE
functify,0.2.6,0.3.0,6,2,1532,2552,4084,10,TRUE
smu,0.1.0,0.1.1,2,2,3,1,4,2,FALSE
smu,0.1.1,0.1.2,3,18,275,93,368,35,FALSE
smu,0.1.1,0.1.2,3,18,275,93,368,35,TRUE
smu,0.0.1,0.1.0,1,16,178,83,261,31,FALSE
smu,0.0.1,0.1.0,1,16,178,83,261,31,TRUE
react-custom-places-input,1.0.0,1.0.1,2,10,40,16,56,11,TRUE
yar-carousel,1.1.1,1.1.2,13,3,21,21,42,4,FALSE
yar-carousel,1.1.0,1.1.1,12,4,4,4,8,4,FALSE
yar-carousel,1.1.3,1.1.4,15,2,16,1,17,2,FALSE
yar-carousel,1.1.2,1.1.3,14,2,15,1,16,2,FALSE
yar-carousel,1.0.0,1.0.1,8,2,21,9,30,6,FALSE
yar-carousel,1.0.1,1.0.2,9,1,1,1,2,1,FALSE
yar-carousel,1.0.2,1.0.3,10,2,23,15,38,4,FALSE
yar-carousel,1.0.3,1.1.0,11,3,55,42,97,6,FALSE
yar-carousel,0.0.7,1.0.0,7,6,878,693,1571,64,FALSE
yar-carousel,0.0.6,0.0.7,6,2,3,3,6,2,FALSE
yar-carousel,1.2.4,1.2.5,20,2,2,2,4,2,FALSE
yar-carousel,0.0.5,0.0.6,5,2,9,5,14,2,FALSE
yar-carousel,1.2.2,1.2.3,18,2,2,2,4,3,FALSE
yar-carousel,1.2.3,1.2.4,19,2,3,3,6,5,FALSE
yar-carousel,1.2.1,1.2.2,17,1,1,1,2,1,FALSE
yar-carousel,1.2.5,1.2.6,21,2,3,2,5,2,FALSE
yar-carousel,1.1.4,1.2.1,16,13,232,219,451,87,TRUE
yar-carousel,1.1.4,1.2.1,16,13,232,219,451,87,FALSE
yar-carousel,0.0.4,0.0.5,4,2,5,3,8,2,FALSE
yar-carousel,0.0.1,0.0.2,1,1,1,1,2,1,FALSE
yar-carousel,0.0.3,0.0.4,3,2,2,2,4,2,FALSE
yar-carousel,0.0.2,0.0.3,2,6,784,2,786,41,FALSE
yar-carousel,1.1.0,1.1.1,12,4,4,4,8,4,TRUE
yar-carousel,1.2.4,1.2.5,20,2,2,2,4,2,TRUE
warehousejs,0.2.2,0.3.0,3,8,673,322,995,30,FALSE
warehousejs,0.2.1,0.2.2,2,3,277,54,331,10,FALSE
warehousejs,0.2.0,0.2.1,1,3,50,51,101,15,FALSE
warehousejs,0.2.1,0.2.2,2,3,277,54,331,10,TRUE
twitch-api-v5,1.0.4,1.1.0,5,1,54,59,113,5,TRUE
twitch-api-v5,1.1.0,1.1.1,6,1,65,18,83,5,FALSE
twitch-api-v5,1.1.1,1.2.0,7,1,177,3,180,5,FALSE
twitch-api-v5,1.0.0,1.0.1,1,1,3,3,6,1,FALSE
twitch-api-v5,1.0.1,1.0.2,2,1,2178,0,2178,20,FALSE
twitch-api-v5,2.0.1,2.0.2,12,1,9,9,18,2,FALSE
twitch-api-v5,1.0.3,1.0.4,4,3,22,10,32,7,FALSE
twitch-api-v5,2.0.0,2.0.1,11,1,11,9,20,4,FALSE
twitch-api-v5,1.3.1,2.0.0,10,1,992,105,1097,13,FALSE
twitch-api-v5,1.3.0,1.3.1,9,1,1,15,16,2,FALSE
twitch-api-v5,1.2.0,1.3.0,8,1,33,1,34,4,FALSE
twitch-api-v5,1.0.2,1.0.3,3,1,3,3,6,1,FALSE
twitch-api-v5,1.0.4,1.1.0,5,1,54,59,113,5,FALSE
get-pkg-version,0.0.4,0.0.5,4,2,7,9,16,3,FALSE
get-pkg-version,0.0.1-alpha,0.0.2,1,1,4,4,8,2,FALSE
get-pkg-version,0.0.3,0.0.4,3,1,4,4,8,2,FALSE
get-pkg-version,0.0.2,0.0.3,2,1,53,12,65,6,FALSE
get-pkg-version,0.0.4,0.0.5,4,2,7,9,16,3,TRUE
get-pkg-version,0.0.2,0.0.3,2,1,53,12,65,6,TRUE
react-darkroom,0.2.0-alpha-3,0.2.0-alpha-4,5,1,615,62,677,5,FALSE
react-darkroom,0.2.0-alpha-2,0.2.0-alpha-3,4,1,615,62,677,5,FALSE
react-darkroom,0.0.0,0.1.0,1,3,196,5,201,3,FALSE
react-darkroom,0.2.0-alpha,0.2.0-alpha-2,3,1,615,62,677,5,FALSE
react-darkroom,0.2.0-alpha-4,0.2.0-alpha-5,6,1,615,62,677,5,FALSE
react-darkroom,0.2.0-alpha-5,0.2.0,7,1,9,23,32,4,FALSE
react-darkroom,0.2.0,0.2.2,8,2,127,4,131,5,FALSE
react-darkroom,0.1.0,0.2.0-alpha,2,1,65,31,96,38,FALSE
react-darkroom,0.3.2,0.3.4,10,2,60,52,112,9,FALSE
react-darkroom,0.3.6,0.3.7,12,5,9753,8463,18216,9,FALSE
react-darkroom,0.3.4,0.3.6,11,2,81,181,262,11,FALSE
react-darkroom,0.2.2,0.3.2,9,7,18343,18900,37243,42,FALSE
react-darkroom,0.1.0,0.2.0-alpha,2,1,65,31,96,38,TRUE
react-darkroom,0.3.6,0.3.7,12,5,9753,8463,18216,9,TRUE
react-darkroom,0.2.2,0.3.2,9,7,18343,18900,37243,42,TRUE
weex-vue-loader,0.2.11,0.2.12,15,28,202,152,354,55,FALSE
weex-vue-loader,0.2.10,0.2.11,14,1,5,5,10,1,FALSE
weex-vue-loader,0.2.7,0.2.8,11,5,58,5,63,10,FALSE
weex-vue-loader,0.2.6,0.2.7,10,1,5,5,10,1,FALSE
weex-vue-loader,0.2.5,0.2.6,9,1,1,1,2,1,FALSE
weex-vue-loader,0.2.4,0.2.5,8,5,28,15,43,11,FALSE
weex-vue-loader,0.2.3,0.2.4,7,2,5,2,7,2,FALSE
weex-vue-loader,0.2.2,0.2.3,6,21,1407,276,1683,88,FALSE
weex-vue-loader,0.2.1,0.2.2,5,7,1209,74,1283,26,FALSE
weex-vue-loader,0.2.0,0.2.1,4,8,59,30,89,11,FALSE
weex-vue-loader,0.2.9,0.2.10,13,1,5,5,10,1,FALSE
weex-vue-loader,0.2.8,0.2.9,12,58,3922,662,4584,148,FALSE
weex-vue-loader,0.2.11,0.2.12,15,28,202,152,354,55,TRUE
weex-vue-loader,0.1.0,0.1.1,1,33,355,201,556,52,FALSE
weex-vue-loader,0.1.1,0.1.2,2,44,703,681,1384,84,FALSE
weex-vue-loader,0.1.2,0.2.0,3,29,173,95,268,34,FALSE
weex-vue-loader,0.2.7,0.2.8,11,5,58,5,63,10,TRUE
weex-vue-loader,0.2.4,0.2.5,8,5,28,15,43,11,TRUE
weex-vue-loader,0.2.0,0.2.1,4,8,59,30,89,11,TRUE
weex-vue-loader,0.2.10,0.2.11,14,1,5,5,10,1,TRUE
weex-vue-loader,0.2.8,0.2.9,12,58,3922,662,4584,148,TRUE
angular2-hapi-engine,0.5.0,0.5.1,2,13,26323,66,26389,23,FALSE
angular2-hapi-engine,0.5.1,0.5.2,3,28,160,181,341,34,FALSE
angular2-hapi-engine,0.5.2,0.7.0,4,116,2398,872,3270,244,FALSE
angular2-hapi-engine,0.10.1,0.11.0,10,56,773,698,1471,82,FALSE
angular2-hapi-engine,0.14.1,0.14.2,18,1,1877,3823,5700,66,FALSE
angular2-hapi-engine,0.14.0,0.14.1,17,13,1584065,12858,1596923,121,FALSE
angular2-hapi-engine,0.14.2,0.15.0,19,17,437,212,649,43,FALSE
angular2-hapi-engine,0.11.0,0.11.1,11,48,315,156,471,83,TRUE
angular2-hapi-engine,0.11.1,0.11.2,12,38,1069,699,1768,142,FALSE
angular2-hapi-engine,0.11.2,0.13.0,13,28,1172,170,1342,36,FALSE
angular2-hapi-engine,0.13.3,0.14.0,16,13,121,73,194,16,FALSE
angular2-hapi-engine,0.13.0,0.13.1,14,31,938,295,1233,43,FALSE
angular2-hapi-engine,0.13.1,0.13.3,15,20,1446,1061,2507,61,FALSE
angular2-hapi-engine,0.10.1,0.11.0,10,56,773,698,1471,82,TRUE
angular2-hapi-engine,0.10.0,0.10.1,9,6,56,49,105,9,FALSE
angular2-hapi-engine,0.7.2,0.8.0,7,77,757,593,1350,92,TRUE
angular2-hapi-engine,0.7.0,0.7.1,5,16,313,71,384,20,TRUE
angular2-hapi-engine,0.8.0,0.10.0,8,4,37,30,67,7,FALSE
angular2-hapi-engine,0.1.0,0.5.0,1,88,1552,19630,21182,193,TRUE
angular2-hapi-engine,0.7.1,0.7.2,6,14,450,29,479,17,TRUE
angular2-hapi-engine,0.5.2,0.7.0,4,116,2398,872,3270,244,TRUE
angular2-hapi-engine,0.11.0,0.11.1,11,48,315,156,471,83,FALSE
angular2-hapi-engine,0.7.2,0.8.0,7,77,757,593,1350,92,FALSE
angular2-hapi-engine,0.7.0,0.7.1,5,16,313,71,384,20,FALSE
angular2-hapi-engine,0.7.1,0.7.2,6,14,450,29,479,17,FALSE
rawcan,0.1.12,0.1.13,7,2,2,1,3,2,FALSE
rawcan,0.1.13,0.1.14,8,2,3,2,5,3,FALSE
rawcan,1.1.1,1.1.2,13,2,6,4,10,4,FALSE
rawcan,1.1.2,1.1.3,14,2,13,5,18,5,FALSE
rawcan,1.0.0,1.1.0,11,5,3706,582,4288,22,FALSE
rawcan,0.1.14,0.1.15,9,2,2,3,5,3,FALSE
rawcan,0.1.15,1.0.0,10,4,52,11,63,4,FALSE
rawcan,1.1.0,1.1.1,12,2,10,3,13,3,FALSE
rawcan,1.1.3,1.1.4,15,2,3,3,6,3,FALSE
rawcan,0.1.9,0.1.12,6,10,95,84,179,23,FALSE
rawcan,0.1.0,0.1.1,1,3,54,49,103,10,FALSE
rawcan,0.1.1,0.1.2,2,2,19,2,21,4,FALSE
rawcan,0.1.2,0.1.3,3,1,7,1,8,2,FALSE
rawcan,0.1.3,0.1.7,4,17,806,772,1578,63,FALSE
rawcan,0.1.7,0.1.9,5,8,2839,120,2959,14,FALSE
rawcan,1.0.0,1.1.0,11,5,3706,582,4288,22,TRUE
rawcan,0.1.14,0.1.15,9,2,2,3,5,3,TRUE
rawcan,0.1.15,1.0.0,10,4,52,11,63,4,TRUE
rawcan,0.1.7,0.1.9,5,8,2839,120,2959,14,TRUE
babel-loader,6.0.1,6.1.0,21,15,380,46,426,31,FALSE
babel-loader,6.0.0,6.0.1,20,9,38,27,65,11,FALSE
babel-loader,6.1.0,6.2.0,22,10,77,43,120,20,FALSE
babel-loader,6.4.0,6.4.1,37,10,325,32,357,15,FALSE
babel-loader,5.4.0,5.4.1,17,46,217,159,376,74,FALSE
babel-loader,5.4.1,5.4.2,18,1,11,4,15,2,FALSE
babel-loader,6.2.10,6.3.0,33,16,215,222,437,22,FALSE
babel-loader,6.2.5,6.2.6,28,8,42,13,55,11,FALSE
babel-loader,6.2.4,6.2.5,27,18,205,37,242,22,FALSE
babel-loader,6.3.2,6.4.0,36,21,1923,1245,3168,49,FALSE
babel-loader,5.2.2,5.3.0,12,4,19,7,26,8,FALSE
babel-loader,5.2.0,5.2.1,10,9,12,12,24,11,FALSE
babel-loader,5.2.1,5.2.2,11,4,3,8,11,4,FALSE
babel-loader,5.3.3,5.4.0,16,38,636,250,886,81,FALSE
babel-loader,5.3.2,5.3.3,15,9,15,12,27,9,FALSE
babel-loader,5.3.1,5.3.2,14,3,7,2,9,3,FALSE
babel-loader,5.3.0,5.3.1,13,4,18,6,24,9,FALSE
babel-loader,5.1.4,5.2.0,9,11,343,44,387,33,FALSE
babel-loader,5.1.0,5.1.2,6,9,182,11,193,11,FALSE
babel-loader,5.1.3,5.1.4,8,8,159,54,213,38,TRUE
babel-loader,5.1.2,5.1.3,7,11,454,80,534,25,FALSE
babel-loader,6.2.1,6.2.2,24,12,32,18,50,20,FALSE
babel-loader,6.2.0,6.2.1,23,8,104,86,190,19,FALSE
babel-loader,6.2.3,6.2.4,26,5,5,5,10,5,FALSE
babel-loader,6.2.2,6.2.3,25,6,5,5,10,5,FALSE
babel-loader,6.3.0,6.3.1,34,5,587,525,1112,6,FALSE
babel-loader,6.3.1,6.3.2,35,2,16,11,27,2,FALSE
babel-loader,6.2.7,6.2.8,30,16,803,850,1653,53,FALSE
babel-loader,6.2.6,6.2.7,29,3,23,4,27,3,FALSE
babel-loader,6.2.9,6.2.10,32,5,191,137,328,9,FALSE
babel-loader,6.2.8,6.2.9,31,12,4417,99,4516,21,FALSE
babel-loader,5.1.3,5.1.4,8,8,159,54,213,38,FALSE
babel-loader,7.0.0-alpha.3,7.0.0-beta.1,41,7,274,10,284,11,FALSE
babel-loader,7.0.0-alpha.2,7.0.0-alpha.3,40,3,55,3,58,5,TRUE
babel-loader,7.0.0-alpha.1,7.0.0-alpha.2,39,22,2055,1268,3323,52,FALSE
babel-loader,4.3.0,5.0.0,4,3,7,5,12,4,FALSE
babel-loader,4.0.0,4.1.0,1,7,17,13,30,8,FALSE
babel-loader,4.2.0,4.3.0,3,17,1597,425,2022,57,FALSE
babel-loader,4.1.0,4.2.0,2,3,201,13,214,5,FALSE
babel-loader,5.0.0,5.1.0,5,20,1875,884,2759,62,FALSE
babel-loader,7.0.0-beta.1,7.0.0,42,11,3193,2428,5621,51,FALSE
babel-loader,5.0.0,5.1.0,5,20,1875,884,2759,62,TRUE
babel-loader,5.1.4,5.2.0,9,11,343,44,387,33,TRUE
babel-loader,5.1.0,5.1.2,6,9,182,11,193,11,TRUE
babel-loader,5.1.2,5.1.3,7,11,454,80,534,25,TRUE
babel-loader,4.3.0,5.0.0,4,3,7,5,12,4,TRUE
babel-loader,5.3.2,5.3.3,15,9,15,12,27,9,TRUE
babel-loader,7.0.0-alpha.2,7.0.0-alpha.3,40,3,55,3,58,5,FALSE
babel-loader,6.2.10,6.3.0,33,16,215,222,437,22,TRUE
babel-loader,7.0.0-alpha.3,7.0.0-beta.1,41,7,274,10,284,11,TRUE
babel-loader,5.2.2,5.3.0,12,4,19,7,26,8,TRUE
babel-loader,6.2.9,6.2.10,32,5,191,137,328,9,TRUE
babel-loader,6.0.0,6.0.1,20,9,38,27,65,11,TRUE
babel-loader,6.2.0,6.2.1,23,8,104,86,190,19,TRUE
cmd-spawn,1.1.0,1.2.0,2,1,2,2,4,1,FALSE
cmd-spawn,1.3.0,1.4.0,4,1,11,8,19,2,FALSE
cmd-spawn,1.0.0,1.1.0,1,1,2,2,4,1,FALSE
cmd-spawn,1.2.0,1.3.0,3,8,547,41,588,73,FALSE
cmd-spawn,1.3.0,1.4.0,4,1,11,8,19,2,TRUE
cmd-spawn,1.2.0,1.3.0,3,8,547,41,588,73,TRUE
nodejs.fm,1.0.4,1.0.5,5,1,15,1,16,2,FALSE
nodejs.fm,1.0.5,1.0.7,6,1,2,2,4,2,FALSE
nodejs.fm,1.0.7,1.0.8,7,2,76,41,117,5,FALSE
nodejs.fm,1.0.0,1.0.1,1,5,1487,1439,2926,40,FALSE
nodejs.fm,1.0.1,1.0.2,2,1,2018,41,2059,41,FALSE
nodejs.fm,1.0.2,1.0.3,3,2,5,1958,1963,19,FALSE
nodejs.fm,1.0.3,1.0.4,4,1,14,10,24,2,FALSE
nodejs.fm,1.0.8,1.0.9,8,2,64,8,72,3,FALSE
nodejs.fm,1.0.9,1.0.10,9,1,2,4,6,1,FALSE
nodejs.fm,1.0.16,1.0.17,16,1,9,5,14,2,FALSE
nodejs.fm,1.0.17,1.0.18,17,1,10,7,17,2,FALSE
nodejs.fm,1.0.14,1.0.15,14,1,6,6,12,2,FALSE
nodejs.fm,1.0.15,1.0.16,15,1,4,3,7,2,FALSE
nodejs.fm,1.0.12,1.0.13,12,3,80,52,132,7,FALSE
nodejs.fm,1.0.13,1.0.14,13,1,2,2,4,2,FALSE
nodejs.fm,1.0.10,1.0.11,10,1,11,3,14,2,FALSE
nodejs.fm,1.0.11,1.0.12,11,1,250,129,379,29,FALSE
nodejs.fm,1.0.18,1.0.19,18,1,250,129,379,29,FALSE
nodejs.fm,1.0.11,1.0.12,11,1,250,129,379,29,TRUE
gollum-nocinema,0.1.9,0.2.0,1,5,52,16,68,9,TRUE
gollum-nocinema,0.2.7,0.2.8,8,3,5,11,16,4,FALSE
gollum-nocinema,0.2.6,0.2.7,7,2,21,17,38,3,FALSE
gollum-nocinema,0.2.5,0.2.6,6,2,32,7,39,4,FALSE
gollum-nocinema,0.2.4,0.2.5,5,4,4,64,68,8,FALSE
gollum-nocinema,0.2.3,0.2.4,4,1,1,1,2,1,FALSE
gollum-nocinema,0.2.1,0.2.3,3,6,180,55,235,20,TRUE
gollum-nocinema,0.2.0,0.2.1,2,3,14,4,18,3,FALSE
gollum-nocinema,0.2.8,0.3.0,9,2,2,2,4,2,FALSE
gollum-nocinema,1.1.1,1.3.0,13,10,180,94,274,13,FALSE
gollum-nocinema,1.0.0,1.0.1,11,7,59,3,62,7,FALSE
gollum-nocinema,1.0.1,1.1.1,12,17,462,108,570,23,FALSE
gollum-nocinema,0.1.9,0.2.0,1,5,52,16,68,9,FALSE
gollum-nocinema,0.2.1,0.2.3,3,6,180,55,235,20,FALSE
gollum-nocinema,1.0.1,1.1.1,12,17,462,108,570,23,TRUE
gollum-nocinema,0.2.5,0.2.6,6,2,32,7,39,4,TRUE
gollum-nocinema,0.2.0,0.2.1,2,3,14,4,18,3,TRUE
gollum-nocinema,1.0.0,1.0.1,11,7,59,3,62,7,TRUE
gollum-nocinema,0.2.6,0.2.7,7,2,21,17,38,3,TRUE
asset_hash,0.2.4,0.2.5,9,1,4,4,8,1,FALSE
asset_hash,0.2.3,0.2.4,8,1,4,4,8,1,FALSE
asset_hash,0.2.2,0.2.3,7,1,4,4,8,1,FALSE
asset_hash,0.2.1,0.2.2,6,1,4,4,8,1,FALSE
asset_hash,0.2.0,0.2.1,5,11,323,145,468,15,FALSE
asset_hash,0.1.54,0.2.0,4,7,108,72,180,7,FALSE
asset_hash,0.1.52,0.1.53,2,2,3,3,6,2,FALSE
asset_hash,0.1.53,0.1.54,3,2,4,4,8,2,FALSE
asset_hash,0.2.3,0.2.4,8,1,4,4,8,1,TRUE
asset_hash,0.1.51,0.1.52,1,3,20,17,37,7,FALSE
asset_hash,0.2.2,0.2.3,7,1,4,4,8,1,TRUE
connect,2.9.2,2.10.0,132,20,561,117,678,38,FALSE
connect,2.9.0,2.9.1,130,38,478,240,718,62,FALSE
connect,2.10.0,2.10.1,133,3,27,5,32,6,FALSE
connect,2.13.0,2.13.1,139,33,97,5302,5399,100,FALSE
connect,2.8.8,2.9.0,129,8,124,68,192,18,FALSE
connect,2.8.7,2.8.8,128,4,75,88,163,5,FALSE
connect,2.8.6,2.8.7,127,7,58,24,82,8,FALSE
connect,2.8.5,2.8.6,126,12,153,68,221,17,FALSE
connect,2.8.4,2.8.5,125,4,13,7,20,5,FALSE
connect,2.8.3,2.8.4,124,5,13,7,20,6,FALSE
connect,2.8.2,2.8.3,123,7,26,21,47,12,FALSE
connect,2.9.1,2.9.2,131,16,397,245,642,37,FALSE
connect,2.11.2,2.12.0,137,14,499,159,658,35,FALSE
connect,2.11.0,2.11.1,135,8,202,31,233,11,FALSE
connect,2.11.1,2.11.2,136,2,8,3,11,3,FALSE
connect,2.12.0,2.13.0,138,44,461,4218,4679,138,FALSE
connect,2.10.1,2.11.0,134,14,520,42,562,26,FALSE
connect,2.27.4,2.27.5,196,9,29,14,43,16,TRUE
connect,2.18.0,2.19.0,155,17,300,115,415,40,FALSE
connect,2.19.6,2.20.0,162,19,184,181,365,55,TRUE
connect,2.19.4,2.19.5,160,6,42,43,85,13,FALSE
connect,2.19.5,2.19.6,161,7,39,11,50,14,FALSE
connect,2.19.2,2.19.3,158,2,12,4,16,4,FALSE
connect,2.19.3,2.19.4,159,10,83,63,146,16,FALSE
connect,2.19.0,2.19.1,156,4,48,13,61,10,FALSE
connect,2.19.1,2.19.2,157,2,12,4,16,4,FALSE
connect,2.25.9,2.25.10,183,4,14,8,22,7,FALSE
connect,2.25.8,2.25.9,182,4,63,8,71,7,FALSE
connect,2.27.6,2.28.0,198,18,103,46,149,34,FALSE
connect,2.25.3,2.25.4,177,12,44,16,60,25,FALSE
connect,2.25.2,2.25.3,176,2,10,4,14,4,FALSE
connect,2.25.1,2.25.2,175,3,13,5,18,6,FALSE
connect,2.25.0,2.25.1,174,5,73,10,83,9,FALSE
connect,2.25.7,2.25.8,181,9,36,17,53,13,FALSE
connect,2.25.6,2.25.7,180,5,19,7,26,10,FALSE
connect,2.25.5,2.25.6,179,4,15,6,21,8,FALSE
connect,2.25.4,2.25.5,178,5,91,11,102,11,FALSE
connect,2.25.10,2.26.0,184,31,130,57,187,60,TRUE
connect,2.22.0,2.23.0,168,9,46,13,59,16,FALSE
connect,2.23.0,2.24.0,169,20,128,30,158,41,FALSE
connect,2.26.5,2.26.6,190,5,20,8,28,9,FALSE
connect,2.20.2,2.21.0,165,12,174,19,193,25,FALSE
connect,2.20.0,2.20.1,163,3,13,7,20,5,TRUE
connect,2.20.1,2.20.2,164,2,10,4,14,4,FALSE
connect,2.21.1,2.22.0,167,9,101,27,128,16,FALSE
connect,2.21.0,2.21.1,166,6,20,8,28,11,FALSE
connect,2.30.1,2.30.2,207,13,39,17,56,22,TRUE
connect,2.28.3,2.29.0,202,21,89,43,132,39,FALSE
connect,2.28.0,2.28.1,199,7,136,16,152,12,FALSE
connect,2.29.2,2.30.0,205,31,650,337,987,60,FALSE
connect,2.29.1,2.29.2,204,26,135,35,170,46,FALSE
connect,2.29.0,2.29.1,203,21,168,41,209,40,FALSE
connect,2.17.2,2.17.3,153,3,20,4,24,5,FALSE
connect,2.26.4,2.26.5,189,3,21,8,29,6,FALSE
connect,2.28.2,2.28.3,201,8,28,10,38,15,FALSE
connect,2.26.6,2.27.0,191,20,102,48,150,50,FALSE
connect,2.17.3,2.18.0,154,4,23,6,29,8,FALSE
connect,2.26.0,2.26.1,185,9,118,16,134,19,FALSE
connect,2.26.1,2.26.2,186,3,13,5,18,6,FALSE
connect,2.26.2,2.26.3,187,4,17,7,24,8,FALSE
connect,2.30.0,2.30.1,206,14,53,24,77,26,FALSE
connect,2.27.5,2.27.6,197,2,12,4,16,4,FALSE
connect,2.26.3,2.26.4,188,3,13,5,18,6,FALSE
connect,2.17.1,2.17.2,152,7,79,47,126,14,FALSE
connect,2.17.0,2.17.1,151,4,116,18,134,15,FALSE
connect,2.28.1,2.28.2,200,4,17,6,23,7,FALSE
connect,2.24.2,2.24.3,172,3,15,5,20,6,FALSE
connect,2.24.3,2.25.0,173,7,32,9,41,14,FALSE
connect,2.24.0,2.24.1,170,16,286,137,423,32,FALSE
connect,2.24.1,2.24.2,171,6,18,8,26,12,FALSE
connect,2.27.1,2.27.2,193,8,137,23,160,15,FALSE
connect,2.27.0,2.27.1,192,13,282,61,343,24,FALSE
connect,2.27.3,2.27.4,195,14,142,36,178,28,FALSE
connect,2.27.2,2.27.3,194,9,168,18,186,16,TRUE
connect,2.16.1,2.16.2,149,7,133,10,143,15,FALSE
connect,2.16.0,2.16.1,148,3,51,13,64,6,FALSE
connect,2.16.2,2.17.0,150,11,249,31,280,32,FALSE
connect,2.14.5,2.15.0,146,28,648,462,1110,78,FALSE
connect,2.14.4,2.14.5,145,10,39,113,152,23,FALSE
connect,2.14.3,2.14.4,144,13,50,33,83,19,FALSE
connect,2.14.2,2.14.3,143,4,35,5,40,8,FALSE
connect,2.14.1,2.14.2,142,15,51,110,161,25,FALSE
connect,2.14.0,2.14.1,141,7,38,34,72,14,TRUE
connect,2.27.4,2.27.5,196,9,29,14,43,16,FALSE
connect,2.19.5,2.19.6,161,7,39,11,50,14,TRUE
connect,2.25.3,2.25.4,177,12,44,16,60,25,TRUE
connect,2.25.10,2.26.0,184,31,130,57,187,60,FALSE
connect,2.15.0,2.16.0,147,26,422,275,697,60,FALSE
connect,2.20.2,2.21.0,165,12,174,19,193,25,TRUE
connect,2.20.0,2.20.1,163,3,13,7,20,5,FALSE
connect,2.28.3,2.29.0,202,21,89,43,132,39,TRUE
connect,2.28.2,2.28.3,201,8,28,10,38,15,TRUE
connect,2.26.6,2.27.0,191,20,102,48,150,50,TRUE
connect,2.17.3,2.18.0,154,4,23,6,29,8,TRUE
connect,2.30.0,2.30.1,206,14,53,24,77,26,TRUE
connect,2.27.5,2.27.6,197,2,12,4,16,4,TRUE
connect,2.27.3,2.27.4,195,14,142,36,178,28,TRUE
connect,2.27.2,2.27.3,194,9,168,18,186,16,FALSE
connect,2.16.2,2.17.0,150,11,249,31,280,32,TRUE
connect,2.6.1,2.6.2,107,8,163,99,262,39,FALSE
connect,2.6.2,2.7.0,108,19,131,91,222,51,FALSE
connect,2.0.3,2.1.0,80,17,271,82,353,28,FALSE
connect,2.0.0,2.0.1,77,19,189,112,301,28,FALSE
connect,2.8.0,2.8.1,121,2,10,5,15,3,FALSE
connect,2.7.10,2.7.11,119,4,11,7,18,6,FALSE
connect,2.7.11,2.8.0,120,21,343,74,417,32,FALSE
connect,2.2.1,2.2.2,86,19,238,167,405,26,FALSE
connect,2.2.0,2.2.1,85,2,24,2,26,5,FALSE
connect,2.2.2,2.3.0,87,12,230,119,349,29,FALSE
connect,2.1.2,2.1.3,83,5,20,8,28,7,FALSE
connect,2.1.3,2.2.0,84,10,133,15,148,18,FALSE
connect,2.1.0,2.1.1,81,4,39,51,90,7,FALSE
connect,2.1.1,2.1.2,82,5,85,6,91,7,FALSE
connect,2.6.0,2.6.1,106,11,140,93,233,20,FALSE
connect,2.8.1,2.8.2,122,9,95,15,110,12,FALSE
connect,2.4.5,2.4.6,103,4,10,5,15,6,FALSE
connect,1.9.1,1.9.2,75,21,230,397,627,39,FALSE
connect,1.9.0,1.9.1,74,4,18,4,22,6,FALSE
connect,1.8.6,1.8.7,72,20,304,75,379,29,FALSE
connect,1.8.0,1.8.1,66,6,944,2573,3517,59,FALSE
connect,1.8.1,1.8.2,67,29,791,293,1084,44,FALSE
connect,1.8.2,1.8.3,68,31,548,244,792,46,FALSE
connect,1.8.3,1.8.4,69,42,961,294,1255,69,FALSE
connect,2.3.8,2.3.9,96,4,38,7,45,9,FALSE
connect,2.3.9,2.4.0,97,4,133,31,164,10,FALSE
connect,2.3.0,2.3.1,88,24,777,613,1390,66,FALSE
connect,2.3.1,2.3.2,89,3,38,25,63,9,FALSE
connect,2.3.2,2.3.3,90,17,155,182,337,35,FALSE
connect,2.3.3,2.3.4,91,9,72,23,95,15,FALSE
connect,2.3.4,2.3.5,92,3,11,10,21,5,FALSE
connect,2.3.5,2.3.6,93,3,119,23,142,11,FALSE
connect,2.3.6,2.3.7,94,15,100,364,464,23,FALSE
connect,2.3.7,2.3.8,95,2,23,4,27,5,FALSE
connect,1.8.4,1.8.5,70,1,96,104,200,3,FALSE
connect,1.8.5,1.8.6,71,148,2113,1431,3544,268,FALSE
connect,2.4.3,2.4.4,101,9,84,21,105,12,FALSE
connect,2.4.2,2.4.3,100,3,9,6,15,5,FALSE
connect,2.4.1,2.4.2,99,7,59,19,78,14,FALSE
connect,2.4.0,2.4.1,98,2,8,4,12,4,FALSE
connect,2.4.6,2.5.0,104,8,31,11,42,11,FALSE
connect,2.5.0,2.6.0,105,10,129,30,159,15,FALSE
connect,2.4.4,2.4.5,102,13,58,19,77,19,FALSE
connect,1.8.7,1.9.0,73,93,1657,1144,2801,200,FALSE
connect,2.7.8,2.7.9,117,3,10,5,15,6,FALSE
connect,2.7.9,2.7.10,118,6,26,14,40,8,FALSE
connect,2.7.4,2.7.5,113,8,223,61,284,15,FALSE
connect,2.7.5,2.7.6,114,2,10,5,15,4,FALSE
connect,2.7.0,2.7.1,109,7,116,13,129,15,FALSE
connect,2.7.1,2.7.2,110,17,172,88,260,39,FALSE
connect,2.7.2,2.7.3,111,29,506,175,681,44,FALSE
connect,2.7.3,2.7.4,112,10,146,62,208,17,FALSE
connect,2.7.6,2.7.7,115,10,48,41,89,15,FALSE
connect,2.7.7,2.7.8,116,2,8,3,11,4,FALSE
connect,2.19.6,2.20.0,162,19,184,181,365,55,FALSE
connect,2.19.3,2.19.4,159,10,83,63,146,16,TRUE
connect,2.30.1,2.30.2,207,13,39,17,56,22,FALSE
connect,2.29.1,2.29.2,204,26,135,35,170,46,TRUE
connect,2.26.0,2.26.1,185,9,118,16,134,19,TRUE
connect,2.26.2,2.26.3,187,4,17,7,24,8,TRUE
connect,2.14.4,2.14.5,145,10,39,113,152,23,TRUE
connect,2.14.3,2.14.4,144,13,50,33,83,19,TRUE
connect,2.18.0,2.19.0,155,17,300,115,415,40,TRUE
connect,2.19.4,2.19.5,160,6,42,43,85,13,TRUE
connect,2.25.9,2.25.10,183,4,14,8,22,7,TRUE
connect,2.27.6,2.28.0,198,18,103,46,149,34,TRUE
connect,2.25.5,2.25.6,179,4,15,6,21,8,TRUE
connect,2.29.2,2.30.0,205,31,650,337,987,60,TRUE
connect,2.26.4,2.26.5,189,3,21,8,29,6,TRUE
connect,2.23.0,2.24.0,169,20,128,30,158,41,TRUE
connect,2.28.1,2.28.2,200,4,17,6,23,7,TRUE
connect,2.24.2,2.24.3,172,3,15,5,20,6,TRUE
connect,2.24.3,2.25.0,173,7,32,9,41,14,TRUE
connect,2.24.0,2.24.1,170,16,286,137,423,32,TRUE
connect,2.24.1,2.24.2,171,6,18,8,26,12,TRUE
connect,2.27.0,2.27.1,192,13,282,61,343,24,TRUE
connect,3.1.1,3.2.0,215,60,391,110,501,113,FALSE
connect,3.1.0,3.1.1,214,51,314,96,410,103,TRUE
connect,3.0.2,3.1.0,213,21,341,130,471,44,FALSE
connect,3.0.0,3.0.1,211,74,801,453,1254,169,FALSE
connect,3.0.1,3.0.2,212,37,283,64,347,69,FALSE
connect,3.0.0-rc.2,3.0.0,210,64,975,380,1355,150,FALSE
connect,3.6.0,3.6.1,227,6,17,8,25,9,FALSE
connect,3.6.1,3.6.2,228,5,15,7,22,8,FALSE
connect,3.2.0,3.3.0,216,50,467,141,608,109,FALSE
connect,3.3.5,3.4.0,222,57,730,368,1098,104,FALSE
connect,3.3.4,3.3.5,221,60,375,115,490,113,FALSE
connect,3.4.0,3.4.1,223,42,191,85,276,69,FALSE
connect,3.4.1,3.5.0,224,12,57,12,69,14,FALSE
connect,3.5.1,3.6.0,226,13,131,14,145,19,FALSE
connect,3.5.0,3.5.1,225,10,22,12,34,12,FALSE
connect,3.3.1,3.3.2,218,6,55,10,65,14,FALSE
connect,3.3.0,3.3.1,217,13,141,30,171,22,FALSE
connect,3.3.3,3.3.4,220,42,301,85,386,78,FALSE
connect,3.3.2,3.3.3,219,11,246,38,284,20,FALSE
connect,2.14.0,2.14.1,141,7,38,34,72,14,FALSE
connect,2.19.2,2.19.3,158,2,12,4,16,4,TRUE
connect,2.19.1,2.19.2,157,2,12,4,16,4,TRUE
connect,2.26.5,2.26.6,190,5,20,8,28,9,TRUE
connect,2.13.1,2.14.0,140,14,57,2600,2657,234,FALSE
connect,2.25.2,2.25.3,176,2,10,4,14,4,TRUE
connect,2.9.0,2.9.1,130,38,478,240,718,62,TRUE
connect,2.21.1,2.22.0,167,9,101,27,128,16,TRUE
connect,2.28.0,2.28.1,199,7,136,16,152,12,TRUE
connect,2.8.4,2.8.5,125,4,13,7,20,5,TRUE
connect,2.8.3,2.8.4,124,5,13,7,20,6,TRUE
connect,2.7.10,2.7.11,119,4,11,7,18,6,TRUE
connect,2.8.1,2.8.2,122,9,95,15,110,12,TRUE
connect,2.3.8,2.3.9,96,4,38,7,45,9,TRUE
connect,2.25.6,2.25.7,180,5,19,7,26,10,TRUE
connect,2.21.0,2.21.1,166,6,20,8,28,11,TRUE
connect,2.29.0,2.29.1,203,21,168,41,209,40,TRUE
connect,2.17.2,2.17.3,153,3,20,4,24,5,TRUE
connect,2.16.1,2.16.2,149,7,133,10,143,15,TRUE
connect,3.1.0,3.1.1,214,51,314,96,410,103,FALSE
connect,1.0.4,1.0.5,33,3,20,5,25,6,FALSE
connect,1.0.5,1.0.6,34,2,16,9,25,5,FALSE
connect,1.0.6,1.1.0,35,4,158,7,165,8,FALSE
connect,1.1.2,1.1.3,38,2,9,151,160,5,FALSE
connect,1.0.0,1.0.1,29,7,59,20,79,12,FALSE
connect,1.0.1,1.0.2,30,5,17,11,28,7,FALSE
connect,1.0.2,1.0.3,31,4,19,4,23,6,FALSE
connect,1.0.3,1.0.4,32,11,82,15,97,18,FALSE
connect,1.1.3,1.1.4,39,3,66,22,88,9,FALSE
connect,2.0.2,2.0.3,79,6,128,12,140,12,FALSE
connect,2.0.1,2.0.2,78,10,222,59,281,20,FALSE
connect,1.6.2,1.6.3,59,11,174,879,1053,23,FALSE
connect,1.6.3,1.6.4,60,1,96,104,200,3,FALSE
connect,1.6.0,1.6.1,57,51,1024,1244,2268,81,FALSE
connect,1.6.1,1.6.2,58,19,92,57,149,24,FALSE
connect,1.1.1,1.1.2,37,4,88,29,117,8,FALSE
connect,1.6.4,1.7.0,61,5,269,36,305,11,FALSE
connect,1.1.5,1.2.0,41,14,383,42,425,24,FALSE
connect,1.7.3,1.8.0,65,52,1059,2781,3840,108,FALSE
connect,1.7.2,1.7.3,64,9,35,23,58,10,FALSE
connect,1.7.1,1.7.2,63,83,2786,1876,4662,477,FALSE
connect,1.4.0,1.4.1,47,9,87,10,97,14,FALSE
connect,1.4.1,1.4.2,48,13,86,158,244,33,FALSE
connect,1.4.2,1.4.3,49,3,19,6,25,6,FALSE
connect,1.4.3,1.4.4,50,7,51,30,81,11,FALSE
connect,1.4.4,1.4.5,51,2,11,3,14,4,FALSE
connect,1.4.5,1.4.6,52,4,22,9,31,7,FALSE
connect,1.4.6,1.5.0,53,10,368,8,376,90,FALSE
connect,1.5.1,1.5.2,55,27,423,225,648,34,FALSE
connect,1.5.0,1.5.1,54,9,204,25,229,21,FALSE
connect,1.5.2,1.6.0,56,7,192,48,240,12,FALSE
connect,1.3.0,1.4.0,46,15,249,106,355,24,FALSE
connect,1.2.2,1.2.3,44,3,8,11,19,5,FALSE
connect,1.2.3,1.3.0,45,2,34,3,37,5,FALSE
connect,1.2.0,1.2.1,42,4,204,6,210,12,FALSE
connect,1.2.1,1.2.2,43,11,512,207,719,15,FALSE
connect,1.1.4,1.1.5,40,3,13,7,20,6,FALSE
connect,1.1.0,1.1.1,36,2,8,3,11,4,FALSE
connect,1.7.0,1.7.1,62,6,120,79,199,7,FALSE
connect,3.6.1,3.6.2,228,5,15,7,22,8,TRUE
connect,3.2.0,3.3.0,216,50,467,141,608,109,TRUE
connect,3.3.0,3.3.1,217,13,141,30,171,22,TRUE
connect,2.25.8,2.25.9,182,4,63,8,71,7,TRUE
connect,2.25.1,2.25.2,175,3,13,5,18,6,TRUE
connect,2.25.0,2.25.1,174,5,73,10,83,9,TRUE
connect,2.25.7,2.25.8,181,9,36,17,53,13,TRUE
connect,0.5.10,1.0.0,28,234,6208,6485,12693,404,FALSE
connect,2.4.5,2.4.6,103,4,10,5,15,6,TRUE
connect,1.8.0,1.8.1,66,6,944,2573,3517,59,TRUE
connect,0.5.8,0.5.9,26,5,11,6,17,7,TRUE
connect,0.5.9,0.5.10,27,39,424,2084,2508,91,TRUE
connect,2.11.0,2.11.1,135,8,202,31,233,11,TRUE
connect,2.11.1,2.11.2,136,2,8,3,11,3,TRUE
connect,2.20.1,2.20.2,164,2,10,4,14,4,TRUE
connect,2.26.1,2.26.2,186,3,13,5,18,6,TRUE
connect,2.17.1,2.17.2,152,7,79,47,126,14,TRUE
connect,2.14.5,2.15.0,146,28,648,462,1110,78,TRUE
connect,3.0.0-rc.1,3.0.0-rc.2,209,71,957,744,1701,157,FALSE
connect,2.4.2,2.4.3,100,3,9,6,15,5,TRUE
connect,2.1.1,2.1.2,82,5,85,6,91,7,TRUE
connect,2.3.3,2.3.4,91,9,72,23,95,15,TRUE
connect,2.0.3,2.1.0,80,17,271,82,353,28,TRUE
connect,2.14.2,2.14.3,143,4,35,5,40,8,TRUE
connect,2.1.3,2.2.0,84,10,133,15,148,18,TRUE
connect,2.3.4,2.3.5,92,3,11,10,21,5,TRUE
connect,1.7.1,1.7.2,63,83,2786,1876,4662,477,TRUE
connect,2.1.0,2.1.1,81,4,39,51,90,7,TRUE
connect,2.7.2,2.7.3,111,29,506,175,681,44,TRUE
iwwa-formula-resolver,1.3.1,2.0.0,8,3,25,25,50,5,FALSE
iwwa-formula-resolver,1.3.0,1.3.1,7,3,4,8,12,3,FALSE
iwwa-formula-resolver,1.2.0,1.2.1,5,2,2,2,4,2,FALSE
iwwa-formula-resolver,1.2.1,1.3.0,6,3,115,25,140,5,FALSE
iwwa-formula-resolver,1.1.1,1.1.2,3,2,7,1,8,2,FALSE
iwwa-formula-resolver,1.1.0,1.1.1,2,1,1,1,2,1,FALSE
iwwa-formula-resolver,1.1.2,1.2.0,4,10,254,39,293,21,FALSE
iwwa-formula-resolver,1.0.0,1.1.0,1,4,47,19,66,6,FALSE
iwwa-formula-resolver,1.0.0,1.1.0,1,4,47,19,66,6,TRUE
dragon.js,0.2.2-alpha-1,0.2.2-alpha-10,13,3,214,32,246,15,FALSE
dragon.js,0.0.5,0.2.0,6,40,28312,42572,70884,223,FALSE
dragon.js,0.2.2-alpha-3,0.2.2-alpha-4,20,1,8,8,16,4,FALSE
dragon.js,0.2.2-alpha-2,0.2.2-alpha-3,19,1,8,8,16,4,FALSE
dragon.js,0.2.2-alpha-5,0.2.2-alpha-6,22,1,21,14,35,7,FALSE
dragon.js,0.2.2-alpha-4,0.2.2-alpha-5,21,1,21,14,35,7,FALSE
dragon.js,0.2.2-alpha-7,0.2.2-alpha-8,24,1,21,14,35,7,FALSE
dragon.js,0.2.2-alpha-6,0.2.2-alpha-7,23,1,21,14,35,7,FALSE
dragon.js,0.2.2-alpha-8,0.2.2-alpha-9,25,1,21,14,35,7,FALSE
dragon.js,0.2.1-a,0.2.1-b,8,1,14,13,27,7,FALSE
dragon.js,0.2.2-alpha-13,0.2.2-alpha-14,17,5,69,71,140,43,FALSE
dragon.js,0.2.1-c,0.2.1-d,10,1,21,14,35,7,FALSE
dragon.js,0.2.0,0.2.1-a,7,6,436467,383,436850,155,FALSE
dragon.js,0.2.2-alpha-11,0.2.2-alpha-12,15,1,21,14,35,7,FALSE
dragon.js,0.2.2-alpha-10,0.2.2-alpha-11,14,1,21,14,35,7,FALSE
dragon.js,0.2.1-b,0.2.1-c,9,2,9,9,18,4,FALSE
dragon.js,0.2.2-alpha-12,0.2.2-alpha-13,16,4,12,8,20,5,FALSE
dragon.js,0.2.1-e,0.2.2-alpha-1,12,1,15,8,23,4,FALSE
dragon.js,0.2.1-d,0.2.1-e,11,1,4,2,6,4,FALSE
dragon.js,0.0.4,0.0.5,5,16,576,233,809,63,FALSE
dragon.js,0.0.3,0.0.4,4,14,26,23,49,14,FALSE
dragon.js,0.0.2,0.0.3,3,8,26539,80,26619,17,FALSE
dragon.js,0.2.2-alpha-3,0.2.2-alpha-4,20,1,8,8,16,4,TRUE
dragon.js,0.0.3,0.0.4,4,14,26,23,49,14,TRUE
dragon.js,0.2.2-alpha-1,0.2.2-alpha-10,13,3,214,32,246,15,TRUE
vue-spectre,0.1.0,0.1.1,1,5,197,19,216,18,TRUE
vue-spectre,0.1.0,0.1.1,1,5,197,19,216,18,FALSE
kuss,0.2.1,0.3.0,9,6,598,470,1068,16,FALSE
kuss,0.2.0,0.2.1,8,5,62,53,115,7,FALSE
kuss,0.1.0,0.1.1,1,9,400,3,403,11,FALSE
kuss,0.1.1,0.1.2,2,5,252,3,255,8,FALSE
kuss,0.1.2,0.1.3,3,15,712,21,733,27,FALSE
kuss,0.1.3,0.1.4,4,3,4,4,8,4,TRUE
kuss,0.1.4,0.1.5,5,11,125,117,242,16,FALSE
kuss,0.1.5,0.1.6,6,2,8,8,16,4,FALSE
kuss,0.1.6,0.2.0,7,11,1369,726,2095,32,FALSE
kuss,0.3.0,0.4.0,10,3,56,0,56,6,FALSE
kuss,0.6.0,0.6.1,16,5,36,24,60,5,FALSE
kuss,0.7.2,0.7.3,20,7,262,450,712,21,FALSE
kuss,0.7.3,0.7.4,21,29,1525,175,1700,77,FALSE
kuss,0.7.0,0.7.1,18,3,5,5,10,3,FALSE
kuss,0.7.1,0.7.2,19,12,492,436,928,40,FALSE
kuss,0.4.1,0.4.2,12,7,359,67,426,14,FALSE
kuss,0.4.0,0.4.1,11,15,639,96,735,27,FALSE
kuss,0.4.2,0.5.0,13,17,1786,272,2058,44,FALSE
kuss,0.5.0,0.5.1,14,15,904,203,1107,33,FALSE
kuss,0.5.1,0.6.0,15,6,2396,343,2739,30,FALSE
kuss,0.9.0,0.9.1,23,5,80,66,146,8,FALSE
kuss,0.9.1,0.9.2,24,7,180,52,232,11,FALSE
kuss,0.9.2,0.9.3,25,3,3,3,6,3,FALSE
kuss,0.9.3,0.9.4,26,5,84,22,106,9,FALSE
kuss,0.9.4,0.9.5,27,2,8,7,15,2,FALSE
kuss,0.9.5,0.9.6,28,2,8,7,15,2,FALSE
kuss,0.9.6,0.9.8,29,4,7,7,14,4,FALSE
kuss,0.6.1,0.7.0,17,3,27,19,46,9,FALSE
kuss,0.7.4,0.9.0,22,7,128,15,143,12,FALSE
kuss,0.1.3,0.1.4,4,3,4,4,8,4,FALSE
kuss,0.7.0,0.7.1,18,3,5,5,10,3,TRUE
kuss,0.2.1,0.3.0,9,6,598,470,1068,16,TRUE
kuss,0.2.0,0.2.1,8,5,62,53,115,7,TRUE
kuss,0.4.2,0.5.0,13,17,1786,272,2058,44,TRUE
kuss,0.4.0,0.4.1,11,15,639,96,735,27,TRUE
kuss,0.5.1,0.6.0,15,6,2396,343,2739,30,TRUE
kuss,0.1.4,0.1.5,5,11,125,117,242,16,TRUE
kuss,0.1.5,0.1.6,6,2,8,8,16,4,TRUE
kuss,0.9.1,0.9.2,24,7,180,52,232,11,TRUE
kuss,0.9.2,0.9.3,25,3,3,3,6,3,TRUE
kuss,0.9.4,0.9.5,27,2,8,7,15,2,TRUE
starhs-api-proxy-aws-lambda-client,1.1.1,1.1.2,7,1,8,8,16,3,FALSE
starhs-api-proxy-aws-lambda-client,1.1.0,1.1.1,6,2,2,1,3,2,FALSE
starhs-api-proxy-aws-lambda-client,1.1.3,1.1.4,9,1,87,2,89,4,FALSE
starhs-api-proxy-aws-lambda-client,1.1.2,1.1.3,8,1,21,11,32,2,FALSE
starhs-api-proxy-aws-lambda-client,1.1.4,1.1.5,10,2,1,2,3,2,FALSE
starhs-api-proxy-aws-lambda-client,1.0.4,1.1.0,5,1,153,6,159,7,FALSE
starhs-api-proxy-aws-lambda-client,1.0.0,1.0.1,1,2,4,3,7,2,FALSE
starhs-api-proxy-aws-lambda-client,1.0.1,1.0.2,2,1,3,3,6,2,FALSE
starhs-api-proxy-aws-lambda-client,1.0.2,1.0.3,3,1,2,2,4,2,FALSE
starhs-api-proxy-aws-lambda-client,1.0.3,1.0.4,4,2,11,13,24,3,FALSE
starhs-api-proxy-aws-lambda-client,2.3.0,2.3.1,16,1,25,1,26,2,FALSE
starhs-api-proxy-aws-lambda-client,2.3.1,2.3.2,17,3,20,18,38,4,FALSE
starhs-api-proxy-aws-lambda-client,2.3.2,2.4.0,18,1,124,2,126,3,FALSE
starhs-api-proxy-aws-lambda-client,2.0.0,2.1.0,12,1,86,3,89,7,FALSE
starhs-api-proxy-aws-lambda-client,2.2.1,2.3.0,15,2,117,4,121,5,FALSE
starhs-api-proxy-aws-lambda-client,2.2.0,2.2.1,14,1,36,0,36,2,TRUE
starhs-api-proxy-aws-lambda-client,1.1.5,2.0.0,11,3,63,11,74,5,FALSE
starhs-api-proxy-aws-lambda-client,2.1.0,2.2.0,13,2,61,1,62,4,FALSE
starhs-api-proxy-aws-lambda-client,2.3.1,2.3.2,17,3,20,18,38,4,TRUE
starhs-api-proxy-aws-lambda-client,2.2.0,2.2.1,14,1,36,0,36,2,FALSE
starhs-api-proxy-aws-lambda-client,1.1.0,1.1.1,6,2,2,1,3,2,TRUE
starhs-api-proxy-aws-lambda-client,1.1.5,2.0.0,11,3,63,11,74,5,TRUE
starhs-api-proxy-aws-lambda-client,1.1.1,1.1.2,7,1,8,8,16,3,TRUE
starhs-api-proxy-aws-lambda-client,2.3.2,2.4.0,18,1,124,2,126,3,TRUE
chare,0.0.5,2.0.2,5,13,339,54,393,28,FALSE
chare,0.0.4,0.0.5,4,8,65,19,84,13,FALSE
chare,2.0.5,2.1.5,9,24,401,175,576,41,FALSE
chare,2.0.4,2.0.5,8,3,6,14,20,7,FALSE
chare,0.0.1,0.0.2,1,1,3,3,6,1,FALSE
chare,2.0.2,2.0.3,6,1,3,5,8,2,FALSE
chare,0.0.3,0.0.4,3,13,381,83,464,28,FALSE
chare,0.0.2,0.0.3,2,2,30,3,33,6,FALSE
chare,2.2.11,2.2.12,17,4,121,12,133,8,FALSE
chare,2.2.9,2.2.10,15,2,4,2,6,3,FALSE
chare,2.2.12,2.2.13,18,4,14,4,18,4,FALSE
chare,2.2.10,2.2.11,16,2,3,2,5,2,FALSE
chare,2.2.8,2.2.9,14,2,3,3,6,2,FALSE
chare,2.2.7,2.2.8,13,9,97,29,126,16,FALSE
chare,2.0.3,2.0.4,7,1,17,28,45,3,FALSE
chare,2.1.6,2.1.7,11,5,26,15,41,9,FALSE
chare,2.1.7,2.2.7,12,10,265,124,389,23,FALSE
chare,2.1.5,2.1.6,10,1,3,3,6,2,FALSE
chare,0.0.3,0.0.4,3,13,381,83,464,28,TRUE
chare,2.2.12,2.2.13,18,4,14,4,18,4,TRUE
figlet-loader,2.0.0,3.0.0,4,27,83,79,162,29,FALSE
figlet-loader,1.1.1,2.0.0,3,2,212,200,412,11,FALSE
figlet-loader,1.1.0,1.1.1,2,22,584,478,1062,32,FALSE
figlet-loader,1.0.0,1.1.0,1,4,129,19,148,13,FALSE
figlet-loader,1.0.0,1.1.0,1,4,129,19,148,13,TRUE
figlet-loader,1.1.0,1.1.1,2,22,584,478,1062,32,TRUE
up-react-control,0.0.5,0.0.6,4,3,697,150,847,32,FALSE
up-react-control,0.0.4,0.0.5,3,1,110,3,113,8,FALSE
up-react-control,0.0.7,0.0.8,6,2,2,2,4,2,FALSE
up-react-control,0.0.6,0.0.7,5,4,255,76,331,24,FALSE
up-react-control,0.0.9,0.0.10,8,2,14,14,28,8,FALSE
up-react-control,0.0.8,0.0.9,7,2,10,11,21,9,FALSE
up-react-control,0.0.11,0.0.12,10,4,8,5,13,4,FALSE
up-react-control,0.0.10,0.0.11,9,3,29,205,234,25,FALSE
up-react-control,0.0.13,0.0.14,12,1,6,5,11,2,FALSE
up-react-control,0.0.12,0.0.13,11,2,4,1,5,2,FALSE
up-react-control,0.0.5,0.0.6,4,3,697,150,847,32,TRUE
up-react-control,0.0.1,0.0.3,1,4,110,3,113,5,FALSE
up-react-control,0.0.3,0.0.4,2,2,10,7,17,4,FALSE
react-super-select,0.1.12,0.1.13,13,1,2,11,13,2,FALSE
react-super-select,0.1.13,0.1.14,14,3,1009,1431,2440,57,FALSE
react-super-select,0.1.10,0.1.11,11,1,5,5,10,3,FALSE
react-super-select,0.1.11,0.1.12,12,1,6,7,13,3,FALSE
react-super-select,0.1.16,0.1.17,17,3,1150,984,2134,44,FALSE
react-super-select,0.1.17,0.1.18,18,4,291,110,401,11,FALSE
react-super-select,0.1.14,0.1.15,15,3,3115,9,3124,19,FALSE
react-super-select,0.1.15,0.1.16,16,3,297,48,345,11,FALSE
react-super-select,0.1.8,0.1.9,9,1,3,2,5,2,FALSE
react-super-select,0.1.9,0.1.10,10,2,5,6,11,5,FALSE
react-super-select,0.1.0,0.1.1,1,3,19,6,25,6,FALSE
react-super-select,0.1.1,0.1.2,2,3,17266,196,17462,346,FALSE
react-super-select,0.1.2,0.1.3,3,5,55,426,481,23,FALSE
react-super-select,0.1.3,0.1.4,4,1,13,4,17,4,FALSE
react-super-select,0.1.4,0.1.5,5,4,1777,676,2453,44,FALSE
react-super-select,0.1.5,0.1.6,6,2,5,6,11,4,FALSE
react-super-select,0.1.6,0.1.7,7,2,10,9,19,5,FALSE
react-super-select,0.1.7,0.1.8,8,1,5,4,9,4,FALSE
react-super-select,1.0.0,1.0.1,47,3,181,148,329,14,FALSE
react-super-select,0.5.14,0.5.15,44,3,389,261,650,17,FALSE
react-super-select,0.2.3,0.3.0,24,3,755,881,1636,15,FALSE
react-super-select,0.2.2,0.2.3,23,3,746,514,1260,17,FALSE
react-super-select,0.2.1,0.2.2,22,1,1467,50,1517,9,FALSE
react-super-select,0.2.0,0.2.1,21,2,42,48932,48974,14,FALSE
react-super-select,0.5.16,1.0.0,46,4,722,670,1392,149,FALSE
react-super-select,0.5.10,0.5.11,40,1,6,6,12,6,FALSE
react-super-select,0.5.11,0.5.12,41,4,315,40,355,23,FALSE
react-super-select,0.5.15,0.5.16,45,2,490,410,900,12,FALSE
react-super-select,0.5.12,0.5.13,42,3,339,211,550,19,FALSE
react-super-select,0.3.0,0.3.1,25,4,17,444,461,12,FALSE
react-super-select,0.3.1,0.4.0,26,3,699,603,1302,20,FALSE
react-super-select,0.5.13,0.5.14,43,1,13,18,31,6,FALSE
react-super-select,0.5.8,0.5.9,38,3,57,41,98,11,FALSE
react-super-select,0.1.6,0.1.7,7,2,10,9,19,5,TRUE
react-super-select,0.5.4,0.5.5,34,4,767,241,1008,45,FALSE
react-super-select,0.5.5,0.5.6,35,2,9,3,12,6,FALSE
react-super-select,0.5.6,0.5.7,36,3,493,205,698,25,FALSE
react-super-select,0.5.0,0.5.1,30,3,859,705,1564,29,FALSE
react-super-select,0.5.1,0.5.2,31,3,7049,5991,13040,17,FALSE
react-super-select,0.5.2,0.5.3,32,7,1968,816,2784,84,FALSE
react-super-select,0.5.3,0.5.4,33,3,491,445,936,13,FALSE
react-super-select,0.5.9,0.5.10,39,2,1116,1192,2308,6,FALSE
react-super-select,0.4.1,0.4.2,28,5,17,11,28,8,FALSE
react-super-select,0.4.0,0.4.1,27,2,168,68,236,34,FALSE
react-super-select,0.4.2,0.5.0,29,9,2082,1296,3378,69,FALSE
react-super-select,0.1.18,0.1.19,19,5,3350,1576,4926,87,FALSE
react-super-select,0.1.19,0.2.0,20,4,48890,5414,54304,53,FALSE
react-super-select,0.5.7,0.5.8,37,5,213,123,336,19,FALSE
react-super-select,0.2.3,0.3.0,24,3,755,881,1636,15,TRUE
react-super-select,0.2.1,0.2.2,22,1,1467,50,1517,9,TRUE
react-super-select,0.3.1,0.4.0,26,3,699,603,1302,20,TRUE
react-super-select,0.1.18,0.1.19,19,5,3350,1576,4926,87,TRUE
react-super-select,0.1.1,0.1.2,2,3,17266,196,17462,346,TRUE
react-super-select,0.1.16,0.1.17,17,3,1150,984,2134,44,TRUE
react-super-select,0.2.0,0.2.1,21,2,42,48932,48974,14,TRUE
react-super-select,0.5.15,0.5.16,45,2,490,410,900,12,TRUE
react-super-select,0.4.2,0.5.0,29,9,2082,1296,3378,69,TRUE
react-super-select,0.1.13,0.1.14,14,3,1009,1431,2440,57,TRUE
material-pickers-time,0.2.1,0.2.2,2,2,2,2,4,2,FALSE
material-pickers-time,0.2.0,0.2.1,1,1,974,217,1191,7,FALSE
material-pickers-time,0.2.1,0.2.2,2,2,2,2,4,2,TRUE
material-pickers-time,0.2.0,0.2.1,1,1,974,217,1191,7,TRUE
react-modal-wrapper,0.1.12,0.1.13,8,3,33,45,78,9,TRUE
react-modal-wrapper,0.1.13,0.1.15,9,4,4,4,8,4,FALSE
react-modal-wrapper,0.1.10,0.1.12,7,6,132,130,262,22,FALSE
react-modal-wrapper,0.1.8,0.1.9,5,1,2,2,4,2,FALSE
react-modal-wrapper,0.1.9,0.1.10,6,3,109,19,128,7,FALSE
react-modal-wrapper,0.1.4,0.1.5,1,5,37,20,57,10,FALSE
react-modal-wrapper,0.1.5,0.1.6,2,3,9,9,18,7,FALSE
react-modal-wrapper,0.1.6,0.1.7,3,3,11,5,16,7,FALSE
react-modal-wrapper,0.1.7,0.1.8,4,3,67,49,116,11,FALSE
react-modal-wrapper,0.1.12,0.1.13,8,3,33,45,78,9,FALSE
react-modal-wrapper,0.1.15,0.2.0,10,7,363,1493,1856,23,FALSE
react-modal-wrapper,0.3.2,0.4.0,20,2,3,3,6,2,FALSE
react-modal-wrapper,0.3.0,0.3.1,18,4,16,14,30,10,FALSE
react-modal-wrapper,0.3.1,0.3.2,19,3,9,9,18,9,FALSE
react-modal-wrapper,0.2.3-hella.3,0.2.3-hella.4,15,1,1,1,2,1,FALSE
react-modal-wrapper,0.2.3-hella.2,0.2.3-hella.3,14,1,1,1,2,1,FALSE
react-modal-wrapper,0.2.3-hella.1,0.2.3-hella.2,13,1,1,1,2,1,FALSE
react-modal-wrapper,0.2.3,0.3.0,17,2,13,12,25,5,FALSE
react-modal-wrapper,0.2.1,0.2.3-hella.1,12,6,37,13,50,15,FALSE
react-modal-wrapper,0.2.0,0.2.1,11,2,6,6,12,2,FALSE
react-modal-wrapper,0.1.13,0.1.15,9,4,4,4,8,4,TRUE
react-modal-wrapper,0.1.15,0.2.0,10,7,363,1493,1856,23,TRUE
react-modal-wrapper,0.1.9,0.1.10,6,3,109,19,128,7,TRUE
react-modal-wrapper,0.3.2,0.4.0,20,2,3,3,6,2,TRUE
ajaxable,0.2.2,0.2.3,3,1,3,1,4,1,FALSE
ajaxable,0.2.1,0.2.2,2,1,25,16,41,4,FALSE
ajaxable,0.1.0,0.2.1,1,10,604,148,752,26,FALSE
ajaxable,0.2.2,0.2.3,3,1,3,1,4,1,TRUE
ajaxable,0.1.0,0.2.1,1,10,604,148,752,26,TRUE
bake-in,0.3.0,0.3.1,3,3,33,7,40,6,FALSE
bake-in,0.3.1,0.3.2,4,4,116,29,145,8,TRUE
bake-in,0.3.2,0.4.0,5,2,374,361,735,10,FALSE
bake-in,0.6.1,0.6.2,12,4,81,18,99,8,FALSE
bake-in,0.6.0,0.6.1,11,4,97,13,110,8,TRUE
bake-in,0.2.0,0.3.0,2,4,152,74,226,11,FALSE
bake-in,0.1.0,0.2.0,1,5,135,40,175,10,FALSE
bake-in,0.4.0,0.5.0,6,2,131,50,181,11,FALSE
bake-in,0.5.0,0.5.1,7,1,1,0,1,1,FALSE
bake-in,0.5.1,0.5.2,8,1,2,2,4,2,FALSE
bake-in,0.5.2,0.5.3,9,8,93,52,145,12,FALSE
bake-in,0.5.3,0.6.0,10,5,98,80,178,12,FALSE
bake-in,0.3.1,0.3.2,4,4,116,29,145,8,FALSE
bake-in,0.6.0,0.6.1,11,4,97,13,110,8,FALSE
epilogue,0.6.3,0.6.4,14,10,43,27,70,12,FALSE
epilogue,0.3.3,0.4.0,6,25,1608,403,2011,88,FALSE
epilogue,0.6.1,0.6.2,12,8,249,41,290,18,TRUE
epilogue,0.6.0,0.6.1,11,3,34,11,45,7,FALSE
epilogue,0.6.6,0.7.0,17,21,1250,330,1580,45,FALSE
epilogue,0.7.0,0.7.1,18,14,397,79,476,23,FALSE
epilogue,0.6.5,0.6.6,16,23,523,160,683,40,FALSE
epilogue,0.6.2,0.6.3,13,6,475,291,766,33,FALSE
epilogue,0.4.0,0.5.0,7,7,1696,754,2450,42,FALSE
epilogue,0.6.4,0.6.5,15,2,37,2,39,4,FALSE
epilogue,0.5.0,0.5.1,8,6,218,44,262,10,FALSE
epilogue,0.5.1,0.5.2,9,55,2124,335,2459,109,FALSE
epilogue,0.5.2,0.6.0,10,32,2202,326,2528,93,FALSE
epilogue,0.3.1,0.3.2,4,40,2033,589,2622,130,FALSE
epilogue,0.3.0,0.3.1,3,3,5,5,10,4,FALSE
epilogue,0.6.5,0.6.6,16,23,523,160,683,40,TRUE
epilogue,0.3.2,0.3.3,5,4,154,25,179,9,FALSE
epilogue,0.6.1,0.6.2,12,8,249,41,290,18,FALSE
epilogue,0.2.0,0.2.1,1,1,1,1,2,1,FALSE
epilogue,0.2.1,0.3.0,2,42,1770,1399,3169,108,FALSE
epilogue,0.6.2,0.6.3,13,6,475,291,766,33,TRUE
epilogue,0.6.0,0.6.1,11,3,34,11,45,7,TRUE
epilogue,0.3.1,0.3.2,4,40,2033,589,2622,130,TRUE
epilogue,0.5.2,0.6.0,10,32,2202,326,2528,93,TRUE
gulpir,0.0.5,0.0.6,5,4,15,171,186,14,FALSE
gulpir,0.0.4,0.0.5,4,2,43,2,45,5,FALSE
gulpir,0.0.7,0.0.8,7,2,34,30,64,2,FALSE
gulpir,0.0.6,0.0.7,6,2,5,2,7,2,FALSE
gulpir,0.0.1,0.0.2,1,2,2,2,4,2,FALSE
gulpir,0.0.3,0.0.4,3,3,34,4,38,4,TRUE
gulpir,0.0.2,0.0.3,2,3,85,2,87,4,FALSE
gulpir,0.0.3,0.0.4,3,3,34,4,38,4,FALSE
gulpir,0.0.5,0.0.6,5,4,15,171,186,14,TRUE
bisheng,0.3.2,0.4.0-beta.0,16,1,7,7,14,3,FALSE
bisheng,0.3.0,0.3.1,14,1,7,7,14,3,FALSE
bisheng,0.12.10,0.12.11,70,1,7,7,14,3,FALSE
bisheng,0.17.2,0.17.3,84,1,7,7,14,3,FALSE
bisheng,0.17.3,0.18.0,85,1,7,7,14,3,FALSE
bisheng,0.17.0,0.17.1,82,1,7,7,14,3,FALSE
bisheng,0.17.1,0.17.2,83,1,7,7,14,3,FALSE
bisheng,0.18.9,0.18.10,95,1,7,7,14,3,FALSE
bisheng,0.18.8,0.18.9,94,1,7,7,14,3,FALSE
bisheng,0.11.0-beta.0,0.11.0,58,1,7,7,14,3,FALSE
bisheng,0.18.1,0.18.2,87,1,7,7,14,3,FALSE
bisheng,0.18.0,0.18.1,86,1,7,7,14,3,FALSE
bisheng,0.18.3,0.18.4,89,1,7,7,14,3,FALSE
bisheng,0.18.2,0.18.3,88,1,7,7,14,3,FALSE
bisheng,0.18.5,0.18.6,91,1,7,7,14,3,FALSE
bisheng,0.18.4,0.18.5,90,1,7,7,14,3,FALSE
bisheng,0.18.7,0.18.8,93,1,7,7,14,3,FALSE
bisheng,0.18.6,0.18.7,92,1,7,7,14,3,FALSE
bisheng,0.8.0-beta.1,0.8.0-beta.2,42,1,7,7,14,3,FALSE
bisheng,0.8.0-beta.0,0.8.0-beta.1,41,1,7,7,14,3,FALSE
bisheng,0.8.0-beta.2,0.8.0,43,1,7,7,14,3,FALSE
bisheng,0.15.0,0.16.0,77,1,7,7,14,3,FALSE
bisheng,0.19.0,0.20.0-beta.0,97,1,7,7,14,3,FALSE
bisheng,0.18.10,0.19.0,96,1,7,7,14,3,FALSE
bisheng,0.16.3,0.17.0,81,1,7,7,14,3,FALSE
bisheng,0.16.2,0.16.3,80,1,7,7,14,3,FALSE
bisheng,0.16.1,0.16.2,79,1,7,7,14,3,FALSE
bisheng,0.16.0,0.16.1,78,1,7,7,14,3,FALSE
bisheng,0.23.2,0.23.3,118,5,49,36,85,13,FALSE
bisheng,0.23.1,0.23.2,117,3,84,54,138,13,FALSE
bisheng,0.23.0,0.23.1,116,5,11,9,20,7,FALSE
bisheng,0.22.6,0.22.7,114,3,14,11,25,5,FALSE
bisheng,0.22.7,0.23.0,115,4,38,10,48,10,FALSE
bisheng,0.22.4,0.22.5,112,4,28,35,63,13,FALSE
bisheng,0.22.5,0.22.6,113,8,35,19,54,11,FALSE
bisheng,0.22.2,0.22.3,110,2,8,8,16,4,FALSE
bisheng,0.22.3,0.22.4,111,2,8,8,16,4,FALSE
bisheng,0.22.0,0.22.1,108,2,20,11,31,4,FALSE
bisheng,0.22.1,0.22.2,109,2,101,92,193,14,FALSE
bisheng,0.5.6,0.6.0,26,1,7,7,14,3,FALSE
bisheng,0.12.11,0.13.0,71,1,7,7,14,3,FALSE
bisheng,0.3.1,0.3.2,15,1,7,7,14,3,FALSE
bisheng,0.6.3,0.6.4,30,1,7,7,14,3,FALSE
bisheng,0.6.2,0.6.3,29,1,7,7,14,3,FALSE
bisheng,0.6.1,0.6.2,28,1,7,7,14,3,FALSE
bisheng,0.6.0,0.6.1,27,1,7,7,14,3,FALSE
bisheng,0.11.0,0.12.0,59,1,7,7,14,3,FALSE
bisheng,0.6.5,0.7.0,32,1,7,7,14,3,FALSE
bisheng,0.6.4,0.6.5,31,1,7,7,14,3,FALSE
bisheng,0.20.0,0.20.1,100,1,7,7,14,3,FALSE
bisheng,0.20.1,0.20.2,101,1,7,7,14,3,FALSE
bisheng,0.20.2,0.20.3,102,1,7,7,14,3,FALSE
bisheng,0.20.3,0.21.0,103,435,7014,3423,10437,1011,FALSE
bisheng,0.4.1,0.5.0,19,1,7,7,14,3,FALSE
bisheng,0.4.0,0.4.1,18,1,7,7,14,3,FALSE
bisheng,0.20.0-beta.0,0.20.0-beta.1,98,1,7,7,14,3,FALSE
bisheng,0.20.0-beta.1,0.20.0,99,1,7,7,14,3,FALSE
bisheng,0.13.2,0.13.3,74,1,7,7,14,3,FALSE
bisheng,0.13.3,0.14.0,75,1,7,7,14,3,FALSE
bisheng,0.13.0,0.13.1,72,1,7,7,14,3,FALSE
bisheng,0.13.1,0.13.2,73,1,7,7,14,3,FALSE
bisheng,0.14.0,0.15.0,76,1,7,7,14,3,FALSE
bisheng,0.21.1,0.21.2,105,4,34,28,62,7,FALSE
bisheng,0.21.0,0.21.1,104,2,9,8,17,4,FALSE
bisheng,0.21.3,0.22.0,107,6,195,102,297,33,FALSE
bisheng,0.21.2,0.21.3,106,3,39,39,78,11,FALSE
bisheng,0.8.0,0.9.0,44,1,7,7,14,3,FALSE
bisheng,0.2.1,0.3.0,13,1,7,7,14,3,FALSE
bisheng,0.2.0,0.2.1,12,1,7,7,14,3,FALSE
bisheng,0.1.0,0.1.1,6,1,7,7,14,3,FALSE
bisheng,0.1.1,0.1.2,7,1,7,7,14,3,FALSE
bisheng,0.1.2,0.1.3,8,1,7,7,14,3,FALSE
bisheng,0.1.3,0.1.4,9,1,7,7,14,3,FALSE
bisheng,0.1.4,0.1.5,10,1,7,7,14,3,FALSE
bisheng,0.1.5,0.2.0,11,1,7,7,14,3,FALSE
bisheng,0.10.1,0.10.2,54,1,7,7,14,3,FALSE
bisheng,0.10.0,0.10.1,53,1,7,7,14,3,FALSE
bisheng,0.10.3,0.10.4,56,1,7,7,14,3,FALSE
bisheng,0.10.2,0.10.3,55,1,7,7,14,3,FALSE
bisheng,0.10.4,0.11.0-beta.0,57,1,7,7,14,3,FALSE
bisheng,0.7.6,0.7.7,39,1,7,7,14,3,FALSE
bisheng,0.7.4,0.7.5,37,1,7,7,14,3,FALSE
bisheng,0.7.5,0.7.6,38,1,7,7,14,3,FALSE
bisheng,0.7.2,0.7.3,35,1,7,7,14,3,FALSE
bisheng,0.7.3,0.7.4,36,1,7,7,14,3,FALSE
bisheng,0.7.0,0.7.1,33,1,7,7,14,3,FALSE
bisheng,0.7.1,0.7.2,34,1,7,7,14,3,FALSE
bisheng,0.12.3,0.12.4,63,1,7,7,14,3,FALSE
bisheng,0.12.2,0.12.3,62,1,7,7,14,3,FALSE
bisheng,0.12.1,0.12.2,61,1,7,7,14,3,FALSE
bisheng,0.12.0,0.12.1,60,1,7,7,14,3,FALSE
bisheng,0.12.7,0.12.8,67,1,7,7,14,3,FALSE
bisheng,0.12.6,0.12.7,66,1,7,7,14,3,FALSE
bisheng,0.12.5,0.12.6,65,1,7,7,14,3,FALSE
bisheng,0.12.4,0.12.5,64,1,7,7,14,3,FALSE
bisheng,0.5.4,0.5.5,24,1,7,7,14,3,FALSE
bisheng,0.5.5,0.5.6,25,1,7,7,14,3,FALSE
bisheng,0.12.9,0.12.10,69,1,7,7,14,3,FALSE
bisheng,0.12.8,0.12.9,68,1,7,7,14,3,FALSE
bisheng,0.5.0,0.5.1,20,1,7,7,14,3,FALSE
bisheng,0.5.1,0.5.2,21,1,7,7,14,3,FALSE
bisheng,0.5.2,0.5.3,22,1,7,7,14,3,FALSE
bisheng,0.5.3,0.5.4,23,1,7,7,14,3,FALSE
bisheng,0.9.0,0.9.1,45,1,7,7,14,3,FALSE
bisheng,0.9.1,0.9.2,46,1,7,7,14,3,FALSE
bisheng,0.9.2,0.9.3,47,1,7,7,14,3,FALSE
bisheng,0.9.3,0.9.4,48,1,7,7,14,3,FALSE
bisheng,0.9.4,0.9.5,49,1,7,7,14,3,FALSE
bisheng,0.9.5,0.9.6,50,1,7,7,14,3,FALSE
bisheng,0.9.6,0.9.7,51,1,7,7,14,3,FALSE
bisheng,0.9.7,0.10.0,52,1,7,7,14,3,FALSE
bisheng,0.4.0-beta.0,0.4.0,17,1,7,7,14,3,FALSE
bisheng,0.1.0-beta.2,0.1.0-beta.3,3,1,7,7,14,3,FALSE
bisheng,0.1.0-beta.3,0.1.0-beta.4,4,1,7,7,14,3,FALSE
bisheng,0.1.0-beta.0,0.1.0-beta.1,1,1,7,7,14,3,FALSE
bisheng,0.1.0-beta.1,0.1.0-beta.2,2,1,7,7,14,3,FALSE
bisheng,0.1.0-beta.4,0.1.0,5,1,7,7,14,3,FALSE
bisheng,0.21.2,0.21.3,106,3,39,39,78,11,TRUE
bisheng,0.19.0,0.20.0-beta.0,97,1,7,7,14,3,TRUE
bisheng,0.1.0-beta.4,0.1.0,5,1,7,7,14,3,TRUE
bisheng,0.7.3,0.7.4,36,1,7,7,14,3,TRUE
bisheng,0.23.2,0.23.3,118,5,49,36,85,13,TRUE
bisheng,0.12.2,0.12.3,62,1,7,7,14,3,TRUE
bisheng,0.18.10,0.19.0,96,1,7,7,14,3,TRUE
bisheng,0.7.4,0.7.5,37,1,7,7,14,3,TRUE
bisheng,0.20.0,0.20.1,100,1,7,7,14,3,TRUE
bisheng,0.13.3,0.14.0,75,1,7,7,14,3,TRUE
bisheng,0.22.7,0.23.0,115,4,38,10,48,10,TRUE
bisheng,0.3.1,0.3.2,15,1,7,7,14,3,TRUE
bisheng,0.4.1,0.5.0,19,1,7,7,14,3,TRUE
bisheng,0.1.2,0.1.3,8,1,7,7,14,3,TRUE
react-flip-move,2.9.5,2.9.6,73,1,1,1,2,1,FALSE
react-flip-move,2.6.9,2.6.10,59,5,29,30,59,7,FALSE
react-flip-move,2.6.8,2.6.9,58,3,49,3,52,5,FALSE
react-flip-move,2.4.0,2.4.1,46,1,6,6,12,2,FALSE
react-flip-move,2.6.10,2.7.0-beta1,60,6,478,148,626,15,FALSE
react-flip-move,2.3.0,2.4.0-rc1,43,1,1,1,2,1,FALSE
react-flip-move,2.4.0-rc2,2.4.0,45,2,38,6,44,5,FALSE
react-flip-move,2.4.0-rc1,2.4.0-rc2,44,1,65,0,65,3,FALSE
react-flip-move,2.6.2,2.6.3,52,4,12,5,17,4,FALSE
react-flip-move,2.7.0,2.7.1,62,3,125,17,142,5,FALSE
react-flip-move,2.6.7,2.6.8,57,6,444,195,639,39,FALSE
react-flip-move,2.6.4,2.6.5,54,8,66,50,116,9,FALSE
react-flip-move,2.6.1,2.6.2,51,3,41,11,52,7,FALSE
react-flip-move,2.5.0,2.6.0,49,4,123,17,140,9,FALSE
react-flip-move,2.6.0,2.6.1,50,6,3200,1132,4332,53,FALSE
react-flip-move,2.7.0-beta1,2.7.0,61,5,147,139,286,9,FALSE
react-flip-move,2.6.5,2.6.6,55,2,9,5,14,3,FALSE
react-flip-move,2.4.1,2.4.2,47,1,7,5,12,2,FALSE
react-flip-move,2.6.6,2.6.7,56,3,10,4,14,3,FALSE
react-flip-move,2.6.3,2.6.4,53,1,2,2,4,2,FALSE
react-flip-move,2.4.2,2.5.0,48,3,33,4,37,4,FALSE
react-flip-move,2.9.10,2.9.11,79,4,59,61,120,8,FALSE
react-flip-move,2.9.11,2.9.12,80,4,637,291,928,21,FALSE
react-flip-move,2.9.12,2.9.13,81,3,5,3,8,3,FALSE
react-flip-move,2.9.9,2.9.10,78,1,1,1,2,1,FALSE
react-flip-move,2.9.9-beta1,2.9.9,77,5,82,30,112,8,FALSE
react-flip-move,1.0.4,1.0.5-0,13,4,631,427,1058,15,FALSE
react-flip-move,1.0.5,1.1.0,15,7,36,30,66,11,FALSE
react-flip-move,2.0.5,2.0.6,32,2,19,19,38,6,FALSE
react-flip-move,1.1.2,1.2.0,18,1,47,38,85,4,FALSE
react-flip-move,1.0.0,1.0.1,10,2,28,55,83,8,FALSE
react-flip-move,1.0.1,1.0.2,11,1,65,0,65,3,FALSE
react-flip-move,1.0.2,1.0.4,12,3,30,12,42,9,FALSE
react-flip-move,1.1.0,1.1.1,16,9,161,212,373,19,FALSE
react-flip-move,2.0.0-beta2,2.0.0-beta3,25,1,65,0,65,3,FALSE
react-flip-move,0.2.3,1.0.0,9,1,37,22,59,4,FALSE
react-flip-move,1.4.2,2.0.0-beta2,24,1,65,0,65,3,FALSE
react-flip-move,2.7.1,2.7.2,63,11,330,32,362,21,FALSE
react-flip-move,0.1.0,0.1.1,1,4,13,64,77,12,FALSE
react-flip-move,2.0.4,2.0.5,31,1,4,4,8,4,FALSE
react-flip-move,1.0.5-0,1.0.5,14,2,355,151,506,10,FALSE
react-flip-move,0.2.2,0.2.3,8,1,65,0,65,3,FALSE
react-flip-move,0.2.1,0.2.2,7,2,2,1,3,1,FALSE
react-flip-move,0.2.0,0.2.1,6,11,20787,19869,40656,29,TRUE
react-flip-move,2.1.2,2.1.3-beta1,37,1,8,2,10,1,FALSE
react-flip-move,0.1.2,0.1.3,3,2,42,29,71,3,FALSE
react-flip-move,0.1.3,0.1.4,4,1,5,2,7,2,FALSE
react-flip-move,0.1.4,0.2.0,5,4,167,102,269,10,FALSE
react-flip-move,2.1.0,2.1.1-beta1,34,4,157,40,197,9,FALSE
react-flip-move,2.1.4,2.2.0,40,4,73,3,76,10,FALSE
react-flip-move,2.0.2,2.0.3,29,1,65,0,65,3,FALSE
react-flip-move,2.1.3,2.1.4,39,2,2,2,4,2,FALSE
react-flip-move,2.1.1,2.1.2,36,3,71,12,83,11,FALSE
react-flip-move,2.7.3,2.7.4,65,6,186,58,244,17,FALSE
react-flip-move,2.0.1,2.0.2,28,2,1482,350,1832,16,FALSE
react-flip-move,2.0.0,2.0.1,27,1,1425,307,1732,11,FALSE
react-flip-move,2.0.6,2.1.0,33,4,116,76,192,20,FALSE
react-flip-move,0.1.1,0.1.2,2,1,46,12,58,2,FALSE
react-flip-move,2.0.3,2.0.4,30,4,40,34,74,10,FALSE
react-flip-move,2.1.3-beta1,2.1.3,38,3,13,954,967,6,FALSE
react-flip-move,1.4.0,1.4.1,22,3,24,8,32,6,FALSE
react-flip-move,1.4.1,1.4.2,23,2,6,6,12,2,FALSE
react-flip-move,1.1.1,1.1.2,17,5,110,56,166,9,FALSE
react-flip-move,2.7.2,2.7.3,64,4,18,23,41,4,FALSE
react-flip-move,2.9.3,2.9.4,71,4,30,30,60,5,FALSE
react-flip-move,1.3.1,1.4.0,21,4,596,392,988,14,FALSE
react-flip-move,1.3.0,1.3.1,20,3,60,13,73,4,FALSE
react-flip-move,1.2.0,1.3.0,19,3,102,22,124,5,FALSE
react-flip-move,2.1.1-beta1,2.1.1,35,1,38,40,78,4,FALSE
react-flip-move,2.9.2,2.9.3,70,4,59,34,93,5,FALSE
react-flip-move,2.9.0,2.9.1,68,3,62,397,459,7,FALSE
react-flip-move,2.9.1,2.9.2,69,3,5856,23,5879,4,FALSE
react-flip-move,2.9.6,2.9.7,74,2,4,5,9,2,FALSE
react-flip-move,2.9.7,2.9.8,75,2,6,4,10,2,FALSE
react-flip-move,2.9.4,2.9.5,72,2,54,28,82,10,FALSE
react-flip-move,2.8.0,2.9.0,67,9,439,127,566,20,FALSE
react-flip-move,2.7.4,2.8.0,66,2,63,7,70,6,FALSE
react-flip-move,2.2.1,2.3.0,42,4,109,95,204,11,FALSE
react-flip-move,2.9.8,2.9.9-beta1,76,3,1142,740,1882,22,FALSE
react-flip-move,2.2.0,2.2.1,41,5,655,592,1247,6,FALSE
react-flip-move,0.2.0,0.2.1,6,11,20787,19869,40656,29,FALSE
react-flip-move,0.1.3,0.1.4,4,1,5,2,7,2,TRUE
react-flip-move,1.0.0,1.0.1,10,2,28,55,83,8,TRUE
react-flip-move,1.4.0,1.4.1,22,3,24,8,32,6,TRUE
react-flip-move,1.4.1,1.4.2,23,2,6,6,12,2,TRUE
react-flip-move,2.3.0,2.4.0-rc1,43,1,1,1,2,1,TRUE
react-flip-move,1.2.0,1.3.0,19,3,102,22,124,5,TRUE
react-flip-move,2.6.0,2.6.1,50,6,3200,1132,4332,53,TRUE
react-flip-move,2.1.2,2.1.3-beta1,37,1,8,2,10,1,TRUE
react-flip-move,2.1.1-beta1,2.1.1,35,1,38,40,78,4,TRUE
react-flip-move,2.4.2,2.5.0,48,3,33,4,37,4,TRUE
react-flip-move,2.0.0,2.0.1,27,1,1425,307,1732,11,TRUE
react-flip-move,1.3.1,1.4.0,21,4,596,392,988,14,TRUE
react-flip-move,2.6.2,2.6.3,52,4,12,5,17,4,TRUE
reducto,1.1.0,1.2.0,6,9,577,151,728,25,FALSE
reducto,1.0.0,1.1.0,5,11,833,597,1430,70,FALSE
reducto,1.3.0,1.4.0,10,20,991,91,1082,56,FALSE
reducto,1.2.2,1.3.0,9,8,210,60,270,22,FALSE
reducto,1.2.0,1.2.1,7,4,40,19,59,7,FALSE
reducto,1.2.1,1.2.2,8,8,116,38,154,16,FALSE
reducto,0.3.0,0.4.0,2,2,55,19,74,5,FALSE
reducto,0.1.0,0.3.0,1,17,451,249,700,55,FALSE
reducto,0.4.0,0.5.0,3,3,297,73,370,23,FALSE
reducto,0.5.0,1.0.0,4,14,433,430,863,42,FALSE
reducto,1.0.0,1.1.0,5,11,833,597,1430,70,TRUE
reducto,1.3.0,1.4.0,10,20,991,91,1082,56,TRUE
reducto,1.2.2,1.3.0,9,8,210,60,270,22,TRUE
reducto,1.2.0,1.2.1,7,4,40,19,59,7,TRUE
rf-materialize,0.3.1,0.4.0,5,1,55,9,64,5,FALSE
rf-materialize,0.3.0,0.3.1,4,1,55,85,140,14,FALSE
rf-materialize,0.2.0,0.3.0,3,1,20,4,24,4,FALSE
rf-materialize,0.4.0,0.4.1,6,1,2,2,4,2,FALSE
rf-materialize,0.1.0,0.1.1,1,1,87,69,156,3,FALSE
rf-materialize,0.1.1,0.2.0,2,1,60,23,83,12,FALSE
rf-materialize,0.1.1,0.2.0,2,1,60,23,83,12,TRUE
angular2-stretchy,1.0.0,1.0.1,1,1,11,2,13,3,TRUE
wavedrom,1.1.0,1.2.0,19,6,393,248,641,12,FALSE
wavedrom,1.0.0,1.0.1,17,2,5,5,10,3,FALSE
wavedrom,1.0.1,1.1.0,18,2,191,116,307,9,FALSE
wavedrom,0.9.1,0.9.2,2,2,3,4,7,2,FALSE
wavedrom,0.9.0,0.9.1,1,1,5,5,10,1,FALSE
wavedrom,0.10.0,0.11.0,11,2,3485,1255,4740,37,FALSE
wavedrom,0.11.0,0.11.1,12,1,5,5,10,1,FALSE
wavedrom,0.11.1,0.11.2,13,1,19,15,34,4,FALSE
wavedrom,0.11.2,0.12.1,14,6,833,488,1321,31,FALSE
wavedrom,0.12.2,1.0.0,16,17,232,83,315,28,FALSE
wavedrom,0.12.1,0.12.2,15,2,2,1,3,2,FALSE
wavedrom,1.4.0,1.4.1,29,4,67,25,92,9,FALSE
wavedrom,0.9.2,0.9.3,3,5,165,129,294,10,FALSE
wavedrom,0.9.3,0.9.4,4,1,9,13,22,5,FALSE
wavedrom,0.9.4,0.9.5,5,1,71,38,109,5,FALSE
wavedrom,0.9.5,0.9.8,6,2,13,13,26,2,FALSE
wavedrom,0.9.8,0.9.9,7,1,5,3,8,3,FALSE
wavedrom,0.9.9,0.9.10,8,4,19,19,38,6,FALSE
wavedrom,1.2.6,1.3.0,26,24,786,262,1048,45,FALSE
wavedrom,1.2.4,1.2.5,24,7,114,28,142,9,FALSE
wavedrom,1.2.5,1.2.6,25,2,3,3,6,2,FALSE
wavedrom,1.2.2,1.2.3,22,2,15,5,20,4,FALSE
wavedrom,1.2.3,1.2.4,23,3,17,16,33,7,FALSE
wavedrom,1.2.0,1.2.1,20,7,61,53,114,12,FALSE
wavedrom,1.2.1,1.2.2,21,2,9,13,22,5,FALSE
wavedrom,1.3.1,1.4.0,28,4,84,15,99,9,FALSE
wavedrom,1.3.0,1.3.1,27,15,780,513,1293,25,FALSE
wavedrom,0.9.10,0.9.11,9,4,1635,42,1677,10,FALSE
wavedrom,0.9.11,0.10.0,10,3,2636,2578,5214,11,FALSE
wavedrom,0.11.0,0.11.1,12,1,5,5,10,1,TRUE
wavedrom,0.10.0,0.11.0,11,2,3485,1255,4740,37,TRUE
wavedrom,1.3.0,1.3.1,27,15,780,513,1293,25,TRUE
react-3d-carousel,0.0.5,0.0.6,5,2,15,15,30,8,FALSE
react-3d-carousel,0.0.4,0.0.5,4,1,4,4,8,3,FALSE
react-3d-carousel,0.0.3,0.0.4,3,2,2,3,5,3,FALSE
react-3d-carousel,0.0.2,0.0.3,2,4,617,415,1032,17,TRUE
react-3d-carousel,0.0.1,0.0.2,1,3,94,90,184,14,FALSE
react-3d-carousel,0.0.2,0.0.3,2,4,617,415,1032,17,FALSE
react-palm,0.5.0,0.6.0,14,6,915,756,1671,7,FALSE
react-palm,0.6.0,0.6.1,15,2,5,5,10,3,FALSE
react-palm,0.4.1,0.4.2,8,3,4,4,8,3,FALSE
react-palm,0.4.0,0.4.1,7,3,7,6,13,3,TRUE
react-palm,0.4.3,0.4.4,10,2,2,2,4,2,FALSE
react-palm,0.4.2,0.4.3,9,3,34,14,48,3,FALSE
react-palm,0.4.5,0.4.6,12,2,2,3,5,2,FALSE
react-palm,0.4.4,0.4.5,11,2,4,3,7,2,FALSE
react-palm,0.4.6,0.5.0,13,9,4770,402,5172,25,FALSE
react-palm,0.0.1,0.0.2,1,8,778,9,787,20,FALSE
react-palm,0.0.2,0.1.0,2,3,209,2,211,4,FALSE
react-palm,0.3.0,0.3.1,5,3,8,2,10,3,FALSE
react-palm,0.3.1,0.4.0,6,17,2589,632,3221,132,FALSE
react-palm,0.1.0,0.2.0,3,7,138,33,171,7,FALSE
react-palm,0.2.0,0.3.0,4,3,46,14,60,4,FALSE
react-palm,0.4.0,0.4.1,7,3,7,6,13,3,FALSE
react-palm,0.0.1,0.0.2,1,8,778,9,787,20,TRUE
react-palm,0.0.2,0.1.0,2,3,209,2,211,4,TRUE
react-palm,0.5.0,0.6.0,14,6,915,756,1671,7,TRUE
react-palm,0.3.1,0.4.0,6,17,2589,632,3221,132,TRUE
react-palm,0.1.0,0.2.0,3,7,138,33,171,7,TRUE
react-palm,0.2.0,0.3.0,4,3,46,14,60,4,TRUE
react-palm,0.4.1,0.4.2,8,3,4,4,8,3,TRUE
react-palm,0.4.2,0.4.3,9,3,34,14,48,3,TRUE
react-palm,0.4.5,0.4.6,12,2,2,3,5,2,TRUE
react-palm,0.4.6,0.5.0,13,9,4770,402,5172,25,TRUE
pas,2.0.7,2.0.8,8,3,691,393,1084,16,FALSE
pas,2.0.6,2.0.7,7,15,822,451,1273,61,FALSE
pas,2.0.5,2.0.6,6,1,88,29,117,6,FALSE
pas,2.0.4,2.0.5,5,1,2,1,3,2,FALSE
pas,2.0.3,2.0.4,4,3,189,90,279,9,FALSE
pas,2.0.2,2.0.3,3,1,88,29,117,6,FALSE
pas,2.0.1,2.0.2,2,4,40,38,78,8,FALSE
pas,2.0.0,2.0.1,1,4,262,180,442,21,FALSE
pas,3.0.4,3.0.5,22,2,48,1,49,4,FALSE
pas,2.0.9,2.0.10,10,5,757,700,1457,41,FALSE
pas,2.0.8,2.0.9,9,1,133,85,218,5,FALSE
pas,2.1.2,2.1.3,16,3,144,79,223,19,FALSE
pas,3.0.5,3.0.6,23,3,257,7,264,7,FALSE
pas,2.1.3,3.0.0,17,2,3555,2271,5826,65,FALSE
pas,3.0.2,3.0.3,20,1,88,29,117,6,FALSE
pas,2.1.0,2.1.1,14,3,312,106,418,19,FALSE
pas,2.1.1,2.1.2,15,7,76,50,126,16,FALSE
pas,3.0.3,3.0.4,21,5,422,279,701,32,FALSE
pas,3.0.0,3.0.1,18,1,448,118,566,7,FALSE
pas,3.0.1,3.0.2,19,2,26,3,29,4,FALSE
pas,3.0.6,3.0.7,24,2,3499,3499,6998,48,FALSE
pas,2.0.12,2.1.0,13,16,649,225,874,40,FALSE
pas,2.0.11,2.0.12,12,2,10,2,12,3,FALSE
pas,2.0.10,2.0.11,11,1,88,29,117,6,FALSE
pas,2.1.0,2.1.1,14,3,312,106,418,19,TRUE
pas,2.1.3,3.0.0,17,2,3555,2271,5826,65,TRUE
pas,2.0.12,2.1.0,13,16,649,225,874,40,TRUE
pas,2.0.6,2.0.7,7,15,822,451,1273,61,TRUE
pas,2.0.3,2.0.4,4,3,189,90,279,9,TRUE
pas,3.0.3,3.0.4,21,5,422,279,701,32,TRUE
gulp-alex,0.1.0,1.0.0,1,1,1,1,2,1,FALSE
gulp-alex,1.0.0,1.0.1,2,4,56,17,73,6,FALSE
gulp-alex,1.0.1,2.0.0,3,12,182,152,334,21,FALSE
gulp-alex,2.0.0,3.0.0,4,32,324,381,705,51,FALSE
gulp-alex,2.0.0,3.0.0,4,32,324,381,705,51,TRUE
gulp-alex,0.1.0,1.0.0,1,1,1,1,2,1,TRUE
ptz-user-app,1.0.0,1.0.1,1,1,252,192,444,14,FALSE
ptz-user-app,1.0.1,1.0.2,2,1,1,1,2,1,FALSE
ptz-user-app,1.1.1,1.2.0,5,2,135,114,249,10,FALSE
ptz-user-app,1.1.0,1.1.1,4,4,42,938,980,25,FALSE
ptz-user-app,1.0.2,1.1.0,3,11,1583,1538,3121,60,FALSE
ptz-user-app,1.4.0,1.5.0,9,2,104,92,196,10,FALSE
ptz-user-app,1.5.1,1.5.2,11,2,275,142,417,10,FALSE
ptz-user-app,1.5.0,1.5.1,10,2,139,123,262,10,FALSE
ptz-user-app,1.5.2,1.5.3,12,12,7354,1983,9337,128,FALSE
ptz-user-app,1.3.0,1.4.0,8,2,2896,95,2991,11,FALSE
ptz-user-app,1.2.0,1.2.1,6,2,840,425,1265,12,FALSE
ptz-user-app,1.2.1,1.3.0,7,2,356,207,563,9,FALSE
ptz-user-app,1.3.0,1.4.0,8,2,2896,95,2991,11,TRUE
ptz-user-app,1.1.0,1.1.1,4,4,42,938,980,25,TRUE
ptz-user-app,1.0.2,1.1.0,3,11,1583,1538,3121,60,TRUE
ptz-user-app,1.5.2,1.5.3,12,12,7354,1983,9337,128,TRUE
ptz-user-app,1.2.1,1.3.0,7,2,356,207,563,9,TRUE
react-collapsible,1.1.0,1.2.0,8,4,223,64,287,13,FALSE
react-collapsible,1.0.0,1.1.0,7,8,394,106,500,18,FALSE
react-collapsible,0.3.0,1.0.0,6,14,50,23,73,17,FALSE
react-collapsible,1.2.1,1.3.0,10,13,330,70,400,29,FALSE
react-collapsible,1.3.0,1.4.0,11,7,604,107,711,29,FALSE
react-collapsible,1.2.0,1.2.1,9,8,161,32,193,17,FALSE
react-collapsible,0.2.0,0.3.0,5,7,295,146,441,18,FALSE
react-collapsible,0.1.0,0.1.1,1,4,24,12,36,8,FALSE
react-collapsible,0.1.1,0.1.2,2,6,5,125,130,7,FALSE
react-collapsible,0.1.2,0.1.3,3,4,95,17,112,9,FALSE
react-collapsible,0.1.3,0.2.0,4,1,16,5,21,5,FALSE
react-collapsible,1.0.0,1.1.0,7,8,394,106,500,18,TRUE
donejs,0.2.7,0.2.8,20,1,2,2,4,1,FALSE
donejs,0.2.6,0.2.7,19,14,276,280,556,14,FALSE
donejs,0.2.5,0.2.6,18,7,18,11,29,7,FALSE
donejs,0.2.4,0.2.5,17,1,2,2,4,1,FALSE
donejs,0.2.3,0.2.4,16,1,3,3,6,1,FALSE
donejs,0.2.2,0.2.3,15,4,24,24,48,4,FALSE
donejs,0.2.1,0.2.2,14,8,33,23,56,8,FALSE
donejs,0.2.0,0.2.1,13,7,18,11,29,7,FALSE
donejs,0.1.0,0.1.1,10,2,11,2,13,3,FALSE
donejs,0.1.1,0.1.3,11,36,1054,754,1808,39,FALSE
donejs,0.2.9,0.2.10,22,1,1,1,2,1,FALSE
donejs,0.2.8,0.2.9,21,6,24,16,40,6,FALSE
donejs,0.5.0-pre.16,0.5.0-pre.17,52,168,5029,1784,6813,527,FALSE
donejs,0.5.0-pre.17,0.5.0-pre.18,53,1,4,1,5,2,FALSE
donejs,0.5.0-pre.14,0.5.0-pre.15,50,2,2,2,4,2,FALSE
donejs,0.5.0-pre.15,0.5.0-pre.16,51,158,3663,2327,5990,346,FALSE
donejs,0.5.0-pre.12,0.5.0-pre.13,48,12,564,310,874,32,FALSE
donejs,0.5.0-pre.13,0.5.0-pre.14,49,64,6636,8416,15052,227,FALSE
donejs,0.5.0-pre.10,0.5.0-pre.11,46,1,84,85,169,3,FALSE
donejs,0.5.0-pre.11,0.5.0-pre.12,47,38,793,275,1068,160,TRUE
donejs,0.3.2,0.4.0,32,1,2,2,4,1,FALSE
donejs,0.3.0,0.3.1,30,4,99,51,150,12,FALSE
donejs,0.3.1,0.3.2,31,1,3,3,6,1,FALSE
donejs,0.5.0-pre.18,0.5.0-pre.19,54,38,6745,886,7631,288,FALSE
donejs,0.2.16,0.3.0,29,1,7,7,14,1,FALSE
donejs,0.2.15,0.2.16,28,11,675,309,984,28,FALSE
donejs,0.2.14,0.2.15,27,5,34,23,57,5,FALSE
donejs,0.2.13,0.2.14,26,7,56,121,177,7,FALSE
donejs,0.2.12,0.2.13,25,3,19,10,29,3,FALSE
donejs,0.2.11,0.2.12,24,1,2,2,4,1,FALSE
donejs,0.2.10,0.2.11,23,1,2,2,4,1,FALSE
donejs,0.5.0-pre.4,0.5.0-pre.5,40,3,4373,762,5135,62,FALSE
donejs,0.5.0-pre.5,0.5.0-pre.6,41,14,8748,632,9380,105,TRUE
donejs,0.5.0-pre.6,0.5.0-pre.7,42,5,505,267,772,22,FALSE
donejs,0.5.0-pre.7,0.5.0-pre.8,43,20,3111,2237,5348,49,FALSE
donejs,0.5.0-pre.0,0.5.0-pre.1,36,5,179,227,406,10,FALSE
donejs,0.5.0-pre.1,0.5.0-pre.2,37,11,459,425,884,20,FALSE
donejs,0.5.0-pre.2,0.5.0-pre.3,38,18,750,371,1121,50,FALSE
donejs,0.5.0-pre.3,0.5.0-pre.4,39,18,11102,10244,21346,95,FALSE
donejs,0.5.0-pre.8,0.5.0-pre.9,44,28,16445,8832,25277,200,FALSE
donejs,0.5.0-pre.9,0.5.0-pre.10,45,8,196,87,283,13,FALSE
donejs,1.0.0-alpha.1,1.0.0-alpha.2,82,2,86,1,87,3,FALSE
donejs,1.0.0-alpha.0,1.0.0-alpha.1,81,75,4104,35255,39359,1133,FALSE
donejs,1.0.0-alpha.3,1.0.0,84,71,6794,19137,25931,671,FALSE
donejs,0.5.0-beta.1,0.5.0-beta.2,34,2,3,3,6,2,FALSE
donejs,0.5.0-pre.11,0.5.0-pre.12,47,38,793,275,1068,160,FALSE
donejs,0.6.0,0.7.0-pre.0,67,31,822,107,929,439,FALSE
donejs,0.5.0-pre.19,0.5.0,55,36,4119,3918,8037,56,FALSE
donejs,0.6.0-pre.3,0.6.0,66,4,40,66,106,5,FALSE
donejs,0.6.0-pre.2,0.6.0-pre.3,65,4,8,14,22,5,FALSE
donejs,0.6.0-pre.1,0.6.0-pre.2,64,9,45,28,73,13,FALSE
donejs,0.8.0-pre.0,0.8.0-pre.1,73,2,2,2,4,2,FALSE
donejs,0.5.4,0.5.5,60,26,561,635,1196,40,FALSE
donejs,0.4.0,0.5.0-beta.1,33,662,82750,42788,125538,2397,FALSE
donejs,0.5.6,0.5.7,62,7,1075,248,1323,37,FALSE
donejs,0.5.7,0.6.0-pre.1,63,6,4874,346,5220,41,FALSE
donejs,0.5.0,0.5.1,56,53,2103,545,2648,92,FALSE
donejs,0.5.1,0.5.2,57,5,22,9,31,5,FALSE
donejs,0.5.2,0.5.3,58,70,8738,4398,13136,258,FALSE
donejs,0.5.3,0.5.4,59,35,2495,1844,4339,107,FALSE
donejs,0.9.0,0.9.1,76,5,20,3,23,5,FALSE
donejs,0.9.1,0.9.2,77,9,641,431,1072,19,FALSE
donejs,0.9.2,0.10.0-pre.0,78,25,854,576,1430,50,FALSE
donejs,1.0.0-alpha.2,1.0.0-alpha.3,83,3,128,34,162,7,FALSE
donejs,0.8.0-pre.1,0.8.0,74,41,1285,847,2132,141,FALSE
donejs,0.5.0-pre.5,0.5.0-pre.6,41,14,8748,632,9380,105,FALSE
donejs,0.5.5,0.5.6,61,20,4117,98,4215,26,FALSE
donejs,0.7.0-pre.0,0.7.0-pre.1,68,4,92,64,156,4,FALSE
donejs,0.10.0-pre.1,1.0.0-alpha.0,80,30,562,611,1173,66,FALSE
donejs,0.10.0-pre.0,0.10.0-pre.1,79,2,12,3,15,4,FALSE
donejs,0.7.0-pre.1,0.7.0,69,9,5453,509,5962,258,FALSE
donejs,0.8.0,0.9.0,75,57,6004,2951,8955,339,FALSE
donejs,0.7.0,0.7.1,70,28,6187,473,6660,81,FALSE
donejs,0.7.1,0.7.2,71,2,2,2,4,2,FALSE
donejs,0.9.0,0.9.1,76,5,20,3,23,5,TRUE
donejs,0.5.0-pre.16,0.5.0-pre.17,52,168,5029,1784,6813,527,TRUE
donejs,0.5.0-pre.15,0.5.0-pre.16,51,158,3663,2327,5990,346,TRUE
donejs,0.5.0-pre.2,0.5.0-pre.3,38,18,750,371,1121,50,TRUE
donejs,0.8.0,0.9.0,75,57,6004,2951,8955,339,TRUE
donejs,0.8.0-pre.1,0.8.0,74,41,1285,847,2132,141,TRUE
scot4,1.1.0,1.2.0,4,5,775,199,974,48,FALSE
scot4,1.0.0,1.0.1,1,3,20,9,29,3,FALSE
scot4,1.0.1,1.0.2,2,2,13,3,16,4,FALSE
scot4,1.0.2,1.1.0,3,2,13,1,14,4,FALSE
scot4,1.6.0,1.7.0,19,1,8219,0,8219,2,FALSE
scot4,1.7.6,1.7.7,26,3,475,736,1211,18,FALSE
scot4,1.7.5,1.7.6,25,1,0,2,2,1,FALSE
scot4,1.7.4,1.7.5,24,1,1,1,2,1,FALSE
scot4,1.7.3,1.7.4,23,1,2,2,4,3,FALSE
scot4,1.7.2,1.7.3,22,2,41,619,660,21,FALSE
scot4,1.7.1,1.7.2,21,1,9,2,11,2,FALSE
scot4,1.7.0,1.7.1,20,3,9,7,16,3,FALSE
scot4,1.4.0,1.4.1,8,1,452,22,474,9,FALSE
scot4,1.4.1,1.4.2,9,1,10,439,449,11,TRUE
scot4,1.4.2,1.5.0,10,8,82,69,151,22,FALSE
scot4,1.5.5,1.5.6,16,1,48,0,48,5,FALSE
scot4,1.5.4,1.5.5,15,2,4,4,8,2,FALSE
scot4,1.5.7,1.6.0,18,1,88,19,107,13,FALSE
scot4,1.5.6,1.5.7,17,1,10,8,18,3,FALSE
scot4,1.5.1,1.5.2,12,1,1,1,2,1,FALSE
scot4,1.5.0,1.5.1,11,1,1,1,2,1,FALSE
scot4,1.5.3,1.5.4,14,1,1,1,2,1,FALSE
scot4,1.5.2,1.5.3,13,3,3,3,6,3,FALSE
scot4,1.3.0,1.4.0,7,1,159,59,218,14,FALSE
scot4,1.2.0,1.2.1,5,5,63,129,192,16,FALSE
scot4,1.2.1,1.3.0,6,1,257,2,259,16,FALSE
scot4,1.21.1,1.22.0,55,4,360,375,735,15,FALSE
scot4,1.21.0,1.21.1,54,1,48,0,48,5,FALSE
scot4,1.24.0,1.24.1,59,1,51,40,91,2,FALSE
scot4,1.20.0,1.21.0,53,1,80,38,118,8,FALSE
scot4,1.23.0,1.24.0,58,1,105,16,121,9,FALSE
scot4,1.25.2,1.25.3,63,4,771,838,1609,14,FALSE
scot4,1.25.3,1.26.0,64,3,68,167,235,35,FALSE
scot4,1.25.0,1.25.1,61,1,0,3,3,1,FALSE
scot4,1.25.1,1.25.2,62,1,20,7,27,5,FALSE
scot4,1.26.0,1.26.1,65,3,408,859,1267,10,FALSE
scot4,1.22.1,1.23.0,57,1,2,3,5,1,FALSE
scot4,1.22.0,1.22.1,56,1,18,9,27,4,FALSE
scot4,1.24.1,1.25.0,60,8,225,216,441,16,FALSE
scot4,1.9.1,1.9.2,32,1,7,8,15,4,FALSE
scot4,1.19.0,1.19.1,51,1,12,50,62,4,FALSE
scot4,1.14.0,1.14.1,43,1,44,37,81,5,FALSE
scot4,1.14.1,1.15.0,44,1,43,14,57,5,FALSE
scot4,1.15.2,1.16.0,47,1,3,9,12,3,FALSE
scot4,1.15.1,1.15.2,46,2,11,2,13,2,FALSE
scot4,1.15.0,1.15.1,45,1,4,15,19,4,FALSE
scot4,1.9.0,1.9.1,31,1,1,0,1,1,FALSE
scot4,1.19.1,1.20.0,52,3,411,199,610,17,FALSE
scot4,1.9.2,1.9.3,33,1,1,1,2,1,FALSE
scot4,1.9.4,1.10.0,35,1,524,33,557,5,FALSE
scot4,1.18.0,1.19.0,50,2,538,438,976,37,FALSE
scot4,1.13.0,1.14.0,42,3,59,46,105,14,FALSE
scot4,1.12.0,1.12.1,40,1,121,21,142,3,FALSE
scot4,1.12.1,1.13.0,41,5,434,428,862,25,FALSE
scot4,1.11.2,1.12.0,39,2,159,27593,27752,696,FALSE
scot4,1.11.1,1.11.2,38,1,268,252,520,3,FALSE
scot4,1.11.0,1.11.1,37,1,2,16,18,2,FALSE
scot4,1.10.0,1.11.0,36,2,109,80,189,14,FALSE
scot4,1.16.0,1.17.0,48,3,217,20,237,7,FALSE
scot4,1.17.0,1.18.0,49,1,227,5,232,4,FALSE
scot4,1.9.3,1.9.4,34,1,19,24,43,3,FALSE
scot4,1.4.1,1.4.2,9,1,10,439,449,11,FALSE
scot4,1.7.7,1.8.0,27,3,447,850,1297,36,FALSE
scot4,1.8.2,1.9.0,30,5,16149,8025,24174,21,FALSE
scot4,1.8.0,1.8.1,28,1,3,3,6,1,FALSE
scot4,1.8.1,1.8.2,29,2,27995,154,28149,695,FALSE
scot4,1.5.3,1.5.4,14,1,1,1,2,1,TRUE
scot4,1.18.0,1.19.0,50,2,538,438,976,37,TRUE
scot4,1.16.0,1.17.0,48,3,217,20,237,7,TRUE
scot4,1.13.0,1.14.0,42,3,59,46,105,14,TRUE
scot4,1.5.4,1.5.5,15,2,4,4,8,2,TRUE
scot4,1.8.1,1.8.2,29,2,27995,154,28149,695,TRUE
scot4,1.7.7,1.8.0,27,3,447,850,1297,36,TRUE
scot4,1.8.2,1.9.0,30,5,16149,8025,24174,21,TRUE
scot4,1.25.2,1.25.3,63,4,771,838,1609,14,TRUE
scot4,1.5.2,1.5.3,13,3,3,3,6,3,TRUE
scot4,1.9.1,1.9.2,32,1,7,8,15,4,TRUE
scot4,1.11.2,1.12.0,39,2,159,27593,27752,696,TRUE
scot4,1.2.1,1.3.0,6,1,257,2,259,16,TRUE
scot4,1.0.0,1.0.1,1,3,20,9,29,3,TRUE
scot4,1.12.1,1.13.0,41,5,434,428,862,25,TRUE
scot4,1.19.1,1.20.0,52,3,411,199,610,17,TRUE
scot4,1.24.0,1.24.1,59,1,51,40,91,2,TRUE
scot4,1.10.0,1.11.0,36,2,109,80,189,14,TRUE
floodesh,0.7.5,0.7.6,41,1,3,3,6,1,FALSE
floodesh,0.2.7,0.2.8,10,1,1,1,2,1,TRUE
floodesh,0.2.6,0.2.7,9,1,1,1,2,1,FALSE
floodesh,0.2.5,0.2.6,8,1,305,60,365,4,FALSE
floodesh,0.2.4,0.2.5,7,9,88,34,122,19,FALSE
floodesh,0.2.3,0.2.4,6,1,1,1,2,1,FALSE
floodesh,0.2.2,0.2.3,5,1,9,3,12,2,FALSE
floodesh,0.2.1,0.2.2,4,1,2,2,4,2,FALSE
floodesh,0.2.0,0.2.1,3,1,11,0,11,1,FALSE
floodesh,0.5.14,0.5.15,33,1,1,1,2,1,FALSE
floodesh,0.5.15,0.6.0,34,1,11,6,17,2,FALSE
floodesh,0.5.12,0.5.13,31,1,1,1,2,1,FALSE
floodesh,0.5.13,0.5.14,32,1,1,1,2,1,FALSE
floodesh,0.2.9,0.2.10,12,1,1,1,2,1,FALSE
floodesh,0.5.11,0.5.12,30,1,1,1,2,1,FALSE
floodesh,0.0.4,0.2.0,2,3,124,51,175,10,FALSE
floodesh,0.7.8,0.7.9,44,1,154,50,204,7,FALSE
floodesh,0.0.2,0.0.4,1,3,143,49,192,11,FALSE
floodesh,0.3.2,0.4.0,16,2,30,88,118,11,FALSE
floodesh,0.7.7,0.7.8,43,1,57,14,71,5,FALSE
floodesh,0.7.4,0.7.5,40,1,40,47,87,7,FALSE
floodesh,0.6.0,0.7.0,35,4,339,314,653,26,FALSE
floodesh,0.7.2,0.7.3,38,1,240,15,255,11,FALSE
floodesh,0.7.3,0.7.4,39,1,1,1,2,1,FALSE
floodesh,0.7.0,0.7.1,36,1,5,5,10,1,FALSE
floodesh,0.7.1,0.7.2,37,2,1,7,8,2,FALSE
floodesh,0.5.8,0.5.9,28,1,1,1,2,1,FALSE
floodesh,0.5.9,0.5.11,29,1,16,10,26,3,FALSE
floodesh,0.4.1,0.4.2,18,1,2,3,5,2,FALSE
floodesh,0.4.0,0.4.1,17,1,13,11,24,5,FALSE
floodesh,0.5.6,0.5.7,26,2,2,1,3,2,FALSE
floodesh,0.2.8,0.2.9,11,1,1,1,2,1,FALSE
floodesh,0.5.0,0.5.1,20,1,10,8,18,2,FALSE
floodesh,0.5.1,0.5.2,21,1,2,2,4,1,FALSE
floodesh,0.5.2,0.5.3,22,1,47,12,59,4,FALSE
floodesh,0.5.3,0.5.4,23,2,19,7,26,3,FALSE
floodesh,0.7.10,0.7.11,46,1,10,3,13,2,FALSE
floodesh,0.7.11,0.7.12,47,1,39,18,57,3,FALSE
floodesh,0.7.12,0.7.13,48,1,44,5,49,3,FALSE
floodesh,0.7.13,0.7.15,49,2,34,35,69,7,FALSE
floodesh,0.2.12,0.3.2,15,14,627,171,798,42,FALSE
floodesh,0.2.11,0.2.12,14,2,45,11,56,17,FALSE
floodesh,0.2.10,0.2.11,13,1,1,1,2,1,FALSE
floodesh,0.5.4,0.5.5,24,1,1,1,2,1,FALSE
floodesh,0.7.16,0.7.17,51,1,36,4,40,5,FALSE
floodesh,0.5.5,0.5.6,25,5,55,29,84,5,FALSE
floodesh,0.4.2,0.5.0,19,1,49,973,1022,12,FALSE
floodesh,0.7.9,0.7.10,45,1,8,7,15,3,FALSE
floodesh,0.7.6,0.7.7,42,1,2,2,4,2,FALSE
floodesh,0.5.7,0.5.8,27,1,1,1,2,1,FALSE
floodesh,0.7.15,0.7.16,50,1,33,19,52,6,FALSE
floodesh,0.2.7,0.2.8,10,1,1,1,2,1,FALSE
floodesh,0.4.2,0.5.0,19,1,49,973,1022,12,TRUE
floodesh,0.7.24,0.8.0,59,2,149,308,457,17,FALSE
floodesh,0.7.21,0.7.22,56,1,5,2,7,2,FALSE
floodesh,0.7.20,0.7.21,55,1,7,3,10,3,FALSE
floodesh,0.7.23,0.7.24,58,1,6,3,9,3,FALSE
floodesh,0.7.22,0.7.23,57,2,13,15,28,3,FALSE
floodesh,0.2.4,0.2.5,7,9,88,34,122,19,TRUE
floodesh,0.8.5,0.8.6,64,1,15,14,29,2,FALSE
floodesh,0.8.4,0.8.5,63,1,4,2,6,3,FALSE
floodesh,0.7.18,0.7.19,53,2,99,307,406,13,FALSE
floodesh,0.7.19,0.7.20,54,1,1,3,4,3,FALSE
floodesh,0.8.6,0.8.7,65,1,7,8,15,3,FALSE
floodesh,0.8.8,0.8.9,67,2,15,29,44,2,FALSE
floodesh,0.8.7,0.8.8,66,1,34,13,47,3,FALSE
floodesh,0.8.2,0.8.4,62,1,26,17,43,3,FALSE
floodesh,0.8.1,0.8.2,61,1,2,2,4,2,FALSE
floodesh,0.7.17,0.7.18,52,2,15,34,49,5,FALSE
floodesh,0.8.0,0.8.1,60,1,2,1,3,2,FALSE
floodesh,0.8.4,0.8.5,63,1,4,2,6,3,TRUE
floodesh,0.7.15,0.7.16,50,1,33,19,52,6,TRUE
floodesh,0.4.0,0.4.1,17,1,13,11,24,5,TRUE
floodesh,0.5.2,0.5.3,22,1,47,12,59,4,TRUE
meshblu-blink1,3.3.3,3.3.4,31,1,10,3,13,3,FALSE
meshblu-blink1,3.1.12,3.1.13,17,1,10,3,13,3,FALSE
meshblu-blink1,3.1.10,3.1.12,16,3,9,20,29,7,FALSE
meshblu-blink1,3.1.7,3.1.8,13,1,2,2,4,2,FALSE
meshblu-blink1,3.1.16,3.1.17,21,3,5,7,12,4,FALSE
meshblu-blink1,3.1.15,3.1.16,20,1,5,3,8,2,FALSE
meshblu-blink1,3.1.18,3.2.0,23,2,67,49,116,5,FALSE
meshblu-blink1,3.1.9,3.1.10,15,1,1,2,3,2,FALSE
meshblu-blink1,3.1.8,3.1.9,14,1,3,2,5,1,FALSE
meshblu-blink1,3.3.1,3.3.2,29,1,160,156,316,11,FALSE
meshblu-blink1,3.3.0,3.3.1,28,1,3,3,6,1,FALSE
meshblu-blink1,3.3.2,3.3.3,30,1,41,13,54,7,FALSE
meshblu-blink1,3.2.0,3.2.1,24,1,82,47,129,3,FALSE
meshblu-blink1,3.2.2,3.2.3,26,1,2,2,4,2,FALSE
meshblu-blink1,3.2.3,3.3.0,27,3,15,12,27,6,FALSE
meshblu-blink1,3.1.17,3.1.18,22,5,6,5,11,5,FALSE
meshblu-blink1,3.2.1,3.2.2,25,1,5,1,6,2,FALSE
meshblu-blink1,1.1.0,1.2.0,3,1,6,9,15,2,FALSE
meshblu-blink1,3.1.1,3.1.2,11,2,12,2,14,3,FALSE
meshblu-blink1,1.0.0,1.0.1,1,1,9,3,12,3,FALSE
meshblu-blink1,1.0.1,1.1.0,2,1,16,7,23,2,FALSE
meshblu-blink1,3.0.0,3.0.1,8,1,2,4,6,2,FALSE
meshblu-blink1,2.0.0,2.1.0,5,1,6,2,8,3,FALSE
meshblu-blink1,2.1.0,2.1.1,6,2,65,48,113,5,FALSE
meshblu-blink1,2.1.1,3.0.0,7,1,49,11,60,3,FALSE
meshblu-blink1,3.0.1,3.0.2,9,1,9,3,12,2,FALSE
meshblu-blink1,3.1.2,3.1.7,12,9,94,17,111,17,FALSE
meshblu-blink1,1.2.0,2.0.0,4,3,42,29,71,5,FALSE
meshblu-blink1,3.1.13,3.1.14,18,20,161,80,241,33,FALSE
meshblu-blink1,3.1.14,3.1.15,19,3,9,7,16,4,FALSE
meshblu-blink1,3.0.2,3.1.1,10,4,30,8,38,5,FALSE
meshblu-blink1,3.1.18,3.2.0,23,2,67,49,116,5,TRUE
spigot-anti-piracy-backend,0.6.0,0.6.1,9,4,19,11,30,6,FALSE
spigot-anti-piracy-backend,0.5.4,0.6.0,8,38,118,162,280,44,FALSE
spigot-anti-piracy-backend,0.4.1,0.4.2,2,1,10,2,12,3,FALSE
spigot-anti-piracy-backend,0.4.0,0.4.1,1,1,20,7,27,2,FALSE
spigot-anti-piracy-backend,0.4.2,0.5.0,3,5,16,20,36,7,FALSE
spigot-anti-piracy-backend,0.5.0,0.5.1,4,47,231,58,289,51,FALSE
spigot-anti-piracy-backend,0.5.1,0.5.2,5,5,24,3,27,6,FALSE
spigot-anti-piracy-backend,0.5.2,0.5.3,6,90,116,99,215,91,FALSE
spigot-anti-piracy-backend,0.5.3,0.5.4,7,25,82,58,140,28,FALSE
spigot-anti-piracy-backend,1.0.0,1.0.1,11,15,279,37,316,21,TRUE
spigot-anti-piracy-backend,0.6.1,1.0.0,10,3,51,77,128,12,FALSE
spigot-anti-piracy-backend,1.0.0,1.0.1,11,15,279,37,316,21,FALSE
spigot-anti-piracy-backend,0.6.1,1.0.0,10,3,51,77,128,12,TRUE
spigot-anti-piracy-backend,0.5.4,0.6.0,8,38,118,162,280,44,TRUE
spigot-anti-piracy-backend,0.5.0,0.5.1,4,47,231,58,289,51,TRUE
spigot-anti-piracy-backend,0.5.3,0.5.4,7,25,82,58,140,28,TRUE
dashlang,0.3.10,0.4.0,97,3,43,12,55,4,FALSE
dashlang,0.2.5,0.3.0,86,2,54,5,59,5,FALSE
dashlang,0.2.4,0.2.5,85,2,8,7,15,2,FALSE
dashlang,0.2.3,0.2.4,84,2,2,2,4,2,FALSE
dashlang,0.3.8,0.3.9,95,2,2,2,4,2,FALSE
dashlang,0.3.9,0.3.10,96,3,5,5,10,3,FALSE
dashlang,0.3.2,0.3.3,89,4,90,64,154,7,FALSE
dashlang,0.3.3,0.3.4,90,2,2,2,4,2,FALSE
dashlang,0.3.0,0.3.1,87,3,10,5,15,4,FALSE
dashlang,0.3.1,0.3.2,88,3,4,3,7,3,FALSE
dashlang,0.3.6,0.3.7,93,2,2,2,4,2,FALSE
dashlang,0.3.7,0.3.8,94,3,18,3,21,4,FALSE
dashlang,0.3.4,0.3.5,91,2,3,3,6,2,FALSE
dashlang,0.3.5,0.3.6,92,6,17,19,36,6,FALSE
dashlang,0.4.9,0.4.10,107,2,3,1,4,2,FALSE
dashlang,0.4.8,0.4.9,106,4,3,6,9,4,FALSE
dashlang,0.4.0,0.4.1,98,2,3,3,6,2,FALSE
dashlang,0.4.3,0.4.4,101,3,4,4,8,3,FALSE
dashlang,0.4.2,0.4.3,100,5,20,15,35,5,FALSE
dashlang,0.5.0,0.5.1,116,2,6,2,8,2,FALSE
dashlang,0.5.1,0.5.2,117,5,12,9,21,5,FALSE
dashlang,0.5.2,0.5.3,118,2,41,41,82,2,FALSE
dashlang,0.5.3,0.5.4,119,3,4,2,6,3,FALSE
dashlang,0.4.11,0.4.12,109,7,14,28,42,8,FALSE
dashlang,0.4.10,0.4.11,108,2,2,2,4,2,FALSE
dashlang,0.4.13,0.4.14,111,3,5,3,8,3,FALSE
dashlang,0.4.12,0.4.13,110,4,21,16,37,4,FALSE
dashlang,0.4.15,0.4.16,113,2,9,8,17,3,FALSE
dashlang,0.4.14,0.4.15,112,2,13,11,24,2,FALSE
dashlang,0.4.17,0.5.0,115,2,3,3,6,2,FALSE
dashlang,0.4.16,0.4.17,114,7,27,8,35,8,FALSE
dashlang,0.4.1,0.4.2,99,5,11,7,18,6,FALSE
dashlang,0.4.5,0.4.6,103,2,2,2,4,2,FALSE
dashlang,0.4.4,0.4.5,102,3,14,16,30,3,FALSE
dashlang,0.4.7,0.4.8,105,2,3,3,6,2,FALSE
dashlang,0.4.6,0.4.7,104,2,4,4,8,2,FALSE
dashlang,0.0.59,0.0.60,58,2,7,7,14,4,FALSE
dashlang,0.0.58,0.0.59,57,2,2,2,4,2,FALSE
dashlang,0.0.51,0.0.52,51,2,2,2,4,2,FALSE
dashlang,0.0.50,0.0.51,50,3,8,6,14,3,FALSE
dashlang,0.0.53,0.0.54,53,2,6,2,8,2,FALSE
dashlang,0.0.52,0.0.53,52,2,2,2,4,2,FALSE
dashlang,0.0.55,0.0.56,55,2,4,2,6,2,FALSE
dashlang,0.0.54,0.0.55,54,2,4,3,7,2,FALSE
dashlang,0.0.56,0.0.58,56,4,5,5,10,4,FALSE
dashlang,0.0.64,0.1.0,63,2,28,10,38,2,FALSE
dashlang,0.0.60,0.0.61,59,3,6,4,10,3,FALSE
dashlang,0.0.61,0.0.62,60,2,2,2,4,2,FALSE
dashlang,0.0.62,0.0.63,61,3,6,4,10,3,FALSE
dashlang,0.0.63,0.0.64,62,4,5,5,10,5,FALSE
dashlang,0.1.0,0.1.1,64,2,4,3,7,2,FALSE
dashlang,0.0.49,0.0.50,49,2,2,2,4,2,FALSE
dashlang,0.0.15,0.0.16,15,2,28,7,35,2,FALSE
dashlang,0.0.14,0.0.15,14,2,2,2,4,2,FALSE
dashlang,0.0.17,0.0.18,17,2,19,14,33,2,FALSE
dashlang,0.0.16,0.0.17,16,2,4,2,6,2,FALSE
dashlang,0.0.11,0.0.12,11,2,4,2,6,2,FALSE
dashlang,0.0.10,0.0.11,10,4,7,4,11,4,FALSE
dashlang,0.0.13,0.0.14,13,2,4,1,5,3,FALSE
dashlang,0.0.12,0.0.13,12,2,4,2,6,2,FALSE
dashlang,0.0.19,0.0.20,19,2,6,3,9,2,FALSE
dashlang,0.0.18,0.0.19,18,2,3,2,5,2,FALSE
dashlang,0.0.20,0.0.21,20,2,30,15,45,3,FALSE
dashlang,0.0.21,0.0.22,21,4,30,16,46,4,FALSE
dashlang,0.0.22,0.0.23,22,2,1,3,4,2,FALSE
dashlang,0.0.23,0.0.24,23,3,7,2,9,4,FALSE
dashlang,0.0.24,0.0.25,24,2,34,16,50,3,FALSE
dashlang,0.0.25,0.0.26,25,2,7,5,12,2,FALSE
dashlang,0.0.26,0.0.27,26,2,3,3,6,2,FALSE
dashlang,0.0.27,0.0.28,27,2,15,5,20,2,FALSE
dashlang,0.0.28,0.0.29,28,1,4,4,8,1,FALSE
dashlang,0.0.29,0.0.30,29,4,19,4,23,4,FALSE
dashlang,0.0.36,0.0.37,36,2,6,4,10,2,FALSE
dashlang,0.2.1,0.2.2,82,3,9,4,13,3,FALSE
dashlang,0.2.0,0.2.1,81,2,10,5,15,2,FALSE
dashlang,0.1.8,0.1.9,72,1,1,1,2,1,FALSE
dashlang,0.1.9,0.1.10,73,2,7,5,12,3,FALSE
dashlang,0.2.2,0.2.3,83,2,7,6,13,3,FALSE
dashlang,0.0.39,0.0.40,39,3,19,13,32,3,FALSE
dashlang,0.0.38,0.0.39,38,2,9,5,14,3,FALSE
dashlang,0.0.37,0.0.38,37,3,16,6,22,4,FALSE
dashlang,0.1.1,0.1.2,65,2,45,9,54,4,FALSE
dashlang,0.0.35,0.0.36,35,3,10,9,19,3,FALSE
dashlang,0.1.3,0.1.4,67,2,6,3,9,2,FALSE
dashlang,0.0.33,0.0.34,33,3,8,6,14,3,FALSE
dashlang,0.1.2,0.1.3,66,4,15,9,24,5,FALSE
dashlang,0.0.31,0.0.32,31,2,11,3,14,2,FALSE
dashlang,0.0.30,0.0.31,30,2,8,5,13,3,FALSE
dashlang,0.0.5,0.0.6,5,2,3,3,6,2,FALSE
dashlang,0.0.4,0.0.5,4,2,4,2,6,2,FALSE
dashlang,0.0.7,0.0.8,7,2,3,3,6,2,FALSE
dashlang,0.0.34,0.0.35,34,2,3,2,5,2,FALSE
dashlang,0.0.1,0.0.2,1,3,21,13,34,4,FALSE
dashlang,0.0.3,0.0.4,3,3,6,2,8,3,FALSE
dashlang,0.0.2,0.0.3,2,2,3,2,5,3,FALSE
dashlang,0.1.4,0.1.5,68,1,1,1,2,1,FALSE
dashlang,0.0.9,0.0.10,9,1,2,0,2,1,FALSE
dashlang,0.0.8,0.0.9,8,2,19,5,24,3,FALSE
dashlang,0.1.5,0.1.6,69,4,4,4,8,4,FALSE
dashlang,0.1.6,0.1.7,70,3,13,6,19,4,FALSE
dashlang,0.1.7,0.1.8,71,2,2,1,3,2,FALSE
dashlang,0.0.48,0.0.49,48,3,11,11,22,3,FALSE
dashlang,0.0.6,0.0.7,6,2,2,2,4,2,FALSE
dashlang,0.0.42,0.0.43,42,3,8,11,19,5,FALSE
dashlang,0.0.43,0.0.44,43,2,111,148,259,2,FALSE
dashlang,0.0.40,0.0.41,40,3,17,5,22,3,FALSE
dashlang,0.0.41,0.0.42,41,3,25,23,48,3,FALSE
dashlang,0.0.46,0.0.47,46,1,1,1,2,1,FALSE
dashlang,0.0.47,0.0.48,47,9,17,12,29,9,FALSE
dashlang,0.0.44,0.0.45,44,7,25,16,41,8,FALSE
dashlang,0.0.45,0.0.46,45,3,55,9,64,4,FALSE
dashlang,0.1.12,0.1.13,76,1,1,1,2,1,FALSE
dashlang,0.1.13,0.1.14,77,2,3,3,6,2,FALSE
dashlang,0.1.10,0.1.11,74,2,24,5,29,3,FALSE
dashlang,0.1.11,0.1.12,75,3,50,48,98,3,FALSE
dashlang,0.1.16,0.2.0,80,6,42,30,72,8,FALSE
dashlang,0.1.14,0.1.15,78,2,9,6,15,3,FALSE
dashlang,0.1.15,0.1.16,79,2,2,2,4,2,FALSE
dashlang,0.0.32,0.0.33,32,10,41,31,72,11,FALSE
dashlang,0.3.1,0.3.2,88,3,4,3,7,3,TRUE
dashlang,0.0.10,0.0.11,10,4,7,4,11,4,TRUE
dashlang,0.0.29,0.0.30,29,4,19,4,23,4,TRUE
dashlang,0.2.5,0.3.0,86,2,54,5,59,5,TRUE
dashlang,0.5.1,0.5.2,117,5,12,9,21,5,TRUE
dashlang,0.5.3,0.5.4,119,3,4,2,6,3,TRUE
pure-stamp,0.1.12,0.1.13,12,3,4731,1786,6517,15,FALSE
pure-stamp,0.1.13,0.1.14,13,3,891,878,1769,10,TRUE
pure-stamp,0.1.10,0.1.11,10,3,11,7,18,3,FALSE
pure-stamp,0.1.11,0.1.12,11,3,1268,1036,2304,8,FALSE
pure-stamp,0.1.14,0.2.0,14,3,929,3649,4578,12,FALSE
pure-stamp,0.1.8,0.1.9,8,2,5172,760,5932,9,FALSE
pure-stamp,0.1.9,0.1.10,9,2,2,2,4,2,FALSE
pure-stamp,0.2.0,0.2.1,15,3,2864,20,2884,4,TRUE
pure-stamp,0.1.1,0.1.2,1,2,63,5,68,4,FALSE
pure-stamp,0.1.2,0.1.3,2,2,5613,1,5614,26,FALSE
pure-stamp,0.1.3,0.1.4,3,2,2,2,4,2,FALSE
pure-stamp,0.1.4,0.1.5,4,3,17,5,22,3,FALSE
pure-stamp,0.1.5,0.1.6,5,3,21,10,31,5,FALSE
pure-stamp,0.1.6,0.1.7,6,4,239,175,414,9,FALSE
pure-stamp,0.1.7,0.1.8,7,4,597,307,904,9,FALSE
pure-stamp,0.1.13,0.1.14,13,3,891,878,1769,10,FALSE
pure-stamp,0.2.0,0.2.1,15,3,2864,20,2884,4,FALSE
pure-stamp,0.1.14,0.2.0,14,3,929,3649,4578,12,TRUE
dubbo-client-zookeeper-hessian,1.0.4,1.0.5,5,2,50,67,117,4,FALSE
dubbo-client-zookeeper-hessian,1.0.5,1.0.6,6,2,16,11,27,4,FALSE
dubbo-client-zookeeper-hessian,1.0.6,1.0.7,7,1,0,2,2,1,FALSE
dubbo-client-zookeeper-hessian,1.0.7,1.0.8,8,3,565,508,1073,7,TRUE
dubbo-client-zookeeper-hessian,1.0.0,1.0.1,1,5,78,424,502,14,FALSE
dubbo-client-zookeeper-hessian,1.0.1,1.0.2,2,2,1,3,4,2,FALSE
dubbo-client-zookeeper-hessian,1.0.2,1.0.3,3,2,6,6,12,4,FALSE
dubbo-client-zookeeper-hessian,1.0.3,1.0.4,4,2,4,4,8,4,FALSE
dubbo-client-zookeeper-hessian,1.0.8,1.0.9,9,1,5,3,8,2,FALSE
dubbo-client-zookeeper-hessian,1.0.9,1.0.10,10,1,29,94,123,5,FALSE
dubbo-client-zookeeper-hessian,1.0.16,1.0.18,17,1,9,8,17,4,FALSE
dubbo-client-zookeeper-hessian,1.0.14,1.0.15,15,1,10,6,16,4,FALSE
dubbo-client-zookeeper-hessian,1.0.15,1.0.16,16,1,15,11,26,4,FALSE
dubbo-client-zookeeper-hessian,1.0.12,1.0.13,13,3,11,3,14,5,FALSE
dubbo-client-zookeeper-hessian,1.0.13,1.0.14,14,1,2,2,4,2,FALSE
dubbo-client-zookeeper-hessian,1.0.10,1.0.11,11,1,2,8,10,4,FALSE
dubbo-client-zookeeper-hessian,1.0.11,1.0.12,12,2,9,5,14,6,FALSE
dubbo-client-zookeeper-hessian,1.0.18,1.0.19,18,1,2,2,4,1,FALSE
dubbo-client-zookeeper-hessian,1.0.19,1.0.20,19,1,4,4,8,3,FALSE
dubbo-client-zookeeper-hessian,1.0.21,1.0.22,21,2,18,14,32,6,FALSE
dubbo-client-zookeeper-hessian,1.0.20,1.0.21,20,1,2,8,10,4,FALSE
dubbo-client-zookeeper-hessian,1.0.7,1.0.8,8,3,565,508,1073,7,FALSE
dubbo-client-zookeeper-hessian,1.0.22,1.0.23,22,1,2,2,4,2,FALSE
dubbo-client-zookeeper-hessian,1.0.22,1.0.23,22,1,2,2,4,2,TRUE
waterwheel,0.9.1,1.0.1,11,5,7,7,14,7,FALSE
waterwheel,1.0.1,1.1.0,12,8,4327,839,5166,28,FALSE
waterwheel,1.1.0,1.2.0,13,8,1527,897,2424,44,FALSE
waterwheel,0.8.1,0.9.1,10,7,1071,1059,2130,46,FALSE
waterwheel,1.3.0,1.3.1,15,6,164,34,198,36,FALSE
waterwheel,1.2.0,1.3.0,14,4,68,4,72,6,FALSE
waterwheel,0.3.0,0.4.0,1,6,1216,188,1404,24,FALSE
waterwheel,0.6.6,0.7.4,8,22,1351,1005,2356,68,FALSE
waterwheel,0.6.5,0.6.6,7,1,2,3,5,1,FALSE
waterwheel,0.6.4,0.6.5,6,2,6,2,8,3,FALSE
waterwheel,0.4.1,0.4.2,3,4,182,100,282,15,FALSE
waterwheel,0.4.0,0.4.1,2,6,71,39,110,16,FALSE
waterwheel,0.4.2,0.5.0,4,11,608,17,625,26,FALSE
waterwheel,0.5.0,0.6.4,5,18,194,54,248,38,FALSE
waterwheel,0.7.4,0.8.1,9,2,750,124,874,22,FALSE
waterwheel,0.6.4,0.6.5,6,2,6,2,8,3,TRUE
waterwheel,0.3.0,0.4.0,1,6,1216,188,1404,24,TRUE
es6-react-component,1.0.4,1.0.5,8,1,11,15,26,4,FALSE
es6-react-component,1.0.5,1.1.0,9,3,53,38,91,6,FALSE
es6-react-component,3.1.1,3.1.2,33,1,0,1,1,1,FALSE
es6-react-component,1.1.2,1.2.0,12,5,200,37,237,22,FALSE
es6-react-component,1.0.0,1.0.1,4,1,4,4,8,3,FALSE
es6-react-component,1.0.1,1.0.2,5,4,31,31,62,11,FALSE
es6-react-component,1.0.2,1.0.3,6,1,7,9,16,2,FALSE
es6-react-component,1.1.0,1.1.1,10,1,1,1,2,1,FALSE
es6-react-component,3.1.0,3.1.1,32,5,158,84,242,27,FALSE
es6-react-component,2.2.1,2.2.2,29,6,65,29,94,13,FALSE
es6-react-component,2.2.0,2.2.1,28,1,1,4,5,3,TRUE
es6-react-component,2.2.2,3.0.0,30,2,16,2,18,2,FALSE
es6-react-component,2.1.2,2.1.3,26,1,0,1,1,1,FALSE
es6-react-component,2.1.3,2.2.0,27,4,37,23,60,12,TRUE
es6-react-component,2.1.0,2.1.1,24,1,0,1,1,1,FALSE
es6-react-component,2.1.1,2.1.2,25,1,34,12,46,5,FALSE
es6-react-component,0.0.1,0.0.2,1,1,0,1,1,1,FALSE
es6-react-component,3.0.0,3.1.0,31,8,80,52,132,21,FALSE
es6-react-component,0.0.3,1.0.0,3,2,1,3,4,2,FALSE
es6-react-component,0.0.2,0.0.3,2,4,39,21,60,9,FALSE
es6-react-component,3.1.4,3.2.0,36,6,121,126,247,18,FALSE
es6-react-component,2.0.0,2.1.0,23,1,1,1,2,1,FALSE
es6-react-component,1.2.0,1.2.1,13,1,4,4,8,2,FALSE
es6-react-component,3.1.2,3.1.3,34,1,0,1,1,1,FALSE
es6-react-component,1.1.1,1.1.2,11,1,0,1,1,1,FALSE
es6-react-component,1.2.6,1.2.7,19,1,5,1,6,2,FALSE
es6-react-component,1.2.7,1.2.8,20,1,0,1,1,1,FALSE
es6-react-component,1.2.4,1.2.5,17,3,20,13,33,7,FALSE
es6-react-component,1.2.5,1.2.6,18,1,0,1,1,1,FALSE
es6-react-component,1.2.2,1.2.3,15,2,20,21,41,3,FALSE
es6-react-component,1.2.3,1.2.4,16,4,13,7,20,9,FALSE
es6-react-component,3.1.3,3.1.4,35,5,103,33,136,19,FALSE
es6-react-component,1.2.1,1.2.2,14,3,10,10,20,3,FALSE
es6-react-component,1.2.8,1.3.0,21,1,0,1,1,1,FALSE
es6-react-component,1.0.3,1.0.4,7,1,11,13,24,4,FALSE
es6-react-component,1.3.0,2.0.0,22,3,12,12,24,6,FALSE
es6-react-component,3.2.0,4.0.0,37,23,412,222,634,59,FALSE
es6-react-component,7.0.2,7.0.3,44,3,4,4,8,3,FALSE
es6-react-component,4.0.0,5.0.0,38,2,40,13,53,6,FALSE
es6-react-component,6.0.1,7.0.0,41,7,40,59,99,19,FALSE
es6-react-component,7.0.1,7.0.2,43,2,4,5,9,2,FALSE
es6-react-component,7.0.3,7.0.4,45,2,3,3,6,2,FALSE
es6-react-component,7.0.0,7.0.1,42,2,12,5,17,4,FALSE
es6-react-component,6.0.0,6.0.1,40,2,11,2,13,3,FALSE
es6-react-component,5.0.0,6.0.0,39,5,67,62,129,14,FALSE
es6-react-component,1.1.2,1.2.0,12,5,200,37,237,22,TRUE
es6-react-component,2.2.0,2.2.1,28,1,1,4,5,3,FALSE
es6-react-component,2.1.3,2.2.0,27,4,37,23,60,12,FALSE
es6-react-component,3.1.3,3.1.4,35,5,103,33,136,19,TRUE
es6-react-component,1.2.1,1.2.2,14,3,10,10,20,3,TRUE
es6-react-component,0.0.2,0.0.3,2,4,39,21,60,9,TRUE
es6-react-component,1.0.1,1.0.2,5,4,31,31,62,11,TRUE
iconr,0.6.1,0.7.0,40,35,2848,1840,4688,78,FALSE
iconr,0.6.0,0.6.1,39,6,29,7,36,9,FALSE
iconr,0.7.2,0.7.3,43,16,1279,1155,2434,70,FALSE
iconr,0.7.3,0.8.0,44,9,28,1449,1477,46,FALSE
iconr,0.7.0,0.7.1,41,9,41,388,429,18,FALSE
iconr,0.7.1,0.7.2,42,16,396,178,574,35,FALSE
iconr,0.4.9,0.5.0,30,8,25,18,43,12,FALSE
iconr,0.4.8,0.4.9,29,7,25,22,47,10,FALSE
iconr,0.5.4,0.5.5,35,22,190,197,387,43,FALSE
iconr,0.5.5,0.5.6,36,1,1208,525,1733,6,FALSE
iconr,0.5.6,0.5.7,37,1,1208,525,1733,6,FALSE
iconr,0.5.7,0.6.0,38,1,1,1,2,1,FALSE
iconr,0.5.0,0.5.1,31,8,80,40,120,14,FALSE
iconr,0.5.1,0.5.2,32,4,50,34,84,8,FALSE
iconr,0.5.2,0.5.3,33,1,1208,525,1733,6,FALSE
iconr,0.5.3,0.5.4,34,4,13,15,28,4,FALSE
iconr,0.8.4,0.8.5,49,4,4,4,8,4,FALSE
iconr,0.8.1,0.8.2,46,9,105,87,192,17,FALSE
iconr,0.8.0,0.8.1,45,2,3,1,4,2,FALSE
iconr,0.8.3,0.8.4,48,17,207,425,632,20,FALSE
iconr,0.8.2,0.8.3,47,2,1,5,6,2,FALSE
iconr,0.4.7,0.4.8,28,4,5,5,10,5,FALSE
iconr,0.4.6,0.4.7,27,2,68,32,100,7,FALSE
iconr,0.2.2,0.3.0,19,25,368,228,596,50,FALSE
iconr,0.2.1,0.2.2,18,5,43,9,52,6,TRUE
iconr,0.2.0,0.2.1,17,5,13,11,24,7,FALSE
iconr,0.4.9,0.5.0,30,8,25,18,43,12,TRUE
iconr,0.5.3,0.5.4,34,4,13,15,28,4,TRUE
iconr,0.4.1,0.4.2,22,4,38,46,84,9,FALSE
iconr,0.4.0,0.4.1,21,1,1208,525,1733,6,FALSE
iconr,0.4.3,0.4.4,24,1,1,1,2,1,FALSE
iconr,0.1.12,0.1.13,12,13,237,199,436,33,FALSE
iconr,0.1.13,0.1.14,13,2,1,3,4,3,FALSE
iconr,0.4.2,0.4.3,23,1,1208,525,1733,6,FALSE
iconr,0.1.16,0.1.17,15,2,11,5,16,3,FALSE
iconr,0.1.17,0.2.0,16,12,70,56,126,33,FALSE
iconr,0.1.14,0.1.16,14,7,63,21,84,14,FALSE
iconr,0.4.5,0.4.6,26,8,91,55,146,11,FALSE
iconr,0.4.4,0.4.5,25,9,135,371,506,22,FALSE
iconr,0.3.0,0.4.0,20,1,1208,525,1733,6,FALSE
iconr,0.1.8,0.1.9,8,4,30,22,52,4,FALSE
iconr,0.1.9,0.1.10,9,7,35,33,68,17,FALSE
iconr,0.2.1,0.2.2,18,5,43,9,52,6,FALSE
iconr,0.1.0,0.1.1,1,1,1208,525,1733,6,FALSE
iconr,0.1.1,0.1.2,2,1,2,5,7,3,FALSE
iconr,0.1.2,0.1.4,3,12,140,47,187,26,FALSE
iconr,0.1.4,0.1.5,4,2,2,1,3,2,FALSE
iconr,0.1.5,0.1.6,5,3,17,7,24,5,FALSE
iconr,0.1.6,0.1.7,6,2,16,5,21,6,FALSE
iconr,0.1.7,0.1.8,7,8,78,36,114,12,FALSE
iconr,0.1.11,0.1.12,11,5,194,46,240,14,FALSE
iconr,0.1.10,0.1.11,10,7,100,44,144,14,FALSE
iconr,0.5.1,0.5.2,32,4,50,34,84,8,TRUE
iconr,0.8.1,0.8.2,46,9,105,87,192,17,TRUE
iconr,0.8.4,0.8.5,49,4,4,4,8,4,TRUE
iconr,0.4.6,0.4.7,27,2,68,32,100,7,TRUE
noflux,1.1.3,1.1.4,6,2,10,8,18,2,FALSE
noflux,1.1.5,1.1.6,8,3,14,2,16,3,FALSE
noflux,2.0.1,2.1.0,13,3,15,2,17,4,FALSE
noflux,1.1.7,1.1.8,10,1,1,1,2,1,FALSE
noflux,2.0.0,2.0.1,12,2,17,3,20,4,FALSE
noflux,1.1.8,2.0.0,11,4,34,36,70,9,FALSE
noflux,1.1.6,1.1.7,9,2,29,5,34,3,FALSE
noflux,2.2.1,2.2.2,17,8,48,8,56,9,FALSE
noflux,2.2.0,2.2.1,16,3,378,167,545,10,FALSE
noflux,2.2.3,2.2.4,19,1,9,1,10,2,FALSE
noflux,2.2.2,2.2.3,18,2,8,4,12,3,FALSE
noflux,2.1.0,2.1.1,14,2,7,5,12,3,FALSE
noflux,2.1.1,2.2.0,15,3,229,4,233,8,FALSE
noflux,1.1.4,1.1.5,7,2,46,2,48,2,FALSE
noflux,1.1.1,1.1.2,4,2,2,1,3,2,FALSE
noflux,1.1.0,1.1.1,3,2,2,2,4,2,FALSE
noflux,1.1.2,1.1.3,5,2,2,2,4,2,FALSE
noflux,1.0.0,1.0.1,1,2,2,2,4,2,FALSE
noflux,1.0.1,1.1.0,2,2,8,3,11,3,FALSE
noflux,2.2.3,2.2.4,19,1,9,1,10,2,TRUE
wolkenkratzer,0.4.10,0.5.0,33,16,332,68751,69083,91,FALSE
wolkenkratzer,0.4.9,0.4.10,32,1,23394,4,23398,7,FALSE
wolkenkratzer,0.4.8,0.4.9,31,7,23824,331,24155,23,FALSE
wolkenkratzer,0.4.7,0.4.8,30,13,1046,521,1567,64,FALSE
wolkenkratzer,0.5.4,0.6.0,37,29,127754,9227,136981,351,FALSE
wolkenkratzer,0.5.0,0.5.1,34,3,286,14,300,12,FALSE
wolkenkratzer,0.5.1,0.5.2,35,1,4,7,11,3,FALSE
wolkenkratzer,0.5.2,0.5.4,36,7,72798,53916,126714,294,FALSE
wolkenkratzer,0.0.3,0.0.5,3,6,514,24,538,8,FALSE
wolkenkratzer,0.0.2,0.0.3,2,1,21,11,32,1,FALSE
wolkenkratzer,0.5.0,0.5.1,34,3,286,14,300,12,TRUE
wolkenkratzer,0.5.2,0.5.4,36,7,72798,53916,126714,294,TRUE
wolkenkratzer,0.2.5,0.3.1,18,2,2443,3109,5552,512,FALSE
wolkenkratzer,0.2.4,0.2.5,17,1,53,101,154,3,FALSE
wolkenkratzer,0.2.3,0.2.4,16,1,6,6432,6438,3,FALSE
wolkenkratzer,0.2.2,0.2.3,15,1,6430,2,6432,2,FALSE
wolkenkratzer,0.2.1,0.2.2,14,2,57,1,58,3,FALSE
wolkenkratzer,0.2.0,0.2.1,13,1,464,464,928,461,FALSE
wolkenkratzer,0.1.0,0.1.1,8,2,10,7,17,5,FALSE
wolkenkratzer,0.1.1,0.1.2,9,5,2904,2951,5855,152,FALSE
wolkenkratzer,0.1.2,0.1.3,10,6,195727,441,196168,573,FALSE
wolkenkratzer,0.1.3,0.1.4,11,4,1789,494,2283,474,FALSE
wolkenkratzer,0.1.4,0.2.0,12,5,9295,6768,16063,1416,FALSE
wolkenkratzer,0.0.5,0.0.6,4,3,219,1825,2044,56,FALSE
wolkenkratzer,0.0.7,0.0.8,6,6,2231,1923,4154,80,FALSE
wolkenkratzer,0.0.6,0.0.7,5,2,195,50,245,7,FALSE
wolkenkratzer,0.0.1,0.0.2,1,1,2,2,4,1,FALSE
wolkenkratzer,0.3.2,0.3.3,20,1,5,2,7,1,FALSE
wolkenkratzer,0.3.3,0.3.4,21,2,4520,1739,6259,476,FALSE
wolkenkratzer,0.3.1,0.3.2,19,1,861,883,1744,490,FALSE
wolkenkratzer,0.0.8,0.1.0,7,4,209,179,388,18,FALSE
wolkenkratzer,0.3.4,0.4.0,22,16,4634,197038,201672,624,FALSE
wolkenkratzer,0.4.1,0.4.2,24,1,253,8,261,6,FALSE
wolkenkratzer,0.4.0,0.4.1,23,5,83,40,123,6,FALSE
wolkenkratzer,0.4.3,0.4.4,26,1,117,96,213,15,FALSE
wolkenkratzer,0.4.2,0.4.3,25,1,261,29,290,4,FALSE
wolkenkratzer,0.4.6,0.4.7,29,8,2223,2696,4919,112,FALSE
wolkenkratzer,0.4.5,0.4.6,28,5,729,141,870,63,FALSE
wolkenkratzer,0.4.4,0.4.5,27,1,9,4,13,3,FALSE
wolkenkratzer,0.4.1,0.4.2,24,1,253,8,261,6,TRUE
wolkenkratzer,0.2.5,0.3.1,18,2,2443,3109,5552,512,TRUE
wolkenkratzer,0.0.5,0.0.6,4,3,219,1825,2044,56,TRUE
wolkenkratzer,0.3.3,0.3.4,21,2,4520,1739,6259,476,TRUE
wolkenkratzer,0.0.8,0.1.0,7,4,209,179,388,18,TRUE
wolkenkratzer,0.2.1,0.2.2,14,2,57,1,58,3,TRUE
wolkenkratzer,0.4.6,0.4.7,29,8,2223,2696,4919,112,TRUE
wolkenkratzer,0.5.4,0.6.0,37,29,127754,9227,136981,351,TRUE
random-number-display,0.0.5,0.0.6,5,1,1,1,2,1,FALSE
random-number-display,0.0.4,0.0.5,4,1,1,1,2,1,FALSE
random-number-display,0.0.7,0.0.8,7,1,1,1,2,1,FALSE
random-number-display,0.0.6,0.0.7,6,1,1,1,2,1,FALSE
random-number-display,0.0.1,0.0.2,1,2,3,1,4,2,FALSE
random-number-display,0.0.3,0.0.4,3,2,3,3,6,2,FALSE
random-number-display,0.0.2,0.0.3,2,2,15,9,24,5,FALSE
random-number-display,0.0.9,0.0.10,9,1,1,1,2,1,FALSE
random-number-display,0.0.8,0.0.9,8,1,1,1,2,1,FALSE
random-number-display,0.0.11,0.0.12,11,1,1,1,2,1,FALSE
random-number-display,0.0.10,0.0.11,10,1,1,1,2,1,FALSE
random-number-display,0.0.13,0.0.14,13,1,1,1,2,1,FALSE
random-number-display,0.0.12,0.0.13,12,1,1,1,2,1,FALSE
random-number-display,0.0.4,0.0.5,4,1,1,1,2,1,TRUE
random-number-display,0.0.13,0.0.14,13,1,1,1,2,1,TRUE
react-middleware,1.1.1,1.1.2,7,3,3,3,6,3,FALSE
react-middleware,1.1.0,1.1.1,6,5,139,70,209,7,FALSE
react-middleware,1.0.6,1.0.7,3,2,32,4,36,4,FALSE
react-middleware,1.0.7,1.0.8,4,9,157,74,231,22,FALSE
react-middleware,1.1.5,1.1.6,11,3,18,19,37,3,FALSE
react-middleware,1.1.4,1.1.5,10,2,17,17,34,2,FALSE
react-middleware,1.1.7,1.1.8,13,2,7,6,13,2,FALSE
react-middleware,1.1.6,1.1.7,12,4,23,16,39,5,FALSE
react-middleware,1.1.9,1.2.0,15,3,31,39,70,6,FALSE
react-middleware,1.1.8,1.1.9,14,2,2,2,4,2,TRUE
react-middleware,1.0.8,1.1.0,5,5,64,36,100,24,FALSE
react-middleware,1.1.3,1.1.4,9,2,7,1,8,2,FALSE
react-middleware,1.1.2,1.1.3,8,6,323,39,362,22,FALSE
react-middleware,2.2.1,2.2.2,24,3,15,15,30,3,FALSE
react-middleware,2.2.0,2.2.1,23,2,5,20,25,4,FALSE
react-middleware,2.2.3,2.2.4,26,5,151,91,242,29,FALSE
react-middleware,2.2.2,2.2.3,25,3,26,12,38,9,FALSE
react-middleware,2.1.0,2.2.0,22,1,40,46,86,9,FALSE
react-middleware,2.0.2,2.1.0,21,12,944,946,1890,45,FALSE
react-middleware,2.0.1,2.0.2,20,2,53,13,66,5,FALSE
react-middleware,2.0.0,2.0.1,19,4,28,12,40,4,FALSE
react-middleware,1.2.2,2.0.0,18,5,108,60,168,12,FALSE
react-middleware,1.2.0,1.2.1,16,3,33,36,69,9,FALSE
react-middleware,1.2.1,1.2.2,17,5,67,45,112,16,FALSE
react-middleware,1.0.4,1.0.5,1,3,12,11,23,6,FALSE
react-middleware,1.0.5,1.0.6,2,2,2,4,6,2,FALSE
react-middleware,1.1.8,1.1.9,14,2,2,2,4,2,FALSE
react-middleware,2.0.2,2.1.0,21,12,944,946,1890,45,TRUE
react-middleware,1.1.2,1.1.3,8,6,323,39,362,22,TRUE
react-svg-camera,1.1.0,1.1.1,2,6,101,49,150,11,FALSE
react-svg-camera,1.0.0,1.1.0,1,4,219,287,506,12,FALSE
react-svg-camera,1.1.0,1.1.1,2,6,101,49,150,11,TRUE
roots-records,0.0.2,0.1.0,1,8,45,46,91,10,FALSE
roots-records,0.3.2,0.3.3,7,2,16,18,34,4,FALSE
roots-records,0.3.3,0.4.0,8,14,123,54,177,29,FALSE
roots-records,0.3.0,0.3.1,5,7,307,11,318,26,FALSE
roots-records,0.3.1,0.3.2,6,3,5,5,10,5,FALSE
roots-records,0.2.0,0.3.0,4,4,127,53,180,13,FALSE
roots-records,0.1.0,0.1.2,2,1,70,49,119,2,FALSE
roots-records,0.1.2,0.2.0,3,1,1,1,2,1,FALSE
roots-records,0.4.0,0.5.0,9,21,1343,863,2206,167,FALSE
roots-records,0.5.0,0.5.1,10,3,53,5,58,11,FALSE
roots-records,0.3.0,0.3.1,5,7,307,11,318,26,TRUE
roots-records,0.5.0,0.5.1,10,3,53,5,58,11,TRUE
roots-records,0.0.2,0.1.0,1,8,45,46,91,10,TRUE
rx-flow-extensions,1.1.1,1.2.0,6,2,62,91,153,4,FALSE
rx-flow-extensions,1.1.0,1.1.1,5,1,30,3,33,3,FALSE
rx-flow-extensions,1.0.0,1.0.1,1,1,137,3,140,4,FALSE
rx-flow-extensions,1.0.1,1.0.2,2,1,2,2,4,2,FALSE
rx-flow-extensions,1.0.2,1.0.3,3,2,5,3,8,3,FALSE
rx-flow-extensions,1.0.3,1.1.0,4,1,76,4,80,5,FALSE
rx-flow-extensions,1.5.0,1.5.1,12,2,18,2,20,3,FALSE
rx-flow-extensions,1.3.0,1.4.0,10,3,92,60,152,7,FALSE
rx-flow-extensions,1.2.2,1.3.0,9,1,16,2,18,2,FALSE
rx-flow-extensions,1.2.0,1.2.1,7,1,4,3,7,2,FALSE
rx-flow-extensions,1.2.1,1.2.2,8,3,89,64,153,12,FALSE
rx-flow-extensions,1.4.0,1.5.0,11,2,22,3,25,3,FALSE
rx-flow-extensions,1.0.2,1.0.3,3,2,5,3,8,3,TRUE
rx-flow-extensions,1.0.3,1.1.0,4,1,76,4,80,5,TRUE
getpath,0.1.0,0.1.1,3,3,10,4,14,3,FALSE
getpath,0.0.1,0.0.2,1,4,67,2,69,7,FALSE
getpath,0.0.2,0.1.0,2,2,2,2,4,2,TRUE
modelizr,0.7.5,0.7.6,42,9,102,47,149,24,FALSE
modelizr,1.0.0,1.0.1,60,4,21,6,27,7,FALSE
modelizr,0.4.13,0.4.14,31,2,2,2,4,2,FALSE
modelizr,1.0.0-beta.8,1.0.0-beta.9,55,3,80,38,118,12,FALSE
modelizr,1.0.0-beta.9,1.0.0-beta.10,56,4,1031,270,1301,26,FALSE
modelizr,1.0.0-beta.6,1.0.0-beta.7,53,4,11,11,22,5,FALSE
modelizr,1.0.0-beta.7,1.0.0-beta.8,54,4,30,15,45,9,FALSE
modelizr,1.0.0-beta.4,1.0.0-beta.5,51,4,74,49,123,8,FALSE
modelizr,1.0.0-beta.5,1.0.0-beta.6,52,2,2,2,4,2,FALSE
modelizr,1.0.0-beta.2,1.0.0-beta.3,49,5,785,681,1466,46,FALSE
modelizr,1.0.0-beta.3,1.0.0-beta.4,50,6,6583,1769,8352,92,FALSE
modelizr,1.0.0-beta.1,1.0.0-beta.2,48,4,168,40,208,14,FALSE
modelizr,0.4.14,0.5.0,32,4,131,38,169,13,FALSE
modelizr,0.7.8,0.7.9,45,3,28,28,56,4,FALSE
modelizr,0.7.9,0.7.10,46,6,99,43,142,10,FALSE
modelizr,0.3.2,0.3.3,17,2,34,22,56,6,FALSE
modelizr,0.3.3,0.4.0,18,3,586,463,1049,34,FALSE
modelizr,0.3.0,0.3.1,15,2,2,2,4,2,FALSE
modelizr,0.6.0,0.6.1,35,18,4634,4391,9025,80,FALSE
modelizr,0.7.2,0.7.3,39,7,159,78,237,30,FALSE
modelizr,0.7.3,0.7.4,40,4,20,9,29,7,FALSE
modelizr,0.7.0,0.7.1,37,3,72,15,87,3,FALSE
modelizr,0.7.1,0.7.2,38,3,257,106,363,22,FALSE
modelizr,0.4.9,0.4.10,27,2,2,1,3,2,FALSE
modelizr,0.4.8,0.4.9,26,2,73,45,118,9,FALSE
modelizr,0.4.1,0.4.3,20,4,127,31,158,16,FALSE
modelizr,0.4.0,0.4.1,19,2,107,53,160,14,FALSE
modelizr,0.4.3,0.4.4,21,2,38,22,60,4,FALSE
modelizr,0.4.5,0.4.6,23,2,9,9,18,5,FALSE
modelizr,0.4.4,0.4.5,22,2,2,2,4,2,FALSE
modelizr,0.4.7,0.4.8,25,2,6,6,12,2,FALSE
modelizr,0.4.6,0.4.7,24,2,4,3,7,3,FALSE
modelizr,0.4.11,0.4.12,29,2,82,26,108,4,FALSE
modelizr,0.4.10,0.4.11,28,2,131,39,170,10,FALSE
modelizr,0.3.0-rc4,0.3.0,14,2,6,6,12,2,FALSE
modelizr,0.4.12,0.4.13,30,2,4,4,8,4,FALSE
modelizr,0.3.0-rc2,0.3.0-rc3,12,2,22,2,24,4,FALSE
modelizr,0.3.0-rc3,0.3.0-rc4,13,2,118,111,229,8,FALSE
modelizr,1.0.0-beta.12,1.0.0,59,8,454,131,585,31,FALSE
modelizr,0.3.0-rc1,0.3.0-rc2,11,2,47,11,58,5,FALSE
modelizr,0.7.10,1.0.0-beta.1,47,17,4560,1616,6176,101,FALSE
modelizr,1.0.0-beta.10,1.0.0-beta.11,57,8,2138,2640,4778,117,FALSE
modelizr,0.3.1,0.3.2,16,2,7,7,14,3,FALSE
modelizr,0.5.0,0.5.1,33,2,22,10,32,8,FALSE
modelizr,0.5.1,0.6.0,34,11,645,382,1027,61,FALSE
modelizr,0.7.6,0.7.7,43,7,141,114,255,25,FALSE
modelizr,1.0.0-beta.11,1.0.0-beta.12,58,4,19,14,33,9,FALSE
modelizr,0.7.7,0.7.8,44,6,115,41,156,10,FALSE
modelizr,0.6.1,0.7.0,36,13,1470,850,2320,97,FALSE
modelizr,0.7.4,0.7.5,41,6,272,115,387,24,FALSE
modelizr,0.1.1,0.1.2,2,2,43,48,91,2,FALSE
modelizr,0.2.0,0.2.1,9,2,5,4,9,3,FALSE
modelizr,0.2.1,0.3.0-rc1,10,5,916,714,1630,37,FALSE
modelizr,0.1.0,0.1.1,1,2,81,44,125,7,FALSE
modelizr,0.1.3,0.1.4,4,2,118,55,173,2,FALSE
modelizr,0.1.4,0.1.5,5,3,18,8,26,3,FALSE
modelizr,0.1.5,0.1.6,6,2,26,4,30,5,TRUE
modelizr,0.1.2,0.1.3,3,2,3,23,26,5,FALSE
modelizr,0.1.7,0.2.0,8,3,144,70,214,6,TRUE
modelizr,0.1.6,0.1.7,7,2,13,12,25,2,FALSE
modelizr,0.6.1,0.7.0,36,13,1470,850,2320,97,TRUE
modelizr,0.1.5,0.1.6,6,2,26,4,30,5,FALSE
modelizr,0.1.7,0.2.0,8,3,144,70,214,6,FALSE
modelizr,0.2.1,0.3.0-rc1,10,5,916,714,1630,37,TRUE
modelizr,0.7.5,0.7.6,42,9,102,47,149,24,TRUE
modelizr,0.7.0,0.7.1,37,3,72,15,87,3,TRUE
modelizr,0.1.3,0.1.4,4,2,118,55,173,2,TRUE
modelizr,0.4.9,0.4.10,27,2,2,1,3,2,TRUE
modelizr,1.0.0-beta.8,1.0.0-beta.9,55,3,80,38,118,12,TRUE
modelizr,0.4.1,0.4.3,20,4,127,31,158,16,TRUE
modelizr,0.4.3,0.4.4,21,2,38,22,60,4,TRUE
modelizr,0.4.10,0.4.11,28,2,131,39,170,10,TRUE
thorken,1.1.1,1.2.0,3,2,87,3,90,5,FALSE
thorken,1.1.0,1.1.1,2,5,171,6,177,11,FALSE
thorken,1.0.0,1.1.0,1,2,113,41,154,7,FALSE
thorken,1.2.0,1.2.1,4,4,36,10,46,5,FALSE
thorken,1.2.1,1.3.0,5,2,80,2,82,5,FALSE
thorken,1.2.1,1.3.0,5,2,80,2,82,5,TRUE
thorken,1.2.0,1.2.1,4,4,36,10,46,5,TRUE
open-stack,1.1.7,1.1.8,9,1,19,0,19,1,FALSE
open-stack,1.1.8,1.1.11,10,1,19,0,19,1,FALSE
open-stack,1.1.24,1.1.25,24,1,19,0,19,1,FALSE
open-stack,1.1.25,1.2.0,25,1,19,0,19,1,FALSE
open-stack,1.1.20,1.1.21,20,1,19,0,19,1,FALSE
open-stack,1.1.21,1.1.22,21,1,19,0,19,1,FALSE
open-stack,1.1.22,1.1.23,22,1,19,0,19,1,FALSE
open-stack,1.1.23,1.1.24,23,1,19,0,19,1,FALSE
open-stack,1.2.6,1.2.7,32,1,19,0,19,1,FALSE
open-stack,1.2.4,1.2.5,30,1,19,0,19,1,FALSE
open-stack,1.2.5,1.2.6,31,1,19,0,19,1,FALSE
open-stack,1.2.2,1.2.3,28,1,19,0,19,1,FALSE
open-stack,1.2.3,1.2.4,29,1,19,0,19,1,FALSE
open-stack,1.2.0,1.2.1,26,1,19,0,19,1,FALSE
open-stack,1.2.1,1.2.2,27,1,19,0,19,1,FALSE
open-stack,1.1.19,1.1.20,19,1,19,0,19,1,FALSE
open-stack,1.1.18,1.1.19,18,1,19,0,19,1,FALSE
open-stack,1.1.11,1.1.12,11,1,19,0,19,1,FALSE
open-stack,1.1.13,1.1.14,13,1,19,0,19,1,FALSE
open-stack,1.1.12,1.1.13,12,1,19,0,19,1,FALSE
open-stack,1.1.15,1.1.16,15,1,19,0,19,1,FALSE
open-stack,1.1.14,1.1.15,14,1,19,0,19,1,FALSE
open-stack,1.1.17,1.1.18,17,1,19,0,19,1,FALSE
open-stack,1.1.16,1.1.17,16,1,19,0,19,1,FALSE
open-stack,1.1.5,1.1.6,7,1,19,0,19,1,FALSE
open-stack,1.1.4,1.1.5,6,1,19,0,19,1,FALSE
open-stack,1.1.6,1.1.7,8,1,19,0,19,1,FALSE
open-stack,1.1.1,1.1.2,3,1,19,0,19,1,FALSE
open-stack,1.1.0,1.1.1,2,1,19,0,19,1,FALSE
open-stack,1.1.3,1.1.4,5,1,19,0,19,1,FALSE
open-stack,1.1.2,1.1.3,4,1,19,0,19,1,FALSE
open-stack,1.2.5,1.2.6,31,1,19,0,19,1,TRUE
open-stack,1.2.2,1.2.3,28,1,19,0,19,1,TRUE
open-stack,1.1.4,1.1.5,6,1,19,0,19,1,TRUE
open-stack,1.1.24,1.1.25,24,1,19,0,19,1,TRUE
open-stack,1.1.20,1.1.21,20,1,19,0,19,1,TRUE
open-stack,1.1.15,1.1.16,15,1,19,0,19,1,TRUE
hls-ts,0.2.4,0.3.0,9,3,2214,236,2450,37,FALSE
hls-ts,0.2.3,0.2.4,8,5,683,192,875,24,FALSE
hls-ts,0.2.2,0.2.3,7,2,31,19,50,17,FALSE
hls-ts,0.2.1,0.2.2,6,2,18,18,36,17,FALSE
hls-ts,0.2.0,0.2.1,5,8,43973,115,44088,146,FALSE
hls-ts,0.1.2,0.1.4,1,3,4,4,8,4,FALSE
hls-ts,0.1.4,0.1.5,2,2,439,373,812,4,FALSE
hls-ts,0.1.5,0.1.6,3,6,419,156,575,22,FALSE
hls-ts,0.1.6,0.2.0,4,5,956,84,1040,26,FALSE
hls-ts,0.2.4,0.3.0,9,3,2214,236,2450,37,TRUE
peak,0.0.1,0.0.2,1,1,2,0,2,1,FALSE
peak,0.0.2,0.1.0,2,6,664,151,815,21,FALSE
peak,0.3.2,0.4.0,6,20,764,432,1196,71,FALSE
peak,0.3.1,0.3.2,5,5,984,720,1704,36,FALSE
peak,0.4.1,0.4.2,8,3,5,2,7,3,FALSE
peak,0.2.1,0.3.1,4,14,3376,2131,5507,142,FALSE
peak,0.1.0,0.2.1,3,20,2779,1296,4075,104,FALSE
peak,0.4.0,0.4.1,7,1,9,9,18,1,FALSE
peak,0.4.3,0.4.4,10,6,15,10,25,7,FALSE
peak,0.4.2,0.4.3,9,2,3,3,6,2,FALSE
peak,0.3.2,0.4.0,6,20,764,432,1196,71,TRUE
peak,0.3.1,0.3.2,5,5,984,720,1704,36,TRUE
babel-plugin-yui,0.0.5,0.0.6,5,3,5,5,10,5,FALSE
babel-plugin-yui,0.0.4,0.0.5,4,3,70,64,134,14,FALSE
babel-plugin-yui,0.0.6,0.0.7,6,1,4,2,6,2,FALSE
babel-plugin-yui,0.0.1,0.0.2,1,15,110,159,269,40,FALSE
babel-plugin-yui,0.0.3,0.0.4,3,1,128,228,356,17,FALSE
babel-plugin-yui,0.0.2,0.0.3,2,2,10,10,20,8,FALSE
babel-plugin-yui,0.0.4,0.0.5,4,3,70,64,134,14,TRUE
fun-react,0.3.8,0.3.9,30,1,9,3,12,3,FALSE
fun-react,0.3.2,0.3.3,24,1,26,12,38,7,FALSE
fun-react,0.3.3,0.3.4,25,1,24,7,31,4,FALSE
fun-react,0.3.1,0.3.2,23,3,2223,12,2235,59,FALSE
fun-react,0.3.6,0.3.7,28,1,31,16,47,6,FALSE
fun-react,0.3.7,0.3.8,29,2,10,3,13,4,FALSE
fun-react,0.3.4,0.3.5,26,1,13,5,18,4,FALSE
fun-react,0.3.5,0.3.6,27,1,11,9,20,4,FALSE
fun-react,0.3.3,0.3.4,25,1,24,7,31,4,TRUE
fun-react,0.3.0,0.3.1,22,9,180,14,194,16,FALSE
fun-react,0.2.0,0.3.0,21,5,251,49,300,19,FALSE
fun-react,0.1.0,0.1.1,17,3,10,3,13,5,FALSE
fun-react,0.1.1,0.1.2,18,1,37,11,48,6,FALSE
fun-react,0.1.2,0.1.3,19,1,11,1,12,4,FALSE
fun-react,0.1.3,0.2.0,20,3,156,14,170,16,FALSE
fun-react,0.0.12,0.0.13,12,1,4,4,8,5,FALSE
fun-react,0.0.15,0.0.16,15,12,909,302,1211,67,FALSE
fun-react,0.0.14,0.0.15,14,1,13,9,22,2,FALSE
fun-react,0.0.16,0.1.0,16,17,458,229,687,53,FALSE
fun-react,0.0.11,0.0.12,11,4,118,154,272,16,FALSE
fun-react,0.0.10,0.0.11,10,1,101,16,117,6,FALSE
fun-react,0.0.13,0.0.14,13,4,163,14,177,11,FALSE
fun-react,0.0.5,0.0.6,5,1,2,2,4,2,FALSE
fun-react,0.0.4,0.0.5,4,1,9,3,12,3,FALSE
fun-react,0.0.6,0.0.7,6,1,9,3,12,3,FALSE
fun-react,0.0.1,0.0.2,1,6,226,67,293,17,FALSE
fun-react,0.0.3,0.0.4,3,1,9,9,18,4,FALSE
fun-react,0.0.2,0.0.3,2,6,163,37,200,19,FALSE
fun-react,0.0.9,0.0.10,9,1,3,1,4,2,FALSE
fun-react,0.0.8,0.0.9,8,1,9,383,392,11,FALSE
fun-react,0.0.7,0.0.8,7,2,384,6,390,11,FALSE
fun-react,0.2.0,0.3.0,21,5,251,49,300,19,TRUE
fun-react,0.3.8,0.3.9,30,1,9,3,12,3,TRUE
fun-react,0.0.10,0.0.11,10,1,101,16,117,6,TRUE
fun-react,0.0.1,0.0.2,1,6,226,67,293,17,TRUE
opal-components,0.20.29,0.20.30,312,1,6,6,12,4,FALSE
opal-components,0.24.29,0.24.30,407,1,25,18,43,4,FALSE
opal-components,0.18.33,0.18.34,269,1,10,9,19,4,FALSE
opal-components,0.18.32,0.18.33,268,1,1,1,2,1,FALSE
opal-components,0.18.31,0.18.32,267,1,1,1,2,1,FALSE
opal-components,0.18.30,0.18.31,266,1,5,5,10,4,FALSE
opal-components,0.18.37,0.18.38,273,1,5,8,13,4,FALSE
opal-components,0.18.36,0.18.37,272,1,11,11,22,10,FALSE
opal-components,0.18.35,0.18.36,271,1,2,2,4,1,FALSE
opal-components,0.18.34,0.18.35,270,1,1,1,2,1,FALSE
opal-components,0.18.39,0.19.0,275,1,1,1,2,1,FALSE
opal-components,0.18.38,0.18.39,274,1,7,7,14,5,FALSE
opal-components,0.16.19,0.16.21,230,2,761,763,1524,42,FALSE
opal-components,0.16.18,0.16.19,229,1,9,2,11,4,FALSE
opal-components,0.17.0,0.18.0,236,1,15,6,21,4,FALSE
opal-components,0.18.9,0.18.10,246,1,423,418,841,88,FALSE
opal-components,0.18.8,0.18.9,245,1,33,33,66,21,FALSE
opal-components,0.24.21,0.24.22,400,1,1,1,2,1,FALSE
opal-components,0.24.20,0.24.21,399,1,1,1,2,1,FALSE
opal-components,0.24.26,0.24.28,405,1,30,4,34,6,FALSE
opal-components,0.24.25,0.24.26,404,1,1,1,2,1,FALSE
opal-components,0.24.24,0.24.25,403,1,1,1,2,1,FALSE
opal-components,0.18.1,0.18.2,238,1,98,102,200,21,FALSE
opal-components,0.18.0,0.18.1,237,1,1,1,2,1,FALSE
opal-components,0.18.3,0.18.4,240,1,1,1,2,1,FALSE
opal-components,0.24.28,0.24.29,406,1,9,5,14,5,FALSE
opal-components,0.18.5,0.18.6,242,1,95,98,193,43,FALSE
opal-components,0.18.4,0.18.5,241,1,120,121,241,43,FALSE
opal-components,0.18.7,0.18.8,244,1,22,21,43,8,FALSE
opal-components,0.18.6,0.18.7,243,1,90,97,187,43,FALSE
opal-components,0.18.20,0.18.21,257,1,22,5,27,4,FALSE
opal-components,0.18.21,0.18.22,258,1,75,66,141,54,FALSE
opal-components,0.18.22,0.18.23,259,1,9,4,13,4,FALSE
opal-components,0.18.23,0.18.24,260,1,108,119,227,33,FALSE
opal-components,0.18.24,0.18.25,261,1,6,6,12,4,FALSE
opal-components,0.18.25,0.18.27,262,2,163,164,327,48,FALSE
opal-components,0.20.18,0.20.19,301,1,20,34,54,8,FALSE
opal-components,0.20.19,0.20.20,302,1,14,15,29,5,FALSE
opal-components,0.20.16,0.20.17,299,1,4,4,8,4,FALSE
opal-components,0.18.29,0.18.30,265,1,1,1,2,1,FALSE
opal-components,0.20.14,0.20.15,297,1,123,119,242,15,FALSE
opal-components,0.20.15,0.20.16,298,1,87,83,170,7,FALSE
opal-components,0.20.12,0.20.13,295,1,8,11,19,4,FALSE
opal-components,0.20.13,0.20.14,296,1,85,92,177,22,FALSE
opal-components,0.20.10,0.20.11,293,1,4,3,7,4,FALSE
opal-components,0.20.11,0.20.12,294,1,10,3,13,4,FALSE
opal-components,0.18.28,0.18.29,264,1,5,5,10,4,FALSE
opal-components,0.20.46,0.20.47,329,1,5,10,15,4,FALSE
opal-components,0.20.17,0.20.18,300,1,9,9,18,7,FALSE
opal-components,0.21.24,0.21.25,361,1,13,14,27,4,FALSE
opal-components,0.21.20,0.21.21,358,1,1,1,2,1,FALSE
opal-components,0.20.40,0.20.41,323,1,1,1,2,1,FALSE
opal-components,0.19.4,0.19.5,280,1,29,17,46,5,FALSE
opal-components,0.20.48,0.20.49,331,1,1,1,2,1,FALSE
opal-components,0.20.43,0.20.44,326,1,42,4,46,5,FALSE
opal-components,0.19.5,0.19.6,281,1,10,10,20,10,FALSE
opal-components,0.20.42,0.20.43,325,1,54,48,102,5,FALSE
opal-components,0.21.21,0.21.22,359,1,1,1,2,1,FALSE
opal-components,0.18.19,0.18.20,256,1,84,80,164,63,FALSE
opal-components,0.18.18,0.18.19,255,1,7,9,16,4,FALSE
opal-components,0.18.15,0.18.16,252,1,65,71,136,21,FALSE
opal-components,0.20.49,0.20.50,332,1,31,32,63,10,FALSE
opal-components,0.18.17,0.18.18,254,1,7,7,14,4,FALSE
opal-components,0.18.16,0.18.17,253,1,122,128,250,35,FALSE
opal-components,0.18.11,0.18.12,248,1,59,59,118,25,FALSE
opal-components,0.18.10,0.18.11,247,1,568,568,1136,9,FALSE
opal-components,0.18.13,0.18.14,250,1,7,7,14,4,FALSE
opal-components,0.18.12,0.18.13,249,1,67,80,147,28,FALSE
opal-components,0.23.3,0.23.4,379,1,31,24,55,10,FALSE
opal-components,0.23.2,0.23.3,378,1,1,1,2,1,FALSE
opal-components,0.23.1,0.23.2,377,1,1,1,2,1,FALSE
opal-components,0.23.0,0.23.1,376,1,1,1,2,1,FALSE
opal-components,0.23.4,0.24.0,380,1,1,1,2,1,FALSE
opal-components,0.24.3,0.24.4,384,1,129,43,172,4,FALSE
opal-components,0.22.2,0.23.0,375,1,84,84,168,76,FALSE
opal-components,0.22.0,0.22.1,373,1,346,343,689,69,FALSE
opal-components,0.22.1,0.22.2,374,1,65,65,130,10,FALSE
opal-components,0.19.8,0.20.0,284,1,49,65,114,19,FALSE
opal-components,0.21.32,0.21.34,368,1,164,24,188,14,FALSE
opal-components,0.21.31,0.21.32,367,1,1,1,2,1,FALSE
opal-components,0.21.30,0.21.31,366,1,1,1,2,1,FALSE
opal-components,0.21.37,0.22.0,372,1,1,1,2,1,FALSE
opal-components,0.21.36,0.21.37,371,1,3,17,20,7,FALSE
opal-components,0.21.35,0.21.36,370,1,75,105,180,11,FALSE
opal-components,0.21.34,0.21.35,369,1,5,4,9,3,FALSE
opal-components,0.24.23,0.24.24,402,1,20,8,28,6,FALSE
opal-components,0.16.24,0.16.25,234,1,14,7,21,4,FALSE
opal-components,0.16.25,0.17.0,235,1,4,3,7,2,FALSE
opal-components,0.16.22,0.16.23,232,1,1,1,2,1,FALSE
opal-components,0.16.23,0.16.24,233,1,263,157,420,49,FALSE
opal-components,0.16.21,0.16.22,231,1,1,1,2,1,FALSE
opal-components,0.20.45,0.20.46,328,1,29,13,42,4,FALSE
opal-components,0.20.44,0.20.45,327,1,33,34,67,5,FALSE
opal-components,0.24.18,0.24.19,397,1,3334,2910,6244,38,FALSE
opal-components,0.24.19,0.24.20,398,1,1,1,2,1,FALSE
opal-components,0.20.41,0.20.42,324,1,1,1,2,1,FALSE
opal-components,0.21.25,0.21.26,362,1,30,9,39,5,FALSE
opal-components,0.21.26,0.21.27,363,1,1,1,2,1,FALSE
opal-components,0.21.27,0.21.29,364,1,1,1,2,1,FALSE
opal-components,0.21.29,0.21.30,365,2,180,204,384,23,FALSE
opal-components,0.24.10,0.24.11,391,1,196,209,405,53,FALSE
opal-components,0.24.11,0.24.14,392,1,29,29,58,7,FALSE
opal-components,0.24.16,0.24.17,395,1,20,14,34,4,FALSE
opal-components,0.24.17,0.24.18,396,1,65,17,82,13,FALSE
opal-components,0.24.14,0.24.15,393,1,706,706,1412,42,FALSE
opal-components,0.24.15,0.24.16,394,1,28,34,62,48,FALSE
opal-components,0.20.4,0.20.5,287,1,436,224,660,55,FALSE
opal-components,0.20.5,0.20.6,288,1,759,191,950,90,FALSE
opal-components,0.20.6,0.20.7,289,1,31,31,62,22,FALSE
opal-components,0.20.7,0.20.8,290,1,202,203,405,57,FALSE
opal-components,0.20.0,0.20.1,285,1,80,80,160,65,FALSE
opal-components,0.20.1,0.20.4,286,3,119,95,214,25,FALSE
opal-components,0.20.47,0.20.48,330,1,1,1,2,1,FALSE
opal-components,0.20.8,0.20.9,291,1,9,9,18,4,FALSE
opal-components,0.20.9,0.20.10,292,1,14,13,27,5,FALSE
opal-components,0.21.9,0.21.10,349,1,15,10,25,7,FALSE
opal-components,0.21.8,0.21.9,348,1,520,448,968,64,FALSE
opal-components,0.21.1,0.21.2,341,1,32,10,42,5,FALSE
opal-components,0.21.0,0.21.1,340,1,6,10,16,4,FALSE
opal-components,0.21.3,0.21.4,343,1,129,26,155,15,FALSE
opal-components,0.21.2,0.21.3,342,1,7,15,22,7,FALSE
opal-components,0.21.5,0.21.6,345,1,97,87,184,5,FALSE
opal-components,0.21.4,0.21.5,344,1,18,20,38,10,FALSE
opal-components,0.21.7,0.21.8,347,1,1,1,2,1,FALSE
opal-components,0.21.6,0.21.7,346,1,234,233,467,53,FALSE
opal-components,0.20.52,0.20.53,335,1,13,13,26,5,FALSE
opal-components,0.20.53,0.20.54,336,1,26,5,31,6,FALSE
opal-components,0.20.50,0.20.51,333,1,51,23,74,13,FALSE
opal-components,0.20.51,0.20.52,334,1,39,16,55,6,FALSE
opal-components,0.20.56,0.21.0,339,1,25,25,50,19,FALSE
opal-components,0.21.18,0.21.19,356,1,59,34,93,6,FALSE
opal-components,0.20.54,0.20.55,337,1,1,1,2,1,FALSE
opal-components,0.20.55,0.20.56,338,1,6,5,11,4,FALSE
opal-components,0.21.15,0.21.16,353,1,350,350,700,50,FALSE
opal-components,0.21.17,0.21.18,355,1,1,1,2,1,FALSE
opal-components,0.21.16,0.21.17,354,1,309,209,518,84,FALSE
opal-components,0.21.11,0.21.12,351,1,7,7,14,7,FALSE
opal-components,0.21.10,0.21.11,350,1,7,7,14,5,FALSE
opal-components,0.21.12,0.21.15,352,1,1,1,2,1,FALSE
opal-components,0.20.33,0.20.34,316,1,10,10,20,7,FALSE
opal-components,0.24.22,0.24.23,401,1,1,1,2,1,FALSE
opal-components,0.20.27,0.20.28,310,1,14,2,16,5,FALSE
opal-components,0.20.26,0.20.27,309,1,38,39,77,6,FALSE
opal-components,0.20.25,0.20.26,308,1,126,65,191,10,FALSE
opal-components,0.20.24,0.20.25,307,1,20,11,31,5,FALSE
opal-components,0.20.23,0.20.24,306,1,115,105,220,57,FALSE
opal-components,0.20.22,0.20.23,305,1,42,15,57,5,FALSE
opal-components,0.20.21,0.20.22,304,1,1,1,2,1,FALSE
opal-components,0.20.20,0.20.21,303,1,1,1,2,1,FALSE
opal-components,0.18.2,0.18.3,239,1,1,1,2,1,FALSE
opal-components,0.20.28,0.20.29,311,1,32,2,34,5,FALSE
opal-components,0.24.8,0.24.9,389,1,1,1,2,1,FALSE
opal-components,0.24.9,0.24.10,390,1,1,1,2,1,FALSE
opal-components,0.19.6,0.19.7,282,1,158,155,313,18,FALSE
opal-components,0.19.7,0.19.8,283,1,18,18,36,6,FALSE
opal-components,0.19.0,0.19.1,276,1,51,51,102,39,FALSE
opal-components,0.19.1,0.19.2,277,1,223,212,435,10,FALSE
opal-components,0.19.2,0.19.3,278,1,474,485,959,17,FALSE
opal-components,0.19.3,0.19.4,279,1,31,10,41,12,FALSE
opal-components,0.24.0,0.24.1,381,1,7039,8781,15820,90,FALSE
opal-components,0.24.1,0.24.2,382,1,47,45,92,13,FALSE
opal-components,0.24.2,0.24.3,383,1,68,70,138,30,FALSE
opal-components,0.18.27,0.18.28,263,1,5,5,10,4,FALSE
opal-components,0.24.4,0.24.5,385,1,1,1,2,1,FALSE
opal-components,0.24.5,0.24.6,386,1,1,1,2,1,FALSE
opal-components,0.24.6,0.24.7,387,1,80,14,94,5,FALSE
opal-components,0.24.7,0.24.8,388,1,5,8,13,4,FALSE
opal-components,0.20.34,0.20.35,317,1,12,12,24,5,FALSE
opal-components,0.20.35,0.20.36,318,1,8,8,16,4,FALSE
opal-components,0.20.36,0.20.37,319,1,27,10,37,46,FALSE
opal-components,0.20.37,0.20.38,320,1,55,18,73,5,FALSE
opal-components,0.20.30,0.20.31,313,1,11,3,14,5,FALSE
opal-components,0.20.31,0.20.32,314,1,42,15,57,4,FALSE
opal-components,0.20.32,0.20.33,315,1,26,38,64,7,FALSE
opal-components,0.21.22,0.21.24,360,1,77,45,122,10,FALSE
opal-components,0.20.38,0.20.39,321,1,42,38,80,12,FALSE
opal-components,0.20.39,0.20.40,322,1,1,1,2,1,FALSE
opal-components,0.18.14,0.18.15,251,1,5,4,9,4,FALSE
opal-components,0.21.19,0.21.20,357,1,509,511,1020,48,FALSE
opal-components,0.1.161,0.1.162,159,1,11,15,26,14,FALSE
opal-components,0.1.160,0.1.161,158,1,62,22,84,4,FALSE
opal-components,0.1.163,0.1.164,161,1,10,3,13,4,FALSE
opal-components,0.1.162,0.1.163,160,1,4,4,8,4,FALSE
opal-components,0.1.165,0.1.166,163,1,1,1,2,1,FALSE
opal-components,0.1.164,0.1.165,162,2,8,8,16,5,FALSE
opal-components,0.1.167,0.1.168,165,1,130,224,354,17,FALSE
opal-components,0.1.166,0.1.167,164,1,7,5,12,5,FALSE
opal-components,0.1.168,0.1.170,166,1,20,8,28,5,FALSE
opal-components,0.1.38,0.1.39,38,1,530,100,630,34,FALSE
opal-components,0.1.39,0.1.40,39,1,26,20,46,10,FALSE
opal-components,0.1.34,0.1.35,35,1,4,4,8,4,FALSE
opal-components,0.1.35,0.1.37,36,1,97,76,173,21,FALSE
opal-components,0.1.37,0.1.38,37,1,693,89,782,27,FALSE
opal-components,0.1.30,0.1.31,31,1,477,72,549,23,FALSE
opal-components,0.1.31,0.1.32,32,1,530,33,563,21,FALSE
opal-components,0.1.32,0.1.33,33,1,31,36,67,6,FALSE
opal-components,0.1.33,0.1.34,34,1,6,5,11,4,FALSE
opal-components,0.1.125,0.1.126,123,1,4,4,8,4,FALSE
opal-components,0.1.124,0.1.125,122,1,127,14,141,12,FALSE
opal-components,0.1.127,0.1.128,125,1,4,4,8,4,FALSE
opal-components,0.1.126,0.1.127,124,1,30,17,47,22,FALSE
opal-components,0.1.121,0.1.122,119,1,84,66,150,18,FALSE
opal-components,0.1.120,0.1.121,118,1,29,14,43,12,FALSE
opal-components,0.1.123,0.1.124,121,1,7,16,23,10,FALSE
opal-components,0.1.122,0.1.123,120,1,81,18,99,11,FALSE
opal-components,0.1.129,0.1.130,127,1,1,1,2,1,FALSE
opal-components,0.1.128,0.1.129,126,1,27,20,47,10,FALSE
opal-components,0.1.190,0.1.191,186,1,1,1,2,1,FALSE
opal-components,0.1.191,0.1.192,187,1,1,1,2,1,FALSE
opal-components,0.1.192,0.1.193,188,1,193,151,344,11,FALSE
opal-components,0.1.193,0.1.194,189,1,1,1,2,1,FALSE
opal-components,0.1.194,0.1.196,190,2,68,64,132,14,FALSE
opal-components,0.1.196,0.1.197,191,1,21,22,43,5,FALSE
opal-components,0.1.197,0.1.198,192,1,1,1,2,1,FALSE
opal-components,0.1.198,0.1.199,193,1,1,1,2,1,FALSE
opal-components,0.1.199,0.1.200,194,1,61,53,114,8,FALSE
opal-components,0.1.98,0.1.99,96,1,12,8,20,4,FALSE
opal-components,0.1.99,0.1.100,97,1,3,3,6,1,FALSE
opal-components,0.1.92,0.1.93,91,1,6,6,12,5,FALSE
opal-components,0.1.93,0.1.95,92,1,1,1,2,1,FALSE
opal-components,0.1.90,0.1.91,89,1,16,39,55,10,FALSE
opal-components,0.1.91,0.1.92,90,1,14,11,25,6,FALSE
opal-components,0.1.96,0.1.97,94,1,1,1,2,1,FALSE
opal-components,0.1.97,0.1.98,95,1,6,6,12,4,FALSE
opal-components,0.1.95,0.1.96,93,1,350,342,692,64,FALSE
opal-components,0.1.8,0.1.9,9,1,153,148,301,40,FALSE
opal-components,0.1.9,0.1.10,10,1,14,12,26,4,FALSE
opal-components,0.1.0,0.1.1,1,1,225,20,245,9,FALSE
opal-components,0.1.1,0.1.2,2,1,115,127,242,50,FALSE
opal-components,0.1.2,0.1.3,3,1,152,127,279,15,FALSE
opal-components,0.1.3,0.1.4,4,1,1563,297,1860,40,FALSE
opal-components,0.1.4,0.1.5,5,1,1,1,2,1,FALSE
opal-components,0.1.5,0.1.6,6,1,424,138,562,17,FALSE
opal-components,0.1.6,0.1.7,7,1,118,99,217,15,FALSE
opal-components,0.1.7,0.1.8,8,1,86,89,175,8,FALSE
opal-components,0.1.67,0.1.68,67,1,661,21,682,15,FALSE
opal-components,0.1.66,0.1.67,66,1,787,125,912,33,FALSE
opal-components,0.1.65,0.1.66,65,1,136,98,234,25,FALSE
opal-components,0.1.64,0.1.65,64,1,84,7,91,8,FALSE
opal-components,0.1.63,0.1.64,63,1,24,24,48,14,FALSE
opal-components,0.1.62,0.1.63,62,1,4,4,8,4,FALSE
opal-components,0.1.61,0.1.62,61,1,26,2,28,4,FALSE
opal-components,0.1.60,0.1.61,60,1,1,1,2,1,FALSE
opal-components,0.1.68,0.1.70,68,1,75,122,197,31,FALSE
opal-components,0.16.17,0.16.18,228,1,286,107,393,9,FALSE
opal-components,0.16.16,0.16.17,227,1,670,618,1288,24,FALSE
opal-components,0.16.15,0.16.16,226,1,118,118,236,108,FALSE
opal-components,0.16.14,0.16.15,225,1,45,46,91,16,FALSE
opal-components,0.16.12,0.16.14,224,1,92,69,161,16,FALSE
opal-components,0.16.11,0.16.12,223,1,26,20,46,7,FALSE
opal-components,0.16.10,0.16.11,222,1,247,225,472,7,FALSE
opal-components,0.1.178,0.1.179,175,1,153,62,215,15,FALSE
opal-components,0.1.179,0.1.180,176,1,132,168,300,10,FALSE
opal-components,0.1.176,0.1.177,173,1,1,1,2,1,FALSE
opal-components,0.1.177,0.1.178,174,1,1,1,2,1,FALSE
opal-components,0.1.174,0.1.175,171,1,1,1,2,1,FALSE
opal-components,0.1.175,0.1.176,172,1,1,1,2,1,FALSE
opal-components,0.1.172,0.1.173,169,1,87,30,117,6,FALSE
opal-components,0.1.173,0.1.174,170,1,16,4,20,4,FALSE
opal-components,0.1.170,0.1.171,167,1,4,3,7,4,FALSE
opal-components,0.1.171,0.1.172,168,1,2,6,8,4,FALSE
opal-components,0.1.29,0.1.30,30,1,4,4,8,4,FALSE
opal-components,0.1.28,0.1.29,29,1,12,12,24,8,FALSE
opal-components,0.1.23,0.1.24,24,1,1608,660,2268,70,FALSE
opal-components,0.1.22,0.1.23,23,1,14,34,48,10,FALSE
opal-components,0.1.21,0.1.22,22,1,1661,338,1999,56,FALSE
opal-components,0.1.20,0.1.21,21,1,22,21,43,2,FALSE
opal-components,0.1.27,0.1.28,28,1,4,3,7,4,FALSE
opal-components,0.1.26,0.1.27,27,1,101,21,122,9,FALSE
opal-components,0.1.25,0.1.26,26,1,422,488,910,52,FALSE
opal-components,0.1.24,0.1.25,25,1,27,22,49,4,FALSE
opal-components,0.1.58,0.1.59,58,1,6,6,12,4,FALSE
opal-components,0.1.59,0.1.60,59,1,1,1,2,1,FALSE
opal-components,0.1.56,0.1.57,56,1,7,3,10,4,FALSE
opal-components,0.1.57,0.1.58,57,1,8,9,17,4,FALSE
opal-components,0.1.54,0.1.55,54,1,3,4,7,4,FALSE
opal-components,0.1.55,0.1.56,55,1,16,18,34,8,FALSE
opal-components,0.1.52,0.1.53,52,1,1,1,2,1,FALSE
opal-components,0.1.53,0.1.54,53,1,4,3,7,4,FALSE
opal-components,0.1.50,0.1.51,50,1,4,3,7,4,FALSE
opal-components,0.1.51,0.1.52,51,1,5,5,10,4,FALSE
opal-components,0.1.212,0.1.214,207,1,8,4,12,4,FALSE
opal-components,0.1.211,0.1.212,206,1,51,31,82,6,FALSE
opal-components,0.1.217,0.1.218,211,1,494,513,1007,33,FALSE
opal-components,0.1.215,0.1.216,209,1,153,160,313,3,FALSE
opal-components,0.1.214,0.1.215,208,2,1646,1763,3409,51,FALSE
opal-components,0.1.218,0.16.0,212,1,718,657,1375,29,FALSE
opal-components,0.1.216,0.1.217,210,1,747,742,1489,31,FALSE
opal-components,0.1.132,0.1.133,130,1,6,6,12,4,FALSE
opal-components,0.1.133,0.1.134,131,1,14,14,28,9,FALSE
opal-components,0.1.130,0.1.131,128,1,1,1,2,1,FALSE
opal-components,0.1.131,0.1.132,129,1,49,6,55,5,FALSE
opal-components,0.1.136,0.1.137,134,1,1,1,2,1,FALSE
opal-components,0.1.137,0.1.138,135,1,1,1,2,1,FALSE
opal-components,0.1.134,0.1.135,132,1,51,15,66,5,FALSE
opal-components,0.1.135,0.1.136,133,1,36,28,64,5,FALSE
opal-components,0.1.138,0.1.139,136,1,1,1,2,1,FALSE
opal-components,0.1.139,0.1.140,137,1,21,12,33,5,FALSE
opal-components,0.1.147,0.1.148,145,1,37,84,121,17,FALSE
opal-components,0.1.146,0.1.147,144,1,1,1,2,1,FALSE
opal-components,0.1.145,0.1.146,143,1,16,32,48,5,FALSE
opal-components,0.1.144,0.1.145,142,1,48,33,81,40,FALSE
opal-components,0.1.143,0.1.144,141,1,7,3,10,4,FALSE
opal-components,0.1.142,0.1.143,140,1,6,5,11,4,FALSE
opal-components,0.1.141,0.1.142,139,1,55,62,117,8,FALSE
opal-components,0.1.140,0.1.141,138,1,30,6,36,4,FALSE
opal-components,0.1.149,0.1.150,147,1,39,37,76,17,FALSE
opal-components,0.1.148,0.1.149,146,1,7,7,14,4,FALSE
opal-components,0.1.89,0.1.90,88,1,4,4,8,4,FALSE
opal-components,0.1.12,0.1.13,13,1,6,2,8,4,FALSE
opal-components,0.1.13,0.1.14,14,1,127,102,229,5,FALSE
opal-components,0.1.10,0.1.11,11,1,4,4,8,4,FALSE
opal-components,0.1.11,0.1.12,12,1,4,4,8,4,FALSE
opal-components,0.1.16,0.1.17,17,1,44,48,92,4,FALSE
opal-components,0.1.17,0.1.18,18,1,14,14,28,5,FALSE
opal-components,0.1.86,0.1.87,85,1,1,1,2,1,FALSE
opal-components,0.1.15,0.1.16,16,1,12,12,24,10,FALSE
opal-components,0.1.18,0.1.19,19,1,6,14,20,4,FALSE
opal-components,0.1.19,0.1.20,20,1,15,15,30,8,FALSE
opal-components,0.1.109,0.1.110,107,1,5,7,12,4,FALSE
opal-components,0.1.108,0.1.109,106,1,7,5,12,5,FALSE
opal-components,0.1.103,0.1.104,101,1,8,8,16,4,FALSE
opal-components,0.1.102,0.1.103,100,1,43,30,73,10,FALSE
opal-components,0.1.101,0.1.102,99,1,22,19,41,4,FALSE
opal-components,0.1.100,0.1.101,98,1,5,5,10,4,FALSE
opal-components,0.1.107,0.1.108,105,1,14,18,32,7,FALSE
opal-components,0.1.106,0.1.107,104,1,38,32,70,8,FALSE
opal-components,0.1.105,0.1.106,103,1,1,1,2,1,FALSE
opal-components,0.1.104,0.1.105,102,1,19,5,24,4,FALSE
opal-components,0.16.7,0.16.8,220,1,1,1,2,1,FALSE
opal-components,0.16.6,0.16.7,219,1,1,1,2,1,FALSE
opal-components,0.16.5,0.16.6,218,1,1,1,2,1,FALSE
opal-components,0.16.4,0.16.5,217,1,1,1,2,1,FALSE
opal-components,0.16.3,0.16.4,216,1,1,1,2,1,FALSE
opal-components,0.16.2,0.16.3,215,1,1,1,2,1,FALSE
opal-components,0.16.1,0.16.2,214,1,1,1,2,1,FALSE
opal-components,0.16.0,0.16.1,213,1,131,114,245,12,FALSE
opal-components,0.16.8,0.16.10,221,1,1558,1692,3250,17,FALSE
opal-components,0.1.49,0.1.50,49,1,8,7,15,4,FALSE
opal-components,0.1.48,0.1.49,48,1,5,5,10,4,FALSE
opal-components,0.1.45,0.1.46,45,1,9,3,12,4,FALSE
opal-components,0.1.44,0.1.45,44,1,14,9,23,5,FALSE
opal-components,0.1.47,0.1.48,47,1,7,9,16,4,FALSE
opal-components,0.1.46,0.1.47,46,1,14,5,19,5,FALSE
opal-components,0.1.41,0.1.42,41,1,831,682,1513,56,FALSE
opal-components,0.1.40,0.1.41,40,1,217,232,449,35,FALSE
opal-components,0.1.43,0.1.44,43,1,13,9,22,5,FALSE
opal-components,0.1.42,0.1.43,42,1,1,1,2,1,FALSE
opal-components,0.1.200,0.1.201,195,1,27,27,54,4,FALSE
opal-components,0.1.201,0.1.202,196,1,1,1,2,1,FALSE
opal-components,0.1.202,0.1.203,197,1,3,3,6,1,FALSE
opal-components,0.1.203,0.1.204,198,1,17,17,34,7,FALSE
opal-components,0.1.204,0.1.205,199,1,37,9,46,8,FALSE
opal-components,0.1.205,0.1.206,200,2,129,194,323,36,FALSE
opal-components,0.1.206,0.1.207,201,1,78,62,140,6,FALSE
opal-components,0.1.207,0.1.208,202,1,6,2,8,4,FALSE
opal-components,0.1.208,0.1.209,203,1,98,53,151,30,FALSE
opal-components,0.1.209,0.1.210,204,1,771,827,1598,15,FALSE
opal-components,0.1.154,0.1.155,152,1,1,1,2,1,FALSE
opal-components,0.1.155,0.1.156,153,1,1,1,2,1,FALSE
opal-components,0.1.156,0.1.157,154,1,55,17,72,8,FALSE
opal-components,0.1.157,0.1.158,155,1,53,21,74,8,FALSE
opal-components,0.1.150,0.1.151,148,1,6,4,10,5,FALSE
opal-components,0.1.151,0.1.152,149,1,480,533,1013,70,FALSE
opal-components,0.1.152,0.1.153,150,1,7,7,14,4,TRUE
opal-components,0.1.153,0.1.154,151,1,1,1,2,1,FALSE
opal-components,0.1.158,0.1.159,156,1,1,1,2,1,FALSE
opal-components,0.1.159,0.1.160,157,1,6,2,8,4,FALSE
opal-components,0.1.88,0.1.89,87,1,177,125,302,27,FALSE
opal-components,0.1.81,0.1.82,80,1,8,10,18,4,FALSE
opal-components,0.1.80,0.1.81,79,1,13,5,18,5,FALSE
opal-components,0.1.83,0.1.84,82,1,6,8,14,5,FALSE
opal-components,0.1.82,0.1.83,81,1,1,1,2,1,FALSE
opal-components,0.1.85,0.1.86,84,1,20,20,40,16,FALSE
opal-components,0.1.84,0.1.85,83,1,37,6,43,4,FALSE
opal-components,0.1.118,0.1.119,116,1,13,3,16,4,FALSE
opal-components,0.1.119,0.1.120,117,1,16,3,19,5,FALSE
opal-components,0.1.87,0.1.88,86,1,1,1,2,1,FALSE
opal-components,0.1.110,0.1.111,108,1,1,1,2,1,FALSE
opal-components,0.1.111,0.1.112,109,1,11,9,20,4,FALSE
opal-components,0.1.112,0.1.113,110,1,15,7,22,4,FALSE
opal-components,0.1.113,0.1.114,111,1,1,1,2,1,FALSE
opal-components,0.1.114,0.1.115,112,1,302,241,543,56,FALSE
opal-components,0.1.115,0.1.116,113,1,6,4,10,5,FALSE
opal-components,0.1.116,0.1.117,114,1,26,8,34,5,TRUE
opal-components,0.1.117,0.1.118,115,1,1,1,2,1,FALSE
opal-components,0.1.183,0.1.184,180,1,1,1,2,1,FALSE
opal-components,0.1.182,0.1.183,179,1,5,5,10,4,FALSE
opal-components,0.1.181,0.1.182,178,1,10,8,18,4,FALSE
opal-components,0.1.180,0.1.181,177,1,1,1,2,1,FALSE
opal-components,0.1.186,0.1.188,183,2,36,13,49,8,FALSE
opal-components,0.1.185,0.1.186,182,1,10,11,21,7,FALSE
opal-components,0.1.184,0.1.185,181,2,52,26,78,15,FALSE
opal-components,0.1.189,0.1.190,185,1,1,1,2,1,FALSE
opal-components,0.1.188,0.1.189,184,1,1,1,2,1,FALSE
opal-components,0.1.14,0.1.15,15,1,290,244,534,21,FALSE
opal-components,0.1.78,0.1.79,77,1,35,14,49,4,FALSE
opal-components,0.1.79,0.1.80,78,1,7,5,12,4,FALSE
opal-components,0.1.70,0.1.71,69,1,11,5,16,4,FALSE
opal-components,0.1.71,0.1.72,70,1,65,96,161,11,FALSE
opal-components,0.1.72,0.1.73,71,1,9,5,14,5,FALSE
opal-components,0.1.73,0.1.74,72,1,1,1,2,1,FALSE
opal-components,0.1.74,0.1.75,73,1,50,55,105,26,FALSE
opal-components,0.1.75,0.1.76,74,1,28,6,34,6,FALSE
opal-components,0.1.76,0.1.77,75,1,23,15,38,7,FALSE
opal-components,0.1.77,0.1.78,76,1,5,5,10,4,FALSE
opal-components,0.1.210,0.1.211,205,1,90,74,164,28,FALSE
opal-components,0.1.152,0.1.153,150,1,7,7,14,4,FALSE
opal-components,0.1.116,0.1.117,114,1,26,8,34,5,FALSE
opal-components,0.1.31,0.1.32,32,1,530,33,563,21,TRUE
opal-components,0.16.14,0.16.15,225,1,45,46,91,16,TRUE
opal-components,0.1.214,0.1.215,208,2,1646,1763,3409,51,TRUE
opal-components,0.20.18,0.20.19,301,1,20,34,54,8,TRUE
opal-components,0.20.56,0.21.0,339,1,25,25,50,19,TRUE
opal-components,0.20.34,0.20.35,317,1,12,12,24,5,TRUE
opal-components,0.1.206,0.1.207,201,1,78,62,140,6,TRUE
opal-components,0.20.43,0.20.44,326,1,42,4,46,5,TRUE
opal-components,0.1.144,0.1.145,142,1,48,33,81,40,TRUE
opal-components,0.18.8,0.18.9,245,1,33,33,66,21,TRUE
opal-components,0.1.7,0.1.8,8,1,86,89,175,8,TRUE
opal-components,0.1.148,0.1.149,146,1,7,7,14,4,TRUE
opal-components,0.16.19,0.16.21,230,2,761,763,1524,42,TRUE
opal-components,0.1.164,0.1.165,162,2,8,8,16,5,TRUE
opal-components,0.1.216,0.1.217,210,1,747,742,1489,31,TRUE
opal-components,0.1.12,0.1.13,13,1,6,2,8,4,TRUE
opal-components,0.1.49,0.1.50,49,1,8,7,15,4,TRUE
opal-components,0.1.119,0.1.120,117,1,16,3,19,5,TRUE
opal-components,0.16.15,0.16.16,226,1,118,118,236,108,TRUE
opal-components,0.18.37,0.18.38,273,1,5,8,13,4,TRUE
opal-components,0.18.36,0.18.37,272,1,11,11,22,10,TRUE
opal-components,0.18.39,0.19.0,275,1,1,1,2,1,TRUE
opal-components,0.16.18,0.16.19,229,1,9,2,11,4,TRUE
opal-components,0.17.0,0.18.0,236,1,15,6,21,4,TRUE
opal-components,0.18.9,0.18.10,246,1,423,418,841,88,TRUE
opal-components,0.18.7,0.18.8,244,1,22,21,43,8,TRUE
opal-components,0.18.6,0.18.7,243,1,90,97,187,43,TRUE
opal-components,0.18.20,0.18.21,257,1,22,5,27,4,TRUE
opal-components,0.18.21,0.18.22,258,1,75,66,141,54,TRUE
opal-components,0.18.23,0.18.24,260,1,108,119,227,33,TRUE
opal-components,0.18.25,0.18.27,262,2,163,164,327,48,TRUE
opal-components,0.20.16,0.20.17,299,1,4,4,8,4,TRUE
opal-components,0.20.12,0.20.13,295,1,8,11,19,4,TRUE
opal-components,0.21.24,0.21.25,361,1,13,14,27,4,TRUE
opal-components,0.21.20,0.21.21,358,1,1,1,2,1,TRUE
opal-components,0.18.19,0.18.20,256,1,84,80,164,63,TRUE
opal-components,0.18.11,0.18.12,248,1,59,59,118,25,TRUE
opal-components,0.16.1,0.16.2,214,1,1,1,2,1,TRUE
opal-components,0.16.0,0.16.1,213,1,131,114,245,12,TRUE
opal-components,0.23.0,0.23.1,376,1,1,1,2,1,TRUE
opal-components,0.24.4,0.24.5,385,1,1,1,2,1,TRUE
opal-components,0.21.37,0.22.0,372,1,1,1,2,1,TRUE
opal-components,0.21.35,0.21.36,370,1,75,105,180,11,TRUE
opal-components,0.16.24,0.16.25,234,1,14,7,21,4,TRUE
opal-components,0.16.21,0.16.22,231,1,1,1,2,1,TRUE
opal-components,0.20.44,0.20.45,327,1,33,34,67,5,TRUE
opal-components,0.20.46,0.20.47,329,1,5,10,15,4,TRUE
opal-components,0.21.26,0.21.27,363,1,1,1,2,1,TRUE
opal-components,0.20.4,0.20.5,287,1,436,224,660,55,TRUE
opal-components,0.20.5,0.20.6,288,1,759,191,950,90,TRUE
opal-components,0.20.0,0.20.1,285,1,80,80,160,65,TRUE
opal-components,0.1.217,0.1.218,211,1,494,513,1007,33,TRUE
opal-components,0.1.218,0.16.0,212,1,718,657,1375,29,TRUE
opal-components,0.20.1,0.20.4,286,3,119,95,214,25,TRUE
opal-components,0.21.9,0.21.10,349,1,15,10,25,7,TRUE
opal-components,0.21.1,0.21.2,341,1,32,10,42,5,TRUE
opal-components,0.21.0,0.21.1,340,1,6,10,16,4,TRUE
opal-components,0.21.3,0.21.4,343,1,129,26,155,15,TRUE
opal-components,0.21.2,0.21.3,342,1,7,15,22,7,TRUE
opal-components,0.21.5,0.21.6,345,1,97,87,184,5,TRUE
opal-components,0.21.4,0.21.5,344,1,18,20,38,10,TRUE
opal-components,0.21.7,0.21.8,347,1,1,1,2,1,TRUE
opal-components,0.21.6,0.21.7,346,1,234,233,467,53,TRUE
opal-components,0.20.52,0.20.53,335,1,13,13,26,5,TRUE
opal-components,0.20.51,0.20.52,334,1,39,16,55,6,TRUE
opal-components,0.21.10,0.21.11,350,1,7,7,14,5,TRUE
opal-components,0.22.1,0.22.2,374,1,65,65,130,10,TRUE
opal-components,0.1.205,0.1.206,200,2,129,194,323,36,TRUE
opal-components,0.1.209,0.1.210,204,1,771,827,1598,15,TRUE
opal-components,0.16.25,0.17.0,235,1,4,3,7,2,TRUE
opal-components,0.20.27,0.20.28,310,1,14,2,16,5,TRUE
opal-components,0.20.26,0.20.27,309,1,38,39,77,6,TRUE
opal-components,0.20.23,0.20.24,306,1,115,105,220,57,TRUE
opal-components,0.20.20,0.20.21,303,1,1,1,2,1,TRUE
opal-components,0.19.5,0.19.6,281,1,10,10,20,10,TRUE
opal-components,0.19.1,0.19.2,277,1,223,212,435,10,TRUE
opal-components,0.19.2,0.19.3,278,1,474,485,959,17,TRUE
opal-components,0.19.3,0.19.4,279,1,31,10,41,12,TRUE
opal-components,0.24.1,0.24.2,382,1,47,45,92,13,TRUE
opal-components,0.24.2,0.24.3,383,1,68,70,138,30,TRUE
opal-components,0.24.3,0.24.4,384,1,129,43,172,4,TRUE
opal-components,0.19.8,0.20.0,284,1,49,65,114,19,TRUE
opal-components,0.20.36,0.20.37,319,1,27,10,37,46,TRUE
opal-components,0.20.31,0.20.32,314,1,42,15,57,4,TRUE
opal-components,0.20.32,0.20.33,315,1,26,38,64,7,TRUE
opal-components,0.1.109,0.1.110,107,1,5,7,12,4,TRUE
opal-components,0.1.141,0.1.142,139,1,55,62,117,8,TRUE
opal-components,0.24.29,0.24.30,407,1,25,18,43,4,TRUE
opal-components,0.1.32,0.1.33,33,1,31,36,67,6,TRUE
opal-components,0.23.4,0.24.0,380,1,1,1,2,1,TRUE
opal-components,0.1.154,0.1.155,152,1,1,1,2,1,TRUE
opal-components,0.1.184,0.1.185,181,2,52,26,78,15,TRUE
opal-components,0.1.67,0.1.68,67,1,661,21,682,15,TRUE
opal-components,0.1.174,0.1.175,171,1,1,1,2,1,TRUE
opal-components,0.24.5,0.24.6,386,1,1,1,2,1,TRUE
opal-components,0.1.35,0.1.37,36,1,97,76,173,21,TRUE
opal-components,0.1.151,0.1.152,149,1,480,533,1013,70,TRUE
opal-components,0.20.38,0.20.39,321,1,42,38,80,12,TRUE
opal-components,0.1.129,0.1.130,127,1,1,1,2,1,TRUE
opal-components,0.1.1,0.1.2,2,1,115,127,242,50,TRUE
opal-components,0.1.63,0.1.64,63,1,24,24,48,14,TRUE
opal-components,0.16.12,0.16.14,224,1,92,69,161,16,TRUE
opal-components,0.1.25,0.1.26,26,1,422,488,910,52,TRUE
opal-components,0.1.200,0.1.201,195,1,27,27,54,4,TRUE
opal-components,0.1.157,0.1.158,155,1,53,21,74,8,TRUE
opal-components,0.16.10,0.16.11,222,1,247,225,472,7,TRUE
opal-components,0.20.11,0.20.12,294,1,10,3,13,4,TRUE
opal-components,0.20.17,0.20.18,300,1,9,9,18,7,TRUE
opal-components,0.20.6,0.20.7,289,1,31,31,62,22,TRUE
most-test,1.1.0,1.2.0,5,2,309,40,349,6,FALSE
most-test,1.0.0,1.0.1,1,6,39,72,111,9,FALSE
most-test,1.0.1,1.0.2,2,1,1,7,8,3,FALSE
most-test,1.0.2,1.0.3,3,1,5,1,6,1,FALSE
most-test,1.0.3,1.1.0,4,5,50,3,53,7,FALSE
most-test,1.2.0,1.3.0,6,4,191,44,235,7,FALSE
most-test,1.0.0,1.0.1,1,6,39,72,111,9,TRUE
bids-validator,0.18.19,0.18.20,79,19,165,40,205,25,FALSE
bids-validator,0.18.18,0.18.19,78,13,55,20,75,14,FALSE
bids-validator,0.18.15,0.18.16,75,3,4,4,8,4,FALSE
bids-validator,0.18.14,0.18.15,74,4,38,28,66,11,FALSE
bids-validator,0.18.17,0.18.18,77,22,158,44,202,28,FALSE
bids-validator,0.18.16,0.18.17,76,27,808,317,1125,54,FALSE
bids-validator,0.18.11,0.18.13,72,19,531,211,742,39,FALSE
bids-validator,0.18.10,0.18.11,71,10,209,33,242,20,FALSE
bids-validator,0.18.13,0.18.14,73,5,57,7,64,9,FALSE
bids-validator,0.17.0,0.18.0,60,21,346,250,596,29,FALSE
bids-validator,0.20.0,0.21.0,94,22,192,124,316,31,FALSE
bids-validator,0.19.4,0.19.5,88,3,9,5,14,4,FALSE
bids-validator,0.19.5,0.19.6,89,3,4,4,8,4,FALSE
bids-validator,0.19.6,0.19.7,90,3,9,7,16,6,FALSE
bids-validator,0.19.7,0.19.8,91,1,3,1,4,2,FALSE
bids-validator,0.19.0,0.19.1,84,1,2,2,4,2,FALSE
bids-validator,0.19.1,0.19.2,85,5,8,5,13,8,FALSE
bids-validator,0.19.2,0.19.3,86,12,40,13,53,17,FALSE
bids-validator,0.19.3,0.19.4,87,4,12,8,20,6,FALSE
bids-validator,0.21.1,0.21.2,96,22,258,120,378,31,FALSE
bids-validator,0.21.0,0.21.1,95,4,52,18,70,10,FALSE
bids-validator,0.19.8,0.19.9,92,12,211,48,259,20,FALSE
bids-validator,0.19.9,0.20.0,93,5,135,20,155,10,FALSE
bids-validator,0.18.9,0.18.10,70,3,16,16,32,4,FALSE
bids-validator,0.18.8,0.18.9,69,5,37,11,48,7,FALSE
bids-validator,0.18.1,0.18.2,62,3,29,7,36,7,FALSE
bids-validator,0.18.0,0.18.1,61,6,15,12,27,8,FALSE
bids-validator,0.18.3,0.18.4,64,24,846,645,1491,47,FALSE
bids-validator,0.18.2,0.18.3,63,3,260,250,510,4,FALSE
bids-validator,0.18.5,0.18.6,66,2,18,22,40,5,FALSE
bids-validator,0.18.4,0.18.5,65,9,36,37,73,11,FALSE
bids-validator,0.18.7,0.18.8,68,4,7,3,10,5,FALSE
bids-validator,0.18.6,0.18.7,67,5,28,8,36,6,FALSE
bids-validator,0.18.20,0.18.21,80,16,106,22,128,19,FALSE
bids-validator,0.18.21,0.18.22,81,3,90,16,106,10,FALSE
bids-validator,0.18.22,0.18.23,82,3,175,34,209,17,FALSE
bids-validator,0.18.23,0.19.0,83,6,1030,281,1311,36,FALSE
bids-validator,0.15.2,0.15.3,45,4,76,18,94,14,FALSE
bids-validator,0.15.3,0.15.4,46,10,50,73,123,14,FALSE
bids-validator,0.14.0,0.14.1,41,3,4,2,6,4,FALSE
bids-validator,0.10.1,0.10.2,25,5,17,13,30,5,FALSE
bids-validator,0.10.0,0.10.1,24,3,3,3,6,3,FALSE
bids-validator,0.10.3,0.10.4,27,3,16,14,30,4,FALSE
bids-validator,0.10.2,0.10.3,26,4,9,3,12,4,FALSE
bids-validator,0.16.6,0.16.7,58,22,945,592,1537,63,FALSE
bids-validator,0.11.0,0.11.1,29,2,3,4,7,3,FALSE
bids-validator,0.11.1,0.11.2,30,6,12,14,26,10,FALSE
bids-validator,0.11.2,0.11.3,31,2,22,14,36,4,FALSE
bids-validator,0.11.3,0.11.4,32,4,28,13,41,6,FALSE
bids-validator,0.16.7,0.17.0,59,26,887,605,1492,57,FALSE
bids-validator,0.12.2,0.13.0,37,8,139,128,267,27,FALSE
bids-validator,0.12.0,0.12.1,35,5,21,8,29,8,FALSE
bids-validator,0.16.3,0.16.4,55,5,37,23,60,6,FALSE
bids-validator,0.16.2,0.16.3,54,9,61,60,121,13,FALSE
bids-validator,0.16.1,0.16.2,53,13,198,131,329,15,FALSE
bids-validator,0.16.0,0.16.1,52,21,345,142,487,28,FALSE
bids-validator,0.13.2,0.14.0,40,15,498,56,554,36,FALSE
bids-validator,0.13.0,0.13.1,38,10,147,81,228,15,FALSE
bids-validator,0.13.1,0.13.2,39,5,35,17,52,7,FALSE
bids-validator,0.15.0,0.15.1,43,6,41,11,52,8,FALSE
bids-validator,0.15.1,0.15.2,44,12,210,140,350,24,FALSE
bids-validator,0.14.1,0.15.0,42,3,45,5,50,9,FALSE
bids-validator,0.15.6,0.15.7,48,4,5,5,10,5,FALSE
bids-validator,0.15.8,0.15.9,50,16,71,38,109,23,FALSE
bids-validator,0.15.9,0.16.0,51,12,248,20,268,22,FALSE
bids-validator,0.16.5,0.16.6,57,6,9,6,15,6,FALSE
bids-validator,0.15.7,0.15.8,49,5,21,15,36,7,FALSE
bids-validator,0.16.4,0.16.5,56,21,277,52,329,26,FALSE
bids-validator,0.11.4,0.11.5,33,2,2,2,4,2,FALSE
bids-validator,0.15.4,0.15.6,47,11,116,31,147,21,FALSE
bids-validator,0.11.5,0.12.0,34,6,47,22,69,12,FALSE
bids-validator,0.10.4,0.11.0,28,10,918,530,1448,48,FALSE
bids-validator,0.12.1,0.12.2,36,4,18,4,22,5,FALSE
bids-validator,0.3.2,0.3.3,12,8,542,372,914,12,FALSE
bids-validator,0.3.3,0.3.4,13,2,3,3,6,2,FALSE
bids-validator,0.3.0,0.3.1,10,1,1,1,2,1,FALSE
bids-validator,0.3.1,0.3.2,11,2,6,3,9,2,FALSE
bids-validator,0.3.6,0.4.0,16,8,233,104,337,20,FALSE
bids-validator,0.3.4,0.3.5,14,5,66,84,150,11,FALSE
bids-validator,0.3.5,0.3.6,15,5,41,19,60,9,FALSE
bids-validator,0.6.0,0.7.0,19,4,75,75,150,11,FALSE
bids-validator,0.4.0,0.5.0,17,17,778,80,858,31,FALSE
bids-validator,0.2.2,0.3.0,9,7,293,185,478,10,FALSE
bids-validator,0.2.1,0.2.2,8,3,9,7,16,3,FALSE
bids-validator,0.2.0,0.2.1,7,7,92,50,142,14,FALSE
bids-validator,0.1.0,0.1.1,2,2,7,4,11,4,FALSE
bids-validator,0.1.1,0.1.2,3,2,3,4,7,3,FALSE
bids-validator,0.1.2,0.1.3,4,2,2,2,4,2,FALSE
bids-validator,0.1.3,0.1.4,5,11,142,266,408,20,FALSE
bids-validator,0.1.4,0.2.0,6,3,9,5,14,3,FALSE
bids-validator,0.0.0,0.1.0,1,3,9,5,14,4,FALSE
bids-validator,0.7.0,0.7.1,20,7,83,97,180,7,FALSE
bids-validator,0.7.1,0.9.0,21,13,835,385,1220,35,FALSE
bids-validator,0.5.0,0.6.0,18,5,52,6,58,5,FALSE
bids-validator,0.9.0,0.9.1,22,11,960,1200,2160,33,FALSE
bids-validator,0.9.1,0.10.0,23,33,1409,720,2129,76,FALSE
bids-validator,0.14.0,0.14.1,41,3,4,2,6,4,TRUE
bids-validator,0.1.4,0.2.0,6,3,9,5,14,3,TRUE
bids-validator,0.3.2,0.3.3,12,8,542,372,914,12,TRUE
bids-validator,0.3.4,0.3.5,14,5,66,84,150,11,TRUE
bids-validator,0.18.7,0.18.8,68,4,7,3,10,5,TRUE
bids-validator,0.18.6,0.18.7,67,5,28,8,36,6,TRUE
bids-validator,0.11.2,0.11.3,31,2,22,14,36,4,TRUE
bids-validator,0.18.3,0.18.4,64,24,846,645,1491,47,TRUE
bids-validator,0.18.4,0.18.5,65,9,36,37,73,11,TRUE
hy-res,0.0.15,0.0.16,14,2,55,3,58,4,FALSE
hy-res,0.0.14,0.0.15,13,5,57,13,70,10,FALSE
hy-res,0.0.17,0.0.18,16,5,100,55,155,15,FALSE
hy-res,0.0.16,0.0.17,15,19,535,114,649,41,FALSE
hy-res,0.0.11,0.0.12,10,19,850,246,1096,57,FALSE
hy-res,0.0.10,0.0.11,9,16,199,107,306,34,FALSE
hy-res,0.0.13,0.0.14,12,3,3,3,6,3,FALSE
hy-res,0.0.12,0.0.13,11,2,6,1,7,2,FALSE
hy-res,0.0.19,0.0.20,18,2,7,6,13,3,FALSE
hy-res,0.0.18,0.0.19,17,6,70,29,99,9,FALSE
hy-res,0.0.5,0.0.6,5,8,73,66,139,13,FALSE
hy-res,0.0.4,0.0.5,4,2,6,6,12,3,FALSE
hy-res,0.0.7,0.0.9,7,6,45,10,55,14,FALSE
hy-res,0.0.6,0.0.7,6,3,142,55,197,14,FALSE
hy-res,0.0.1,0.0.2,1,2,12,13,25,5,FALSE
hy-res,0.0.3,0.0.4,3,2,8,2,10,2,FALSE
hy-res,0.0.2,0.0.3,2,8,50,1561,1611,33,FALSE
hy-res,0.0.9,0.0.10,8,41,1360,498,1858,111,TRUE
hy-res,0.0.20,0.0.21,19,20,6478,1124,7602,51,FALSE
hy-res,0.0.21,0.0.22,20,18,721,133,854,41,FALSE
hy-res,0.0.22,0.0.23,21,32,1287,598,1885,114,FALSE
hy-res,0.0.23,0.0.24,22,6,548,146,694,45,FALSE
hy-res,0.0.24,0.0.25,23,2,82,10,92,4,FALSE
hy-res,0.0.25,0.0.26,24,3,32,45,77,10,FALSE
hy-res,0.0.9,0.0.10,8,41,1360,498,1858,111,FALSE
hy-res,0.0.16,0.0.17,15,19,535,114,649,41,TRUE
hy-res,0.0.12,0.0.13,11,2,6,1,7,2,TRUE
hy-res,0.0.10,0.0.11,9,16,199,107,306,34,TRUE
hy-res,0.0.7,0.0.9,7,6,45,10,55,14,TRUE
hy-res,0.0.11,0.0.12,10,19,850,246,1096,57,TRUE
hy-res,0.0.18,0.0.19,17,6,70,29,99,9,TRUE
hy-res,0.0.19,0.0.20,18,2,7,6,13,3,TRUE
hy-res,0.0.14,0.0.15,13,5,57,13,70,10,TRUE
kea-logic,0.3.1,0.3.2,15,2,19,25,44,3,FALSE
kea-logic,0.7.2,0.8.0,33,3,108,65,173,9,FALSE
kea-logic,0.2.2,0.3.0,13,2,216,1,217,5,FALSE
kea-logic,0.2.1,0.2.2,12,3,671,521,1192,18,FALSE
kea-logic,0.2.0,0.2.1,11,2,24,1,25,3,FALSE
kea-logic,0.1.0,0.1.1,5,1,2,2,4,2,FALSE
kea-logic,0.1.1,0.1.2,6,1,2,2,4,2,FALSE
kea-logic,0.1.2,0.1.3,7,1,3,2,5,2,FALSE
kea-logic,0.1.3,0.1.4,8,1,3,1,4,2,FALSE
kea-logic,0.1.4,0.1.5,9,1,5,2,7,3,FALSE
kea-logic,0.1.5,0.2.0,10,2,73,1,74,3,FALSE
kea-logic,0.10.1,0.10.2,39,2,23,21,44,2,FALSE
kea-logic,0.10.0,0.10.1,38,2,2,1,3,2,FALSE
kea-logic,0.10.3,0.10.4,41,2,3,3,6,3,FALSE
kea-logic,0.10.2,0.10.3,40,2,26,24,50,2,FALSE
kea-logic,0.0.1,0.0.2,1,1,55,14,69,3,FALSE
kea-logic,0.10.4,0.11.0,42,5,2635,190,2825,20,FALSE
kea-logic,0.0.2,0.0.4,2,2,133,9,142,6,FALSE
kea-logic,0.3.2,0.3.3,16,2,34,27,61,3,FALSE
kea-logic,0.3.3,0.3.4,17,2,9,1,10,3,FALSE
kea-logic,0.3.0,0.3.1,14,8,404,106,510,9,FALSE
kea-logic,0.6.0,0.6.1,25,2,7,7,14,5,FALSE
kea-logic,0.11.0,0.11.1,43,5,90,45,135,10,FALSE
kea-logic,0.11.1,0.11.2,44,43,2926,1240,4166,166,FALSE
kea-logic,0.6.5,0.7.0,30,2,220,28,248,5,FALSE
kea-logic,0.6.4,0.6.5,29,2,12,2,14,3,FALSE
kea-logic,0.4.1,0.4.2,20,2,8,3,11,2,FALSE
kea-logic,0.4.0,0.4.1,19,2,9,5,14,3,FALSE
kea-logic,0.4.3,0.5.0,22,2,114,1,115,5,FALSE
kea-logic,0.3.4,0.4.0,18,2,89,2,91,5,FALSE
kea-logic,0.5.0,0.5.1,23,2,3,3,6,3,FALSE
kea-logic,0.5.1,0.6.0,24,2,77,4,81,9,FALSE
kea-logic,0.9.0,0.10.0,37,4,198,47,245,15,FALSE
kea-logic,0.0.5,0.1.0,4,1,72,21,93,3,FALSE
kea-logic,0.0.4,0.0.5,3,1,92,83,175,3,FALSE
kea-logic,0.8.1,0.8.2,35,8,215,122,337,9,FALSE
kea-logic,0.8.0,0.8.1,34,3,128,97,225,3,FALSE
kea-logic,0.8.2,0.9.0,36,5,52,41,93,7,FALSE
kea-logic,0.4.2,0.4.3,21,2,10,3,13,2,FALSE
kea-logic,0.7.0,0.7.1,31,2,70,3,73,5,FALSE
kea-logic,0.6.3,0.6.4,28,2,11,11,22,3,FALSE
kea-logic,0.6.2,0.6.3,27,2,210,2,212,7,FALSE
kea-logic,0.7.1,0.7.2,32,2,55,47,102,3,FALSE
kea-logic,0.6.1,0.6.2,26,2,13,5,18,3,FALSE
kea-logic,0.2.1,0.2.2,12,3,671,521,1192,18,TRUE
kea-logic,0.4.1,0.4.2,20,2,8,3,11,2,TRUE
kea-logic,0.11.1,0.11.2,44,43,2926,1240,4166,166,TRUE
boldr-ui,0.2.20,0.3.0,53,1,23,225,248,3,FALSE
boldr-ui,0.2.7,0.2.8,40,5,8724,4397,13121,408,FALSE
boldr-ui,0.4.0-alpha.1,0.4.0-alpha.2,74,1,23,225,248,3,FALSE
boldr-ui,0.2.9,0.2.10,42,1,23,225,248,3,FALSE
boldr-ui,0.2.8,0.2.9,41,1,23,225,248,3,FALSE
boldr-ui,0.3.8,0.3.9,62,1,23,225,248,3,FALSE
boldr-ui,0.3.9,0.3.10,63,3,35462,1663,37125,312,FALSE
boldr-ui,0.3.2,0.3.3,56,1,23,225,248,3,FALSE
boldr-ui,0.3.3,0.3.4,57,1,23,225,248,3,FALSE
boldr-ui,0.3.0,0.3.1,54,1,1690,400,2090,33,FALSE
boldr-ui,0.3.1,0.3.2,55,1,23,225,248,3,FALSE
boldr-ui,0.3.6,0.3.7,60,1,23,225,248,3,FALSE
boldr-ui,0.3.7,0.3.8,61,1,23,225,248,3,FALSE
boldr-ui,0.3.4,0.3.5,58,1,23,225,248,3,FALSE
boldr-ui,0.3.5,0.3.6,59,1,23,225,248,3,FALSE
boldr-ui,0.4.0-alpha.4,0.4.0-alpha.5,77,1,23,225,248,3,FALSE
boldr-ui,0.4.0-alpha.5,0.4.0-alpha.6,78,1,23,225,248,3,FALSE
boldr-ui,0.4.0-alpha.6,0.4.0-beta.2,79,4,7553,2867,10420,213,FALSE
boldr-ui,0.3.18,0.3.19,71,1,526,541,1067,30,FALSE
boldr-ui,0.3.19,0.4.0-alpha.0,72,1,1377,133,1510,26,FALSE
boldr-ui,0.4.0-alpha.2,0.4.0-alpha.3,75,1,23,225,248,3,FALSE
boldr-ui,0.4.0-alpha.3,0.4.0-alpha.4,76,1,23,225,248,3,FALSE
boldr-ui,0.3.14,0.3.15,67,1,23,225,248,3,FALSE
boldr-ui,0.3.15,0.3.16,68,1,23,225,248,3,FALSE
boldr-ui,0.3.16,0.3.17,69,1,23,225,248,3,FALSE
boldr-ui,0.3.17,0.3.18,70,1,20,25,45,6,FALSE
boldr-ui,0.3.10,0.3.12,64,1,23,225,248,3,FALSE
boldr-ui,0.3.12,0.3.13,65,1,23,225,248,3,FALSE
boldr-ui,0.3.13,0.3.14,66,5,2990,3056,6046,136,FALSE
boldr-ui,0.2.19,0.2.20,52,1,23,225,248,3,FALSE
boldr-ui,0.2.18,0.2.19,51,1,23,225,248,3,FALSE
boldr-ui,0.2.17,0.2.18,50,1,752,251,1003,32,FALSE
boldr-ui,0.4.0-beta.10,0.4.0-rc.1,88,1,23,225,248,3,FALSE
boldr-ui,0.2.15,0.2.16,48,1,1,3,4,2,FALSE
boldr-ui,0.2.14,0.2.15,47,5,3544,1655,5199,200,FALSE
boldr-ui,0.2.13,0.2.14,46,1,23,225,248,3,FALSE
boldr-ui,0.2.12,0.2.13,45,1,23,225,248,3,FALSE
boldr-ui,0.2.11,0.2.12,44,1,23,225,248,3,FALSE
boldr-ui,0.2.10,0.2.11,43,1,23,225,248,3,FALSE
boldr-ui,0.4.0-rc.1,0.4.0-rc.2,89,1,23,225,248,3,FALSE
boldr-ui,0.4.0-rc.2,0.4.0-rc.3,90,1,23,225,248,3,FALSE
boldr-ui,0.4.0-rc.3,0.4.0-rc.4,91,1,23,225,248,3,FALSE
boldr-ui,0.4.0-rc.4,0.4.0-rc.5,92,1,23,225,248,3,FALSE
boldr-ui,0.4.0-rc.5,0.4.0-rc.6,93,1,23,225,248,3,FALSE
boldr-ui,0.4.0-rc.6,0.4.0-rc.6.1,94,1,23,225,248,3,FALSE
boldr-ui,0.2.16,0.2.17,49,1,23,225,248,3,FALSE
boldr-ui,0.4.0-beta.3,0.4.0-beta.4,81,1,23,225,248,3,FALSE
boldr-ui,0.4.0-beta.2,0.4.0-beta.3,80,1,23,225,248,3,FALSE
boldr-ui,0.4.0-beta.5,0.4.0-beta.6,83,1,23,225,248,3,FALSE
boldr-ui,0.4.0-beta.4,0.4.0-beta.5,82,1,23,225,248,3,FALSE
boldr-ui,0.4.0-beta.7,0.4.0-beta.8,85,1,23,225,248,3,FALSE
boldr-ui,0.4.0-beta.6,0.4.0-beta.7,84,1,23,225,248,3,FALSE
boldr-ui,0.4.0-beta.9,0.4.0-beta.10,87,1,23,225,248,3,FALSE
boldr-ui,0.4.0-beta.8,0.4.0-beta.9,86,1,23,225,248,3,FALSE
boldr-ui,0.4.0-alpha.0,0.4.0-alpha.1,73,1,23,225,248,3,FALSE
boldr-ui,0.1.16,0.1.17,29,1,23,225,248,3,FALSE
boldr-ui,0.0.13,0.1.0,13,1,23,225,248,3,FALSE
boldr-ui,0.0.12,0.0.13,12,1,23,225,248,3,FALSE
boldr-ui,0.1.8,0.1.9,21,2,1341,3396,4737,203,FALSE
boldr-ui,0.1.9,0.1.10,22,1,23,225,248,3,FALSE
boldr-ui,0.2.5,0.2.7,39,1,23,225,248,3,FALSE
boldr-ui,0.2.4,0.2.5,38,1,23,225,248,3,FALSE
boldr-ui,0.0.11,0.0.12,11,1,23,225,248,3,FALSE
boldr-ui,0.0.10,0.0.11,10,1,466,472,938,39,FALSE
boldr-ui,0.2.1,0.2.2,35,1,23,225,248,3,TRUE
boldr-ui,0.2.0,0.2.1,34,1,23,225,248,3,FALSE
boldr-ui,0.1.0,0.1.1,14,1,3035,3543,6578,95,FALSE
boldr-ui,0.1.1,0.1.2,15,1,23,225,248,3,FALSE
boldr-ui,0.1.2,0.1.3,16,1,23,225,248,3,FALSE
boldr-ui,0.1.3,0.1.4,17,1,23,225,248,3,FALSE
boldr-ui,0.1.4,0.1.6,18,1,23,225,248,3,FALSE
boldr-ui,0.1.6,0.1.7,19,1,23,225,248,3,FALSE
boldr-ui,0.1.7,0.1.8,20,1,23,225,248,3,FALSE
boldr-ui,0.0.5,0.0.6,5,1,1,1,2,1,FALSE
boldr-ui,0.0.4,0.0.5,4,1,2829,1435,4264,109,FALSE
boldr-ui,0.0.6,0.0.7,6,1,4117,81,4198,86,FALSE
boldr-ui,0.0.1,0.0.2,1,1,23,225,248,3,FALSE
boldr-ui,0.0.3,0.0.4,3,8,38112,240,38352,280,FALSE
boldr-ui,0.0.2,0.0.3,2,1,23,225,248,3,FALSE
boldr-ui,0.1.20,0.2.0,33,1,342,172,514,14,FALSE
boldr-ui,0.0.9,0.0.10,9,1,23,225,248,3,FALSE
boldr-ui,0.0.8,0.0.9,8,1,23,225,248,3,FALSE
boldr-ui,0.1.12,0.1.13,25,2,9256,869,10125,136,FALSE
boldr-ui,0.1.13,0.1.14,26,1,172,20,192,10,FALSE
boldr-ui,0.1.10,0.1.11,23,1,23,225,248,3,FALSE
boldr-ui,0.1.11,0.1.12,24,1,23,225,248,3,FALSE
boldr-ui,0.1.17,0.1.18,30,1,606,110,716,16,FALSE
boldr-ui,0.1.14,0.1.15,27,1,779,775,1554,39,FALSE
boldr-ui,0.1.15,0.1.16,28,1,54,90,144,10,FALSE
boldr-ui,0.1.18,0.1.19,31,1,962,9397,10359,138,FALSE
boldr-ui,0.1.19,0.1.20,32,1,23,225,248,3,FALSE
boldr-ui,0.0.7,0.0.8,7,1,23,225,248,3,FALSE
boldr-ui,0.2.3,0.2.4,37,1,23,225,248,3,FALSE
boldr-ui,0.2.2,0.2.3,36,1,23,225,248,3,FALSE
boldr-ui,0.2.1,0.2.2,35,1,23,225,248,3,FALSE
boldr-ui,0.4.0-rc.2,0.4.0-rc.3,90,1,23,225,248,3,TRUE
boldr-ui,0.1.12,0.1.13,25,2,9256,869,10125,136,TRUE
boldr-ui,0.0.7,0.0.8,7,1,23,225,248,3,TRUE
boldr-ui,0.2.19,0.2.20,52,1,23,225,248,3,TRUE
boldr-ui,0.4.0-rc.5,0.4.0-rc.6,93,1,23,225,248,3,TRUE
boldr-ui,0.4.0-rc.6,0.4.0-rc.6.1,94,1,23,225,248,3,TRUE
boldr-ui,0.4.0-beta.8,0.4.0-beta.9,86,1,23,225,248,3,TRUE
boldr-ui,0.3.12,0.3.13,65,1,23,225,248,3,TRUE
boldr-ui,0.0.5,0.0.6,5,1,1,1,2,1,TRUE
boldr-ui,0.0.10,0.0.11,10,1,466,472,938,39,TRUE
boldr-ui,0.1.17,0.1.18,30,1,606,110,716,16,TRUE
boldr-ui,0.2.14,0.2.15,47,5,3544,1655,5199,200,TRUE
boldr-ui,0.2.15,0.2.16,48,1,1,3,4,2,TRUE
boldr-ui,0.2.13,0.2.14,46,1,23,225,248,3,TRUE
boldr-ui,0.4.0-beta.3,0.4.0-beta.4,81,1,23,225,248,3,TRUE
boldr-ui,0.0.12,0.0.13,12,1,23,225,248,3,TRUE
boldr-ui,0.1.14,0.1.15,27,1,779,775,1554,39,TRUE
boldr-ui,0.1.13,0.1.14,26,1,172,20,192,10,TRUE
boldr-ui,0.3.17,0.3.18,70,1,20,25,45,6,TRUE
boldr-ui,0.1.20,0.2.0,33,1,342,172,514,14,TRUE
boldr-ui,0.0.1,0.0.2,1,1,23,225,248,3,TRUE
material-ui-markdown-editor,1.0.4,1.0.5,5,2,5,4,9,2,FALSE
material-ui-markdown-editor,1.0.5,1.0.6,6,2,2,2,4,2,FALSE
material-ui-markdown-editor,1.0.6,1.0.7,7,2,4,3,7,3,FALSE
material-ui-markdown-editor,1.0.7,1.0.8,8,4,4,4,8,4,FALSE
material-ui-markdown-editor,1.0.0,1.0.1,1,2,2,2,4,2,FALSE
material-ui-markdown-editor,1.0.1,1.0.2,2,8,74,63846,63920,16,FALSE
material-ui-markdown-editor,1.0.2,1.0.3,3,3,15,10,25,3,FALSE
material-ui-markdown-editor,1.0.3,1.0.4,4,1,1,1,2,1,FALSE
material-ui-markdown-editor,1.0.8,1.0.9,9,2,4,2,6,2,FALSE
material-ui-markdown-editor,1.0.9,1.0.10,10,4,6,36,42,6,FALSE
material-ui-markdown-editor,1.0.7,1.0.8,8,4,4,4,8,4,TRUE
draft-extend,1.1.1,1.1.2,4,3,5,5,10,3,FALSE
draft-extend,1.1.0,1.1.1,3,5,25,31,56,5,FALSE
draft-extend,1.1.2,1.2.0,5,3,5,5,10,3,FALSE
draft-extend,1.0.1,1.0.2,1,2,2,1,3,2,FALSE
draft-extend,1.0.2,1.1.0,2,4,76,74,150,20,FALSE
draft-extend,1.4.0,1.4.1,11,3,13,5,18,3,FALSE
draft-extend,1.4.1,1.5.0-beta,12,3,409,158,567,18,FALSE
draft-extend,1.5.0-beta,1.5.0,13,11,453,95,548,20,FALSE
draft-extend,1.3.3,1.4.0,10,6,78,56,134,14,FALSE
draft-extend,1.3.2,1.3.3,9,3,25,7,32,3,FALSE
draft-extend,1.3.1,1.3.2,8,11,237,157,394,13,FALSE
draft-extend,1.3.0,1.3.1,7,5,23,7,30,5,FALSE
draft-extend,1.2.0,1.3.0,6,6,114,82,196,20,FALSE
draft-extend,1.3.0,1.3.1,7,5,23,7,30,5,TRUE
draft-extend,1.3.1,1.3.2,8,11,237,157,394,13,TRUE
draft-extend,1.1.0,1.1.1,3,5,25,31,56,5,TRUE
tagalong,1.1.0,1.2.0,5,32,650,166,816,44,FALSE
tagalong,1.0.0,1.1.0,4,4,37,5,42,5,FALSE
tagalong,2.0.1,2.1.0,8,3,47,1,48,5,FALSE
tagalong,1.3.0,2.0.1,7,47,2995,1465,4460,110,FALSE
tagalong,1.2.0,1.3.0,6,11,127,125,252,16,FALSE
tagalong,0.1.0,0.1.1,1,1,4,2,6,1,FALSE
tagalong,0.1.1,0.1.2,2,1,4,2,6,1,FALSE
tagalong,0.1.2,1.0.0,3,23,7589,6873,14462,51,FALSE
tagalong,2.1.0,2.1.1,9,2,3,3,6,3,FALSE
tagalong,1.1.0,1.2.0,5,32,650,166,816,44,TRUE
react-thrux,2.0.0,2.1.0,23,1,533,166,699,4,FALSE
react-thrux,2.3.0,2.3.1,34,1,95,66,161,2,FALSE
react-thrux,2.3.1,2.3.2,35,2,1024,377,1401,15,FALSE
react-thrux,2.3.2,2.3.3,36,1,4,4,8,2,FALSE
react-thrux,2.2.4,2.3.0,33,1,8,8,16,2,FALSE
react-thrux,2.2.1,2.2.2,30,1,4,4,8,2,FALSE
react-thrux,2.2.0,2.2.1,29,1,35,12,47,1,FALSE
react-thrux,2.2.3,2.2.4,32,1,4,4,8,2,FALSE
react-thrux,2.2.2,2.2.3,31,1,4,4,8,2,FALSE
react-thrux,2.1.2,2.1.3,26,1,10,5,15,3,FALSE
react-thrux,2.1.3,2.1.4,27,2,32,4,36,4,FALSE
react-thrux,2.1.0,2.1.1,24,1,15,23,38,5,FALSE
react-thrux,2.1.1,2.1.2,25,1,2187,6628,8815,5,FALSE
react-thrux,2.1.4,2.2.0,28,1,3448,4479,7927,10,FALSE
react-thrux,1.2.0,1.2.1,11,1,1115,865,1980,9,FALSE
react-thrux,1.3.4,1.3.5,19,1,2,2,4,1,FALSE
react-thrux,2.3.7,2.3.8,41,1,324,321,645,5,FALSE
react-thrux,1.3.3,1.3.4,18,1,8,6,14,6,FALSE
react-thrux,1.3.2,1.3.3,17,1,68,26,94,6,FALSE
react-thrux,1.3.1,1.3.2,16,1,13,6,19,6,FALSE
react-thrux,1.3.0,1.3.1,15,1,333,60,393,9,FALSE
react-thrux,1.2.2,1.2.3,13,1,154,37,191,6,FALSE
react-thrux,1.3.6,1.3.7,21,1,15,10,25,6,FALSE
react-thrux,1.3.5,1.3.6,20,1,11,11,22,6,FALSE
react-thrux,1.2.1,1.2.2,12,1,371,362,733,6,FALSE
react-thrux,1.3.7,2.0.0,22,1,8022,3943,11965,9,FALSE
react-thrux,1.2.3,1.3.0,14,1,628,611,1239,8,FALSE
react-thrux,1.0.0,1.0.1,1,1,93,78,171,4,FALSE
react-thrux,1.0.1,1.0.2,2,1,14,0,14,1,FALSE
react-thrux,1.0.2,1.0.3,3,1,14,14,28,7,FALSE
react-thrux,2.3.3,2.3.4,37,1,370,404,774,7,FALSE
react-thrux,2.3.4,2.3.5,38,1,28,28,56,3,FALSE
react-thrux,2.3.5,2.3.6,39,1,15,8,23,3,FALSE
react-thrux,2.3.6,2.3.7,40,1,32,24,56,5,FALSE
react-thrux,1.0.4,1.0.5,5,1,9,9,18,3,FALSE
react-thrux,1.0.5,1.0.6,6,1,7,4,11,3,FALSE
react-thrux,1.0.6,1.0.7,7,1,102,7,109,2,FALSE
react-thrux,1.0.7,1.0.8,8,1,1,1,2,1,FALSE
react-thrux,1.0.3,1.0.4,4,1,5,151,156,2,FALSE
react-thrux,1.0.8,1.1.0,9,1,17,16,33,7,FALSE
react-thrux,2.3.0,2.3.1,34,1,95,66,161,2,TRUE
react-thrux,1.1.0,1.2.0,10,1,6145,5733,11878,11,FALSE
react-thrux,1.2.2,1.2.3,13,1,154,37,191,6,TRUE
logbin,1.0.4,1.0.5,6,3,20,24,44,4,FALSE
logbin,1.0.5,1.0.6,7,3,21,6,27,4,FALSE
logbin,1.0.6,1.1.0,8,4,94,18,112,9,FALSE
logbin,1.1.2,1.1.3,11,3,45,33,78,7,FALSE
logbin,1.0.0,1.0.1,2,4,15,4,19,4,FALSE
logbin,1.0.1,1.0.2,3,1,16,8,24,2,FALSE
logbin,1.0.2,1.0.3,4,1,33,26,59,3,FALSE
logbin,1.0.3,1.0.4,5,2,35,28,63,5,FALSE
logbin,1.1.9,1.2.0,17,11,650,120,770,11,FALSE
logbin,1.1.3,1.1.4,12,10,108,76,184,28,FALSE
logbin,1.1.5,1.1.6,14,2,10,3,13,5,FALSE
logbin,1.1.4,1.1.5,13,4,2,2,4,2,FALSE
logbin,1.1.7,1.1.9,16,5,43,76,119,10,FALSE
logbin,1.1.6,1.1.7,15,2,24,27,51,4,FALSE
logbin,1.2.0,1.3.0,18,5,155,29,184,11,FALSE
logbin,1.1.1,1.1.2,10,2,34,142,176,8,FALSE
logbin,1.3.3,1.3.4,22,1,7,4,11,1,FALSE
logbin,1.3.2,1.3.3,21,6,56,217,273,24,FALSE
logbin,1.3.1,1.3.2,20,4,23,31,54,5,FALSE
logbin,1.3.0,1.3.1,19,6,50,48,98,15,FALSE
logbin,1.3.7,1.3.8,26,1,4,4,8,3,FALSE
logbin,1.3.6,1.3.7,25,1,4,4,8,3,FALSE
logbin,1.3.5,1.3.6,24,5,67,153,220,14,FALSE
logbin,1.3.4,1.3.5,23,2,1,2,3,2,FALSE
logbin,1.1.0,1.1.1,9,1,4,4,8,3,FALSE
logbin,1.1.9,1.2.0,17,11,650,120,770,11,TRUE
logbin,0.0.1,1.0.0,1,100,6374,5106,11480,324,FALSE
logbin,1.1.3,1.1.4,12,10,108,76,184,28,TRUE
logbin,1.2.0,1.3.0,18,5,155,29,184,11,TRUE
logbin,1.3.0,1.3.1,19,6,50,48,98,15,TRUE
customelement,1.0.0,1.0.1,1,1,58,0,58,2,FALSE
customelement,1.0.1,1.0.2,2,1,58,0,58,2,FALSE
customelement,1.0.3,1.1.1,4,1,58,0,58,2,FALSE
customelement,1.0.2,1.0.3,3,1,58,0,58,2,FALSE
customelement,1.0.3,1.1.1,4,1,58,0,58,2,TRUE
make-element,1.1.1,1.2.0,4,4,38,30,68,9,FALSE
make-element,1.1.0,1.1.1,3,1,1,1,2,1,FALSE
make-element,1.0.0,1.0.1,1,1,2,7,9,2,FALSE
make-element,1.0.1,1.1.0,2,2,15,15,30,6,FALSE
make-element,1.3.0,1.4.0,6,2,21,11,32,4,FALSE
make-element,1.2.0,1.3.0,5,2,30,12,42,5,FALSE
make-element,1.1.0,1.1.1,3,1,1,1,2,1,TRUE
react-router-dom,4.0.0,4.1.0,10,69,2275,884,3159,162,TRUE
react-router-dom,4.1.0,4.1.1,11,5,760,62,822,12,TRUE
react-router-dom,4.0.0-beta.8,4.0.0,9,26,38817,31357,70174,612,FALSE
react-router-dom,4.0.0-beta.1,4.0.0-beta.2,2,3,9,109,118,11,TRUE
react-router-dom,4.0.0-beta.3,4.0.0-beta.4,4,22,281,55,336,37,TRUE
react-router-dom,4.0.0-beta.2,4.0.0-beta.3,3,9,73,46,119,14,TRUE
react-router-dom,4.0.0-beta.7,4.0.0-beta.8,8,42,12636,2035,14671,272,TRUE
react-router-dom,4.0.0-beta.6,4.0.0-beta.7,7,53,2444,859,3303,188,TRUE
react-router-dom,4.0.0,4.1.0,10,69,2275,884,3159,162,FALSE
react-router-dom,4.1.0,4.1.1,11,5,760,62,822,12,FALSE
react-router-dom,4.0.0-beta.1,4.0.0-beta.2,2,3,9,109,118,11,FALSE
react-router-dom,4.0.0-beta.3,4.0.0-beta.4,4,22,281,55,336,37,FALSE
react-router-dom,4.0.0-beta.2,4.0.0-beta.3,3,9,73,46,119,14,FALSE
react-router-dom,4.0.0-beta.5,4.0.0-beta.6,6,17,163,95,258,37,FALSE
react-router-dom,4.0.0-beta.4,4.0.0-beta.5,5,20,450,114,564,55,FALSE
react-router-dom,4.0.0-beta.6,4.0.0-beta.7,7,53,2444,859,3303,188,FALSE
react-router-dom,4.0.0-beta.7,4.0.0-beta.8,8,42,12636,2035,14671,272,FALSE
react-router-dom,4.0.0-beta.5,4.0.0-beta.6,6,17,163,95,258,37,TRUE
wsdot-route-utils,1.3.1,1.4.0,7,6,2699,5858,8557,21,FALSE
wsdot-route-utils,1.2.0,1.3.0,5,5,1542,240,1782,25,FALSE
wsdot-route-utils,1.1.1,1.2.0,4,6,1222,767,1989,42,FALSE
wsdot-route-utils,1.1.0,1.1.1,3,6,41,30,71,12,FALSE
wsdot-route-utils,1.0.0,1.0.1,1,2,24,1,25,3,FALSE
wsdot-route-utils,1.0.1,1.1.0,2,2,370,26,396,10,FALSE
wsdot-route-utils,1.3.1,1.4.0,7,6,2699,5858,8557,21,TRUE
wsdot-route-utils,1.3.0,1.3.1,6,8,7496,1923,9419,60,TRUE
wsdot-route-utils,1.3.0,1.3.1,6,8,7496,1923,9419,60,FALSE
html-highlighter,0.1.0,0.1.1,1,16,784,893,1677,56,FALSE
html-highlighter,0.1.1,0.1.3,2,3,16,2,18,3,FALSE
html-highlighter,0.1.0,0.1.1,1,16,784,893,1677,56,TRUE
withlocals-cloudinary,0.6.3,0.6.4,85,2,64,16,80,10,FALSE
withlocals-cloudinary,0.6.2,0.6.3,84,1,17,19,36,8,FALSE
withlocals-cloudinary,0.6.1,0.6.2,83,1,464,22,486,10,FALSE
withlocals-cloudinary,0.6.0,0.6.1,82,1,56,2,58,4,FALSE
withlocals-cloudinary,0.6.7,0.7.0,89,4,441,67,508,20,FALSE
withlocals-cloudinary,0.6.6,0.6.7,88,8,388,80,468,33,FALSE
withlocals-cloudinary,0.6.4,0.6.5,86,1,21,7,28,5,FALSE
withlocals-cloudinary,0.6.5,0.6.6,87,1,56,14,70,8,FALSE
withlocals-cloudinary,0.5.1,0.5.2,80,4,14,5,19,8,FALSE
withlocals-cloudinary,0.5.2,0.6.0,81,2,54,6,60,12,FALSE
withlocals-cloudinary,1.1.1,1.1.2,93,1,3,3,6,2,FALSE
withlocals-cloudinary,1.1.0,1.1.1,92,6,176,20,196,13,FALSE
withlocals-cloudinary,1.1.2,1.2.0,94,5,98,29,127,12,FALSE
withlocals-cloudinary,1.0.0,1.1.0,91,4,29,21,50,12,FALSE
withlocals-cloudinary,1.2.4,1.2.5,99,5,32,23,55,13,FALSE
withlocals-cloudinary,1.2.5,1.2.6,100,4,19,7,26,11,FALSE
withlocals-cloudinary,1.2.2,1.2.3,97,7,47,16,63,13,FALSE
withlocals-cloudinary,1.2.3,1.2.4,98,5,37,19,56,11,FALSE
withlocals-cloudinary,1.2.0,1.2.1,95,5,74,61,135,15,FALSE
withlocals-cloudinary,1.2.1,1.2.2,96,2,14,8,22,6,FALSE
withlocals-cloudinary,0.1.1,0.1.7,68,32,256238,288,256526,58,FALSE
withlocals-cloudinary,0.0.39,0.0.40,39,1,153,167,320,4,FALSE
withlocals-cloudinary,0.2.0,0.3.0,71,6,906,836,1742,35,FALSE
withlocals-cloudinary,0.0.15,0.0.16,15,1,153,167,320,4,FALSE
withlocals-cloudinary,0.0.14,0.0.15,14,1,153,167,320,4,FALSE
withlocals-cloudinary,0.0.17,0.0.18,17,1,153,167,320,4,FALSE
withlocals-cloudinary,0.0.16,0.0.17,16,1,153,167,320,4,FALSE
withlocals-cloudinary,0.0.11,0.0.12,11,1,153,167,320,4,FALSE
withlocals-cloudinary,0.0.10,0.0.11,10,1,153,167,320,4,FALSE
withlocals-cloudinary,0.0.13,0.0.14,13,1,793,1298,2091,6,FALSE
withlocals-cloudinary,0.0.12,0.0.13,12,1,153,167,320,4,FALSE
withlocals-cloudinary,0.0.51,0.0.52,51,1,153,167,320,4,FALSE
withlocals-cloudinary,0.0.50,0.0.51,50,1,153,167,320,4,FALSE
withlocals-cloudinary,0.0.35,0.0.36,35,1,153,167,320,4,FALSE
withlocals-cloudinary,0.0.52,0.0.53,52,1,153,167,320,4,FALSE
withlocals-cloudinary,0.0.55,0.0.56,55,1,143,25921,26064,11,FALSE
withlocals-cloudinary,0.0.54,0.0.55,54,1,153,167,320,4,FALSE
withlocals-cloudinary,0.0.57,0.0.58,57,1,153,167,320,4,FALSE
withlocals-cloudinary,0.0.56,0.0.57,56,1,153,167,320,4,FALSE
withlocals-cloudinary,0.0.7,0.0.8,7,1,153,167,320,4,FALSE
withlocals-cloudinary,0.0.34,0.0.35,34,1,153,167,320,4,FALSE
withlocals-cloudinary,0.0.30,0.0.31,30,1,153,167,320,4,FALSE
withlocals-cloudinary,0.0.19,0.0.20,19,1,153,167,320,4,FALSE
withlocals-cloudinary,0.3.0,0.3.1,72,1,1,1,2,1,FALSE
withlocals-cloudinary,0.0.9,0.0.10,9,1,153,167,320,4,FALSE
withlocals-cloudinary,0.0.8,0.0.9,8,1,153,167,320,4,FALSE
withlocals-cloudinary,0.0.18,0.0.19,18,1,153,167,320,4,FALSE
withlocals-cloudinary,0.0.53,0.0.54,53,1,153,167,320,4,FALSE
withlocals-cloudinary,0.0.38,0.0.39,38,1,153,167,320,4,FALSE
withlocals-cloudinary,0.0.31,0.0.32,31,1,153,167,320,4,FALSE
withlocals-cloudinary,0.1.7,0.1.8,69,4,291,256119,256410,18,FALSE
withlocals-cloudinary,0.0.64,0.0.65,64,1,153,167,320,4,FALSE
withlocals-cloudinary,0.0.65,0.0.66,65,1,153,167,320,4,FALSE
withlocals-cloudinary,0.0.66,0.1.0,66,1,153,167,320,4,FALSE
withlocals-cloudinary,0.0.60,0.0.61,60,1,153,167,320,4,FALSE
withlocals-cloudinary,0.0.61,0.0.62,61,1,153,167,320,4,FALSE
withlocals-cloudinary,0.0.62,0.0.63,62,1,153,167,320,4,FALSE
withlocals-cloudinary,0.0.63,0.0.64,63,1,153,167,320,4,FALSE
withlocals-cloudinary,0.0.33,0.0.34,33,1,153,167,320,4,FALSE
withlocals-cloudinary,0.0.49,0.0.50,49,1,153,167,320,4,FALSE
withlocals-cloudinary,0.0.20,0.0.21,20,1,153,167,320,4,FALSE
withlocals-cloudinary,0.0.21,0.0.22,21,1,153,167,320,4,FALSE
withlocals-cloudinary,0.0.22,0.0.23,22,1,153,167,320,4,FALSE
withlocals-cloudinary,0.0.6,0.0.7,6,1,153,167,320,4,FALSE
withlocals-cloudinary,0.0.24,0.0.25,24,1,153,167,320,4,FALSE
withlocals-cloudinary,0.0.25,0.0.26,25,1,25896,25934,51830,6,FALSE
withlocals-cloudinary,0.0.26,0.0.27,26,1,153,167,320,4,FALSE
withlocals-cloudinary,0.0.27,0.0.28,27,1,153,167,320,4,FALSE
withlocals-cloudinary,0.0.28,0.0.29,28,1,153,167,320,4,FALSE
withlocals-cloudinary,0.0.43,0.0.44,43,1,153,167,320,4,FALSE
withlocals-cloudinary,0.0.40,0.0.41,40,1,153,167,320,4,FALSE
withlocals-cloudinary,0.0.41,0.0.42,41,1,153,167,320,4,FALSE
withlocals-cloudinary,0.0.46,0.0.47,46,1,153,167,320,4,FALSE
withlocals-cloudinary,0.0.47,0.0.48,47,1,153,167,320,4,FALSE
withlocals-cloudinary,0.0.29,0.0.30,29,1,153,167,320,4,FALSE
withlocals-cloudinary,0.0.45,0.0.46,45,1,153,167,320,4,FALSE
withlocals-cloudinary,0.0.59,0.0.60,59,1,153,167,320,4,FALSE
withlocals-cloudinary,0.1.0,0.1.1,67,4,355,26526,26881,19,FALSE
withlocals-cloudinary,0.0.42,0.0.43,42,1,153,167,320,4,FALSE
withlocals-cloudinary,0.0.58,0.0.59,58,1,153,167,320,4,FALSE
withlocals-cloudinary,0.0.32,0.0.33,32,1,153,167,320,4,FALSE
withlocals-cloudinary,0.0.48,0.0.49,48,1,153,167,320,4,FALSE
withlocals-cloudinary,0.0.36,0.0.37,36,1,153,167,320,4,FALSE
withlocals-cloudinary,0.1.8,0.2.0,70,7,156,14,170,15,FALSE
withlocals-cloudinary,0.0.23,0.0.24,23,1,153,167,320,4,FALSE
withlocals-cloudinary,0.0.44,0.0.45,44,1,153,167,320,4,FALSE
withlocals-cloudinary,0.0.37,0.0.38,37,1,153,167,320,4,FALSE
withlocals-cloudinary,0.3.1,0.4.0,73,6,24,8,32,8,FALSE
withlocals-cloudinary,2.0.0,2.0.1,102,3,6,20,26,6,FALSE
withlocals-cloudinary,0.4.1,0.4.2,75,6,29,17,46,7,FALSE
withlocals-cloudinary,0.4.0,0.4.1,74,4,28,4,32,9,FALSE
withlocals-cloudinary,0.4.3,0.4.4,77,2,4,4,8,2,FALSE
withlocals-cloudinary,0.4.2,0.4.3,76,4,3,5,8,4,FALSE
withlocals-cloudinary,0.4.4,0.5.0,78,8,266,38,304,21,FALSE
withlocals-cloudinary,0.7.0,1.0.0,90,7,147,107,254,20,FALSE
withlocals-cloudinary,0.5.0,0.5.1,79,5,58,39,97,12,FALSE
withlocals-cloudinary,1.2.6,2.0.0,101,4,585,397,982,32,FALSE
withlocals-cloudinary,0.6.3,0.6.4,85,2,64,16,80,10,TRUE
withlocals-cloudinary,2.0.0,2.0.1,102,3,6,20,26,6,TRUE
withlocals-cloudinary,0.0.5,0.0.6,5,1,153,167,320,4,FALSE
withlocals-cloudinary,0.0.4,0.0.5,4,8,57401,5649,63050,27,FALSE
withlocals-cloudinary,0.0.1,0.0.2,1,4,18,5,23,8,FALSE
withlocals-cloudinary,0.0.3,0.0.4,3,4,18,9,27,10,FALSE
withlocals-cloudinary,0.0.2,0.0.3,2,4,26,8449,8475,8,FALSE
withlocals-cloudinary,0.7.0,1.0.0,90,7,147,107,254,20,TRUE
withlocals-cloudinary,0.4.4,0.5.0,78,8,266,38,304,21,TRUE
withlocals-cloudinary,0.5.2,0.6.0,81,2,54,6,60,12,TRUE
react-component-google-maps,0.2.2,0.3.0,3,9,110,36,146,22,FALSE
react-component-google-maps,0.2.1,0.2.2,2,2,57,3,60,2,FALSE
react-component-google-maps,0.2.0,0.2.1,1,3,18,16,34,4,FALSE
react-component-google-maps,0.2.0,0.2.1,1,3,18,16,34,4,TRUE
lasso-require,3.1.3,3.1.4,41,3,217,3,220,15,FALSE
lasso-require,3.1.2,3.1.3,40,2,4,2,6,2,FALSE
lasso-require,2.0.5,2.1.0,27,2,35,2,37,4,FALSE
lasso-require,2.0.4,2.0.5,26,2,25,2,27,2,FALSE
lasso-require,2.0.3,2.0.4,25,3,182,28,210,6,FALSE
lasso-require,2.0.2,2.0.3,24,2,12,12,24,3,FALSE
lasso-require,2.0.1,2.0.2,23,2,6,2,8,2,FALSE
lasso-require,2.0.0,2.0.1,22,2,1,4,5,3,FALSE
lasso-require,3.1.1,3.1.2,39,2,3,2,5,2,FALSE
lasso-require,2.2.5,2.3.0,34,4,203,224,427,189,FALSE
lasso-require,2.2.4,2.2.5,33,2,2,2,4,2,FALSE
lasso-require,3.1.0,3.1.1,38,2,2,2,4,2,FALSE
lasso-require,2.2.1,2.2.2,30,2,11,7,18,4,FALSE
lasso-require,2.2.0,2.2.1,29,4,11,5,16,4,FALSE
lasso-require,2.2.3,2.2.4,32,3,6,4,10,7,FALSE
lasso-require,2.2.2,2.2.3,31,5,37,32,69,11,FALSE
lasso-require,2.1.0,2.2.0,28,2,124,122,246,15,FALSE
lasso-require,3.1.5,3.2.0,43,3,310,6,316,7,FALSE
lasso-require,3.1.4,3.1.5,42,2,25,5,30,4,FALSE
lasso-require,3.0.0,3.0.1,36,2,10,18,28,2,FALSE
lasso-require,2.3.0,3.0.0,35,1,55,4,59,4,FALSE
lasso-require,1.6.0,1.7.0,19,2,80,13,93,4,FALSE
lasso-require,1.7.0,1.8.0,20,19,8416,4984,13400,371,FALSE
lasso-require,1.4.0,1.4.1,6,2,94,69,163,2,FALSE
lasso-require,1.4.1,1.4.2,7,2,11,2,13,2,FALSE
lasso-require,1.4.2,1.4.3,8,2,5,1,6,2,FALSE
lasso-require,1.4.3,1.4.4,9,2,5,1,6,2,FALSE
lasso-require,1.4.4,1.4.5,10,2,7,2,9,2,FALSE
lasso-require,1.4.5,1.4.6,11,3,432,293,725,18,FALSE
lasso-require,1.4.6,1.4.7,12,2,12,1,13,2,FALSE
lasso-require,1.4.7,1.4.8,13,2,3,3,6,2,FALSE
lasso-require,1.4.8,1.4.9,14,2,4,1,5,2,FALSE
lasso-require,1.4.9,1.4.10,15,2,194,124,318,2,FALSE
lasso-require,3.0.1,3.1.0,37,3,670,60,730,53,FALSE
lasso-require,1.5.0,1.5.1,17,3,27,14,41,5,FALSE
lasso-require,1.3.7,1.3.8,3,4,134,33,167,6,FALSE
lasso-require,1.3.6,1.3.7,2,3,9,3,12,3,FALSE
lasso-require,1.3.5,1.3.6,1,1,5,5,10,3,FALSE
lasso-require,1.3.9,1.4.0,5,6,77,75,152,9,FALSE
lasso-require,1.3.8,1.3.9,4,2,31,6,37,2,FALSE
lasso-require,3.4.2,3.4.3,51,4,20,13,33,5,FALSE
lasso-require,3.4.3,3.4.4,52,3,83,53,136,15,FALSE
lasso-require,3.4.0,3.4.1,49,2,3,3,6,2,FALSE
lasso-require,3.4.1,3.4.2,50,2,4,14,18,3,FALSE
lasso-require,1.5.1,1.6.0,18,2,4,4,8,2,FALSE
lasso-require,3.3.0,3.4.0,48,2,189,71,260,6,FALSE
lasso-require,3.2.0,3.2.1,44,3,45,37,82,3,FALSE
lasso-require,3.2.1,3.2.2,45,2,147,92,239,8,FALSE
lasso-require,3.2.2,3.2.3,46,4,84,78,162,5,FALSE
lasso-require,3.2.3,3.3.0,47,2,17,2,19,2,FALSE
lasso-require,1.4.10,1.5.0,16,2,75,1,76,3,FALSE
lasso-require,1.4.5,1.4.6,11,3,432,293,725,18,TRUE
lasso-require,1.5.1,1.6.0,18,2,4,4,8,2,TRUE
lasso-require,3.2.0,3.2.1,44,3,45,37,82,3,TRUE
lasso-require,1.4.10,1.5.0,16,2,75,1,76,3,TRUE
lasso-require,2.2.2,2.2.3,31,5,37,32,69,11,TRUE
ng2-blur-theme,1.0.0,1.0.1,1,1,112,0,112,1,FALSE
ng2-blur-theme,1.0.1,1.0.2,2,3,30134,35,30169,233,FALSE
ng2-blur-theme,1.0.2,1.0.3,3,1,3,2,5,2,FALSE
ng2-blur-theme,1.0.2,1.0.3,3,1,3,2,5,2,TRUE
ng2-blur-theme,1.0.1,1.0.2,2,3,30134,35,30169,233,TRUE
ship-components-buttons,0.1.0,0.1.1,1,6,67,57,124,17,FALSE
ship-components-buttons,0.1.1,0.1.2,2,2,11,8,19,8,FALSE
ship-components-buttons,0.1.2,0.1.3,3,1,14,34,48,4,FALSE
ship-components-buttons,0.1.3,0.1.4,4,1,5,2,7,2,FALSE
ship-components-buttons,0.1.4,0.1.5,5,2,40,4,44,6,FALSE
ship-components-buttons,0.1.0,0.1.1,1,6,67,57,124,17,TRUE
ship-components-buttons,0.1.4,0.1.5,5,2,40,4,44,6,TRUE
ship-components-buttons,0.1.1,0.1.2,2,2,11,8,19,8,TRUE
availability,2.1.458,2.1.459,466,1,32,0,32,1,FALSE
availability,2.1.448,2.1.449,456,1,32,0,32,1,FALSE
availability,2.1.449,2.1.450,457,1,32,0,32,1,FALSE
availability,2.1.363,2.1.364,371,1,32,0,32,1,FALSE
availability,2.1.362,2.1.363,370,1,32,0,32,1,FALSE
availability,2.1.365,2.1.366,373,1,32,0,32,1,FALSE
availability,2.1.364,2.1.365,372,1,32,0,32,1,FALSE
availability,2.1.367,2.1.368,375,1,32,0,32,1,FALSE
availability,2.1.366,2.1.367,374,1,32,0,32,1,FALSE
availability,2.1.369,2.1.370,377,1,32,0,32,1,FALSE
availability,2.1.368,2.1.369,376,1,32,0,32,1,FALSE
availability,2.1.442,2.1.443,450,1,32,0,32,1,FALSE
availability,2.1.443,2.1.444,451,1,32,0,32,1,FALSE
availability,2.1.444,2.1.445,452,1,32,0,32,1,FALSE
availability,2.1.445,2.1.446,453,1,32,0,32,1,FALSE
availability,2.1.446,2.1.447,454,3,44,4,48,6,FALSE
availability,2.1.447,2.1.448,455,1,32,0,32,1,FALSE
availability,2.1.299,2.1.300,307,1,32,0,32,1,FALSE
availability,2.1.298,2.1.299,306,1,32,0,32,1,FALSE
availability,2.1.295,2.1.296,303,1,32,0,32,1,FALSE
availability,2.1.294,2.1.295,302,1,32,0,32,1,FALSE
availability,2.1.297,2.1.298,305,1,32,0,32,1,FALSE
availability,2.1.296,2.1.297,304,1,32,0,32,1,FALSE
availability,2.1.291,2.1.292,299,1,32,0,32,1,FALSE
availability,2.1.290,2.1.291,298,1,32,0,32,1,FALSE
availability,2.1.293,2.1.294,301,1,32,0,32,1,FALSE
availability,2.1.292,2.1.293,300,1,32,0,32,1,FALSE
availability,2.1.475,2.1.476,483,1,32,0,32,1,FALSE
availability,2.1.474,2.1.475,482,1,32,0,32,1,FALSE
availability,2.1.476,2.1.477,484,1,32,0,32,1,FALSE
availability,2.1.471,2.1.472,479,2,97,3,100,4,FALSE
availability,2.1.470,2.1.471,478,1,32,0,32,1,FALSE
availability,2.1.473,2.1.474,481,1,32,0,32,1,FALSE
availability,2.1.472,2.1.473,480,1,32,0,32,1,FALSE
availability,2.1.277,2.1.278,285,1,32,0,32,1,FALSE
availability,2.1.276,2.1.277,284,2,2,2,4,2,FALSE
availability,2.1.275,2.1.276,283,1,73,0,73,1,FALSE
availability,2.1.378,2.1.379,386,1,32,0,32,1,FALSE
availability,2.1.379,2.1.380,387,1,32,0,32,1,FALSE
availability,2.1.376,2.1.377,384,1,32,0,32,1,FALSE
availability,2.1.377,2.1.378,385,1,32,0,32,1,FALSE
availability,2.1.374,2.1.375,382,1,32,0,32,1,FALSE
availability,2.1.375,2.1.376,383,1,32,0,32,1,FALSE
availability,2.1.372,2.1.373,380,1,32,0,32,1,FALSE
availability,2.1.373,2.1.374,381,1,32,0,32,1,FALSE
availability,2.1.370,2.1.371,378,1,32,0,32,1,FALSE
availability,2.1.371,2.1.372,379,1,32,0,32,1,FALSE
availability,2.1.361,2.1.362,369,1,32,0,32,1,FALSE
availability,2.1.360,2.1.361,368,1,32,0,32,1,FALSE
availability,2.1.288,2.1.289,296,1,32,0,32,1,FALSE
availability,2.1.289,2.1.290,297,1,32,0,32,1,FALSE
availability,2.1.282,2.1.283,290,1,32,0,32,1,FALSE
availability,2.1.283,2.1.284,291,1,32,0,32,1,FALSE
availability,2.1.280,2.1.281,288,1,32,0,32,1,FALSE
availability,2.1.281,2.1.282,289,1,32,0,32,1,FALSE
availability,2.1.286,2.1.287,294,1,32,0,32,1,FALSE
availability,2.1.287,2.1.288,295,1,32,0,32,1,FALSE
availability,2.1.284,2.1.285,292,1,32,0,32,1,FALSE
availability,2.1.285,2.1.286,293,1,32,0,32,1,FALSE
availability,2.1.462,2.1.463,470,1,32,0,32,1,FALSE
availability,2.1.463,2.1.464,471,1,32,0,32,1,FALSE
availability,2.1.460,2.1.461,468,1,32,0,32,1,FALSE
availability,2.1.461,2.1.462,469,1,32,0,32,1,FALSE
availability,2.1.466,2.1.467,474,1,32,0,32,1,FALSE
availability,2.1.467,2.1.468,475,1,32,0,32,1,FALSE
availability,2.1.464,2.1.465,472,1,32,0,32,1,FALSE
availability,2.1.465,2.1.466,473,1,32,0,32,1,FALSE
availability,2.1.468,2.1.469,476,1,32,0,32,1,FALSE
availability,2.1.469,2.1.470,477,1,32,0,32,1,FALSE
availability,2.1.440,2.1.441,448,1,32,0,32,1,FALSE
availability,2.1.309,2.1.310,317,1,32,0,32,1,TRUE
availability,2.1.308,2.1.309,316,1,32,0,32,1,FALSE
availability,2.1.441,2.1.442,449,1,32,0,32,1,FALSE
availability,2.1.303,2.1.304,311,1,32,0,32,1,FALSE
availability,2.1.302,2.1.303,310,1,32,0,32,1,FALSE
availability,2.1.301,2.1.302,309,1,32,0,32,1,FALSE
availability,2.1.300,2.1.301,308,1,32,0,32,1,FALSE
availability,2.1.307,2.1.308,315,1,32,0,32,1,FALSE
availability,2.1.306,2.1.307,314,1,32,0,32,1,FALSE
availability,2.1.305,2.1.306,313,1,32,0,32,1,FALSE
availability,2.1.304,2.1.305,312,1,32,0,32,1,FALSE
availability,2.1.318,2.1.319,326,4,2039,1722,3761,34,FALSE
availability,2.1.319,2.1.320,327,1,190,188,378,23,FALSE
availability,2.1.415,2.1.416,423,1,32,0,32,1,FALSE
availability,2.1.414,2.1.415,422,1,32,0,32,1,FALSE
availability,2.1.413,2.1.414,421,1,32,0,32,1,FALSE
availability,2.1.412,2.1.413,420,1,32,0,32,1,FALSE
availability,2.1.411,2.1.412,419,1,32,0,32,1,FALSE
availability,2.1.410,2.1.411,418,1,32,0,32,1,FALSE
availability,2.1.310,2.1.311,318,1,32,0,32,1,FALSE
availability,2.1.311,2.1.312,319,1,32,0,32,1,FALSE
availability,2.1.312,2.1.313,320,1,32,0,32,1,FALSE
availability,2.1.313,2.1.314,321,1,32,0,32,1,FALSE
availability,2.1.314,2.1.315,322,1,32,0,32,1,FALSE
availability,2.1.315,2.1.316,323,1,32,0,32,1,FALSE
availability,2.1.316,2.1.317,324,1,32,0,32,1,TRUE
availability,2.1.418,2.1.419,426,1,32,0,32,1,FALSE
availability,2.1.417,2.1.418,425,1,32,0,32,1,FALSE
availability,2.1.416,2.1.417,424,1,32,0,32,1,FALSE
availability,2.1.459,2.1.460,467,1,32,0,32,1,FALSE
availability,2.1.383,2.1.384,391,1,49,29,78,24,FALSE
availability,2.1.382,2.1.383,390,1,32,0,32,1,FALSE
availability,2.1.381,2.1.382,389,1,32,0,32,1,FALSE
availability,2.1.380,2.1.381,388,1,32,0,32,1,FALSE
availability,2.1.387,2.1.388,395,1,178,3,181,6,FALSE
availability,2.1.386,2.1.387,394,4,194,8,202,13,FALSE
availability,2.1.385,2.1.386,393,1,32,0,32,1,FALSE
availability,2.1.384,2.1.385,392,1,32,0,32,1,FALSE
availability,2.1.389,2.1.390,397,1,43,1,44,2,FALSE
availability,2.1.388,2.1.389,396,1,52,0,52,1,FALSE
availability,2.1.325,2.1.326,333,1,32,0,32,1,FALSE
availability,2.1.324,2.1.325,332,1,32,0,32,1,FALSE
availability,2.1.327,2.1.328,335,1,135,18,153,5,FALSE
availability,2.1.326,2.1.327,334,1,32,0,32,1,FALSE
availability,2.1.321,2.1.322,329,1,32,0,32,1,FALSE
availability,2.1.320,2.1.321,328,1,32,0,32,1,FALSE
availability,2.1.323,2.1.324,331,1,32,0,32,1,FALSE
availability,2.1.322,2.1.323,330,1,32,0,32,1,FALSE
availability,2.1.329,2.1.330,337,1,32,0,32,1,FALSE
availability,2.1.328,2.1.329,336,1,2,1,3,1,FALSE
availability,2.1.404,2.1.405,412,1,3,0,3,1,FALSE
availability,2.1.405,2.1.406,413,1,32,0,32,1,FALSE
availability,2.1.406,2.1.407,414,1,32,0,32,1,FALSE
availability,2.1.407,2.1.408,415,1,32,0,32,1,FALSE
availability,2.1.400,2.1.401,408,1,32,0,32,1,FALSE
availability,2.1.401,2.1.402,409,1,46,2,48,2,FALSE
availability,2.1.402,2.1.403,410,1,32,0,32,1,FALSE
availability,2.1.403,2.1.404,411,1,32,0,32,1,FALSE
availability,2.1.408,2.1.409,416,1,32,0,32,1,FALSE
availability,2.1.409,2.1.410,417,1,100,0,100,5,FALSE
availability,2.1.358,2.1.359,366,1,32,0,32,1,FALSE
availability,2.1.456,2.1.457,464,1,32,0,32,1,FALSE
availability,2.1.390,2.1.391,398,1,22,9,31,4,FALSE
availability,2.1.391,2.1.392,399,1,32,0,32,1,FALSE
availability,2.1.392,2.1.393,400,1,32,0,32,1,FALSE
availability,2.1.393,2.1.394,401,2,26,31,57,3,FALSE
availability,2.1.394,2.1.395,402,2,27,27,54,19,FALSE
availability,2.1.419,2.1.420,427,1,32,0,32,1,FALSE
availability,2.1.396,2.1.397,404,1,32,0,32,1,FALSE
availability,2.1.397,2.1.398,405,1,32,0,32,1,FALSE
availability,2.1.398,2.1.399,406,1,32,0,32,1,FALSE
availability,2.1.399,2.1.400,407,1,32,0,32,1,FALSE
availability,2.1.317,2.1.318,325,1,32,0,32,1,FALSE
availability,2.1.395,2.1.396,403,1,37,1,38,2,FALSE
availability,2.1.332,2.1.333,340,1,32,0,32,1,FALSE
availability,2.1.333,2.1.334,341,1,32,0,32,1,FALSE
availability,2.1.330,2.1.331,338,1,32,0,32,1,FALSE
availability,2.1.331,2.1.332,339,1,32,0,32,1,FALSE
availability,2.1.336,2.1.337,344,1,32,0,32,1,FALSE
availability,2.1.337,2.1.338,345,1,32,0,32,1,FALSE
availability,2.1.334,2.1.335,342,1,32,0,32,1,FALSE
availability,2.1.335,2.1.336,343,1,32,0,32,1,FALSE
availability,2.1.338,2.1.339,346,1,32,0,32,1,FALSE
availability,2.1.339,2.1.340,347,1,32,0,32,1,FALSE
availability,2.1.431,2.1.432,439,1,32,0,32,1,FALSE
availability,2.1.430,2.1.431,438,1,32,0,32,1,FALSE
availability,2.1.433,2.1.434,441,1,32,0,32,1,FALSE
availability,2.1.432,2.1.433,440,1,32,0,32,1,FALSE
availability,2.1.435,2.1.436,443,1,32,0,32,1,FALSE
availability,2.1.434,2.1.435,442,1,32,0,32,1,FALSE
availability,2.1.437,2.1.438,445,1,32,0,32,1,FALSE
availability,2.1.436,2.1.437,444,1,32,0,32,1,FALSE
availability,2.1.439,2.1.440,447,1,32,0,32,1,FALSE
availability,2.1.438,2.1.439,446,1,32,0,32,1,FALSE
availability,2.1.279,2.1.280,287,1,32,0,32,1,FALSE
availability,2.1.428,2.1.429,436,1,32,0,32,1,FALSE
availability,2.1.429,2.1.430,437,1,32,0,32,1,FALSE
availability,2.1.347,2.1.348,355,1,32,0,32,1,FALSE
availability,2.1.346,2.1.347,354,1,32,0,32,1,FALSE
availability,2.1.345,2.1.346,353,1,32,0,32,1,FALSE
availability,2.1.344,2.1.345,352,1,32,0,32,1,FALSE
availability,2.1.343,2.1.344,351,1,32,0,32,1,FALSE
availability,2.1.342,2.1.343,350,1,32,0,32,1,FALSE
availability,2.1.341,2.1.342,349,1,32,0,32,1,FALSE
availability,2.1.340,2.1.341,348,1,32,0,32,1,FALSE
availability,2.1.426,2.1.427,434,1,32,0,32,1,FALSE
availability,2.1.427,2.1.428,435,1,32,0,32,1,FALSE
availability,2.1.278,2.1.279,286,1,32,0,32,1,FALSE
availability,2.1.425,2.1.426,433,1,32,0,32,1,FALSE
availability,2.1.422,2.1.423,430,1,32,0,32,1,FALSE
availability,2.1.424,2.1.425,432,1,32,0,32,1,FALSE
availability,2.1.420,2.1.421,428,1,32,0,32,1,FALSE
availability,2.1.421,2.1.422,429,1,32,0,32,1,FALSE
availability,2.1.423,2.1.424,431,1,32,0,32,1,FALSE
availability,2.1.349,2.1.350,357,1,32,0,32,1,FALSE
availability,2.1.348,2.1.349,356,1,32,0,32,1,FALSE
availability,2.1.354,2.1.355,362,1,15,0,15,1,FALSE
availability,2.1.355,2.1.356,363,2,25,21,46,3,FALSE
availability,2.1.356,2.1.357,364,1,32,0,32,1,FALSE
availability,2.1.357,2.1.358,365,1,32,0,32,1,FALSE
availability,2.1.350,2.1.351,358,1,32,0,32,1,FALSE
availability,2.1.351,2.1.352,359,1,32,0,32,1,FALSE
availability,2.1.352,2.1.353,360,1,32,0,32,1,FALSE
availability,2.1.353,2.1.354,361,4,216,96,312,11,FALSE
availability,2.1.453,2.1.454,461,1,32,0,32,1,FALSE
availability,2.1.452,2.1.453,460,1,32,0,32,1,FALSE
availability,2.1.451,2.1.452,459,1,32,0,32,1,FALSE
availability,2.1.450,2.1.451,458,1,32,0,32,1,FALSE
availability,2.1.457,2.1.458,465,1,32,0,32,1,FALSE
availability,2.1.359,2.1.360,367,1,32,0,32,1,FALSE
availability,2.1.455,2.1.456,463,1,32,0,32,1,FALSE
availability,2.1.454,2.1.455,462,1,32,0,32,1,FALSE
availability,2.1.21,2.1.22,29,1,32,0,32,1,FALSE
availability,2.1.20,2.1.21,28,1,32,0,32,1,FALSE
availability,2.1.23,2.1.24,31,1,32,0,32,1,FALSE
availability,2.1.22,2.1.23,30,1,32,0,32,1,FALSE
availability,2.1.25,2.1.26,33,1,32,0,32,1,FALSE
availability,2.1.24,2.1.25,32,1,32,0,32,1,FALSE
availability,2.1.27,2.1.28,35,1,32,0,32,1,FALSE
availability,2.1.26,2.1.27,34,1,32,0,32,1,FALSE
availability,2.1.29,2.1.30,37,1,32,0,32,1,FALSE
availability,2.1.28,2.1.29,36,1,32,0,32,1,FALSE
availability,2.1.7,2.1.8,15,1,17,0,17,1,FALSE
availability,2.1.18,2.1.19,26,1,32,0,32,1,FALSE
availability,2.1.19,2.1.20,27,1,32,0,32,1,FALSE
availability,2.1.14,2.1.15,22,1,32,0,32,1,TRUE
availability,2.1.15,2.1.16,23,1,32,0,32,1,FALSE
availability,2.1.16,2.1.17,24,1,32,0,32,1,FALSE
availability,2.1.17,2.1.18,25,1,32,0,32,1,FALSE
availability,2.1.10,2.1.11,18,1,2,2,4,2,FALSE
availability,2.1.11,2.1.12,19,1,32,0,32,1,FALSE
availability,2.1.12,2.1.13,20,1,32,0,32,1,FALSE
availability,2.1.13,2.1.14,21,1,32,0,32,1,FALSE
availability,2.0.4,2.1.0,7,10,1310,854,2164,34,FALSE
availability,2.0.3,2.0.4,6,3,3,3,6,3,FALSE
availability,2.0.2,2.0.3,5,1,2,0,2,1,FALSE
availability,2.0.1,2.0.2,4,3,169,129,298,5,FALSE
availability,2.0.0,2.0.1,3,2,49,5,54,3,FALSE
availability,2.1.400,2.1.401,408,1,32,0,32,1,TRUE
availability,2.1.403,2.1.404,411,1,32,0,32,1,TRUE
availability,2.1.68,2.1.69,76,1,32,0,32,1,FALSE
availability,2.1.65,2.1.66,73,1,32,0,32,1,FALSE
availability,2.1.64,2.1.65,72,1,32,0,32,1,FALSE
availability,2.1.67,2.1.68,75,1,32,0,32,1,FALSE
availability,2.1.66,2.1.67,74,1,32,0,32,1,FALSE
availability,2.1.61,2.1.62,69,1,32,0,32,1,FALSE
availability,2.1.60,2.1.61,68,1,32,0,32,1,FALSE
availability,2.1.63,2.1.64,71,1,32,0,32,1,FALSE
availability,2.1.62,2.1.63,70,1,32,0,32,1,FALSE
availability,2.1.58,2.1.59,66,1,32,0,32,1,FALSE
availability,2.1.59,2.1.60,67,1,32,0,32,1,FALSE
availability,2.1.50,2.1.51,58,1,32,0,32,1,FALSE
availability,2.1.51,2.1.52,59,1,32,0,32,1,FALSE
availability,2.1.52,2.1.53,60,1,32,0,32,1,FALSE
availability,2.1.53,2.1.54,61,1,32,0,32,1,FALSE
availability,2.1.54,2.1.55,62,1,32,0,32,1,FALSE
availability,2.1.55,2.1.56,63,1,32,0,32,1,FALSE
availability,2.1.56,2.1.57,64,1,32,0,32,1,TRUE
availability,2.1.57,2.1.58,65,1,32,0,32,1,FALSE
availability,2.1.2,2.1.3,10,2,2,2,4,2,FALSE
availability,2.1.8,2.1.9,16,2,4,9,13,2,FALSE
availability,2.1.9,2.1.10,17,1,32,0,32,1,FALSE
availability,2.1.6,2.1.7,14,5,43,8,51,7,FALSE
availability,2.1.0,2.1.1,8,2,1,1,2,2,FALSE
availability,2.1.4,2.1.5,12,1,1,1,2,1,FALSE
availability,2.1.5,2.1.6,13,1,1,1,2,1,FALSE
availability,2.1.3,2.1.4,11,2,3,1,4,2,FALSE
availability,2.1.46,2.1.47,54,1,32,0,32,1,FALSE
availability,2.1.45,2.1.46,53,1,32,0,32,1,FALSE
availability,2.1.1,2.1.2,9,2,2,2,4,2,FALSE
availability,2.1.43,2.1.44,51,1,32,0,32,1,FALSE
availability,2.1.42,2.1.43,50,1,32,0,32,1,FALSE
availability,2.1.41,2.1.42,49,1,32,0,32,1,FALSE
availability,2.1.40,2.1.41,48,1,32,0,32,1,FALSE
availability,2.1.49,2.1.50,57,1,32,0,32,1,FALSE
availability,2.1.48,2.1.49,56,1,32,0,32,1,FALSE
availability,2.1.47,2.1.48,55,1,32,0,32,1,FALSE
availability,2.1.44,2.1.45,52,1,32,0,32,1,FALSE
availability,2.1.32,2.1.33,40,1,32,0,32,1,FALSE
availability,2.1.33,2.1.34,41,1,32,0,32,1,FALSE
availability,2.1.30,2.1.31,38,1,32,0,32,1,FALSE
availability,2.1.31,2.1.32,39,1,32,0,32,1,FALSE
availability,2.1.36,2.1.37,44,1,32,0,32,1,FALSE
availability,2.1.37,2.1.38,45,1,32,0,32,1,FALSE
availability,2.1.34,2.1.35,42,1,32,0,32,1,FALSE
availability,2.1.35,2.1.36,43,1,32,0,32,1,FALSE
availability,2.1.38,2.1.39,46,1,32,0,32,1,FALSE
availability,2.1.39,2.1.40,47,1,32,0,32,1,FALSE
availability,2.1.271,2.1.272,279,1,32,0,32,1,FALSE
availability,2.1.270,2.1.271,278,1,32,0,32,1,FALSE
availability,2.1.268,2.1.269,276,1,32,0,32,1,FALSE
availability,2.1.22,2.1.23,30,1,32,0,32,1,TRUE
availability,2.1.274,2.1.275,282,3,226,84,310,13,FALSE
availability,2.1.272,2.1.273,280,1,32,0,32,1,FALSE
availability,2.1.14,2.1.15,22,1,32,0,32,1,FALSE
availability,2.1.282,2.1.283,290,1,32,0,32,1,TRUE
availability,2.1.264,2.1.265,272,1,32,0,32,1,FALSE
availability,2.1.309,2.1.310,317,1,32,0,32,1,FALSE
availability,2.1.308,2.1.309,316,1,32,0,32,1,TRUE
availability,2.1.260,2.1.261,268,1,32,0,32,1,FALSE
availability,2.1.261,2.1.262,269,1,32,0,32,1,FALSE
availability,2.1.262,2.1.263,270,1,32,0,32,1,FALSE
availability,2.1.269,2.1.270,277,1,32,0,32,1,FALSE
availability,2.1.250,2.1.251,258,1,32,0,32,1,FALSE
availability,2.1.252,2.1.253,260,1,32,0,32,1,FALSE
availability,2.1.255,2.1.256,263,1,32,0,32,1,FALSE
availability,2.1.257,2.1.258,265,1,32,0,32,1,FALSE
availability,2.1.256,2.1.257,264,1,32,0,32,1,FALSE
availability,2.1.258,2.1.259,266,1,32,0,32,1,TRUE
availability,2.1.316,2.1.317,324,1,32,0,32,1,FALSE
availability,2.1.416,2.1.417,424,1,32,0,32,1,TRUE
availability,2.1.253,2.1.254,261,1,32,0,32,1,FALSE
availability,2.1.251,2.1.252,259,1,32,0,32,1,FALSE
availability,2.1.254,2.1.255,262,1,32,0,32,1,FALSE
availability,2.1.246,2.1.247,254,1,32,0,32,1,FALSE
availability,2.1.247,2.1.248,255,1,32,0,32,1,FALSE
availability,2.1.244,2.1.245,252,1,32,0,32,1,TRUE
availability,2.1.245,2.1.246,253,1,32,0,32,1,FALSE
availability,2.1.242,2.1.243,250,1,32,0,32,1,FALSE
availability,2.1.243,2.1.244,251,1,32,0,32,1,FALSE
availability,2.1.240,2.1.241,248,1,32,0,32,1,FALSE
availability,2.1.241,2.1.242,249,1,32,0,32,1,FALSE
availability,2.1.232,2.1.233,240,1,32,0,32,1,FALSE
availability,2.1.418,2.1.419,426,1,32,0,32,1,TRUE
availability,2.1.248,2.1.249,256,1,32,0,32,1,FALSE
availability,2.1.225,2.1.226,233,1,32,0,32,1,FALSE
availability,2.1.233,2.1.234,241,1,32,0,32,1,FALSE
availability,2.1.231,2.1.232,239,1,32,0,32,1,TRUE
availability,2.1.230,2.1.231,238,1,32,0,32,1,FALSE
availability,2.1.237,2.1.238,245,1,32,0,32,1,FALSE
availability,2.1.236,2.1.237,244,1,32,0,32,1,FALSE
availability,2.1.235,2.1.236,243,1,1,4,5,1,FALSE
availability,2.1.234,2.1.235,242,1,32,0,32,1,FALSE
availability,2.1.249,2.1.250,257,1,32,0,32,1,FALSE
availability,2.1.228,2.1.229,236,1,32,0,32,1,FALSE
availability,2.1.265,2.1.266,273,1,32,0,32,1,FALSE
availability,2.1.266,2.1.267,274,1,32,0,32,1,FALSE
availability,2.1.267,2.1.268,275,1,32,0,32,1,FALSE
availability,2.1.56,2.1.57,64,1,32,0,32,1,FALSE
availability,2.1.263,2.1.264,271,1,32,0,32,1,FALSE
availability,2.1.222,2.1.223,230,1,32,0,32,1,FALSE
availability,2.1.227,2.1.228,235,1,32,0,32,1,FALSE
availability,2.1.223,2.1.224,231,1,32,0,32,1,FALSE
availability,2.1.224,2.1.225,232,1,32,0,32,1,FALSE
availability,2.1.229,2.1.230,237,1,32,0,32,1,FALSE
availability,2.1.31,2.1.32,39,1,32,0,32,1,TRUE
availability,2.1.226,2.1.227,234,1,32,0,32,1,FALSE
availability,2.1.259,2.1.260,267,1,32,0,32,1,TRUE
availability,2.1.239,2.1.240,247,1,32,0,32,1,FALSE
availability,2.1.238,2.1.239,246,1,32,0,32,1,FALSE
availability,2.1.273,2.1.274,281,1,32,0,32,1,FALSE
availability,2.1.258,2.1.259,266,1,32,0,32,1,FALSE
availability,2.1.247,2.1.248,255,1,32,0,32,1,TRUE
availability,2.1.336,2.1.337,344,1,32,0,32,1,TRUE
availability,2.1.231,2.1.232,239,1,32,0,32,1,FALSE
availability,2.1.224,2.1.225,232,1,32,0,32,1,TRUE
availability,2.1.244,2.1.245,252,1,32,0,32,1,FALSE
availability,2.1.420,2.1.421,428,1,32,0,32,1,TRUE
availability,2.1.259,2.1.260,267,1,32,0,32,1,FALSE
availability,2.1.363,2.1.364,371,1,32,0,32,1,TRUE
availability,2.1.293,2.1.294,301,1,32,0,32,1,TRUE
availability,2.1.163,2.1.164,171,1,32,0,32,1,FALSE
availability,2.1.162,2.1.163,170,1,32,0,32,1,FALSE
availability,2.1.161,2.1.162,169,1,32,0,32,1,FALSE
availability,2.1.167,2.1.168,175,1,32,0,32,1,FALSE
availability,2.1.166,2.1.167,174,1,32,0,32,1,FALSE
availability,2.1.165,2.1.166,173,1,32,0,32,1,FALSE
availability,2.1.164,2.1.165,172,1,32,0,32,1,FALSE
availability,2.1.169,2.1.170,177,1,32,0,32,1,FALSE
availability,2.1.168,2.1.169,176,1,32,0,32,1,FALSE
availability,2.1.138,2.1.139,146,1,32,0,32,1,FALSE
availability,2.1.139,2.1.140,147,1,32,0,32,1,FALSE
availability,2.1.134,2.1.135,142,1,32,0,32,1,FALSE
availability,2.1.135,2.1.136,143,1,32,0,32,1,FALSE
availability,2.1.136,2.1.137,144,1,32,0,32,1,FALSE
availability,2.1.137,2.1.138,145,1,32,0,32,1,FALSE
availability,2.1.130,2.1.131,138,1,32,0,32,1,FALSE
availability,2.1.131,2.1.132,139,1,32,0,32,1,FALSE
availability,2.1.132,2.1.133,140,1,32,0,32,1,FALSE
availability,2.1.133,2.1.134,141,1,32,0,32,1,FALSE
availability,2.1.181,2.1.182,189,1,32,0,32,1,FALSE
availability,2.1.160,2.1.161,168,1,32,0,32,1,FALSE
availability,2.1.180,2.1.181,188,1,32,0,32,1,FALSE
availability,2.1.183,2.1.184,191,1,32,0,32,1,FALSE
availability,2.1.182,2.1.183,190,1,32,0,32,1,FALSE
availability,2.1.185,2.1.186,193,1,32,0,32,1,FALSE
availability,2.1.184,2.1.185,192,1,32,0,32,1,FALSE
availability,2.1.187,2.1.188,195,1,32,0,32,1,FALSE
availability,2.1.186,2.1.187,194,1,32,0,32,1,TRUE
availability,2.1.189,2.1.190,197,1,32,0,32,1,FALSE
availability,2.1.221,2.1.222,229,1,13,17,30,2,FALSE
availability,2.1.222,2.1.223,230,1,32,0,32,1,TRUE
availability,2.1.94,2.1.95,102,1,32,0,32,1,FALSE
availability,2.1.95,2.1.96,103,1,32,0,32,1,FALSE
availability,2.1.96,2.1.97,104,1,32,0,32,1,FALSE
availability,2.1.97,2.1.98,105,1,32,0,32,1,FALSE
availability,2.1.90,2.1.91,98,1,32,0,32,1,FALSE
availability,2.1.91,2.1.92,99,1,32,0,32,1,FALSE
availability,2.1.92,2.1.93,100,1,32,0,32,1,FALSE
availability,2.1.93,2.1.94,101,1,32,0,32,1,FALSE
availability,2.1.98,2.1.99,106,1,32,0,32,1,FALSE
availability,2.1.99,2.1.100,107,1,32,0,32,1,FALSE
availability,2.1.170,2.1.171,178,1,32,0,32,1,FALSE
availability,2.1.171,2.1.172,179,1,32,0,32,1,FALSE
availability,2.1.172,2.1.173,180,1,32,0,32,1,FALSE
availability,2.1.173,2.1.174,181,1,32,0,32,1,FALSE
availability,2.1.174,2.1.175,182,1,32,0,32,1,FALSE
availability,2.1.175,2.1.176,183,1,32,0,32,1,FALSE
availability,2.1.176,2.1.177,184,1,32,0,32,1,FALSE
availability,2.1.177,2.1.178,185,1,32,0,32,1,FALSE
availability,2.1.178,2.1.179,186,1,32,0,32,1,FALSE
availability,2.1.179,2.1.180,187,1,32,0,32,1,FALSE
availability,2.1.188,2.1.189,196,1,32,0,32,1,FALSE
availability,2.1.109,2.1.110,117,1,32,0,32,1,FALSE
availability,2.1.108,2.1.109,116,1,32,0,32,1,FALSE
availability,2.1.101,2.1.102,109,1,32,0,32,1,FALSE
availability,2.1.100,2.1.101,108,1,32,0,32,1,FALSE
availability,2.1.103,2.1.104,111,1,32,0,32,1,FALSE
availability,2.1.102,2.1.103,110,1,32,0,32,1,FALSE
availability,2.1.105,2.1.106,113,1,32,0,32,1,FALSE
availability,2.1.104,2.1.105,112,1,32,0,32,1,FALSE
availability,2.1.107,2.1.108,115,1,32,0,32,1,FALSE
availability,2.1.106,2.1.107,114,1,32,0,32,1,FALSE
availability,2.1.215,2.1.216,223,1,32,0,32,1,FALSE
availability,2.1.214,2.1.215,222,1,32,0,32,1,FALSE
availability,2.1.217,2.1.218,225,1,32,0,32,1,FALSE
availability,2.1.216,2.1.217,224,1,32,0,32,1,FALSE
availability,2.1.211,2.1.212,219,1,32,0,32,1,FALSE
availability,2.1.210,2.1.211,218,1,32,0,32,1,FALSE
availability,2.1.213,2.1.214,221,1,32,0,32,1,FALSE
availability,2.1.212,2.1.213,220,1,32,0,32,1,FALSE
availability,2.1.219,2.1.220,227,1,32,0,32,1,FALSE
availability,2.1.218,2.1.219,226,1,32,0,32,1,FALSE
availability,2.1.198,2.1.199,206,1,32,0,32,1,FALSE
availability,2.1.199,2.1.200,207,1,32,0,32,1,FALSE
availability,2.1.196,2.1.197,204,1,32,0,32,1,FALSE
availability,2.1.197,2.1.198,205,1,32,0,32,1,FALSE
availability,2.1.194,2.1.195,202,1,32,0,32,1,FALSE
availability,2.1.195,2.1.196,203,1,32,0,32,1,FALSE
availability,2.1.192,2.1.193,200,1,32,0,32,1,FALSE
availability,2.1.193,2.1.194,201,1,32,0,32,1,FALSE
availability,2.1.190,2.1.191,198,1,32,0,32,1,FALSE
availability,2.1.191,2.1.192,199,1,32,0,32,1,FALSE
availability,2.1.362,2.1.363,370,1,32,0,32,1,TRUE
availability,2.1.83,2.1.84,91,2,76,9,85,4,FALSE
availability,2.1.82,2.1.83,90,1,50,41,91,6,FALSE
availability,2.1.81,2.1.82,89,2,29,48,77,9,FALSE
availability,2.1.80,2.1.81,88,1,9,9,18,4,FALSE
availability,2.1.87,2.1.88,95,1,32,0,32,1,FALSE
availability,2.1.86,2.1.87,94,1,32,0,32,1,FALSE
availability,2.1.85,2.1.86,93,1,32,0,32,1,FALSE
availability,2.1.84,2.1.85,92,1,32,0,32,1,FALSE
availability,2.1.89,2.1.90,97,1,32,0,32,1,FALSE
availability,2.1.88,2.1.89,96,1,32,0,32,1,TRUE
availability,2.1.149,2.1.150,157,1,32,0,32,1,FALSE
availability,2.1.148,2.1.149,156,1,32,0,32,1,FALSE
availability,2.1.145,2.1.146,153,1,32,0,32,1,FALSE
availability,2.1.144,2.1.145,152,1,32,0,32,1,FALSE
availability,2.1.147,2.1.148,155,1,32,0,32,1,FALSE
availability,2.1.146,2.1.147,154,1,32,0,32,1,FALSE
availability,2.1.141,2.1.142,149,1,32,0,32,1,FALSE
availability,2.1.140,2.1.141,148,1,32,0,32,1,FALSE
availability,2.1.143,2.1.144,151,1,32,0,32,1,FALSE
availability,2.1.142,2.1.143,150,1,32,0,32,1,FALSE
availability,2.1.396,2.1.397,404,1,32,0,32,1,TRUE
availability,2.1.112,2.1.113,120,1,32,0,32,1,FALSE
availability,2.1.119,2.1.120,127,1,32,0,32,1,FALSE
availability,2.1.202,2.1.203,210,1,32,0,32,1,FALSE
availability,2.1.203,2.1.204,211,1,32,0,32,1,FALSE
availability,2.1.200,2.1.201,208,1,32,0,32,1,FALSE
availability,2.1.201,2.1.202,209,1,32,0,32,1,FALSE
availability,2.1.206,2.1.207,214,1,32,0,32,1,FALSE
availability,2.1.207,2.1.208,215,1,32,0,32,1,FALSE
availability,2.1.204,2.1.205,212,1,32,0,32,1,FALSE
availability,2.1.205,2.1.206,213,1,32,0,32,1,FALSE
availability,2.1.208,2.1.209,216,1,32,0,32,1,FALSE
availability,2.1.209,2.1.210,217,1,32,0,32,1,FALSE
availability,2.1.116,2.1.117,124,1,32,0,32,1,FALSE
availability,2.1.117,2.1.118,125,1,32,0,32,1,FALSE
availability,2.1.114,2.1.115,122,1,32,0,32,1,FALSE
availability,2.1.115,2.1.116,123,1,32,0,32,1,FALSE
availability,2.1.113,2.1.114,121,1,32,0,32,1,FALSE
availability,2.1.110,2.1.111,118,1,32,0,32,1,FALSE
availability,2.1.111,2.1.112,119,1,32,0,32,1,FALSE
availability,2.1.118,2.1.119,126,1,32,0,32,1,FALSE
availability,2.1.220,2.1.221,228,1,32,0,32,1,FALSE
availability,2.1.78,2.1.79,86,1,32,0,32,1,FALSE
availability,2.1.79,2.1.80,87,1,32,0,32,1,FALSE
availability,2.1.76,2.1.77,84,1,32,0,32,1,FALSE
availability,2.1.77,2.1.78,85,1,32,0,32,1,FALSE
availability,2.1.74,2.1.75,82,1,32,0,32,1,FALSE
availability,2.1.75,2.1.76,83,1,32,0,32,1,FALSE
availability,2.1.72,2.1.73,80,1,32,0,32,1,FALSE
availability,2.1.73,2.1.74,81,1,32,0,32,1,FALSE
availability,2.1.70,2.1.71,78,1,32,0,32,1,TRUE
availability,2.1.71,2.1.72,79,1,32,0,32,1,FALSE
availability,2.1.129,2.1.130,137,1,32,0,32,1,FALSE
availability,2.1.128,2.1.129,136,1,32,0,32,1,FALSE
availability,2.1.127,2.1.128,135,1,32,0,32,1,FALSE
availability,2.1.126,2.1.127,134,1,32,0,32,1,FALSE
availability,2.1.125,2.1.126,133,1,32,0,32,1,FALSE
availability,2.1.124,2.1.125,132,1,32,0,32,1,FALSE
availability,2.1.123,2.1.124,131,1,32,0,32,1,FALSE
availability,2.1.122,2.1.123,130,1,32,0,32,1,FALSE
availability,2.1.121,2.1.122,129,1,32,0,32,1,FALSE
availability,2.1.120,2.1.121,128,1,32,0,32,1,FALSE
availability,2.1.158,2.1.159,166,1,32,0,32,1,FALSE
availability,2.1.159,2.1.160,167,1,32,0,32,1,FALSE
availability,2.1.152,2.1.153,160,1,32,0,32,1,FALSE
availability,2.1.153,2.1.154,161,1,32,0,32,1,FALSE
availability,2.1.150,2.1.151,158,1,32,0,32,1,FALSE
availability,2.1.151,2.1.152,159,1,32,0,32,1,FALSE
availability,2.1.156,2.1.157,164,1,32,0,32,1,FALSE
availability,2.1.157,2.1.158,165,1,32,0,32,1,FALSE
availability,2.1.154,2.1.155,162,1,32,0,32,1,FALSE
availability,2.1.155,2.1.156,163,1,32,0,32,1,TRUE
availability,2.1.88,2.1.89,96,1,32,0,32,1,FALSE
availability,2.1.141,2.1.142,149,1,32,0,32,1,TRUE
availability,2.1.140,2.1.141,148,1,32,0,32,1,TRUE
availability,2.1.124,2.1.125,132,1,32,0,32,1,TRUE
availability,2.1.122,2.1.123,130,1,32,0,32,1,TRUE
availability,2.1.405,2.1.406,413,1,32,0,32,1,TRUE
availability,2.1.186,2.1.187,194,1,32,0,32,1,FALSE
availability,2.1.433,2.1.434,441,1,32,0,32,1,TRUE
availability,2.1.155,2.1.156,163,1,32,0,32,1,FALSE
availability,2.1.69,2.1.70,77,1,39,58,97,5,FALSE
availability,1.0.0,1.0.1,1,1,0,1,1,1,FALSE
availability,1.0.1,2.0.0,2,3,83,77,160,13,FALSE
availability,2.1.70,2.1.71,78,1,32,0,32,1,FALSE
availability,2.1.94,2.1.95,102,1,32,0,32,1,TRUE
availability,2.1.95,2.1.96,103,1,32,0,32,1,TRUE
availability,2.1.96,2.1.97,104,1,32,0,32,1,TRUE
availability,2.1.279,2.1.280,287,1,32,0,32,1,TRUE
availability,2.1.436,2.1.437,444,1,32,0,32,1,TRUE
availability,2.1.470,2.1.471,478,1,32,0,32,1,TRUE
availability,2.1.233,2.1.234,241,1,32,0,32,1,TRUE
availability,2.1.234,2.1.235,242,1,32,0,32,1,TRUE
availability,2.1.179,2.1.180,187,1,32,0,32,1,TRUE
availability,2.1.144,2.1.145,152,1,32,0,32,1,TRUE
availability,2.1.29,2.1.30,37,1,32,0,32,1,TRUE
availability,2.1.3,2.1.4,11,2,3,1,4,2,TRUE
availability,2.1.53,2.1.54,61,1,32,0,32,1,TRUE
availability,2.1.168,2.1.169,176,1,32,0,32,1,TRUE
availability,2.1.167,2.1.168,175,1,32,0,32,1,TRUE
availability,2.1.123,2.1.124,131,1,32,0,32,1,TRUE
availability,2.1.151,2.1.152,159,1,32,0,32,1,TRUE
availability,2.1.100,2.1.101,108,1,32,0,32,1,TRUE
availability,2.1.4,2.1.5,12,1,1,1,2,1,TRUE
availability,2.1.113,2.1.114,121,1,32,0,32,1,TRUE
availability,2.1.337,2.1.338,345,1,32,0,32,1,TRUE
availability,2.1.205,2.1.206,213,1,32,0,32,1,TRUE
availability,2.1.136,2.1.137,144,1,32,0,32,1,TRUE
availability,2.1.214,2.1.215,222,1,32,0,32,1,TRUE
availability,2.1.71,2.1.72,79,1,32,0,32,1,TRUE
availability,2.1.461,2.1.462,469,1,32,0,32,1,TRUE
availability,2.1.369,2.1.370,377,1,32,0,32,1,TRUE
availability,2.1.323,2.1.324,331,1,32,0,32,1,TRUE
availability,2.1.112,2.1.113,120,1,32,0,32,1,TRUE
availability,2.1.87,2.1.88,95,1,32,0,32,1,TRUE
availability,2.1.98,2.1.99,106,1,32,0,32,1,TRUE
availability,2.1.85,2.1.86,93,1,32,0,32,1,TRUE
availability,2.1.84,2.1.85,92,1,32,0,32,1,TRUE
availability,2.1.413,2.1.414,421,1,32,0,32,1,TRUE
availability,2.1.380,2.1.381,388,1,32,0,32,1,TRUE
availability,2.1.326,2.1.327,334,1,32,0,32,1,TRUE
availability,2.1.399,2.1.400,407,1,32,0,32,1,TRUE
availability,2.1.119,2.1.120,127,1,32,0,32,1,TRUE
availability,2.1.101,2.1.102,109,1,32,0,32,1,TRUE
availability,2.1.342,2.1.343,350,1,32,0,32,1,TRUE
availability,2.1.350,2.1.351,358,1,32,0,32,1,TRUE
jsbarcode,3.1.0,3.2.0,21,2,42,3,45,6,FALSE
jsbarcode,3.0.2,3.0.3,19,3,88,124,212,18,FALSE
jsbarcode,3.0.3,3.1.0,20,5,666,266,932,12,FALSE
jsbarcode,3.0.0,3.0.1,17,6,61,57,118,10,FALSE
jsbarcode,2.0.0,2.3.3,1,48,1518,1105,2623,117,FALSE
jsbarcode,3.0.0-beta.4,3.0.0,16,5,84,86,170,6,FALSE
jsbarcode,3.0.0-beta.2,3.0.0-beta.3,14,9,9947,25,9972,16,FALSE
jsbarcode,3.0.0-beta.3,3.0.0-beta.4,15,8,169,181,350,30,FALSE
jsbarcode,3.3.12,3.3.13,34,2,26,11,37,14,FALSE
jsbarcode,3.3.11,3.3.12,33,2,4,7,11,4,FALSE
jsbarcode,3.3.10,3.3.11,32,1,2,3,5,2,FALSE
jsbarcode,3.3.13,3.3.14,35,5,93,64,157,19,FALSE
jsbarcode,3.0.1,3.0.2,18,4,22,200,222,12,TRUE
jsbarcode,3.3.14,3.3.15,36,37,4108,3820,7928,106,FALSE
jsbarcode,3.2.0,3.2.1,22,3,152,60,212,8,FALSE
jsbarcode,3.2.1,3.3.0,23,6,970,263,1233,16,FALSE
jsbarcode,2.3.8,2.3.9,7,1,4,4,8,1,FALSE
jsbarcode,2.3.9,2.4.9,8,32,1171,798,1969,66,FALSE
jsbarcode,2.3.3,2.3.4,2,2,9,9,18,5,FALSE
jsbarcode,2.3.4,2.3.5,3,1,4,4,8,1,FALSE
jsbarcode,2.3.5,2.3.6,4,1,4,4,8,1,FALSE
jsbarcode,2.3.6,2.3.7,5,1,4,4,8,1,FALSE
jsbarcode,2.3.7,2.3.8,6,1,4,4,8,1,FALSE
jsbarcode,2.4.9,2.4.10,9,5,179,70,249,10,FALSE
jsbarcode,2.5.0,2.5.1,12,4,155,158,313,12,FALSE
jsbarcode,2.5.1,3.0.0-beta.2,13,71,27235,17036,44271,513,FALSE
jsbarcode,2.4.11,2.5.0,11,4,427,362,789,13,FALSE
jsbarcode,2.4.10,2.4.11,10,2,63,10,73,6,FALSE
jsbarcode,3.3.0,3.3.2,24,7,197,49,246,30,FALSE
jsbarcode,3.3.3,3.3.4,26,3,204,41,245,11,FALSE
jsbarcode,3.3.2,3.3.3,25,11,1531,1430,2961,24,FALSE
jsbarcode,3.3.5,3.3.6,28,4,79,57,136,79,FALSE
jsbarcode,3.3.4,3.3.5,27,2,97,2,99,6,FALSE
jsbarcode,3.3.7,3.3.9,30,5,45,153,198,19,FALSE
jsbarcode,3.3.6,3.3.7,29,5,69,143,212,19,FALSE
jsbarcode,3.3.9,3.3.10,31,3,6,9,15,6,FALSE
jsbarcode,3.0.1,3.0.2,18,4,22,200,222,12,FALSE
jsbarcode,3.5.0-beta.2,3.5.1,46,2,45,18,63,16,FALSE
jsbarcode,3.5.0-beta,3.5.0-beta.2,45,5,115,21,136,14,FALSE
jsbarcode,3.3.18,3.3.20,40,4,574,156,730,24,FALSE
jsbarcode,3.3.15,3.3.16,37,3,6,212,218,7,FALSE
jsbarcode,3.3.17,3.3.18,39,2,13,13,26,13,FALSE
jsbarcode,3.3.16,3.3.17,38,4,28,26,54,16,FALSE
jsbarcode,3.3.20,3.3.22,41,14,274,222,496,50,FALSE
jsbarcode,3.3.22,3.3.23,42,2,49,30,79,16,FALSE
jsbarcode,3.3.23,3.4.0,43,9,443,27,470,23,FALSE
jsbarcode,3.4.0,3.5.0-beta,44,10,2255,1417,3672,139,FALSE
jsbarcode,3.5.4,3.5.5,50,2,139,127,266,15,FALSE
jsbarcode,3.5.9,3.6.0,55,6,213,63,276,25,FALSE
jsbarcode,3.5.8,3.5.9,54,4,42,35,77,17,FALSE
jsbarcode,3.5.7,3.5.8,53,5,170,80,250,23,FALSE
jsbarcode,3.5.6,3.5.7,52,2,38,38,76,14,FALSE
jsbarcode,3.5.5,3.5.6,51,4,80,96,176,16,FALSE
jsbarcode,3.5.3,3.5.4,49,9,94,57,151,24,FALSE
jsbarcode,3.5.2,3.5.3,48,8,582,433,1015,33,FALSE
jsbarcode,3.5.1,3.5.2,47,2,23,12,35,13,FALSE
jsbarcode,3.7.0,3.8.0,57,8,3638,2519,6157,74,FALSE
jsbarcode,3.6.0,3.7.0,56,13,1306,1437,2743,61,FALSE
jsbarcode,3.3.16,3.3.17,38,4,28,26,54,16,TRUE
jsbarcode,3.3.5,3.3.6,28,4,79,57,136,79,TRUE
jsbarcode,3.5.0-beta.2,3.5.1,46,2,45,18,63,16,TRUE
jsbarcode,3.0.2,3.0.3,19,3,88,124,212,18,TRUE
jsbarcode,3.5.7,3.5.8,53,5,170,80,250,23,TRUE
jsbarcode,3.3.7,3.3.9,30,5,45,153,198,19,TRUE
jsbarcode,3.3.18,3.3.20,40,4,574,156,730,24,TRUE
jsbarcode,3.3.15,3.3.16,37,3,6,212,218,7,TRUE
jsbarcode,2.3.9,2.4.9,8,32,1171,798,1969,66,TRUE
jsbarcode,3.3.23,3.4.0,43,9,443,27,470,23,TRUE
jsbarcode,3.3.3,3.3.4,26,3,204,41,245,11,TRUE
schema-inspector,1.4.4,1.4.5,13,1,64,2,66,3,FALSE
schema-inspector,1.4.5,1.4.6,14,5,47,6,53,10,FALSE
schema-inspector,1.6.5,1.6.6,34,5,7,7,14,5,FALSE
schema-inspector,1.6.3,1.6.4,32,3,21,9,30,5,FALSE
schema-inspector,1.6.2,1.6.3,31,3,51,37,88,3,FALSE
schema-inspector,1.4.8,1.4.9,17,6,192,78,270,14,FALSE
schema-inspector,1.6.0,1.6.1,29,2,67,4,71,6,FALSE
schema-inspector,1.6.1,1.6.2,30,1,6,6,12,4,FALSE
schema-inspector,1.6.6,1.6.7,35,5,71,44,115,8,FALSE
schema-inspector,1.6.7,1.6.8,36,1,2,2,4,2,FALSE
schema-inspector,1.6.4,1.6.5,33,3,17,7,24,5,FALSE
schema-inspector,1.4.9,1.5.0,18,2,7,2,9,3,FALSE
schema-inspector,1.4.0,1.4.1,9,2,7,8,15,4,FALSE
schema-inspector,1.4.1,1.4.2,10,5,214,42,256,14,FALSE
schema-inspector,1.4.2,1.4.3,11,3,5,5,10,3,FALSE
schema-inspector,1.4.3,1.4.4,12,1,22,29,51,3,FALSE
schema-inspector,1.5.9,1.6.0,28,6,51,21,72,7,FALSE
schema-inspector,1.5.8,1.5.9,27,1,45,57,102,2,FALSE
schema-inspector,1.4.6,1.4.7,15,1,7,7,14,5,FALSE
schema-inspector,1.4.7,1.4.8,16,2,27,23,50,7,FALSE
schema-inspector,1.5.5,1.5.6,24,2,13,4,17,4,FALSE
schema-inspector,1.5.4,1.5.5,23,1,58,14,72,4,FALSE
schema-inspector,1.5.7,1.5.8,26,3,38,5,43,5,FALSE
schema-inspector,1.5.6,1.5.7,25,1,30,2,32,3,FALSE
schema-inspector,1.5.1,1.5.2,20,2,99,31,130,5,FALSE
schema-inspector,1.5.0,1.5.1,19,8,35,86,121,8,FALSE
schema-inspector,1.5.3,1.5.4,22,1,4,1,5,2,FALSE
schema-inspector,1.5.2,1.5.3,21,1,29,16,45,3,FALSE
schema-inspector,1.3.3,1.3.4,3,3,3,1,4,3,FALSE
schema-inspector,1.3.2,1.3.3,2,2,33,25,58,2,FALSE
schema-inspector,1.3.1,1.3.2,1,8,736,691,1427,15,FALSE
schema-inspector,1.3.6,1.3.8,6,5,227,82,309,13,FALSE
schema-inspector,1.3.5,1.3.6,5,7,113,4,117,8,FALSE
schema-inspector,1.3.4,1.3.5,4,1,41,3,44,2,FALSE
schema-inspector,1.3.9,1.4.0,8,1,103,7,110,4,FALSE
schema-inspector,1.3.8,1.3.9,7,13,79,35,114,16,FALSE
schema-inspector,1.4.5,1.4.6,14,5,47,6,53,10,TRUE
schema-inspector,1.3.1,1.3.2,1,8,736,691,1427,15,TRUE
airdcpp-apisocket,1.0.0-beta3,1.0.0-beta4,16,8,503,190,693,23,FALSE
airdcpp-apisocket,1.0.0-beta2,1.0.0-beta3,15,2,4,4,8,3,FALSE
airdcpp-apisocket,1.0.0-beta1,1.0.0-beta2,14,5,84,68,152,17,FALSE
airdcpp-apisocket,1.0.0-beta7,1.0.0-beta8,20,3,24,14,38,10,FALSE
airdcpp-apisocket,1.0.0-beta6,1.0.0-beta7,19,2,25,14,39,7,FALSE
airdcpp-apisocket,1.0.0-beta5,1.0.0-beta6,18,2,58,19,77,4,FALSE
airdcpp-apisocket,1.0.0-beta4,1.0.0-beta5,17,2,5,4,9,3,FALSE
airdcpp-apisocket,1.0.0-beta8,1.0.0-beta9,21,3,3,2,5,3,FALSE
airdcpp-apisocket,0.1.7,0.1.8,8,2,3,2,5,2,FALSE
airdcpp-apisocket,0.1.8,1.0.0-beta.10,9,38,944,478,1422,93,FALSE
airdcpp-apisocket,0.1.1,0.1.2,2,6,295,12,307,8,FALSE
airdcpp-apisocket,0.1.0,0.1.1,1,1,2,1,3,2,FALSE
airdcpp-apisocket,1.0.0-beta.10,1.0.0-beta.11,10,2,9,4,13,4,FALSE
airdcpp-apisocket,0.1.2,0.1.3,3,1,12,2,14,3,FALSE
airdcpp-apisocket,0.1.3,0.1.4,4,2,8,4,12,4,FALSE
airdcpp-apisocket,0.1.4,0.1.5,5,10,39,26,65,10,FALSE
airdcpp-apisocket,0.1.5,0.1.6,6,2,13,2,15,2,FALSE
airdcpp-apisocket,0.1.6,0.1.7,7,13,362,120,482,25,FALSE
airdcpp-apisocket,1.0.0-beta.11,1.0.0-beta.12,11,11,648,142,790,28,FALSE
airdcpp-apisocket,1.1.0,1.1.1,26,2,3,2,5,2,FALSE
airdcpp-apisocket,1.0.0,1.1.0,25,6,154,74,228,14,FALSE
airdcpp-apisocket,1.0.0-beta9,1.0.0-rc.1,22,21,726,180,906,47,FALSE
airdcpp-apisocket,1.0.0-beta.12,1.0.0-beta.13,12,2,50,17,67,7,FALSE
airdcpp-apisocket,1.0.0-rc.2,1.0.0,24,5,15,540,555,10,FALSE
airdcpp-apisocket,1.0.0-rc.1,1.0.0-rc.2,23,3,29,5,34,4,FALSE
airdcpp-apisocket,1.0.0-beta2,1.0.0-beta3,15,2,4,4,8,3,TRUE
airdcpp-apisocket,1.0.0-rc.1,1.0.0-rc.2,23,3,29,5,34,4,TRUE
airdcpp-apisocket,1.0.0-beta4,1.0.0-beta5,17,2,5,4,9,3,TRUE
airdcpp-apisocket,1.0.0-beta3,1.0.0-beta4,16,8,503,190,693,23,TRUE
react-redux-saga-router,0.3.1,0.3.2,6,1,3,2,5,1,FALSE
react-redux-saga-router,0.3.6,0.4.0,11,2,19,6,25,4,FALSE
react-redux-saga-router,0.7.0,0.7.1,17,1,2,2,4,2,FALSE
react-redux-saga-router,0.2.0,0.3.0,4,3,150,40,190,13,FALSE
react-redux-saga-router,0.1.0,0.1.1,1,2,1,2,3,2,FALSE
react-redux-saga-router,0.1.1,0.1.2,2,2,11,2,13,11,FALSE
react-redux-saga-router,0.1.2,0.2.0,3,16,2193,1489,3682,66,FALSE
react-redux-saga-router,0.7.1,0.7.2,18,1,1,1,2,1,FALSE
react-redux-saga-router,0.3.2,0.3.3,7,3,98,42,140,5,FALSE
react-redux-saga-router,0.3.3,0.3.4,8,1,6,5,11,3,FALSE
react-redux-saga-router,0.3.0,0.3.1,5,2,95,71,166,6,FALSE
react-redux-saga-router,0.6.0,0.6.1,14,2,106,54,160,14,FALSE
react-redux-saga-router,0.7.2,0.8.0,19,4,260,22,282,14,FALSE
react-redux-saga-router,0.3.4,0.3.5,9,1,64,2,66,8,FALSE
react-redux-saga-router,0.3.5,0.3.6,10,2,19,2,21,4,FALSE
react-redux-saga-router,0.4.0,0.5.0,12,2,105,14,119,4,FALSE
react-redux-saga-router,0.5.0,0.6.0,13,3,145,12,157,9,FALSE
react-redux-saga-router,0.9.0,0.9.1,22,2,122,30,152,9,FALSE
react-redux-saga-router,0.8.1,0.9.0,21,7,2409,1123,3532,62,FALSE
react-redux-saga-router,0.8.0,0.8.1,20,4,130,79,209,8,FALSE
react-redux-saga-router,0.6.2,0.7.0,16,1,201,5,206,7,FALSE
react-redux-saga-router,0.6.1,0.6.2,15,2,201,5,206,3,FALSE
react-redux-saga-router,0.3.2,0.3.3,7,3,98,42,140,5,TRUE
react-redux-saga-router,0.4.0,0.5.0,12,2,105,14,119,4,TRUE
react-redux-saga-router,0.8.1,0.9.0,21,7,2409,1123,3532,62,TRUE
react-redux-saga-router,0.3.6,0.4.0,11,2,19,6,25,4,TRUE
atmo,0.9.5,0.9.6,11,5,26,12,38,7,FALSE
atmo,0.10.1,0.10.2,14,15,39,21,60,19,FALSE
atmo,0.10.0,0.10.1,13,8,14,9,23,8,FALSE
atmo,0.10.3,0.11.0,16,10,2912,1891,4803,12,FALSE
atmo,0.10.2,0.10.3,15,3,51,2,53,4,FALSE
atmo,0.6.1,0.8.1,5,43,3407,1589,4996,175,FALSE
atmo,0.11.0,0.12.0,17,4,36,23,59,10,FALSE
atmo,0.12.0,0.13.0,18,5,51,20,71,10,FALSE
atmo,0.4.1,0.5.1,3,8,2259,814,3073,35,FALSE
atmo,0.4.0,0.4.1,2,6,18,10,28,9,FALSE
atmo,0.5.1,0.6.1,4,1,4,2,6,2,FALSE
atmo,0.13.0,0.13.1,19,2,12,1,13,2,FALSE
atmo,0.13.1,0.14.0,20,3,13,3,16,5,FALSE
atmo,0.14.1,0.14.2,22,5,14424,9272,23696,28,FALSE
atmo,0.14.0,0.14.1,21,2,3,3,6,3,FALSE
atmo,0.9.6,0.10.0,12,20,777,401,1178,31,FALSE
atmo,0.8.5,0.9.5,10,7,79,24,103,9,FALSE
atmo,0.8.4,0.8.5,9,3,6,31,37,11,FALSE
atmo,0.8.1,0.8.2,6,5,41,5,46,8,FALSE
atmo,0.8.3,0.8.4,8,1,9213,1223,10436,4,FALSE
atmo,0.8.2,0.8.3,7,1,2,2,4,2,FALSE
atmo,0.3.0,0.4.0,1,14,36760,31903,68663,39,FALSE
atmo,0.14.1,0.14.2,22,5,14424,9272,23696,28,TRUE
atmo,0.9.5,0.9.6,11,5,26,12,38,7,TRUE
atmo,0.13.0,0.13.1,19,2,12,1,13,2,TRUE
atmo,0.10.2,0.10.3,15,3,51,2,53,4,TRUE
atmo,0.13.1,0.14.0,20,3,13,3,16,5,TRUE
atmo,0.8.5,0.9.5,10,7,79,24,103,9,TRUE
apeman-react-toast,1.0.4,1.0.5,5,3,20,15,35,9,FALSE
apeman-react-toast,1.0.5,1.0.6,6,2,593,444,1037,5,FALSE
apeman-react-toast,1.0.6,1.1.0,7,2,3922,1342,5264,13,FALSE
apeman-react-toast,1.1.2,1.1.3,10,2,736,794,1530,8,FALSE
apeman-react-toast,1.0.0,1.0.1,1,5,68562,28443,97005,41,FALSE
apeman-react-toast,1.0.1,1.0.2,2,1,45,57,102,11,FALSE
apeman-react-toast,1.0.2,1.0.3,3,3,51,62,113,14,FALSE
apeman-react-toast,1.0.3,1.0.4,4,2,8,7,15,4,FALSE
apeman-react-toast,1.1.9,1.1.10,17,1,68,13,81,6,FALSE
apeman-react-toast,1.1.8,1.1.9,16,1,3,3,6,2,FALSE
apeman-react-toast,1.1.3,1.1.4,11,3,14702,10919,25621,16,FALSE
apeman-react-toast,1.1.6,1.1.7,14,1,3,3,6,2,FALSE
apeman-react-toast,1.1.5,1.1.6,13,2,17,13,30,6,FALSE
apeman-react-toast,1.1.4,1.1.5,12,1,6108,5402,11510,5,FALSE
apeman-react-toast,1.1.7,1.1.8,15,2,23471,19373,42844,10,FALSE
apeman-react-toast,2.0.0,2.0.1,23,2,3423,2896,6319,46,FALSE
apeman-react-toast,1.1.1,1.1.2,9,4,691,531,1222,14,FALSE
apeman-react-toast,1.1.0,1.1.1,8,1,41,7,48,6,FALSE
apeman-react-toast,1.1.10,1.1.12,18,2,595,76,671,18,FALSE
apeman-react-toast,1.1.13,1.1.14,20,2,2113,51662,53775,15,FALSE
apeman-react-toast,1.1.12,1.1.13,19,1,61,25,86,5,FALSE
apeman-react-toast,1.1.15,2.0.0,22,2,3544,2937,6481,50,FALSE
apeman-react-toast,1.1.14,1.1.15,21,2,133,62,195,10,FALSE
apeman-react-toast,2.0.7,2.0.8,30,4,2205,10084,12289,17,FALSE
apeman-react-toast,2.0.6,2.0.7,29,1,2838,2998,5836,5,FALSE
apeman-react-toast,2.0.5,2.0.6,28,1,3,3,6,2,FALSE
apeman-react-toast,2.0.4,2.0.5,27,1,34,73,107,7,FALSE
apeman-react-toast,2.0.3,2.0.4,26,1,15,15,30,6,FALSE
apeman-react-toast,2.0.2,2.0.3,25,4,4862,2901,7763,56,FALSE
apeman-react-toast,2.0.9,2.0.10,32,3,51,27,78,9,FALSE
apeman-react-toast,2.0.8,2.0.9,31,7,174,148,322,20,FALSE
apeman-react-toast,2.0.17,3.0.0,40,3,212,261,473,14,FALSE
apeman-react-toast,2.0.16,2.0.17,39,3,62,80,142,10,FALSE
apeman-react-toast,2.0.15,2.0.16,38,3,56,31,87,7,FALSE
apeman-react-toast,2.0.14,2.0.15,37,1,2,2,4,1,FALSE
apeman-react-toast,2.0.13,2.0.14,36,3,389,459,848,40,FALSE
apeman-react-toast,2.0.12,2.0.13,35,2,356,429,785,35,FALSE
apeman-react-toast,2.0.11,2.0.12,34,3,105,115,220,17,FALSE
apeman-react-toast,2.0.10,2.0.11,33,1,2,2,4,1,FALSE
apeman-react-toast,2.0.1,2.0.2,24,1,1067,1125,2192,3,FALSE
apeman-react-toast,2.0.16,2.0.17,39,3,62,80,142,10,TRUE
apeman-react-toast,2.0.15,2.0.16,38,3,56,31,87,7,TRUE
apeman-react-toast,2.0.14,2.0.15,37,1,2,2,4,1,TRUE
apeman-react-toast,2.0.13,2.0.14,36,3,389,459,848,40,TRUE
apeman-react-toast,2.0.11,2.0.12,34,3,105,115,220,17,TRUE
apeman-react-toast,2.0.7,2.0.8,30,4,2205,10084,12289,17,TRUE
apeman-react-toast,2.0.5,2.0.6,28,1,3,3,6,2,TRUE
apeman-react-toast,1.1.6,1.1.7,14,1,3,3,6,2,TRUE
apeman-react-toast,2.0.2,2.0.3,25,4,4862,2901,7763,56,TRUE
apeman-react-toast,1.1.4,1.1.5,12,1,6108,5402,11510,5,TRUE
pelias-whosonfirst,1.1.0,2.0.0,2,4,8,2,10,4,FALSE
pelias-whosonfirst,1.0.0,1.1.0,1,26,240,143,383,33,FALSE
pelias-whosonfirst,2.0.0,2.1.0,3,16,237,35,272,19,TRUE
pelias-whosonfirst,2.3.0,2.3.1,6,1,13,11,24,2,FALSE
pelias-whosonfirst,2.3.1,2.4.0,7,14,636,422,1058,29,FALSE
pelias-whosonfirst,2.7.0,2.8.0,13,3,335,39,374,17,FALSE
pelias-whosonfirst,2.2.0,2.3.0,5,26,1305,1152,2457,38,FALSE
pelias-whosonfirst,2.6.0,2.7.0,12,18,100,38,138,22,FALSE
pelias-whosonfirst,2.1.0,2.2.0,4,13,478,166,644,25,FALSE
pelias-whosonfirst,2.4.0,2.5.0,8,6,8,147,155,10,FALSE
pelias-whosonfirst,2.5.2,2.6.0,11,6,234,281,515,22,FALSE
pelias-whosonfirst,2.5.0,2.5.1,9,6,67,205,272,15,FALSE
pelias-whosonfirst,2.5.1,2.5.2,10,2,8,0,8,2,FALSE
pelias-whosonfirst,2.0.0,2.1.0,3,16,237,35,272,19,FALSE
pelias-whosonfirst,2.15.0,2.16.0,22,2,184,4,188,12,FALSE
pelias-whosonfirst,2.14.0,2.15.0,21,3,110,4,114,12,FALSE
pelias-whosonfirst,2.13.0,2.14.0,20,31,3428,1272,4700,93,FALSE
pelias-whosonfirst,2.11.0,2.12.0,18,2,2,2,4,2,FALSE
pelias-whosonfirst,2.12.0,2.13.0,19,5,20,16,36,5,FALSE
pelias-whosonfirst,2.9.0,2.9.1,15,4,2,8,10,3,FALSE
pelias-whosonfirst,2.9.1,2.10.0,16,2,740,300,1040,20,FALSE
pelias-whosonfirst,2.10.0,2.11.0,17,11,53,41,94,13,FALSE
pelias-whosonfirst,2.8.0,2.9.0,14,21,888,1018,1906,55,FALSE
pelias-whosonfirst,2.8.0,2.9.0,14,21,888,1018,1906,55,TRUE
pelias-whosonfirst,2.2.0,2.3.0,5,26,1305,1152,2457,38,TRUE
pelias-whosonfirst,2.1.0,2.2.0,4,13,478,166,644,25,TRUE
pelias-whosonfirst,2.9.1,2.10.0,16,2,740,300,1040,20,TRUE
pelias-whosonfirst,2.3.1,2.4.0,7,14,636,422,1058,29,TRUE
universal-redux-boilerplate,1.0.5,1.0.6,5,5,81,52,133,14,FALSE
universal-redux-boilerplate,1.0.4,1.0.5,4,4,138,32,170,18,FALSE
universal-redux-boilerplate,1.0.0,1.0.2,1,10,37,14,51,15,FALSE
universal-redux-boilerplate,1.0.2,1.0.3,2,1,36,42,78,7,FALSE
universal-redux-boilerplate,1.0.3,1.0.4,3,3,23,19,42,4,TRUE
universal-redux-boilerplate,1.0.3,1.0.4,3,3,23,19,42,4,FALSE
universal-redux-boilerplate,1.0.5,1.0.6,5,5,81,52,133,14,TRUE
universal-redux-boilerplate,1.0.4,1.0.5,4,4,138,32,170,18,TRUE
react-broadcast,0.0.1,0.0.2,1,4,99,3,102,9,FALSE
react-broadcast,0.0.3,0.1.0,3,3,253,45,298,10,FALSE
react-broadcast,0.0.2,0.0.3,2,5,86,6,92,8,FALSE
react-broadcast,0.1.0,0.1.1,4,2,17,14,31,2,FALSE
react-broadcast,0.1.1,0.1.2,5,14,65,28,93,15,FALSE
react-broadcast,0.1.1,0.1.2,5,14,65,28,93,15,TRUE
js-xdr,0.0.5,0.0.6,5,6,9626,10512,20138,43,FALSE
js-xdr,0.0.4,0.0.5,4,2,3572,3090,6662,5,FALSE
js-xdr,0.0.7,0.0.8,7,1,191,97,288,5,FALSE
js-xdr,0.0.6,0.0.7,6,3,124,61,185,7,FALSE
js-xdr,0.0.3,0.0.4,3,2,3553,3556,7109,5,FALSE
js-xdr,0.0.9,0.0.10,9,2,74,52,126,6,FALSE
js-xdr,0.0.8,0.0.9,8,2,2652,2646,5298,6,FALSE
js-xdr,0.0.11,0.0.12,11,7,33501,34935,68436,22,FALSE
js-xdr,0.0.10,0.0.11,10,5,35719,34120,69839,11,FALSE
js-xdr,0.0.12,1.0.0,12,4,35780,34228,70008,12,FALSE
js-xdr,0.0.1,0.0.2,1,4,21,6,27,5,FALSE
js-xdr,0.0.3,0.0.4,3,2,3553,3556,7109,5,TRUE
js-xdr,0.0.2,0.0.3,2,7,204,82,286,32,FALSE
js-xdr,0.0.4,0.0.5,4,2,3572,3090,6662,5,TRUE
js-xdr,0.0.1,0.0.2,1,4,21,6,27,5,TRUE
js-xdr,0.0.2,0.0.3,2,7,204,82,286,32,TRUE
evoluttree,0.1.5-a,0.1.5-b,21,2,9,5,14,6,FALSE
evoluttree,0.1.7-b,0.1.7-c,26,1,3,3,6,3,FALSE
evoluttree,0.1.7-c,0.1.7-d,27,2,43,35,78,5,FALSE
evoluttree,0.1.7-a,0.1.7-b,25,1,35,14,49,1,FALSE
evoluttree,0.1.8,0.1.9,34,1,26,11,37,2,FALSE
evoluttree,0.1.9,0.2.0,35,11,1021,255,1276,51,FALSE
evoluttree,0.1.8-b,0.1.8-c,32,1,48,7,55,3,FALSE
evoluttree,0.2.3,0.2.4-a,49,40,565,453,1018,108,FALSE
evoluttree,0.2.2,0.2.3-a,39,19,470,308,778,51,FALSE
evoluttree,0.2.1,0.2.2-a,37,13,359,216,575,36,TRUE
evoluttree,0.2.0,0.2.1,36,4,33,28,61,5,FALSE
evoluttree,0.1.0,0.1.1,1,4,356,55,411,22,FALSE
evoluttree,0.1.1,0.1.2-a,2,4,147,21,168,12,FALSE
evoluttree,0.1.2,0.1.3,18,7,432,288,720,54,FALSE
evoluttree,0.1.3,0.1.4,19,16,515,574,1089,62,FALSE
evoluttree,0.1.4,0.1.5-a,20,2,468,60,528,20,FALSE
evoluttree,0.1.5,0.1.6,23,5,42,12,54,10,FALSE
evoluttree,0.1.6,0.1.7-a,24,2,104,254,358,7,FALSE
evoluttree,0.1.7,0.1.8-a,30,15,744,452,1196,69,FALSE
evoluttree,0.1.2-f,0.1.2-g,8,1,81,84,165,7,FALSE
evoluttree,0.2.3-b,0.2.3-c,41,3,40,62,102,12,FALSE
evoluttree,0.2.3-c,0.2.3-d,42,3,10,8,18,6,FALSE
evoluttree,0.1.7-d,0.1.7-e,28,2,88,25,113,12,FALSE
evoluttree,0.2.3-h,0.2.3-i,47,6,110,90,200,23,FALSE
evoluttree,0.2.3-a,0.2.3-b,40,4,18,10,28,8,FALSE
evoluttree,0.2.3-e,0.2.3-f,44,3,9,46,55,12,FALSE
evoluttree,0.2.3-d,0.2.3-e,43,3,9,6,15,7,FALSE
evoluttree,0.2.3-g,0.2.3-h,46,4,28,6,34,6,FALSE
evoluttree,0.1.8-a,0.1.8-b,31,1,6,4,10,4,FALSE
evoluttree,0.2.3-f,0.2.3-g,45,2,6,8,14,6,FALSE
evoluttree,0.2.4-b,0.2.4-c,51,2,21,10,31,5,FALSE
evoluttree,0.2.4-c,0.2.4-d,52,2,34,11,45,5,FALSE
evoluttree,0.2.4-a,0.2.4-b,50,3,9,11,20,3,FALSE
evoluttree,0.2.4-d,0.2.4-e,53,4,110,43,153,10,FALSE
evoluttree,0.1.2-g,0.1.2-h,9,1,35,14,49,1,FALSE
evoluttree,0.1.2-e,0.1.2-f,7,1,35,14,49,1,FALSE
evoluttree,0.1.2-d,0.1.2-e,6,1,35,14,49,1,FALSE
evoluttree,0.1.2-c,0.1.2-d,5,1,35,14,49,1,FALSE
evoluttree,0.1.2-b,0.1.2-c,4,2,10,3,13,3,FALSE
evoluttree,0.1.2-a,0.1.2-b,3,1,35,14,49,1,FALSE
evoluttree,0.1.2-n,0.1.2-o,16,1,35,14,49,1,FALSE
evoluttree,0.1.2-m,0.1.2-n,15,1,35,14,49,1,FALSE
evoluttree,0.1.2-l,0.1.2-m,14,1,35,14,49,1,FALSE
evoluttree,0.1.2-k,0.1.2-l,13,1,35,14,49,1,FALSE
evoluttree,0.1.2-j,0.1.2-k,12,1,35,14,49,1,FALSE
evoluttree,0.1.2-i,0.1.2-j,11,1,35,14,49,1,FALSE
evoluttree,0.1.2-h,0.1.2-i,10,1,137,89,226,16,FALSE
evoluttree,0.2.1,0.2.2-a,37,13,359,216,575,36,FALSE
evoluttree,0.1.8-b,0.1.8-c,32,1,48,7,55,3,TRUE
evoluttree,0.1.0,0.1.1,1,4,356,55,411,22,TRUE
evoluttree,0.1.4,0.1.5-a,20,2,468,60,528,20,TRUE
evoluttree,0.1.9,0.2.0,35,11,1021,255,1276,51,TRUE
evoluttree,0.1.7-d,0.1.7-e,28,2,88,25,113,12,TRUE
evoluttree,0.1.2-h,0.1.2-i,10,1,137,89,226,16,TRUE
evoluttree,0.2.0,0.2.1,36,4,33,28,61,5,TRUE
melon-timepicker,0.3.2,0.3.3,3,1,2,2,4,2,FALSE
melon-timepicker,0.3.0,0.3.1,1,1,2,2,4,2,FALSE
melon-timepicker,0.3.1,0.3.2,2,1,2,2,4,2,FALSE
melon-timepicker,1.1.1,1.1.2,9,2,12,7,19,6,FALSE
melon-timepicker,1.1.0,1.1.1,8,5,45,21,66,14,FALSE
melon-timepicker,1.1.3,1.1.4,11,3,88,56,144,25,FALSE
melon-timepicker,1.1.2,1.1.3,10,1,47,15,62,5,FALSE
melon-timepicker,1.1.5,1.1.6,13,1,5,299,304,7,FALSE
melon-timepicker,1.1.4,1.1.5,12,2,496,63,559,29,FALSE
melon-timepicker,1.0.2,1.1.0,7,8,1024,564,1588,54,FALSE
melon-timepicker,1.0.0,1.0.1,5,7,130,567,697,34,FALSE
melon-timepicker,1.0.1,1.0.2,6,2,186,139,325,26,FALSE
melon-timepicker,0.3.3,1.0.0,4,6,2000,2042,4042,82,FALSE
melon-timepicker,1.0.2,1.1.0,7,8,1024,564,1588,54,TRUE
melon-timepicker,0.3.3,1.0.0,4,6,2000,2042,4042,82,TRUE
melon-timepicker,1.1.1,1.1.2,9,2,12,7,19,6,TRUE
melon-timepicker,0.3.1,0.3.2,2,1,2,2,4,2,TRUE
watson-developer-cloud,1.0.4,1.0.5,39,3,27,15,42,5,FALSE
watson-developer-cloud,1.0.5,1.0.6,40,22,342,109,451,59,FALSE
watson-developer-cloud,1.0.6,1.1.0,41,24,28586,184,28770,186,FALSE
watson-developer-cloud,1.0.3,1.0.4,38,25,1043,219,1262,53,FALSE
watson-developer-cloud,2.18.0,2.19.1,122,15,78,24,102,17,FALSE
watson-developer-cloud,2.25.1,2.26.0,136,9,163,33,196,10,FALSE
watson-developer-cloud,2.25.0,2.25.1,135,2,58,1,59,4,FALSE
watson-developer-cloud,1.6.2,1.7.0,60,2,18,7,25,3,FALSE
watson-developer-cloud,1.6.1,1.6.2,59,7,99,92,191,10,FALSE
watson-developer-cloud,2.23.1,2.23.2,132,4,10,5,15,5,FALSE
watson-developer-cloud,2.23.0,2.23.1,131,3,58,24,82,4,FALSE
watson-developer-cloud,2.23.2,2.24.1,133,9,118,44,162,12,FALSE
watson-developer-cloud,2.22.1,2.22.2,129,10,107,34,141,12,FALSE
watson-developer-cloud,1.12.4,2.0.0,72,34,3291,2001,5292,243,FALSE
watson-developer-cloud,1.12.0,1.12.2,69,5,278,6,284,7,FALSE
watson-developer-cloud,1.12.2,1.12.3,70,17,385,68,453,23,FALSE
watson-developer-cloud,1.12.3,1.12.4,71,3,7,3,10,3,FALSE
watson-developer-cloud,2.8.3,2.9.0,99,7,149,24,173,15,FALSE
watson-developer-cloud,2.8.2,2.8.3,98,7,83,17,100,11,FALSE
watson-developer-cloud,1.10.0,1.12.0,68,14,660,18,678,27,FALSE
watson-developer-cloud,0.9.18,0.9.19,15,1,75,2,77,3,FALSE
watson-developer-cloud,0.9.19,0.9.20,16,2,29,18,47,3,FALSE
watson-developer-cloud,0.9.13,0.9.14,11,20,1129,37,1166,37,FALSE
watson-developer-cloud,0.9.16,0.9.18,14,8,84,74,158,17,FALSE
watson-developer-cloud,0.9.14,0.9.15,12,1,13,33,46,4,FALSE
watson-developer-cloud,0.9.15,0.9.16,13,2,307,8,315,10,FALSE
watson-developer-cloud,2.8.1,2.8.2,97,6,2747,601,3348,40,FALSE
watson-developer-cloud,2.28.0,2.28.1,141,1,1,1,2,1,FALSE
watson-developer-cloud,0.9.27,0.9.28,24,19,856,580,1436,43,FALSE
watson-developer-cloud,2.31.0,2.31.1,145,12,1128,569,1697,139,FALSE
watson-developer-cloud,2.31.1,2.31.2,146,5,349,24,373,8,FALSE
watson-developer-cloud,2.31.2,2.32.0,147,7,1255,525,1780,43,FALSE
watson-developer-cloud,0.9.26,0.9.27,23,9,1159,161,1320,31,FALSE
watson-developer-cloud,2.9.0,2.9.1,100,9,13,10,23,11,FALSE
watson-developer-cloud,2.9.1,2.10.1,101,6,194,25,219,12,FALSE
watson-developer-cloud,0.9.30,0.10.0,27,17,629,166,795,43,FALSE
watson-developer-cloud,2.0.3,2.1.0,76,25,983,1954,2937,96,FALSE
watson-developer-cloud,2.0.2,2.0.3,75,4,36,1476,1512,14,FALSE
watson-developer-cloud,2.0.1,2.0.2,74,44,1413,5291,6704,69,FALSE
watson-developer-cloud,2.0.0,2.0.1,73,11,179,98,277,21,FALSE
watson-developer-cloud,2.15.2,2.15.5,117,17,33949,8110,42059,266,FALSE
watson-developer-cloud,2.15.0,2.15.2,116,5,11,9,20,8,FALSE
watson-developer-cloud,2.29.0,2.30.0,143,26,1155,55,1210,42,FALSE
watson-developer-cloud,2.15.5,2.16.0,118,21,3791,244,4035,50,FALSE
watson-developer-cloud,2.2.0,2.3.2,82,22,3166,4471,7637,73,FALSE
watson-developer-cloud,0.9.23,0.9.24,20,7,297,34,331,17,FALSE
watson-developer-cloud,0.9.22,0.9.23,19,12,2526,378,2904,18,FALSE
watson-developer-cloud,0.9.21,0.9.22,18,2,22,3,25,3,FALSE
watson-developer-cloud,0.9.20,0.9.21,17,4,81,7,88,4,FALSE
watson-developer-cloud,2.13.0,2.13.1,106,7,74,97,171,8,FALSE
watson-developer-cloud,2.13.1,2.14.0,107,7,515,36,551,10,FALSE
watson-developer-cloud,0.9.25,0.9.26,22,4,339,66,405,9,FALSE
watson-developer-cloud,0.9.24,0.9.25,21,11,1708,21,1729,24,FALSE
watson-developer-cloud,0.9.29,0.9.30,26,30,2384,450,2834,131,FALSE
watson-developer-cloud,0.9.28,0.9.29,25,19,974,970,1944,58,FALSE
watson-developer-cloud,2.11.0,2.11.1,103,8,85,9,94,8,FALSE
watson-developer-cloud,2.11.1,2.12.0,104,6,635,24,659,9,FALSE
watson-developer-cloud,1.9.1,1.9.2,64,2,2,2,4,2,FALSE
watson-developer-cloud,1.9.0,1.9.1,63,2,33,5,38,3,FALSE
watson-developer-cloud,1.9.3,1.9.4,66,6,422,417,839,8,FALSE
watson-developer-cloud,1.9.2,1.9.3,65,2,38,2,40,3,FALSE
watson-developer-cloud,1.9.4,1.10.0,67,17,244,3109,3353,66,FALSE
watson-developer-cloud,2.20.0,2.20.1,124,3,3,3,6,3,FALSE
watson-developer-cloud,2.20.1,2.21.0,125,14,227,69,296,38,FALSE
watson-developer-cloud,1.5.1,1.6.1,58,7,528,11,539,13,FALSE
watson-developer-cloud,1.5.0,1.5.1,57,3,3,3,6,3,FALSE
watson-developer-cloud,1.3.3,1.4.1,55,14,182,85,267,23,FALSE
watson-developer-cloud,2.30.0,2.31.0,144,5,729,348,1077,14,FALSE
watson-developer-cloud,1.3.1,1.3.3,54,10,50,27,77,13,FALSE
watson-developer-cloud,1.3.0,1.3.1,53,6,40,12,52,10,FALSE
watson-developer-cloud,2.4.3,2.4.4,87,5,44,3,47,6,FALSE
watson-developer-cloud,2.4.2,2.4.3,86,2,8,11,19,5,FALSE
watson-developer-cloud,2.4.1,2.4.2,85,2,5,2,7,3,FALSE
watson-developer-cloud,2.4.0,2.4.1,84,2,70,27,97,8,FALSE
watson-developer-cloud,2.4.6,2.5.0,90,12,583,58,641,20,FALSE
watson-developer-cloud,2.4.5,2.4.6,89,2,10,10,20,4,FALSE
watson-developer-cloud,2.4.4,2.4.5,88,2,6,3,9,4,FALSE
watson-developer-cloud,2.32.0,2.32.1,148,3,52,6,58,5,FALSE
watson-developer-cloud,2.26.0,2.26.1,137,15,511,21,532,19,FALSE
watson-developer-cloud,2.26.1,2.27.0,138,1,1,1,2,1,FALSE
watson-developer-cloud,2.6.1,2.6.2,93,7,57,562,619,12,FALSE
watson-developer-cloud,2.6.0,2.6.1,92,5,18,10,28,11,FALSE
watson-developer-cloud,2.6.2,2.7.0,94,7,4428,61,4489,30,FALSE
watson-developer-cloud,2.24.1,2.25.0,134,5,1254,180,1434,21,FALSE
watson-developer-cloud,2.17.0,2.17.1,120,9,50,45,95,59,FALSE
watson-developer-cloud,2.17.1,2.18.0,121,13,2515,153,2668,39,FALSE
watson-developer-cloud,1.1.1,1.1.2,43,2,3,3,6,2,FALSE
watson-developer-cloud,1.1.0,1.1.1,42,17,211,48,259,20,FALSE
watson-developer-cloud,1.1.3,1.2.0,45,3,4,5,9,3,FALSE
watson-developer-cloud,1.1.2,1.1.3,44,17,193,106,299,22,FALSE
watson-developer-cloud,2.14.8,2.15.0,115,5,93,69,162,11,FALSE
watson-developer-cloud,2.14.6,2.14.8,114,6,232,87,319,37,FALSE
watson-developer-cloud,2.14.5,2.14.6,113,3,5,3,8,3,FALSE
watson-developer-cloud,2.14.4,2.14.5,112,13,409,36,445,20,FALSE
watson-developer-cloud,2.14.3,2.14.4,111,3,257,283,540,7,FALSE
watson-developer-cloud,2.14.2,2.14.3,110,3,3,1,4,3,FALSE
watson-developer-cloud,2.14.1,2.14.2,109,3,7,3,10,4,FALSE
watson-developer-cloud,2.14.0,2.14.1,108,4,6,3,9,4,FALSE
watson-developer-cloud,2.1.2,2.1.3,79,13,251,94,345,18,FALSE
watson-developer-cloud,2.1.3,2.1.4,80,4,8,17,25,6,FALSE
watson-developer-cloud,2.1.0,2.1.1,77,5,11,11,22,13,FALSE
watson-developer-cloud,2.1.1,2.1.2,78,2,2,2,4,2,FALSE
watson-developer-cloud,1.0.0-beta.2,1.0.0-beta.3,36,11,1174,77,1251,30,FALSE
watson-developer-cloud,1.0.0-beta.3,1.0.3,37,14,86,28,114,22,FALSE
watson-developer-cloud,2.1.4,2.2.0,81,9,1481,1357,2838,57,FALSE
watson-developer-cloud,1.0.0-beta.1,1.0.0-beta.2,35,13,4079,3400,7479,116,FALSE
watson-developer-cloud,0.10.1,0.10.2,29,11,2264,115,2379,44,FALSE
watson-developer-cloud,0.10.0,0.10.1,28,4,11,8,19,8,FALSE
watson-developer-cloud,0.10.3,0.10.4,31,19,2305,566,2871,85,FALSE
watson-developer-cloud,0.10.2,0.10.3,30,2,11,3,14,2,FALSE
watson-developer-cloud,0.10.5,0.10.6,33,30,2964,1259,4223,47,FALSE
watson-developer-cloud,0.10.4,0.10.5,32,27,636,669,1305,52,FALSE
watson-developer-cloud,0.10.6,1.0.0-beta.1,34,47,7082,2178,9260,117,FALSE
watson-developer-cloud,2.22.0,2.22.1,128,2,2,2,4,2,FALSE
watson-developer-cloud,2.12.0,2.13.0,105,5,228,40,268,5,FALSE
watson-developer-cloud,2.22.2,2.23.0,130,5,505,14,519,6,FALSE
watson-developer-cloud,2.19.1,2.20.0,123,4,156,307,463,12,FALSE
watson-developer-cloud,1.8.0,1.9.0,62,21,2582,1004,3586,44,FALSE
watson-developer-cloud,1.7.0,1.8.0,61,11,2292,534,2826,52,FALSE
watson-developer-cloud,1.4.1,1.5.0,56,23,1502,119,1621,32,FALSE
watson-developer-cloud,2.3.2,2.4.0,83,9,1270,127,1397,34,FALSE
watson-developer-cloud,2.21.1,2.22.0,127,73,3908,1355,5263,208,FALSE
watson-developer-cloud,2.21.0,2.21.1,126,4,86,80,166,31,FALSE
watson-developer-cloud,1.2.6,1.3.0,52,3,17,334,351,8,FALSE
watson-developer-cloud,1.2.4,1.2.5,50,6,65,40,105,9,FALSE
watson-developer-cloud,1.2.5,1.2.6,51,10,555,279,834,37,FALSE
watson-developer-cloud,1.2.2,1.2.3,48,14,65,16,81,19,FALSE
watson-developer-cloud,1.2.3,1.2.4,49,4,4,4,8,4,FALSE
watson-developer-cloud,1.2.0,1.2.1,46,8,131,83,214,17,FALSE
watson-developer-cloud,1.2.1,1.2.2,47,19,15274,645,15919,122,FALSE
watson-developer-cloud,2.5.0,2.6.0,91,13,2460,1196,3656,78,FALSE
watson-developer-cloud,2.10.1,2.11.0,102,15,483,52,535,31,FALSE
watson-developer-cloud,2.7.0,2.7.1,95,3,6,3,9,4,FALSE
watson-developer-cloud,2.7.1,2.8.1,96,14,209,23,232,20,FALSE
watson-developer-cloud,2.28.1,2.29.0,142,10,342,150,492,30,FALSE
watson-developer-cloud,2.27.1,2.28.0,140,8,27,19,46,8,FALSE
watson-developer-cloud,2.27.0,2.27.1,139,3,50,262,312,4,FALSE
watson-developer-cloud,2.16.0,2.17.0,119,18,9383,9164,18547,236,FALSE
watson-developer-cloud,0.9.11,0.9.13,10,25,828,634,1462,41,FALSE
watson-developer-cloud,0.9.1,0.9.2,1,2,21,1,22,2,FALSE
watson-developer-cloud,0.9.2,0.9.3,2,2,45,27,72,6,FALSE
watson-developer-cloud,0.9.3,0.9.4,3,3,37,19,56,5,FALSE
watson-developer-cloud,0.9.4,0.9.5,4,8,15,15,30,8,FALSE
watson-developer-cloud,0.9.5,0.9.6,5,5,199,7,206,9,FALSE
watson-developer-cloud,0.9.6,0.9.7,6,4,7,7,14,4,FALSE
watson-developer-cloud,0.9.7,0.9.8,7,2,51,20,71,3,FALSE
watson-developer-cloud,0.9.8,0.9.9,8,11,726,430,1156,54,FALSE
watson-developer-cloud,0.9.9,0.9.11,9,6,315,17,332,10,FALSE
watson-developer-cloud,0.9.13,0.9.14,11,20,1129,37,1166,37,TRUE
watson-developer-cloud,2.31.2,2.32.0,147,7,1255,525,1780,43,TRUE
watson-developer-cloud,0.10.3,0.10.4,31,19,2305,566,2871,85,TRUE
watson-developer-cloud,1.0.4,1.0.5,39,3,27,15,42,5,TRUE
watson-developer-cloud,1.0.6,1.1.0,41,24,28586,184,28770,186,TRUE
watson-developer-cloud,1.0.3,1.0.4,38,25,1043,219,1262,53,TRUE
watson-developer-cloud,2.17.1,2.18.0,121,13,2515,153,2668,39,TRUE
watson-developer-cloud,1.0.0-beta.3,1.0.3,37,14,86,28,114,22,TRUE
watson-developer-cloud,0.10.6,1.0.0-beta.1,34,47,7082,2178,9260,117,TRUE
watson-developer-cloud,2.21.1,2.22.0,127,73,3908,1355,5263,208,TRUE
watson-developer-cloud,1.1.0,1.1.1,42,17,211,48,259,20,TRUE
watson-developer-cloud,2.31.1,2.31.2,146,5,349,24,373,8,TRUE
watson-developer-cloud,0.9.30,0.10.0,27,17,629,166,795,43,TRUE
watson-developer-cloud,2.32.0,2.32.1,148,3,52,6,58,5,TRUE
watson-developer-cloud,2.0.3,2.1.0,76,25,983,1954,2937,96,TRUE
watson-developer-cloud,2.20.1,2.21.0,125,14,227,69,296,38,TRUE
watson-developer-cloud,2.25.1,2.26.0,136,9,163,33,196,10,TRUE
watson-developer-cloud,2.6.0,2.6.1,92,5,18,10,28,11,TRUE
watson-developer-cloud,2.1.0,2.1.1,77,5,11,11,22,13,TRUE
watson-developer-cloud,2.22.0,2.22.1,128,2,2,2,4,2,TRUE
watson-developer-cloud,2.23.1,2.23.2,132,4,10,5,15,5,TRUE
watson-developer-cloud,2.22.1,2.22.2,129,10,107,34,141,12,TRUE
watson-developer-cloud,2.26.0,2.26.1,137,15,511,21,532,19,TRUE
watson-developer-cloud,2.14.0,2.14.1,108,4,6,3,9,4,TRUE
watson-developer-cloud,2.31.0,2.31.1,145,12,1128,569,1697,139,TRUE
watson-developer-cloud,2.23.2,2.24.1,133,9,118,44,162,12,TRUE
watson-developer-cloud,1.9.0,1.9.1,63,2,33,5,38,3,TRUE
watson-developer-cloud,1.2.6,1.3.0,52,3,17,334,351,8,TRUE
watson-developer-cloud,2.16.0,2.17.0,119,18,9383,9164,18547,236,TRUE
mrt,0.1.1,0.1.2,14,4,1331,2285,3616,87,FALSE
mrt,0.1.0,0.1.1,13,5,55,27,82,14,FALSE
mrt,0.1.3,0.1.4,16,4,69,19,88,11,FALSE
mrt,0.1.4,0.1.5,17,4,1931,77,2008,53,FALSE
mrt,0.3.0,0.3.1,24,6,7206,3870,11076,147,FALSE
mrt,0.3.1,0.4.0,25,6,1575,1560,3135,205,FALSE
mrt,0.1.5,0.1.6,18,4,491,3,494,13,FALSE
mrt,0.1.8,0.1.9,21,4,143,17,160,15,FALSE
mrt,0.1.9,0.2.0,22,4,167,23,190,15,FALSE
mrt,0.1.7,0.1.8,20,6,318,3,321,18,FALSE
mrt,0.1.6,0.1.7,19,4,225,7,232,11,FALSE
mrt,0.2.0,0.3.0,23,11,5900,11072,16972,237,FALSE
mrt,0.4.1,0.4.2,27,5,259,7,266,13,FALSE
mrt,0.4.0,0.4.1,26,4,6,6,12,6,FALSE
mrt,0.1.2,0.1.3,15,4,257,3,260,11,FALSE
mrt,0.4.2,0.4.4,28,7,298,9,307,17,FALSE
mrt,0.4.5,0.4.6,30,5,116,46,162,21,FALSE
mrt,0.4.4,0.4.5,29,4,393,103,496,23,FALSE
mrt,0.4.6,0.4.7,31,3,268,16,284,12,FALSE
mrt,0.0.11,0.1.0,12,8,5426,285,5711,93,FALSE
mrt,0.0.10,0.0.11,11,4,33,31,64,7,FALSE
mrt,0.0.5,0.0.6,6,4,29,33,62,9,FALSE
mrt,0.0.4,0.0.5,5,4,139,13,152,11,FALSE
mrt,0.0.7,0.0.8,8,4,197,19,216,11,FALSE
mrt,0.0.6,0.0.7,7,4,17,3,20,9,FALSE
mrt,0.0.1,0.0.2,2,4,5,5,10,5,FALSE
mrt,0.0.3,0.0.4,4,4,217,21,238,15,FALSE
mrt,0.0.2,0.0.3,3,3,6,687,693,18,FALSE
mrt,0.0.9,0.0.10,10,4,27,27,54,5,FALSE
mrt,0.0.8,0.0.9,9,3,147,3,150,12,FALSE
mrt,0.0.11,0.1.0,12,8,5426,285,5711,93,TRUE
mrt,0.3.0,0.3.1,24,6,7206,3870,11076,147,TRUE
mrt,0.0.3,0.0.4,4,4,217,21,238,15,TRUE
mrt,0.4.5,0.4.6,30,5,116,46,162,21,TRUE
devebot-cli,0.1.10,0.1.11,11,1,7,7,14,1,FALSE
devebot-cli,0.1.11,0.1.12,12,1,7,7,14,1,TRUE
devebot-cli,0.1.8,0.1.9,9,1,7,7,14,1,FALSE
devebot-cli,0.1.9,0.1.10,10,4,289,93,382,10,FALSE
devebot-cli,0.1.0,0.1.1,1,2,113,64,177,5,FALSE
devebot-cli,0.1.1,0.1.2,2,1,19,15,34,2,FALSE
devebot-cli,0.1.2,0.1.3,3,1,7,7,14,1,FALSE
devebot-cli,0.1.3,0.1.4,4,1,7,7,14,1,FALSE
devebot-cli,0.1.4,0.1.5,5,5,421,344,765,20,FALSE
devebot-cli,0.1.5,0.1.6,6,1,7,7,14,1,FALSE
devebot-cli,0.1.6,0.1.7,7,1,7,7,14,1,FALSE
devebot-cli,0.1.7,0.1.8,8,1,7,7,14,1,FALSE
devebot-cli,0.1.11,0.1.12,12,1,7,7,14,1,FALSE
devebot-cli,0.1.2,0.1.3,3,1,7,7,14,1,TRUE
react-howler,3.4.0,3.4.1,14,1,328,1245,1573,3,FALSE
react-howler,3.1.0,3.2.0,11,3,98,39,137,9,FALSE
react-howler,3.0.0,3.0.1,9,1,4,1,5,1,FALSE
react-howler,3.0.1,3.1.0,10,6,27,21,48,8,FALSE
react-howler,2.0.0,3.0.0,8,4,24,16,40,5,FALSE
react-howler,3.5.0,3.6.0,16,4,282,246,528,12,FALSE
react-howler,3.6.0,3.6.1,17,6,1986,1822,3808,26,FALSE
react-howler,3.6.1,3.6.2,18,3,1066,1280,2346,15,FALSE
react-howler,3.4.1,3.5.0,15,2,15,5,20,5,FALSE
react-howler,3.2.0,3.3.0,12,8,10277,1103,11380,32,FALSE
react-howler,3.3.0,3.4.0,13,2,10,1,11,4,FALSE
react-howler,1.0.0,1.0.1,5,4,8,7,15,8,FALSE
react-howler,1.0.1,1.0.2,6,2,6,2,8,3,FALSE
react-howler,0.1.0,0.1.1,1,1,127,5,132,2,FALSE
react-howler,0.1.1,0.1.2,2,2,3,1,4,2,FALSE
react-howler,0.1.2,0.1.3,3,3,5,1,6,4,FALSE
react-howler,0.1.3,1.0.0,4,7,66,14,80,12,FALSE
react-howler,0.1.3,1.0.0,4,7,66,14,80,12,TRUE
react-howler,1.0.2,2.0.0,7,8,138,206,344,34,FALSE
react-howler,3.6.0,3.6.1,17,6,1986,1822,3808,26,TRUE
react-howler,3.6.1,3.6.2,18,3,1066,1280,2346,15,TRUE
angular-wormhole,1.1.2,1.1.3,4,1,30,16,46,4,FALSE
angular-wormhole,1.1.1,1.1.2,3,3,716,15,731,7,TRUE
angular-wormhole,1.1.0,1.1.1,2,3,9,4,13,4,TRUE
angular-wormhole,1.1.2,1.1.3,4,1,30,16,46,4,TRUE
angular-wormhole,1.0.0,1.1.0,1,3,75,9,84,6,TRUE
angular-wormhole,1.1.0,1.1.1,2,3,9,4,13,4,FALSE
angular-wormhole,1.0.0,1.1.0,1,3,75,9,84,6,FALSE
vue-charts,0.0.5,0.1.0,1,3,2738,1051,3789,39,FALSE
vue-charts,0.1.13,0.1.14,4,9,477,127,604,39,TRUE
vue-charts,0.1.14,0.2.1,5,8,388,155,543,45,FALSE
vue-charts,0.1.0,0.1.1,2,2,8,17,25,7,FALSE
vue-charts,0.1.1,0.1.13,3,3,123,72,195,21,FALSE
vue-charts,0.1.13,0.1.14,4,9,477,127,604,39,FALSE
vue-charts,0.0.5,0.1.0,1,3,2738,1051,3789,39,TRUE
vue-charts,0.1.14,0.2.1,5,8,388,155,543,45,TRUE
vue-charts,0.1.0,0.1.1,2,2,8,17,25,7,TRUE
bix,1.3.1,1.3.2,25,1,104,1609,1713,28,FALSE
bix,1.3.0,1.3.1,24,1,57,56,113,23,FALSE
bix,1.0.4,1.0.5,5,3,3297,3023,6320,42,FALSE
bix,1.0.5,1.0.6,6,1,9,9,18,7,TRUE
bix,1.0.6,1.1.0,7,1,2614,2747,5361,25,FALSE
bix,1.1.2,1.1.3-1,10,4,14,12,26,9,FALSE
bix,1.0.0,1.0.1,1,1,604,611,1215,6,FALSE
bix,1.0.1,1.0.2,2,1,80,126,206,6,FALSE
bix,1.0.2,1.0.3,3,1,128,109,237,9,FALSE
bix,1.0.3,1.0.4,4,1,9,17,26,9,FALSE
bix,1.1.3,1.1.5,12,10,462,1105,1567,39,FALSE
bix,1.1.5,1.2.0,13,5,318,288,606,32,FALSE
bix,1.1.1,1.1.2,9,6,511,235,746,71,FALSE
bix,1.2.6,1.2.7,20,9,982,528,1510,22,FALSE
bix,1.2.4,1.2.5,18,1,421,280,701,15,FALSE
bix,1.2.5,1.2.6,19,4,328,268,596,30,FALSE
bix,1.2.2,1.2.3,16,1,1354,119,1473,12,FALSE
bix,1.2.3,1.2.4,17,1,6,6,12,6,FALSE
bix,1.2.0,1.2.1,14,5,1103,859,1962,29,FALSE
bix,1.2.1,1.2.2,15,1,21,14,35,10,FALSE
bix,1.2.8,1.2.9,22,1,7,4,11,6,FALSE
bix,1.2.9,1.3.0,23,1,3420,8016,11436,56,FALSE
bix,1.1.0,1.1.1,8,1,22,2,24,3,FALSE
bix,1.2.7,1.2.8,21,4,467,324,791,43,FALSE
bix,1.0.5,1.0.6,6,1,9,9,18,7,FALSE
bix,1.1.2,1.1.3-1,10,4,14,12,26,9,TRUE
bix,1.1.3,1.1.5,12,10,462,1105,1567,39,TRUE
firebase-client,0.1.0,0.1.1,3,7,131,13,144,8,FALSE
firebase-client,0.0.1,0.1.0,2,3,33,17,50,4,FALSE
firebase-client,0.1.0,0.1.1,3,7,131,13,144,8,TRUE
rn-navigation,1.1.0,1.1.1,21,1,370,187,557,13,FALSE
rn-navigation,1.0.16,1.0.17,16,1,1,0,1,1,FALSE
rn-navigation,1.0.17,1.0.18,17,1,1,0,1,1,FALSE
rn-navigation,1.0.15,1.0.16,15,1,1,0,1,1,FALSE
rn-navigation,1.0.12,1.0.13,13,1,1,0,1,1,FALSE
rn-navigation,1.0.13,1.0.15,14,1,1,0,1,1,FALSE
rn-navigation,1.0.11,1.0.12,12,1,5,9,14,1,FALSE
rn-navigation,1.0.19,1.0.20,19,2,7544,14,7558,67,FALSE
rn-navigation,1.0.18,1.0.19,18,1,1,1,2,1,FALSE
rn-navigation,1.0.20,1.1.0,20,7,467,315,782,31,FALSE
rn-navigation,1.0.4,1.0.5,5,1,1,0,1,1,FALSE
rn-navigation,1.0.5,1.0.6,6,1,1,0,1,1,FALSE
rn-navigation,1.0.6,1.0.7,7,1,1,0,1,1,FALSE
rn-navigation,1.0.7,1.0.8,8,1,1,0,1,1,FALSE
rn-navigation,1.0.8,1.0.9,9,1,1,0,1,1,FALSE
rn-navigation,1.0.9,1.0.10,10,4,2630,107,2737,10,FALSE
rn-navigation,1.0.1,1.0.2,2,1,1,0,1,1,FALSE
rn-navigation,1.0.2,1.0.3,3,1,7,4,11,4,FALSE
rn-navigation,1.0.3,1.0.4,4,1,1,0,1,1,FALSE
rn-navigation,1.0.10,1.0.11,11,1,1,0,1,1,FALSE
rn-navigation,1.0.10,1.0.11,11,1,1,0,1,1,TRUE
babelify,7.0.2,7.1.0,18,4,79,9,88,7,FALSE
babelify,7.0.0,7.0.1,16,2,2,2,4,2,FALSE
babelify,7.0.1,7.0.2,17,3,28,18,46,11,FALSE
babelify,6.1.2,6.1.3,11,3,3,1,4,3,FALSE
babelify,6.1.3,6.2.0,12,4,26,24,50,6,FALSE
babelify,6.1.0,6.1.1,9,7,15,7,22,9,FALSE
babelify,6.1.1,6.1.2,10,4,81,20,101,6,FALSE
babelify,7.1.0,7.2.0,19,8,605,109,714,30,FALSE
babelify,7.2.0,7.3.0,20,7,295,189,484,17,FALSE
babelify,6.2.0,6.3.0,13,5,97,51,148,7,FALSE
babelify,6.3.0,6.4.0,14,5,120,7,127,10,FALSE
babelify,6.4.0,7.0.0,15,2,5,44,49,4,FALSE
babelify,7.0.2,7.1.0,18,4,79,9,88,7,TRUE
babelify,5.0.1,5.0.2,1,2,9,9,18,4,FALSE
babelify,5.0.2,5.0.3,2,1,2,2,4,2,FALSE
babelify,5.0.3,5.0.4,3,13,50,25,75,15,FALSE
babelify,5.0.4,5.0.5,4,4,4,12,16,5,FALSE
babelify,6.1.0,6.1.1,9,7,15,7,22,9,TRUE
babelify,6.0.2,6.1.0,8,9,399,63,462,34,FALSE
babelify,6.0.1,6.0.2,7,5,53,13,66,5,FALSE
babelify,6.4.0,7.0.0,15,2,5,44,49,4,TRUE
babelify,7.0.1,7.0.2,17,3,28,18,46,11,TRUE
babelify,6.0.0,6.0.1,6,4,5,13,18,5,TRUE
babelify,6.1.2,6.1.3,11,3,3,1,4,3,TRUE
babelify,7.1.0,7.2.0,19,8,605,109,714,30,TRUE
babelify,6.0.0,6.0.1,6,4,5,13,18,5,FALSE
babelify,6.1.1,6.1.2,10,4,81,20,101,6,TRUE
babelify,6.2.0,6.3.0,13,5,97,51,148,7,TRUE
webstomp-obs,1.1.1,1.2.0,17,2,481,195,676,16,FALSE
webstomp-obs,1.0.5,1.0.6,14,1,108,28,136,9,FALSE
webstomp-obs,1.0.6,1.1.0,15,1,648,36,684,7,FALSE
webstomp-obs,1.0.0,1.0.1,12,1,346,17,363,13,FALSE
webstomp-obs,1.0.1,1.0.5,13,7,785,168,953,30,TRUE
webstomp-obs,1.1.0,1.1.1,16,1,10,6,16,3,FALSE
webstomp-obs,0.3.2,0.3.3,10,2,14,6,20,3,FALSE
webstomp-obs,0.3.3,1.0.0,11,1,1,1,2,1,FALSE
webstomp-obs,0.3.0,0.3.1,8,1,36,4,40,2,FALSE
webstomp-obs,0.3.1,0.3.2,9,1,1,1,2,1,FALSE
webstomp-obs,0.2.6,0.3.0,7,3,44,9,53,6,FALSE
webstomp-obs,0.2.5,0.2.6,6,1,1,1,2,1,FALSE
webstomp-obs,0.2.4,0.2.5,5,1,1,1,2,1,FALSE
webstomp-obs,0.2.3,0.2.4,4,2,27,12,39,8,FALSE
webstomp-obs,0.2.2,0.2.3,3,1,1,1,2,1,FALSE
webstomp-obs,0.2.1,0.2.2,2,1,1,1,2,1,FALSE
webstomp-obs,0.2.0,0.2.1,1,1,1,1,2,1,FALSE
webstomp-obs,1.0.1,1.0.5,13,7,785,168,953,30,FALSE
webstomp-obs,1.0.6,1.1.0,15,1,648,36,684,7,TRUE
webstomp-obs,1.1.1,1.2.0,17,2,481,195,676,16,TRUE
webstomp-obs,0.3.2,0.3.3,10,2,14,6,20,3,TRUE
webstomp-obs,0.3.0,0.3.1,8,1,36,4,40,2,TRUE
webstomp-obs,0.3.1,0.3.2,9,1,1,1,2,1,TRUE
webstomp-obs,0.2.6,0.3.0,7,3,44,9,53,6,TRUE
webstomp-obs,0.2.3,0.2.4,4,2,27,12,39,8,TRUE
webstomp-obs,0.3.3,1.0.0,11,1,1,1,2,1,TRUE
trafficlight,3.2.2,3.2.3,12,1,21,19,40,4,FALSE
trafficlight,1.1.1,2.0.0,3,2,837,44,881,6,FALSE
trafficlight,1.1.0,1.1.1,2,1,14,13,27,3,FALSE
trafficlight,3.1.0,3.2.0,9,3,122,116,238,5,FALSE
trafficlight,1.0.0,1.1.0,1,10,158,15,173,14,FALSE
trafficlight,2.0.1,2.0.2,5,7,825,302,1127,19,FALSE
trafficlight,2.0.0,2.0.1,4,2,4,4,8,3,FALSE
trafficlight,3.0.0,3.1.0,8,5,139,94,233,10,FALSE
trafficlight,3.2.0,3.2.1,10,2,12,2,14,3,FALSE
trafficlight,3.2.1,3.2.2,11,1,2,2,4,1,FALSE
trafficlight,2.1.0,3.0.0,7,7,511,250,761,17,FALSE
trafficlight,1.1.0,1.1.1,2,1,14,13,27,3,TRUE
trafficlight,1.0.0,1.1.0,1,10,158,15,173,14,TRUE
trafficlight,3.2.0,3.2.1,10,2,12,2,14,3,TRUE
trafficlight,3.2.1,3.2.2,11,1,2,2,4,1,TRUE
trafficlight,3.2.2,3.2.3,12,1,21,19,40,4,TRUE
trafficlight,2.1.0,3.0.0,7,7,511,250,761,17,TRUE
fpx,0.0.5,0.0.6,5,1,21,23,44,5,FALSE
fpx,0.0.4,0.0.5,4,1,230,117,347,5,FALSE
fpx,0.0.7,0.0.8,7,1,11,3,14,3,FALSE
fpx,0.0.6,0.0.7,6,3,749,747,1496,16,FALSE
fpx,0.0.3,0.0.4,3,1,24,42,66,3,FALSE
fpx,0.0.2,0.0.3,2,3,477,338,815,23,FALSE
fpx,0.0.12,0.0.13,12,1,45,5,50,5,FALSE
fpx,0.0.9,0.0.10,9,3,574,331,905,27,FALSE
fpx,0.0.8,0.0.9,8,1,11,3,14,3,FALSE
fpx,0.0.20,0.1.0,20,1,18,7,25,3,FALSE
fpx,0.0.14,0.0.15,14,1,92,79,171,5,FALSE
fpx,0.0.17,0.0.18,17,1,3,0,3,1,FALSE
fpx,0.0.16,0.0.17,16,1,34,4,38,7,FALSE
fpx,0.0.11,0.0.12,11,1,751,183,934,20,FALSE
fpx,0.0.10,0.0.11,10,5,282,284,566,16,FALSE
fpx,0.0.13,0.0.14,13,3,259,169,428,17,FALSE
fpx,0.1.0,0.2.0,21,1,58,43,101,8,FALSE
fpx,0.0.19,0.0.20,19,1,2,2,4,2,FALSE
fpx,0.0.18,0.0.19,18,2,148,34,182,15,FALSE
fpx,0.0.15,0.0.16,15,1,128,35,163,16,FALSE
fpx,0.0.1,0.0.2,1,4,574,151,725,35,FALSE
fpx,0.0.2,0.0.3,2,3,477,338,815,23,TRUE
fpx,0.0.4,0.0.5,4,1,230,117,347,5,TRUE
simple-sqlite-promise,0.0.5,0.0.6,4,1,18,13,31,6,FALSE
simple-sqlite-promise,0.0.7,0.1.0,6,1,3,5,8,4,FALSE
simple-sqlite-promise,0.0.6,0.0.7,5,1,2,2,4,1,FALSE
simple-sqlite-promise,0.0.1,0.0.2,1,1,20,20,40,5,FALSE
simple-sqlite-promise,0.0.3,0.0.5,3,1,37,31,68,6,FALSE
simple-sqlite-promise,0.0.2,0.0.3,2,2,15,5,20,7,FALSE
simple-sqlite-promise,0.1.0,0.1.1,7,1,10,13,23,4,FALSE
simple-sqlite-promise,0.1.1,0.1.2,8,1,47,18,65,4,FALSE
simple-sqlite-promise,0.1.0,0.1.1,7,1,10,13,23,4,TRUE
file-matcher,1.0.0,1.1.0,8,3,87,55,142,5,FALSE
file-matcher,1.0.0-rc.7,1.0.0,7,1,7,1,8,2,FALSE
file-matcher,1.0.0-rc.6,1.0.0-rc.7,6,4,42,32,74,5,FALSE
file-matcher,1.0.0-rc.5,1.0.0-rc.6,5,2,11,12,23,3,FALSE
file-matcher,1.0.0-rc.4,1.0.0-rc.5,4,5,31,20,51,10,FALSE
file-matcher,1.0.0-rc.3,1.0.0-rc.4,3,1,41,11,52,3,FALSE
file-matcher,1.0.0-rc.2,1.0.0-rc.3,2,1,4,3,7,2,FALSE
file-matcher,1.0.0-rc.1,1.0.0-rc.2,1,1,16,0,16,1,FALSE
file-matcher,1.0.0,1.1.0,8,3,87,55,142,5,TRUE
file-matcher,1.0.0-rc.6,1.0.0-rc.7,6,4,42,32,74,5,TRUE
file-matcher,1.0.0-rc.4,1.0.0-rc.5,4,5,31,20,51,10,TRUE
file-matcher,1.0.0-rc.3,1.0.0-rc.4,3,1,41,11,52,3,TRUE
kinvey-javascript-sdk-core,3.1.2,3.2.0,24,11,50843,1146,51989,66,FALSE
kinvey-javascript-sdk-core,3.1.1,3.1.2,23,72,15701,13649,29350,220,FALSE
kinvey-javascript-sdk-core,3.1.0,3.1.1,22,18,595,106,701,46,FALSE
kinvey-javascript-sdk-core,3.0.2,3.0.3,20,18,42818,113,42931,150,FALSE
kinvey-javascript-sdk-core,3.0.3,3.1.0,21,33,32630,31958,64588,595,FALSE
kinvey-javascript-sdk-core,3.0.1,3.0.2,19,22,1953,1010,2963,58,FALSE
kinvey-javascript-sdk-core,3.0.0-beta.29,3.0.0-beta.30,17,35,3236,2060,5296,192,FALSE
kinvey-javascript-sdk-core,3.0.0-beta.28,3.0.0-beta.29,16,32,6468,6833,13301,173,FALSE
kinvey-javascript-sdk-core,3.0.0-beta.23,3.0.0-beta.24,11,86,1899191,1897966,3797157,35572,FALSE
kinvey-javascript-sdk-core,3.0.0-beta.30,3.0.1,18,31,3140,2101,5241,130,FALSE
kinvey-javascript-sdk-core,3.0.0-beta.21,3.0.0-beta.22,9,3,3,55,58,3,FALSE
kinvey-javascript-sdk-core,3.0.0-beta.20,3.0.0-beta.21,8,2,6,3,9,4,FALSE
kinvey-javascript-sdk-core,3.0.0-beta.27,3.0.0-beta.28,15,6,13,17,30,6,FALSE
kinvey-javascript-sdk-core,3.0.0-beta.26,3.0.0-beta.27,14,5,27,18,45,5,FALSE
kinvey-javascript-sdk-core,3.0.0-beta.25,3.0.0-beta.26,13,39,412,170,582,51,FALSE
kinvey-javascript-sdk-core,3.0.0-beta.24,3.0.0-beta.25,12,31,1450,26972,28422,134,FALSE
kinvey-javascript-sdk-core,3.0.0-beta.22,3.0.0-beta.23,10,2,13,2,15,3,FALSE
kinvey-javascript-sdk-core,3.0.0-beta.18,3.0.0-beta.20,7,38,31257,30098,61355,488,FALSE
kinvey-javascript-sdk-core,3.0.0-beta.16,3.0.0-beta.17,5,18,428,289,717,48,FALSE
kinvey-javascript-sdk-core,3.0.0-beta.17,3.0.0-beta.18,6,15,5179,2915,8094,133,FALSE
kinvey-javascript-sdk-core,3.0.0-beta.14,3.0.0-beta.15,3,34,3858,3764,7622,321,FALSE
kinvey-javascript-sdk-core,3.0.0-beta.15,3.0.0-beta.16,4,6,22,13,35,11,FALSE
kinvey-javascript-sdk-core,3.0.0-beta.12,3.0.0-beta.13,1,19,2274,1915,4189,133,FALSE
kinvey-javascript-sdk-core,3.0.0-beta.13,3.0.0-beta.14,2,8,10153,402,10555,131,FALSE
kinvey-javascript-sdk-core,3.1.0,3.1.1,22,18,595,106,701,46,TRUE
kinvey-javascript-sdk-core,3.0.3,3.1.0,21,33,32630,31958,64588,595,TRUE
kinvey-javascript-sdk-core,3.0.0-beta.29,3.0.0-beta.30,17,35,3236,2060,5296,192,TRUE
kinvey-javascript-sdk-core,3.1.1,3.1.2,23,72,15701,13649,29350,220,TRUE
kinvey-javascript-sdk-core,3.0.0-beta.30,3.0.1,18,31,3140,2101,5241,130,TRUE
kinvey-javascript-sdk-core,3.0.0-beta.12,3.0.0-beta.13,1,19,2274,1915,4189,133,TRUE
kinvey-javascript-sdk-core,3.0.0-beta.13,3.0.0-beta.14,2,8,10153,402,10555,131,TRUE
kinvey-javascript-sdk-core,3.1.2,3.2.0,24,11,50843,1146,51989,66,TRUE
kinvey-javascript-sdk-core,3.0.0-beta.28,3.0.0-beta.29,16,32,6468,6833,13301,173,TRUE
kinvey-javascript-sdk-core,3.0.0-beta.16,3.0.0-beta.17,5,18,428,289,717,48,TRUE
kinvey-javascript-sdk-core,3.0.0-beta.18,3.0.0-beta.20,7,38,31257,30098,61355,488,TRUE
kinvey-javascript-sdk-core,3.0.0-beta.17,3.0.0-beta.18,6,15,5179,2915,8094,133,TRUE
kinvey-javascript-sdk-core,3.0.2,3.0.3,20,18,42818,113,42931,150,TRUE
kinvey-javascript-sdk-core,3.0.0-beta.23,3.0.0-beta.24,11,86,1899191,1897966,3797157,35572,TRUE
react-scrollspy,0.0.4,0.1.0,4,4,39,13,52,7,FALSE
react-scrollspy,0.0.1,0.0.2,1,5,5,5,10,5,FALSE
react-scrollspy,0.0.3,0.0.4,3,3,7,1,8,4,FALSE
react-scrollspy,0.0.2,0.0.3,2,5,59,11,70,7,FALSE
react-scrollspy,0.1.0,0.1.1,5,2,2,1,3,2,FALSE
react-scrollspy,0.1.1,0.1.2,6,2,4,5,9,3,FALSE
react-scrollspy,0.1.2,0.1.3,7,2,3,1,4,2,FALSE
react-scrollspy,0.1.3,0.1.4,8,3,33,5,38,3,FALSE
react-scrollspy,0.1.4,0.1.5,9,2,8,8,16,2,FALSE
react-scrollspy,0.1.5,0.1.6,10,3,3,3,6,3,FALSE
react-scrollspy,0.1.6,0.1.7,11,3,13,4,17,3,FALSE
react-scrollspy,3.1.0,3.1.1,39,5,87,84,171,13,FALSE
react-scrollspy,3.0.2,3.1.0,38,3,100,31,131,6,FALSE
react-scrollspy,3.0.0,3.0.1,36,4,33,19,52,10,FALSE
react-scrollspy,3.0.1,3.0.2,37,1,3,3,6,1,FALSE
react-scrollspy,2.6.1,2.6.2,30,3,4,4,8,3,FALSE
react-scrollspy,2.6.0,2.6.1,29,5,5,5,10,5,FALSE
react-scrollspy,2.6.3,2.6.4,32,7,42,16,58,7,FALSE
react-scrollspy,2.6.2,2.6.3,31,4,21,3,24,5,FALSE
react-scrollspy,2.6.5,2.7.0,34,10,18160,5484,23644,46,FALSE
react-scrollspy,2.6.4,2.6.5,33,3,21,17,38,5,FALSE
react-scrollspy,2.7.0,3.0.0,35,6,34,186,220,17,FALSE
react-scrollspy,2.3.0,2.3.1,24,4,11,9,20,5,FALSE
react-scrollspy,2.3.1,2.4.0,25,11,209,68,277,21,TRUE
react-scrollspy,2.4.1,2.5.0,27,8,92,17,109,16,FALSE
react-scrollspy,2.4.0,2.4.1,26,3,7,1,8,3,FALSE
react-scrollspy,2.5.0,2.6.0,28,5,137,19,156,15,FALSE
react-scrollspy,1.1.0,1.1.2,15,8,30,22,52,8,FALSE
react-scrollspy,1.0.0,1.1.0,14,4,19,5,24,5,FALSE
react-scrollspy,2.0.0,2.1.0,17,3,39,35,74,5,FALSE
react-scrollspy,2.6.5,2.7.0,34,10,18160,5484,23644,46,TRUE
react-scrollspy,1.1.2,2.0.0,16,6,20,22,42,7,FALSE
react-scrollspy,2.2.1,2.2.2,22,3,9,2,11,4,FALSE
react-scrollspy,2.2.0,2.2.1,21,3,4,3,7,4,FALSE
react-scrollspy,2.2.2,2.3.0,23,9,125,38,163,15,FALSE
react-scrollspy,2.1.2,2.2.0,20,9,123,23,146,14,FALSE
react-scrollspy,2.1.0,2.1.1,18,3,11,5,16,3,FALSE
react-scrollspy,2.1.1,2.1.2,19,3,5,3,8,3,FALSE
react-scrollspy,2.3.1,2.4.0,25,11,209,68,277,21,FALSE
react-scrollspy,0.2.0,1.0.0,13,8,234,206,440,17,FALSE
react-scrollspy,0.1.7,0.2.0,12,4,21,19,40,4,FALSE
react-scrollspy,3.0.0,3.0.1,36,4,33,19,52,10,TRUE
react-scrollspy,0.1.6,0.1.7,11,3,13,4,17,3,TRUE
react-scrollspy,2.6.4,2.6.5,33,3,21,17,38,5,TRUE
react-scrollspy,2.6.3,2.6.4,32,7,42,16,58,7,TRUE
react-scrollspy,2.2.2,2.3.0,23,9,125,38,163,15,TRUE
react-scrollspy,0.0.2,0.0.3,2,5,59,11,70,7,TRUE
react-scrollspy,2.1.0,2.1.1,18,3,11,5,16,3,TRUE
blib,1.8.0,1.9.0,9,8,4879,2259,7138,69,FALSE
blib,1.4.0,1.5.0,5,3,38,43,81,9,FALSE
blib,1.1.0,1.2.0,2,2,297,38,335,7,FALSE
blib,1.5.0,1.6.0,6,2,640,402,1042,19,FALSE
blib,1.6.0,1.7.0,7,1,1,1,2,1,FALSE
blib,1.3.0,1.4.0,4,3,1005,539,1544,16,FALSE
blib,1.2.0,1.3.0,3,2,988,7,995,13,FALSE
blib,1.9.0,1.9.1,10,3,203,84,287,22,TRUE
blib,1.7.0,1.8.0,8,12,3587,757,4344,74,FALSE
blib,1.5.0,1.6.0,6,2,640,402,1042,19,TRUE
blib,1.9.0,1.9.1,10,3,203,84,287,22,FALSE
ribosome,0.9.0,0.10.0,11,3,484,374,858,6,FALSE
ribosome,0.10.0,0.11.0,12,3,435,123,558,6,FALSE
ribosome,0.3.0,0.4.0,5,1,910,274,1184,8,FALSE
ribosome,0.6.0,0.7.0,8,2,462,430,892,5,FALSE
ribosome,0.8.0,0.9.0,10,2,254,198,452,5,FALSE
ribosome,0.7.0,0.8.0,9,2,400,410,810,5,FALSE
ribosome,0.2.0,0.3.0,4,1,29,13,42,9,FALSE
ribosome,0.1.0,0.2.0,3,1,2499,693,3192,12,FALSE
ribosome,0.4.0,0.5.0,6,1,118,43,161,8,FALSE
ribosome,0.5.0,0.6.0,7,2,649,1110,1759,5,FALSE
ribosome,0.3.0,0.4.0,5,1,910,274,1184,8,TRUE
ribosome,0.9.0,0.10.0,11,3,484,374,858,6,TRUE
idsp-web-seed2-uploader,1.0.4,1.0.5,4,1,2,1,3,2,FALSE
idsp-web-seed2-uploader,1.0.5,1.0.6,5,1,2,2,4,2,FALSE
idsp-web-seed2-uploader,1.0.6,1.0.7,6,2,12,2,14,4,FALSE
idsp-web-seed2-uploader,1.0.7,1.0.8,7,1,6,3,9,3,FALSE
idsp-web-seed2-uploader,1.0.1,1.0.2,1,1,33771,3,33774,20,FALSE
idsp-web-seed2-uploader,1.0.2,1.0.3,2,2,8,6,14,5,FALSE
idsp-web-seed2-uploader,1.0.3,1.0.4,3,1,6,3,9,3,FALSE
idsp-web-seed2-uploader,1.0.8,1.0.9,8,1,5,3,8,4,FALSE
idsp-web-seed2-uploader,1.0.9,1.0.10,9,1,234,1,235,2,FALSE
idsp-web-seed2-uploader,1.0.16,1.0.17,16,1,6,3,9,3,FALSE
idsp-web-seed2-uploader,1.0.17,1.0.18,17,1,8475,19,8494,8,FALSE
idsp-web-seed2-uploader,1.0.14,1.0.15,14,1,163,6775,6938,12,FALSE
idsp-web-seed2-uploader,1.0.15,1.0.16,15,1,6,3,9,3,FALSE
idsp-web-seed2-uploader,1.0.12,1.0.13,12,2,14,5,19,4,FALSE
idsp-web-seed2-uploader,1.0.13,1.0.14,13,1,6,3,9,3,FALSE
idsp-web-seed2-uploader,1.0.10,1.0.11,10,2,26,11,37,7,FALSE
idsp-web-seed2-uploader,1.0.11,1.0.12,11,1,6,3,9,3,FALSE
idsp-web-seed2-uploader,1.0.18,1.0.19,18,1,3,3,6,3,FALSE
idsp-web-seed2-uploader,1.0.8,1.0.9,8,1,5,3,8,4,TRUE
idsp-web-seed2-uploader,1.0.9,1.0.10,9,1,234,1,235,2,TRUE
idsp-web-seed2-uploader,1.0.12,1.0.13,12,2,14,5,19,4,TRUE
videojs-vast-vpaid,3.0.0-beta.8,3.0.0-beta.9,37,1,1,1,2,1,FALSE
videojs-vast-vpaid,3.0.0-beta.9,3.0.0-beta.10,38,1,1,1,2,1,FALSE
videojs-vast-vpaid,2.0.0-beta.2,2.0.0-beta.3,28,1,1,1,2,1,FALSE
videojs-vast-vpaid,3.0.0-beta.6,3.0.0-beta.7,35,1,1,1,2,1,FALSE
videojs-vast-vpaid,3.0.0-beta.7,3.0.0-beta.8,36,1,1,1,2,1,FALSE
videojs-vast-vpaid,3.0.0-beta.4,3.0.0-beta.5,33,1,1,1,2,1,FALSE
videojs-vast-vpaid,3.0.0-beta.5,3.0.0-beta.6,34,1,1,1,2,1,FALSE
videojs-vast-vpaid,2.0.0-beta.1,2.0.0-beta.2,27,1,1,1,2,1,FALSE
videojs-vast-vpaid,3.0.0-beta.10,3.0.0-beta.11,39,1,1,1,2,1,FALSE
videojs-vast-vpaid,0.0.60,0.1.4,6,69,11002,10667,21669,185,FALSE
videojs-vast-vpaid,0.1.23,0.1.24,13,2,21,22,43,5,FALSE
videojs-vast-vpaid,0.1.22,0.1.23,12,1,1,1,2,1,FALSE
videojs-vast-vpaid,0.0.2,0.0.30,1,134,11136,4534,15670,399,FALSE
videojs-vast-vpaid,0.1.9,0.1.22,11,51,3338,2879,6217,204,FALSE
videojs-vast-vpaid,0.1.7,0.1.9,10,14,643,340,983,48,FALSE
videojs-vast-vpaid,0.1.6,0.1.7,9,4,60,33,93,9,FALSE
videojs-vast-vpaid,0.0.40,0.0.41,4,2,256,251,507,6,FALSE
videojs-vast-vpaid,0.0.41,0.0.60,5,76,11615,9671,21286,257,FALSE
videojs-vast-vpaid,0.1.4,0.1.5,7,1,1,1,2,1,FALSE
videojs-vast-vpaid,0.1.5,0.1.6,8,1,42,9,51,6,FALSE
videojs-vast-vpaid,0.0.31,0.0.40,3,24,3742,6523,10265,102,FALSE
videojs-vast-vpaid,0.0.30,0.0.31,2,8,409,283,692,21,FALSE
videojs-vast-vpaid,1.0.4,1.0.5,19,14,1193,552,1745,70,FALSE
videojs-vast-vpaid,1.0.5,1.1.0,20,6,17509,9216,26725,141,FALSE
videojs-vast-vpaid,1.0.0,1.0.1,15,2,198,18,216,8,FALSE
videojs-vast-vpaid,1.0.1,1.0.2,16,2,100,10,110,5,FALSE
videojs-vast-vpaid,2.0.1,2.0.2,31,3,23,6,29,5,FALSE
videojs-vast-vpaid,1.1.0,1.2.0,21,3,52,20,72,8,FALSE
videojs-vast-vpaid,1.0.2,1.0.3,17,2,80,34,114,4,FALSE
videojs-vast-vpaid,2.0.0,2.0.1,30,55,28717,15258,43975,401,FALSE
videojs-vast-vpaid,0.1.24,1.0.0,14,24,33072,17917,50989,304,FALSE
videojs-vast-vpaid,1.0.3,1.0.4,18,1,5,0,5,1,FALSE
videojs-vast-vpaid,1.2.2,1.2.3,24,1,1,1,2,1,FALSE
videojs-vast-vpaid,1.2.3,1.3.0,25,18,5122,3807,8929,95,FALSE
videojs-vast-vpaid,1.2.0,1.2.1,22,1,1,1,2,1,FALSE
videojs-vast-vpaid,1.2.1,1.2.2,23,1,3125,1205,4330,18,FALSE
videojs-vast-vpaid,2.0.2,3.0.0-beta.4,32,1,1,1,2,1,FALSE
videojs-vast-vpaid,1.3.0,2.0.0-beta.1,26,8,1355,401,1756,55,FALSE
videojs-vast-vpaid,1.0.2,1.0.3,17,2,80,34,114,4,TRUE
videojs-vast-vpaid,0.1.7,0.1.9,10,14,643,340,983,48,TRUE
videojs-vast-vpaid,2.0.1,2.0.2,31,3,23,6,29,5,TRUE
videojs-vast-vpaid,1.1.0,1.2.0,21,3,52,20,72,8,TRUE
videojs-vast-vpaid,1.0.3,1.0.4,18,1,5,0,5,1,TRUE
videojs-vast-vpaid,1.0.0,1.0.1,15,2,198,18,216,8,TRUE
videojs-vast-vpaid,0.1.5,0.1.6,8,1,42,9,51,6,TRUE
videojs-vast-vpaid,0.1.24,1.0.0,14,24,33072,17917,50989,304,TRUE
videojs-vast-vpaid,1.0.4,1.0.5,19,14,1193,552,1745,70,TRUE
videojs-vast-vpaid,0.1.23,0.1.24,13,2,21,22,43,5,TRUE
ecb-exchange-rates,0.0.5,0.0.6,5,7,413,12,425,16,FALSE
ecb-exchange-rates,0.0.4,0.0.5,4,1,1,1,2,1,FALSE
ecb-exchange-rates,0.0.6,0.0.7,6,1,1,1,2,1,FALSE
ecb-exchange-rates,0.0.1,0.0.2,1,1,33,19,52,3,FALSE
ecb-exchange-rates,0.0.3,0.0.4,3,3,88,29,117,5,FALSE
ecb-exchange-rates,0.0.2,0.0.3,2,2,95,8,103,5,FALSE
ecb-exchange-rates,0.0.5,0.0.6,5,7,413,12,425,16,TRUE
redux-form-material-ui,4.0.1,4.1.0,9,8,334,48,382,26,FALSE
redux-form-material-ui,1.1.0,2.0.0,2,2,368,283,651,24,FALSE
redux-form-material-ui,4.1.0,4.1.1,10,6,226,98,324,20,FALSE
redux-form-material-ui,4.1.2,4.1.3,12,7,109,30,139,14,FALSE
redux-form-material-ui,3.0.0,4.0.0,7,5,486,42,528,32,FALSE
redux-form-material-ui,4.0.0,4.0.1,8,1,5,8,13,3,FALSE
redux-form-material-ui,4.1.4,4.2.0,14,6,832,714,1546,45,FALSE
redux-form-material-ui,2.0.0,2.1.0,3,2,69,6,75,9,TRUE
redux-form-material-ui,2.2.0,3.0.0,6,1,113,69,182,15,FALSE
redux-form-material-ui,1.0.0,1.1.0,1,5,569,14,583,17,FALSE
redux-form-material-ui,2.1.0,2.1.1,4,1,1,1,2,1,FALSE
redux-form-material-ui,2.1.1,2.2.0,5,3,429,219,648,21,FALSE
redux-form-material-ui,4.1.3,4.1.4,13,7,1476,1195,2671,50,FALSE
redux-form-material-ui,4.1.1,4.1.2,11,2,205,29,234,11,FALSE
redux-form-material-ui,2.0.0,2.1.0,3,2,69,6,75,9,FALSE
redux-form-material-ui,1.0.0,1.1.0,1,5,569,14,583,17,TRUE
redux-form-material-ui,4.1.4,4.2.0,14,6,832,714,1546,45,TRUE
redux-form-material-ui,1.1.0,2.0.0,2,2,368,283,651,24,TRUE
redux-form-material-ui,4.1.1,4.1.2,11,2,205,29,234,11,TRUE
redux-form-material-ui,4.0.1,4.1.0,9,8,334,48,382,26,TRUE
redux-form-material-ui,2.2.0,3.0.0,6,1,113,69,182,15,TRUE
clappr-videocontext-playback,0.1.0-0,0.1.0,2,2,21,4,25,3,FALSE
clappr-videocontext-playback,0.0.1-0,0.1.0-0,1,3,81,43,124,6,FALSE
clappr-videocontext-playback,0.0.1-0,0.1.0-0,1,3,81,43,124,6,TRUE
cerebral-react-immutable-store,0.4.0,0.4.1,11,1,45,25,70,2,FALSE
cerebral-react-immutable-store,0.3.0,0.4.0,10,5,33,8,41,7,FALSE
cerebral-react-immutable-store,0.5.1,0.5.3,14,4,5,3,8,4,FALSE
cerebral-react-immutable-store,0.1.0,0.1.1,1,1,2,2,4,2,FALSE
cerebral-react-immutable-store,0.2.2,0.3.0,9,2,157,66,223,4,FALSE
cerebral-react-immutable-store,0.2.1,0.2.2,8,3,22,17,39,3,FALSE
cerebral-react-immutable-store,0.2.0,0.2.1,7,1,7,2,9,2,FALSE
cerebral-react-immutable-store,0.4.1,0.5.0,12,3,37,97,134,6,FALSE
cerebral-react-immutable-store,0.1.1,0.1.2,2,2,2,2,4,2,TRUE
cerebral-react-immutable-store,0.1.2,0.1.3,3,1,2,2,4,2,FALSE
cerebral-react-immutable-store,0.1.3,0.1.5,4,2,6,4,10,3,FALSE
cerebral-react-immutable-store,0.5.0,0.5.1,13,4,15,15,30,5,FALSE
cerebral-react-immutable-store,0.1.5,0.1.6,5,1,2,2,4,1,FALSE
cerebral-react-immutable-store,0.1.6,0.2.0,6,2,19,8,27,4,TRUE
cerebral-react-immutable-store,0.5.3,0.6.0,15,1,5,3,8,2,FALSE
cerebral-react-immutable-store,0.1.1,0.1.2,2,2,2,2,4,2,FALSE
cerebral-react-immutable-store,0.1.6,0.2.0,6,2,19,8,27,4,FALSE
typescript-logger,1.0.4,1.1.0,5,7,170,101,271,31,FALSE
typescript-logger,1.0.2-beta,1.0.3-beta,3,4,31,12,43,5,FALSE
typescript-logger,1.0.0-beta,1.0.1-beta,1,3,30,29,59,5,FALSE
typescript-logger,1.0.1-beta,1.0.2-beta,2,2,62,6,68,10,FALSE
typescript-logger,1.0.3-beta,1.0.4,4,3,344,9,353,9,FALSE
typescript-logger,1.0.0-beta,1.0.1-beta,1,3,30,29,59,5,TRUE
composer-runtime-hlf,0.7.4-20170531224226,0.7.4-20170601142718,642,1,35,37,72,3,FALSE
composer-runtime-hlf,0.7.4-20170531212938,0.7.4-20170531221058,640,1,232,122,354,31,FALSE
composer-runtime-hlf,0.7.4-20170531145655,0.7.4-20170531175620,635,1,846,733,1579,11,FALSE
composer-runtime-hlf,0.7.4-20170531183904,0.7.4-20170531193135,637,1,35,37,72,3,FALSE
composer-runtime-hlf,0.7.4-20170531193135,0.7.4-20170531202043,638,1,1670,1590,3260,86,FALSE
composer-runtime-hlf,0.7.4-20170531140019,0.7.4-20170531145655,634,1,35,37,72,3,FALSE
composer-runtime-hlf,0.7.4-20170601145149,0.7.4-20170601151520,644,1,12,18,30,5,FALSE
composer-runtime-hlf,0.7.4-20170531103935,0.7.4-20170531112809,632,1,4,4,8,3,FALSE
composer-runtime-hlf,0.7.4-20170531092210,0.7.4-20170531103935,631,1,1,0,1,1,FALSE
composer-runtime-hlf,0.7.4-20170531082238,0.7.4-20170531092210,630,1,0,1,1,1,FALSE
composer-runtime-hlf,0.7.4-20170531221058,0.7.4-20170531224226,641,1,35,37,72,3,FALSE
composer-runtime-hlf,0.7.4-20170531175620,0.7.4-20170531183904,636,1,20,16,36,2,FALSE
composer-runtime-hlf,0.7.4-20170531112809,0.7.4-20170531140019,633,1,42,49,91,3,FALSE
composer-runtime-hlf,0.7.4-20170601151520,0.7.4-20170601161655,645,1,348,276,624,10,FALSE
composer-runtime-hlf,0.7.4-20170601142718,0.7.4-20170601145149,643,1,35,37,72,3,FALSE
composer-runtime-hlf,0.7.4-20170531202043,0.7.4-20170531212938,639,1,1,1,2,1,FALSE
composer-runtime-hlf,0.7.4-20170530142459,0.7.4-20170530143521,628,1,35,37,72,3,FALSE
composer-runtime-hlf,0.4.2-20170210154528,0.4.2-20170210165116,84,11,1294,176070,177364,512,FALSE
composer-runtime-hlf,0.4.4-20170222181333,0.4.4-20170222230901,145,4,88339,119,88458,394,FALSE
composer-runtime-hlf,0.5.7-20170403153420,0.5.7-20170403223455,411,1,3,0,3,3,FALSE
composer-runtime-hlf,0.5.13-20170421141512,0.5.13-20170421192031,473,1,97,99,196,9,FALSE
composer-runtime-hlf,0.7.1-20170502142052,0.7.1-20170502151544,510,1,34,34,68,20,FALSE
composer-runtime-hlf,0.4.4-20170214110241,0.4.4-20170214121537,101,10,471,229,700,56,FALSE
composer-runtime-hlf,0.5.2-20170313115127,0.5.2-20170313120948,284,1,20,17,37,3,FALSE
composer-runtime-hlf,0.4.5-20170309172415,0.4.5-20170309201406,264,4,279,35,314,20,FALSE
composer-runtime-hlf,0.4.5-20170226224342,0.4.5-20170226235234,158,7,1588,1022,2610,67,FALSE
composer-runtime-hlf,0.4.1-20170204131504,0.4.1-20170204143115,56,2,46,33,79,6,FALSE
composer-runtime-hlf,0.5.8-20170407092318,0.5.8-20170407140006,430,1,144,21,165,4,FALSE
composer-runtime-hlf,0.4.1-20170202162756,0.4.1-20170202183923,39,6,132,78,210,18,FALSE
composer-runtime-hlf,0.5.2-20170314152048,0.5.2-20170314164109,302,13,1017,531,1548,59,FALSE
composer-runtime-hlf,0.5.6-20170328172301,0.5.6-20170329065851,393,1,293,1,294,7,FALSE
composer-runtime-hlf,0.5.6-20170330083135,0.5.6-20170330093909,398,1,114,5,119,2,FALSE
composer-runtime-hlf,0.4.5-20170227095701,0.4.5-20170227130557,161,8,6584,1315,7899,1419,FALSE
composer-runtime-hlf,0.5.2-20170314142206,0.5.2-20170314152048,301,6,668,280,948,49,FALSE
composer-runtime-hlf,0.7.4-20170525234800,0.7.4-20170526042055,612,1,26,1,27,2,FALSE
composer-runtime-hlf,0.4.4-20170213164028,0.4.4-20170213183233,97,9,21,12,33,9,FALSE
composer-runtime-hlf,0.4.5-20170307114907,0.4.5-20170307131531,217,6,1903,504,2407,75,FALSE
composer-runtime-hlf,0.7.3-20170525082746,0.7.3-20170525092654,608,1,2,8,10,1,FALSE
composer-runtime-hlf,0.4.4-20170214073109,0.4.4-20170214110241,100,14,18362,28587,46949,408,FALSE
composer-runtime-hlf,0.5.11-20170417112232,0.5.11-20170417175551,457,1,23,14,37,3,FALSE
composer-runtime-hlf,0.5.11-20170414140455,0.5.11-20170414172920,455,1,63,137,200,5,FALSE
composer-runtime-hlf,0.4.1-20170202095650,0.4.1-20170202123714,33,7,2029,742,2771,42,FALSE
composer-runtime-hlf,0.4.2-20170210130108,0.4.2-20170210154528,83,12,1092,175673,176765,636,FALSE
composer-runtime-hlf,0.4.1-20170202123714,0.4.1-20170202124113,34,1,35,37,72,3,FALSE
composer-runtime-hlf,0.7.1-20170505151238,0.7.1,531,1,35,37,72,3,FALSE
composer-runtime-hlf,0.4.5-20170303110503,0.4.5-20170303130657,197,2,420,176,596,12,FALSE
composer-runtime-hlf,0.5.11-20170418064625,0.5.11-20170418105809,459,1,4,7,11,3,FALSE
composer-runtime-hlf,0.7.4-20170530092927,0.7.4-20170530105630,625,1,0,75,75,1,FALSE
composer-runtime-hlf,0.5.6-20170327224800,0.5.6-20170328000248,388,1,164,14,178,10,FALSE
composer-runtime-hlf,0.4.4-20170222170514,0.4.4-20170222181333,144,4,207,27,234,8,FALSE
composer-runtime-hlf,0.5.6-20170403092355,0.5.6-20170403140747,408,1,15,3,18,2,FALSE
composer-runtime-hlf,0.4.1-20170203133343,0.4.1-20170203144824,48,4,7,4,11,7,FALSE
composer-runtime-hlf,0.4.5-20170308143124,0.4.5-20170308143910,234,1,35,37,72,3,FALSE
composer-runtime-hlf,0.5.6-20170321114011,0.5.6-20170321132516,362,1,0,2,2,1,FALSE
composer-runtime-hlf,0.4.1-20170203133121,0.4.1-20170203133343,47,1,758,909,1667,92,FALSE
composer-runtime-hlf,0.7.3-20170517115303,0.7.3-20170517125550,581,1,33,29,62,2,FALSE
composer-runtime-hlf,0.4.5-20170304165445,0.4.5-20170304194231,204,2,70,14,84,10,FALSE
composer-runtime-hlf,0.7.3-20170517144754,0.7.3-20170517163408,583,1,822,48,870,16,FALSE
composer-runtime-hlf,0.7.3-20170512193834,0.7.3-20170513063455,571,2,30,4,34,5,FALSE
composer-runtime-hlf,0.5.2-20170314100110,0.5.2-20170314104849,297,5,519,300,819,32,FALSE
composer-runtime-hlf,0.7.3-20170517094659,0.7.3-20170517105923,579,1,14,2,16,2,FALSE
composer-runtime-hlf,0.7.2-20170508113734,0.7.2-20170508135105,540,1,54,54,108,29,FALSE
composer-runtime-hlf,0.5.6-20170322133654,0.5.6-20170322144011,368,1,268,21,289,9,FALSE
composer-runtime-hlf,0.4.1-20170131192515,0.4.1-20170131222734,21,4,889,1068,1957,86,FALSE
composer-runtime-hlf,0.4.5-20170228171523,0.4.5-20170301073428,183,6,8903,2710,11613,703,FALSE
composer-runtime-hlf,0.7.1-20170503192825,0.7.1-20170503210021,516,1,14,14,28,3,FALSE
composer-runtime-hlf,0.7.4-20170528142626,0.7.4-20170529161140,620,1,35,37,72,3,FALSE
composer-runtime-hlf,0.5.6-20170320091921,0.5.6-20170320102223,354,1,15,4,19,4,FALSE
composer-runtime-hlf,0.4.4-20170213155418,0.4.4-20170213164028,96,4,30,44,74,11,FALSE
composer-runtime-hlf,0.7.2-20170511073210,0.7.2-20170511081458,559,1,1,2,3,3,FALSE
composer-runtime-hlf,0.4.1-20170202141422,0.4.1-20170202162523,37,6,196,155,351,27,FALSE
composer-runtime-hlf,0.5.2-20170315145417,0.5.2-20170315155558,318,10,1028,421,1449,77,FALSE
composer-runtime-hlf,0.7.3-20170524145629,0.7.3-20170524154239,603,1,46,578,624,19,FALSE
composer-runtime-hlf,0.4.5-20170228164847,0.4.5-20170228171523,182,1,107,21,128,6,FALSE
composer-runtime-hlf,0.4.5-20170305165559,0.4.5-20170306081940,207,4,8,8,16,2,FALSE
composer-runtime-hlf,0.4.5-20170228095129,0.4.5-20170228123838,177,3,22,28,50,2,FALSE
composer-runtime-hlf,0.5.2-20170315095743,0.5.2-20170315102717,312,5,2017,667,2684,120,FALSE
composer-runtime-hlf,0.4.5-20170308223548,0.4.5-20170308224616,249,1,35,37,72,3,FALSE
composer-runtime-hlf,0.4.5-20170308134235,0.4.5-20170308140018,232,3,189,122,311,19,FALSE
composer-runtime-hlf,0.5.2-20170316191301,0.5.2-20170316201319,336,2,2,2,4,2,FALSE
composer-runtime-hlf,0.4.2-20170209082751,0.4.2-20170209100742,73,6,417280,1137,418417,1195,FALSE
composer-runtime-hlf,0.5.2-20170312203244,0.5.2-20170312210923,279,3,1653,1512,3165,21,FALSE
composer-runtime-hlf,0.4.5-20170308162902,0.4.5-20170308163844,241,1,35,37,72,3,FALSE
composer-runtime-hlf,0.4.4-20170219163718,0.4.4-20170219230928,129,1,10175,0,10175,244,FALSE
composer-runtime-hlf,0.5.2-20170316144946,0.5.2-20170316152340,330,6,825,649,1474,40,FALSE
composer-runtime-hlf,0.5.11-20170412161822,0.5.11-20170413081721,452,1,11,10,21,3,FALSE
composer-runtime-hlf,0.5.2-20170313142435,0.5.2-20170313154525,288,9,6484,5053,11537,368,FALSE
composer-runtime-hlf,0.4.5-20170308182803,0.4.5-20170308194911,245,1,500,13,513,15,FALSE
composer-runtime-hlf,0.5.2-20170314211349,0.5.2-20170314220420,308,2,456,122,578,18,FALSE
composer-runtime-hlf,0.7.3-20170517163408,0.7.3-20170517185539,584,1,95,52,147,9,FALSE
composer-runtime-hlf,0.5.13-20170422110932,0.5.13-20170424101321,476,1,41,24,65,3,FALSE
composer-runtime-hlf,0.5.7-20170405225116,0.5.7-20170406092009,420,1,6,9,15,4,FALSE
composer-runtime-hlf,0.5.10-20170410133745,0.5.10-20170410145627,440,1,53,2,55,2,FALSE
composer-runtime-hlf,0.5.7,0.5.8-20170406224000,427,1,96,97,193,25,FALSE
composer-runtime-hlf,0.7.1-20170504194131,0.7.1-20170504214639,525,1,81,42,123,3,FALSE
composer-runtime-hlf,0.5.11-20170420160816,0.5.11-20170420171417,466,1,32,75,107,1,FALSE
composer-runtime-hlf,0.5.6-20170327135819,0.5.6-20170327152530,385,1,20,4,24,3,FALSE
composer-runtime-hlf,0.5.8-20170406224000,0.5.8-20170406224305,428,1,35,37,72,3,FALSE
composer-runtime-hlf,0.5.6-20170322095319,0.5.6-20170322133654,367,1,44,26,70,3,FALSE
composer-runtime-hlf,0.5.9-20170409091911,0.5.9-20170409215918,435,1,0,0,0,0,FALSE
composer-runtime-hlf,0.5.2-20170314194114,0.5.2-20170314211349,307,3,314,55,369,12,FALSE
composer-runtime-hlf,0.5.6-20170402192220,0.5.6-20170403084448,406,1,6193,1611,7804,64,FALSE
composer-runtime-hlf,0.7.3-20170524104159,0.7.3-20170524104708,599,1,35,37,72,3,FALSE
composer-runtime-hlf,0.5.6-20170319165038,0.5.6-20170320091921,353,1,46,5,51,1,FALSE
composer-runtime-hlf,0.7.3-20170524225241,0.7.3-20170524235951,606,1,86,10,96,4,FALSE
composer-runtime-hlf,0.5.13-20170424145000,0.5.13-20170424155417,478,1,18,8,26,3,FALSE
composer-runtime-hlf,0.7.2-20170509150231,0.7.2-20170509215115,547,1,8,8,16,1,FALSE
composer-runtime-hlf,0.4.5-20170309155736,0.4.5-20170309165943,262,7,829,98,927,49,FALSE
composer-runtime-hlf,0.4.5-20170308131738,0.4.5-20170308133243,230,3,336,172,508,28,FALSE
composer-runtime-hlf,0.4.5-20170228133305,0.4.5-20170228151858,179,5,1970,1153,3123,78,FALSE
composer-runtime-hlf,0.4.3-20170211153544,0.4.3-20170211163711,90,2,189,6,195,2,FALSE
composer-runtime-hlf,0.7.2-20170508201056,0.7.2-20170509102910,544,1,11257,11252,22509,94,FALSE
composer-runtime-hlf,0.4.1-20170131222835,0.4.1-20170201120431,23,11,2032,1442,3474,128,FALSE
composer-runtime-hlf,0.4.5-20170309140844,0.4.5-20170309143407,259,1,35,37,72,3,FALSE
composer-runtime-hlf,0.5.13-20170426092503,0.5.13-20170426100536,484,1,497,280,777,79,FALSE
composer-runtime-hlf,0.7.2-20170509102910,0.7.2-20170509132635,545,1,147,15,162,2,FALSE
composer-runtime-hlf,0.4.5-20170228163435,0.4.5-20170228164847,181,1,35,37,72,3,FALSE
composer-runtime-hlf,0.4.5-20170228000104,0.4.5-20170228003553,172,1,12,5,17,4,FALSE
composer-runtime-hlf,0.4.1-20170201131837,0.4.1-20170201132059,26,1,35,37,72,3,FALSE
composer-runtime-hlf,0.4.2-20170208185715,0.4.2-20170209060232,71,14,806177,2139,808316,2224,FALSE
composer-runtime-hlf,0.5.6-20170331161339,0.5.6-20170401084624,403,1,1,1,2,1,FALSE
composer-runtime-hlf,0.4.5-20170307195014,0.4.5-20170307210010,224,3,580,324,904,40,FALSE
composer-runtime-hlf,0.5.0-20170311090653,0.5.0-20170311165758,272,2,158,127,285,33,FALSE
composer-runtime-hlf,0.5.6-20170327162514,0.5.6-20170327224800,387,1,1,1,2,1,FALSE
composer-runtime-hlf,0.5.5,0.5.6-20170317171321,350,1,86,86,172,25,FALSE
composer-runtime-hlf,0.4.4-20170212163424,0.4.4-20170213155418,95,7,2149,228314,230463,663,FALSE
composer-runtime-hlf,0.4.5-20170306190519,0.4.5-20170306204926,214,1,111,204734,204845,462,FALSE
composer-runtime-hlf,0.4.2-20170207233353,0.4.2-20170208121509,68,13,39208,1730,40938,253,FALSE
composer-runtime-hlf,0.5.6-20170321102551,0.5.6-20170321114011,361,1,2,1,3,1,FALSE
composer-runtime-hlf,0.5.11-20170414131345,0.5.11-20170414140455,454,1,1120,117,1237,11,FALSE
composer-runtime-hlf,0.7.2,0.7.3-20170512105624,568,3,125,99,224,26,FALSE
composer-runtime-hlf,0.7.3,0.7.4-20170525193844,610,1,92,92,184,24,FALSE
composer-runtime-hlf,0.7.0,0.7.1-20170501205612,504,3,5300,531,5831,82,FALSE
composer-runtime-hlf,0.7.1,0.7.2-20170505194144,532,1,88,88,176,24,FALSE
composer-runtime-hlf,0.7.2-20170510170851,0.7.2-20170510224135,556,1,104,75,179,2,FALSE
composer-runtime-hlf,0.7.3-20170513063455,0.7.3-20170513161412,572,1,15,18,33,3,FALSE
composer-runtime-hlf,0.5.8,0.5.9-20170409091911,434,1,95,95,190,25,FALSE
composer-runtime-hlf,0.5.9,0.5.10-20170409232614,437,1,95,95,190,25,FALSE
composer-runtime-hlf,0.5.4,0.5.5-20170317165420,348,2,117,360,477,35,FALSE
composer-runtime-hlf,0.5.2-20170313154525,0.5.2-20170313155056,289,1,35,37,72,3,FALSE
composer-runtime-hlf,0.5.6,0.5.7-20170403153420,410,1,93,93,186,25,FALSE
composer-runtime-hlf,0.4.5-20170309150353,0.4.5-20170309155736,261,10,984,189,1173,73,FALSE
composer-runtime-hlf,0.5.0,0.5.1,275,11,629,472,1101,130,FALSE
composer-runtime-hlf,0.5.1,0.5.2-20170312003519,276,1,86,86,172,25,FALSE
composer-runtime-hlf,0.7.3-20170518201536,0.7.3-20170519124107,591,1,5,1,6,1,FALSE
composer-runtime-hlf,0.5.3,0.5.4-20170317010639,341,1,86,86,172,25,FALSE
composer-runtime-hlf,0.7.3-20170515142750,0.7.3-20170516211022,577,1,488,40,528,11,FALSE
composer-runtime-hlf,0.4.5-20170304144245,0.4.5-20170304165445,203,1,35,37,72,3,FALSE
composer-runtime-hlf,0.7.1-20170503235534,0.7.1-20170504100253,520,1,1036,767,1803,32,FALSE
composer-runtime-hlf,0.5.2-20170313164734,0.5.2-20170313181004,294,6,793,427,1220,51,FALSE
composer-runtime-hlf,0.5.11-20170417175551,0.5.11-20170418064625,458,1,715,748,1463,20,FALSE
composer-runtime-hlf,0.4.5-20170308154526,0.4.5-20170308155525,238,1,35,37,72,3,FALSE
composer-runtime-hlf,0.4.5-20170308143910,0.4.5-20170308152046,235,7,160,54,214,22,FALSE
composer-runtime-hlf,0.7.2-20170512065403,0.7.2-20170512091332,566,1,0,0,0,0,FALSE
composer-runtime-hlf,0.7.3-20170525092654,0.7.3,609,1,35,37,72,3,FALSE
composer-runtime-hlf,0.4.4-20170223164152,0.4.4-20170224133853,154,5,1715,447,2162,390,FALSE
composer-runtime-hlf,0.5.10-20170410155533,0.5.10,442,1,35,37,72,3,FALSE
composer-runtime-hlf,0.4.5-20170307172449,0.4.5-20170307195014,223,4,2112,3438,5550,175,FALSE
composer-runtime-hlf,0.4.4-20170220133531,0.4.4-20170220163845,131,2,14969,863,15832,400,FALSE
composer-runtime-hlf,0.5.13-20170427200328,0.5.13-20170427230055,491,1,37,23,60,9,FALSE
composer-runtime-hlf,0.4.5-20170307231805,0.4.5-20170308102441,227,4,3076,1128,4204,72,FALSE
composer-runtime-hlf,0.5.2-20170316085350,0.5.2-20170316100248,323,6,861,347,1208,80,FALSE
composer-runtime-hlf,0.5.6-20170320143610,0.5.6-20170320165206,357,1,35,37,72,3,FALSE
composer-runtime-hlf,0.4.4-20170218163722,0.4.4-20170219163718,128,1,35,37,72,3,FALSE
composer-runtime-hlf,0.4.5-20170303220536,0.4.5-20170304144245,202,2,2,8,10,6,FALSE
composer-runtime-hlf,0.7.3-20170518103321,0.7.3-20170518123305,586,1,1132,60,1192,53,FALSE
composer-runtime-hlf,0.5.2-20170314224640,0.5.2-20170315092953,310,9,5935,1549,7484,223,FALSE
composer-runtime-hlf,0.7.3-20170514112333,0.7.3-20170515083534,574,1,10,10,20,2,FALSE
composer-runtime-hlf,0.5.4-20170317144845,0.5.4-20170317150754,345,1,35,37,72,3,FALSE
composer-runtime-hlf,0.4.5-20170301170106,0.4.5-20170302031641,190,1,269,36,305,8,FALSE
composer-runtime-hlf,0.5.7-20170404205452,0.5.7-20170405074925,414,1,102,30,132,5,FALSE
composer-runtime-hlf,0.4.1-20170202124113,0.4.1-20170202141342,35,6,10516,877,11393,35,FALSE
composer-runtime-hlf,0.5.11-20170411145259,0.5.11-20170411155746,445,1,43,4,47,3,FALSE
composer-runtime-hlf,0.5.8-20170408203136,0.5.8,433,1,35,37,72,3,FALSE
composer-runtime-hlf,0.5.10-20170410103131,0.5.10-20170410133745,439,1,13,22,35,5,FALSE
composer-runtime-hlf,0.4.5-20170228075050,0.4.5-20170228092014,175,4,497,448,945,53,FALSE
composer-runtime-hlf,0.5.6-20170321165404,0.5.6-20170322091842,365,1,19,447,466,6,FALSE
composer-runtime-hlf,0.7.4-20170527142420,0.7.4-20170527212230,618,1,21,13,34,4,FALSE
composer-runtime-hlf,0.7.3-20170517125550,0.7.3-20170517144754,582,1,288,268,556,12,FALSE
composer-runtime-hlf,0.4.2-20170209060232,0.4.2-20170209082751,72,4,260,49,309,28,FALSE
composer-runtime-hlf,0.4.1-20170206200727,0.4.1-20170207100801,62,7,308,561,869,73,FALSE
composer-runtime-hlf,0.5.6-20170328000248,0.5.6-20170328110516,389,1,285,35,320,2,FALSE
composer-runtime-hlf,0.5.2-20170314091451,0.5.2-20170314100110,296,4,470,264,734,28,FALSE
composer-runtime-hlf,0.4.5-20170228123838,0.4.5-20170228133305,178,2,1388,792,2180,55,FALSE
composer-runtime-hlf,0.4.5-20170306204926,0.4.5-20170307102840,215,15,2433,1239226,1241659,3219,FALSE
composer-runtime-hlf,0.7.1-20170502151544,0.7.1-20170502172623,511,1,13,13,26,9,FALSE
composer-runtime-hlf,0.7.1-20170502072833,0.7.1-20170502083132,506,1,249,34,283,8,FALSE
composer-runtime-hlf,0.7.4-20170525193844,0.7.4-20170525234800,611,1,22,17,39,4,FALSE
composer-runtime-hlf,0.4.2-20170209183400,0.4.2-20170209212225,79,5,46,6,52,6,FALSE
composer-runtime-hlf,0.4.1-20170202071214,0.4.1-20170202071455,30,1,35,37,72,3,FALSE
composer-runtime-hlf,0.4.5-20170307222427,0.4.5-20170307231805,226,2,223,144,367,5,FALSE
composer-runtime-hlf,0.7.2-20170506190618,0.7.2-20170507111349,536,1,445,6,451,11,FALSE
composer-runtime-hlf,0.4.5-20170308165354,0.4.5-20170308171031,243,3,86,11,97,9,FALSE
composer-runtime-hlf,0.5.9-20170409215918,0.5.9,436,1,35,37,72,3,FALSE
composer-runtime-hlf,0.4.5-20170301164949,0.4.5-20170301170106,189,1,148,114,262,4,FALSE
composer-runtime-hlf,0.7.1-20170503091344,0.7.1-20170503100703,513,1,93,0,93,1,FALSE
composer-runtime-hlf,0.7.2-20170509215115,0.7.2-20170509222126,548,1,35,37,72,3,FALSE
composer-runtime-hlf,0.4.4-20170223121522,0.4.4-20170223141017,152,3,1547,358,1905,202,FALSE
composer-runtime-hlf,0.4.1-20170206174256,0.4.1-20170206200727,61,6,38,19,57,7,FALSE
composer-runtime-hlf,0.7.3-20170513161412,0.7.3-20170514112333,573,1,376,2,378,4,FALSE
composer-runtime-hlf,0.4.4-20170222155234,0.4.4-20170222164618,142,2,88372,167,88539,423,FALSE
composer-runtime-hlf,0.4.1-20170201120431,0.4.1-20170201120902,24,1,35,37,72,3,FALSE
composer-runtime-hlf,0.7.2-20170507130651,0.7.2-20170508093534,538,1,220,135,355,11,FALSE
composer-runtime-hlf,0.7.2-20170506073514,0.7.2-20170506084056,534,1,448,24,472,7,FALSE
composer-runtime-hlf,0.4.1-20170203144913,0.4.1-20170203213537,50,13,30733,2301,33034,201,FALSE
composer-runtime-hlf,0.5.2-20170313163500,0.5.2-20170313164059,291,1,35,37,72,3,FALSE
composer-runtime-hlf,0.4.4-20170221140404,0.4.4-20170221145846,133,5,2843,508,3351,2408,FALSE
composer-runtime-hlf,0.7.3-20170512143234,0.7.3-20170512193834,570,1,32,13,45,4,FALSE
composer-runtime-hlf,0.5.2-20170315221517,0.5.2-20170315224329,321,1,35,37,72,3,FALSE
composer-runtime-hlf,0.5.2-20170313111819,0.5.2-20170313115127,283,3,156,113,269,17,FALSE
composer-runtime-hlf,0.7.3-20170524124715,0.7.3-20170524134549,601,1,0,0,0,1,FALSE
composer-runtime-hlf,0.4.1-20170204102327,0.4.1-20170204125930,54,4,0,0,0,2,FALSE
composer-runtime-hlf,0.4.4-20170215190130,0.4.4-20170215212457,112,2,71,9,80,4,FALSE
composer-runtime-hlf,0.7.3-20170515093334,0.7.3-20170515142750,576,1,1,1,2,1,FALSE
composer-runtime-hlf,0.4.4-20170220163845,0.4.4-20170221140404,132,16,43055,203931,246986,2412,FALSE
composer-runtime-hlf,0.4.5-20170308112144,0.4.5-20170308131738,229,5,3635,1417,5052,129,FALSE
composer-runtime-hlf,0.7.4-20170527212230,0.7.4-20170528142626,619,1,35,37,72,3,FALSE
composer-runtime-hlf,0.4.5-20170227224333,0.4.5-20170227230120,170,1,35,37,72,3,FALSE
composer-runtime-hlf,0.4.5-20170227143707,0.4.5-20170227165138,164,14,6690,785,7475,204,FALSE
composer-runtime-hlf,0.5.2-20170316100248,0.5.2-20170316110451,324,3,333,123,456,42,FALSE
composer-runtime-hlf,0.3.11-20170130162307,0.3.11-20170130165810,8,2,3815,323,4138,96,FALSE
composer-runtime-hlf,0.5.7-20170406203424,0.5.7-20170406212740,425,1,134,40,174,11,FALSE
composer-runtime-hlf,0.4.1-20170131180331,0.4.1-20170131192303,19,2,233,630,863,59,FALSE
composer-runtime-hlf,0.5.6-20170327152530,0.5.6-20170327162514,386,1,16,3,19,1,FALSE
composer-runtime-hlf,0.7.2-20170508143222,0.7.2-20170508150422,542,1,93,24,117,8,FALSE
composer-runtime-hlf,0.4.4-20170215103230,0.4.4-20170215130619,108,15,4844,314,5158,85,FALSE
composer-runtime-hlf,0.5.6-20170320175009,0.5.6-20170321093733,359,1,246,122,368,12,FALSE
composer-runtime-hlf,0.7.3-20170512105624,0.7.3-20170512143234,569,1,11,11,22,1,FALSE
composer-runtime-hlf,0.4.1-20170202141342,0.4.1-20170202141422,36,1,35,37,72,3,FALSE
composer-runtime-hlf,0.5.2-20170313083042,0.5.2-20170313092430,281,1,2,2,4,2,FALSE
composer-runtime-hlf,0.5.13-20170425174559,0.5.13-20170426092503,483,1,50,5,55,6,FALSE
composer-runtime-hlf,0.4.4-20170216074216,0.4.4-20170216122304,117,5,5644,1727,7371,276,FALSE
composer-runtime-hlf,0.4.4-20170223095537,0.4.4-20170223103517,150,5,3345,787,4132,90,FALSE
composer-runtime-hlf,0.7.3-20170524104708,0.7.3-20170524124715,600,1,35,37,72,3,FALSE
composer-runtime-hlf,0.5.7-20170406193752,0.5.7-20170406203424,424,1,76,0,76,2,FALSE
composer-runtime-hlf,0.5.2-20170316110451,0.5.2-20170316120427,325,8,312,331,643,51,FALSE
composer-runtime-hlf,0.5.6-20170330070544,0.5.6-20170330083135,397,1,211,12,223,5,FALSE
composer-runtime-hlf,0.5.2-20170314173438,0.5.2-20170314175605,304,1,35,37,72,3,FALSE
composer-runtime-hlf,0.7.4-20170530043839,0.7.4-20170530052600,622,1,13,15,28,13,FALSE
composer-runtime-hlf,0.4.5-20170302170551,0.4.5-20170302190028,193,2,273,88531,88804,196,FALSE
composer-runtime-hlf,0.4.5-20170226235234,0.4.5-20170227091408,159,3,6300,1077,7377,211,FALSE
composer-runtime-hlf,0.4.1-20170202184119,0.4.1-20170202223046,41,4,170,80,250,21,FALSE
composer-runtime-hlf,0.4.4-20170214163805,0.4.4-20170214190006,105,2,9,9,18,2,FALSE
composer-runtime-hlf,0.4.1-20170203144824,0.4.1-20170203144913,49,1,35,37,72,3,FALSE
composer-runtime-hlf,0.7.0-20170428141114,0.7.0-20170428144416,496,1,2,2,4,1,FALSE
composer-runtime-hlf,0.5.13-20170422071634,0.5.13-20170422110932,475,1,648,144,792,20,FALSE
composer-runtime-hlf,0.5.2-20170316163815,0.5.2-20170316170252,332,1,35,37,72,3,FALSE
composer-runtime-hlf,0.4.4-20170216122304,0.4.4-20170216130939,118,3,3668,640,4308,131,FALSE
composer-runtime-hlf,0.4.4-20170217134744,0.4.4-20170217163657,125,4,1294,411,1705,74,FALSE
composer-runtime-hlf,0.7.2-20170510224135,0.7.2-20170511000120,557,1,545,0,545,27,FALSE
composer-runtime-hlf,0.5.11-20170419231210,0.5.11-20170420063536,463,1,35,37,72,3,FALSE
composer-runtime-hlf,0.4.5-20170303140812,0.4.5-20170303193345,199,2,557,201,758,34,FALSE
composer-runtime-hlf,0.5.6-20170327100206,0.5.6-20170327131316,383,1,35,37,72,3,FALSE
composer-runtime-hlf,0.4.5-20170302225038,0.4.5-20170303100755,195,3,62,16,78,2,FALSE
composer-runtime-hlf,0.4.2-20170208121509,0.4.2-20170208164504,69,12,202809,538,203347,625,FALSE
composer-runtime-hlf,0.5.6-20170328152710,0.5.6-20170328172301,392,1,408,39,447,2,FALSE
composer-runtime-hlf,0.5.12,0.5.13-20170420203045,469,1,97,97,194,25,FALSE
composer-runtime-hlf,0.5.10,0.5.11-20170411102332,443,1,96,96,192,25,FALSE
composer-runtime-hlf,0.5.11,0.5.12,468,3,157,185,342,48,FALSE
composer-runtime-hlf,0.5.6-20170403084448,0.5.6-20170403092355,407,1,1,6,7,1,FALSE
composer-runtime-hlf,0.5.2-20170313131302,0.5.2-20170313142026,286,5,192,157,349,24,FALSE
composer-runtime-hlf,0.7.2-20170511142719,0.7.2-20170511174126,563,2,221,41,262,5,FALSE
composer-runtime-hlf,0.7.3-20170524092303,0.7.3-20170524104159,598,1,214,56,270,37,FALSE
composer-runtime-hlf,0.4.5-20170303193345,0.4.5-20170303211223,200,1,204314,15,204329,469,FALSE
composer-runtime-hlf,0.4.5-20170302031641,0.4.5-20170302165055,191,3,393,84,477,12,FALSE
composer-runtime-hlf,0.4.5-20170301073428,0.4.5-20170301102843,184,6,318,199,517,11,FALSE
composer-runtime-hlf,0.7.2-20170511000120,0.7.2-20170511073210,558,1,155,54,209,9,FALSE
composer-runtime-hlf,0.4.4-20170222152544,0.4.4-20170222155234,141,2,101054,1229,102283,1481,FALSE
composer-runtime-hlf,0.4.5-20170301143921,0.4.5-20170301153907,187,2,0,1,1,1,FALSE
composer-runtime-hlf,0.7.0-20170428204746,0.7.0-20170429134507,500,1,4,35,39,5,FALSE
composer-runtime-hlf,0.7.1-20170504100253,0.7.1-20170504110951,521,1,466,162,628,19,FALSE
composer-runtime-hlf,0.4.5-20170309112355,0.4.5-20170309133051,257,1,35,37,72,3,FALSE
composer-runtime-hlf,0.5.13-20170421192031,0.5.13-20170422071634,474,1,124,3,127,10,FALSE
composer-runtime-hlf,0.5.11-20170418155913,0.5.11-20170419231210,462,4,199,1948,2147,50,FALSE
composer-runtime-hlf,0.4.5-20170309143407,0.4.5-20170309150353,260,2,183,6,189,16,FALSE
composer-runtime-hlf,0.5.13-20170426100536,0.5.13-20170426161821,485,1,1,1,2,1,FALSE
composer-runtime-hlf,0.5.6-20170401095849,0.5.6-20170402192220,405,1,13,0,13,2,FALSE
composer-runtime-hlf,0.7.4-20170530074729,0.7.4-20170530092927,624,1,93,29,122,2,FALSE
composer-runtime-hlf,0.4.4-20170214230354,0.4.4-20170215103230,107,7,2752,311,3063,94,FALSE
composer-runtime-hlf,0.4.5-20170309212740,0.4.5-20170310112516,266,2,190,198,388,50,FALSE
composer-runtime-hlf,0.4.1-20170202162523,0.4.1-20170202162756,38,1,35,37,72,3,FALSE
composer-runtime-hlf,0.4.5-20170308171031,0.4.5-20170308182803,244,3,141,3,144,9,FALSE
composer-runtime-hlf,0.4.2-20170210165116,0.4.2-20170210173439,85,1,35,37,72,3,FALSE
composer-runtime-hlf,0.7.3-20170524134549,0.7.3-20170524145629,602,1,46,65,111,6,FALSE
composer-runtime-hlf,0.7.0-20170428000725,0.7.0-20170428090650,493,1,137,142,279,27,FALSE
composer-runtime-hlf,0.5.13-20170427130946,0.5.13-20170427143854,488,1,78,117,195,7,FALSE
composer-runtime-hlf,0.5.11-20170411155746,0.5.11-20170411171848,446,1,1,1,2,1,FALSE
composer-runtime-hlf,0.4.4-20170221160317,0.4.4-20170221163852,136,2,11407,227,11634,1059,FALSE
composer-runtime-hlf,0.5.2-20170315224329,0.5.2-20170316085350,322,2,4,16,20,6,FALSE
composer-runtime-hlf,0.4.3-20170211163711,0.4.3-20170211170822,91,1,189,6,195,2,FALSE
composer-runtime-hlf,0.5.6-20170324122620,0.5.6-20170324170727,378,1,322,57,379,14,FALSE
composer-runtime-hlf,0.5.2-20170313142026,0.5.2-20170313142435,287,1,26,23,49,5,FALSE
composer-runtime-hlf,0.3.11-20170130181002,0.3.11,12,1,35,37,72,3,FALSE
composer-runtime-hlf,0.7.2-20170509222126,0.7.2-20170510080340,549,1,7,7,14,3,FALSE
composer-runtime-hlf,0.4.2-20170210181945,0.4.2-20170210203654,87,1,464,446,910,12,FALSE
composer-runtime-hlf,0.5.2-20170316152340,0.5.2-20170316163815,331,7,172,437,609,23,FALSE
composer-runtime-hlf,0.5.7-20170406092009,0.5.7-20170406105358,421,1,59,44,103,4,FALSE
composer-runtime-hlf,0.4.1-20170201132059,0.4.1-20170201183738,27,19,2456,1573,4029,146,FALSE
composer-runtime-hlf,0.7.2-20170508150422,0.7.2-20170508201056,543,1,86,13,99,4,FALSE
composer-runtime-hlf,0.5.6-20170318165009,0.5.6-20170319165038,352,1,35,37,72,3,FALSE
composer-runtime-hlf,0.5.2-20170315155558,0.5.2-20170315164951,319,4,835,317,1152,51,FALSE
composer-runtime-hlf,0.7.3-20170518142623,0.7.3-20170518201536,590,1,364,154,518,9,FALSE
composer-runtime-hlf,0.5.2-20170314164109,0.5.2-20170314173438,303,3,30,10,40,5,FALSE
composer-runtime-hlf,0.4.2-20170210203654,0.4.2,88,1,35,37,72,3,FALSE
composer-runtime-hlf,0.7.3-20170524154239,0.7.3-20170524214122,604,1,373,3,376,7,FALSE
composer-runtime-hlf,0.5.11-20170420063536,0.5.11-20170420145917,464,1,185,8,193,30,FALSE
composer-runtime-hlf,0.5.6-20170320102223,0.5.6-20170320125116,355,1,73,1,74,2,FALSE
composer-runtime-hlf,0.7.2-20170510092802,0.7.2-20170510103407,551,1,6,6,12,2,FALSE
composer-runtime-hlf,0.5.13-20170425144442,0.5.13-20170425165811,481,1,25,6,31,7,FALSE
composer-runtime-hlf,0.5.13-20170427162249,0.5.13-20170427200328,490,1,262,1,263,8,FALSE
composer-runtime-hlf,0.5.2-20170314220420,0.5.2-20170314224640,309,1,2,7,9,2,FALSE
composer-runtime-hlf,0.4.5-20170303211223,0.4.5-20170303220536,201,1,35,37,72,3,FALSE
composer-runtime-hlf,0.5.4-20170317120624,0.5.4-20170317144845,344,5,13,10,23,10,FALSE
composer-runtime-hlf,0.4.4-20170215153422,0.4.4-20170215190130,111,8,9689,456,10145,128,FALSE
composer-runtime-hlf,0.4.4-20170215140741,0.4.4-20170215153422,110,4,2339,109,2448,31,FALSE
composer-runtime-hlf,0.5.4-20170317095054,0.5.4-20170317120624,343,9,169,415,584,51,FALSE
composer-runtime-hlf,0.7.1-20170504110951,0.7.1-20170504123539,522,1,23,6,29,3,FALSE
composer-runtime-hlf,0.3.11-20170130160915,0.3.11-20170130162307,7,1,2,2,4,1,FALSE
composer-runtime-hlf,0.4.1-20170202183923,0.4.1-20170202184119,40,1,35,37,72,3,FALSE
composer-runtime-hlf,0.4.4-20170217121825,0.4.4-20170217134744,124,2,598,160,758,28,FALSE
composer-runtime-hlf,0.7.0-20170428194216,0.7.0-20170428201639,498,1,4,4,8,4,FALSE
composer-runtime-hlf,0.7.2-20170505194144,0.7.2-20170506073514,533,1,83,2,85,4,FALSE
composer-runtime-hlf,0.5.6-20170323152728,0.5.6-20170323162551,375,1,1857,572,2429,22,FALSE
composer-runtime-hlf,0.7.1-20170505135229,0.7.1-20170505151238,530,1,48,19,67,1,FALSE
composer-runtime-hlf,0.7.4-20170526142254,0.7.4-20170527112128,615,1,504,9,513,8,FALSE
composer-runtime-hlf,0.5.2-20170316120427,0.5.2-20170316123938,326,7,6723,3435,10158,268,FALSE
composer-runtime-hlf,0.4.5-20170308223539,0.4.5-20170308223548,248,1,35,37,72,3,FALSE
composer-runtime-hlf,0.4.4-20170221152406,0.4.4-20170221160317,135,1,225,25,250,3,FALSE
composer-runtime-hlf,0.4.4-20170217111110,0.4.4-20170217121825,123,3,598,160,758,28,FALSE
composer-runtime-hlf,0.5.6-20170325121708,0.5.6-20170326213853,380,1,1,1,2,1,FALSE
composer-runtime-hlf,0.5.2-20170313164059,0.5.2-20170313164109,292,1,35,37,72,3,FALSE
composer-runtime-hlf,0.4.5-20170309014012,0.4.5-20170309090031,254,2,2231,120,2351,46,FALSE
composer-runtime-hlf,0.5.2-20170313092430,0.5.2-20170313111819,282,9,5796,4799,10595,276,FALSE
composer-runtime-hlf,0.4.5-20170308133243,0.4.5-20170308134235,231,1,35,37,72,3,FALSE
composer-runtime-hlf,0.5.7-20170405191000,0.5.7-20170405195758,418,1,205,12,217,41,FALSE
composer-runtime-hlf,0.5.2-20170315105805,0.5.2-20170315112253,314,2,111,15,126,7,FALSE
composer-runtime-hlf,0.7.2-20170511174126,0.7.2-20170511184348,564,1,55,11,66,3,FALSE
composer-runtime-hlf,0.4.5-20170308155525,0.4.5-20170308162049,239,3,2346,947,3293,86,FALSE
composer-runtime-hlf,0.4.2-20170209140612,0.4.2-20170209153456,76,5,128,4,132,11,FALSE
composer-runtime-hlf,0.5.7-20170405074925,0.5.7-20170405122348,415,1,2,2,4,1,FALSE
composer-runtime-hlf,0.5.6-20170323112438,0.5.6-20170323145047,373,1,1,1,2,1,FALSE
composer-runtime-hlf,0.5.6-20170326213853,0.5.6-20170327062813,381,1,0,1,1,1,FALSE
composer-runtime-hlf,0.5.4-20170317010639,0.5.4-20170317095054,342,3,1562,1129,2691,150,FALSE
composer-runtime-hlf,0.4.4-20170215225310,0.4.4-20170216065443,115,2,2470,134,2604,35,FALSE
composer-runtime-hlf,0.5.7-20170406120956,0.5.7-20170406193752,423,1,1,0,1,1,FALSE
composer-runtime-hlf,0.5.13-20170427143854,0.5.13-20170427162249,489,1,117,10,127,2,FALSE
composer-runtime-hlf,0.7.2-20170511103750,0.7.2-20170511133356,561,1,126,43,169,4,FALSE
composer-runtime-hlf,0.4.1-20170206135056,0.4.1-20170206153101,59,9,488,211,699,20,FALSE
composer-runtime-hlf,0.4.5-20170309090031,0.4.5-20170309103452,255,11,5179,493,5672,154,FALSE
composer-runtime-hlf,0.5.11-20170412142640,0.5.11-20170412150650,450,1,6,18,24,1,FALSE
composer-runtime-hlf,0.5.2-20170315120404,0.5.2-20170315133233,316,1,84,53,137,9,FALSE
composer-runtime-hlf,0.5.11-20170412105027,0.5.11-20170412130723,448,1,263,137,400,7,FALSE
composer-runtime-hlf,0.5.2-20170313155056,0.5.2-20170313163500,290,4,485,286,771,56,FALSE
composer-runtime-hlf,0.5.6-20170328132842,0.5.6-20170328152710,391,1,440,79,519,5,FALSE
composer-runtime-hlf,0.4.4-20170217164556,0.4.4-20170218163722,127,1,35,37,72,3,FALSE
composer-runtime-hlf,0.7.0-20170430150534,0.7.0-20170501193650,502,1,1,1,2,1,FALSE
composer-runtime-hlf,0.4.4-20170222142641,0.4.4-20170222145515,139,2,12,12,24,4,FALSE
composer-runtime-hlf,0.5.13-20170425165811,0.5.13-20170425174559,482,1,1,0,1,1,FALSE
composer-runtime-hlf,0.7.2-20170508093534,0.7.2-20170508113734,539,2,66,65,131,5,FALSE
composer-runtime-hlf,0.7.3-20170519155658,0.7.3-20170519191537,593,1,120,90,210,7,FALSE
composer-runtime-hlf,0.5.13-20170420210947,0.5.13-20170421093118,471,1,1,1,2,1,FALSE
composer-runtime-hlf,0.5.8-20170407140006,0.5.8-20170407163302,431,1,5,2,7,3,FALSE
composer-runtime-hlf,0.5.6-20170327062813,0.5.6-20170327100206,382,1,328,42,370,2,FALSE
composer-runtime-hlf,0.3.11-20170130165810,0.3.11-20170130173458,9,3,520,368,888,95,FALSE
composer-runtime-hlf,0.5.13-20170424101321,0.5.13-20170424145000,477,1,55,37,92,3,FALSE
composer-runtime-hlf,0.4.1-20170206153101,0.4.1-20170206174256,60,7,165,42,207,16,FALSE
composer-runtime-hlf,0.4.5-20170302165055,0.4.5-20170302170551,192,1,35,37,72,3,FALSE
composer-runtime-hlf,0.5.10-20170410145627,0.5.10-20170410155533,441,1,10,10,20,3,FALSE
composer-runtime-hlf,0.7.3-20170515083534,0.7.3-20170515093334,575,1,6,6,12,4,FALSE
composer-runtime-hlf,0.4.2-20170208164504,0.4.2-20170208185715,70,8,202411,512,202923,573,FALSE
composer-runtime-hlf,0.5.2-20170316172111,0.5.2-20170316175024,334,1,14,14,28,2,FALSE
composer-runtime-hlf,0.5.6-20170330093909,0.5.6-20170330105333,399,1,5,3,8,3,FALSE
composer-runtime-hlf,0.7.3-20170524214122,0.7.3-20170524225241,605,1,1720,24,1744,36,FALSE
composer-runtime-hlf,0.4.4-20170214135606,0.4.4-20170214153654,103,5,371,103,474,36,FALSE
composer-runtime-hlf,0.3.9,0.3.10-20170130140804,3,26,24111,584,24695,794,FALSE
composer-runtime-hlf,0.4.5-20170308152715,0.4.5-20170308154526,237,2,171,76,247,13,FALSE
composer-runtime-hlf,0.4.5-20170306081940,0.4.5-20170306113142,208,3,205709,329,206038,511,FALSE
composer-runtime-hlf,0.7.2-20170511133356,0.7.2-20170511142719,562,1,326,93,419,13,FALSE
composer-runtime-hlf,0.5.11-20170411102332,0.5.11-20170411145259,444,1,21,21,42,1,FALSE
composer-runtime-hlf,0.4.5-20170307161757,0.4.5-20170307172308,221,12,8028,300595,308623,1039,FALSE
composer-runtime-hlf,0.4.4-20170216145206,0.4.4-20170216154109,120,2,673,229,902,42,FALSE
composer-runtime-hlf,0.5.6-20170323145047,0.5.6-20170323152728,374,1,2,0,2,1,FALSE
composer-runtime-hlf,0.4.4-20170216130939,0.4.4-20170216145206,119,6,1200,634,1834,91,FALSE
composer-runtime-hlf,0.7.2-20170508135105,0.7.2-20170508143222,541,1,91,91,182,3,FALSE
composer-runtime-hlf,0.7.2-20170510145522,0.7.2-20170510162533,554,1,239,185,424,10,FALSE
composer-runtime-hlf,0.7.2-20170511081458,0.7.2-20170511103750,560,1,246,94,340,4,FALSE
composer-runtime-hlf,0.5.6-20170328110516,0.5.6-20170328132842,390,1,24,3,27,2,FALSE
composer-runtime-hlf,0.5.11-20170414172920,0.5.11-20170417112232,456,1,923,225,1148,12,FALSE
composer-runtime-hlf,0.5.11-20170420145917,0.5.11-20170420160816,465,1,27,8,35,22,FALSE
composer-runtime-hlf,0.5.7-20170405122348,0.5.7-20170405154329,416,1,352,2,354,11,FALSE
composer-runtime-hlf,0.5.11-20170418124512,0.5.11-20170418155913,461,1,98,45,143,9,FALSE
composer-runtime-hlf,0.5.2-20170314191345,0.5.2-20170314194114,306,1,47,61,108,4,FALSE
composer-runtime-hlf,0.7.1-20170502172623,0.7.1-20170503091344,512,1,5,5,10,2,FALSE
composer-runtime-hlf,0.5.2-20170313120948,0.5.2-20170313131302,285,2,10,10,20,2,FALSE
composer-runtime-hlf,0.4.5-20170227130557,0.4.5-20170227140500,162,4,7,864,871,82,FALSE
composer-runtime-hlf,0.4.5-20170307142217,0.4.5-20170307153350,219,6,5211,94239,99450,465,FALSE
composer-runtime-hlf,0.4.4-20170221145846,0.4.4-20170221152406,134,3,982,380,1362,808,FALSE
composer-runtime-hlf,0.5.2-20170315102717,0.5.2-20170315105805,313,2,2,2,4,2,FALSE
composer-runtime-hlf,0.4.1-20170204125930,0.4.1-20170204131504,55,2,1,1,2,1,FALSE
composer-runtime-hlf,0.4.5-20170227140500,0.4.5-20170227143707,163,3,542,698,1240,435,FALSE
composer-runtime-hlf,0.4.5-20170308102441,0.4.5-20170308112144,228,1,41,64,105,6,FALSE
composer-runtime-hlf,0.5.7-20170404193825,0.5.7-20170404205452,413,1,299,1,300,4,FALSE
composer-runtime-hlf,0.7.1-20170505075003,0.7.1-20170505082916,527,1,6,9325,9331,216,FALSE
composer-runtime-hlf,0.4.4-20170216065443,0.4.4-20170216074216,116,2,118,21,139,7,FALSE
composer-runtime-hlf,0.4.4-20170222145515,0.4.4-20170222152544,140,3,176054,46,176100,766,FALSE
composer-runtime-hlf,0.4.4-20170222164618,0.4.4-20170222170514,143,4,88336,132,88468,422,FALSE
composer-runtime-hlf,0.4.4-20170211213407,0.4.4-20170212163424,94,1,35,37,72,3,FALSE
composer-runtime-hlf,0.4.4-20170223103517,0.4.4-20170223121522,151,4,3345,855,4200,435,FALSE
composer-runtime-hlf,0.4.5-20170301153907,0.4.5-20170301164949,188,4,450,220,670,22,FALSE
composer-runtime-hlf,0.4.1,0.4.2-20170206223553,65,63,31921,2786,34707,312,FALSE
composer-runtime-hlf,0.4.0,0.4.1-20170131144110,16,11,910,811,1721,253,FALSE
composer-runtime-hlf,0.4.3,0.4.4-20170211213407,93,5,794,52900,53694,276,FALSE
composer-runtime-hlf,0.4.2,0.4.3-20170211153544,89,2,128,128,256,40,FALSE
composer-runtime-hlf,0.4.5,0.5.0-20170310095413,268,238,590753,2249232,2839985,9949,FALSE
composer-runtime-hlf,0.4.4,0.4.5-20170224153926,156,1,578,1014,1592,39,FALSE
composer-runtime-hlf,0.4.5-20170227165138,0.4.5-20170227165156,165,1,35,37,72,3,FALSE
composer-runtime-hlf,0.4.2-20170209170941,0.4.2-20170209183400,78,3,3,3,6,4,FALSE
composer-runtime-hlf,0.4.5-20170308210152,0.4.5-20170308223539,247,7,2493,159,2652,101,FALSE
composer-runtime-hlf,0.5.6-20170403140747,0.5.6,409,1,35,37,72,3,FALSE
composer-runtime-hlf,0.4.5-20170308194911,0.4.5-20170308210152,246,2,703,32,735,24,FALSE
composer-runtime-hlf,0.7.3-20170520185533,0.7.3-20170523201332,595,1,4,4,8,4,FALSE
composer-runtime-hlf,0.5.11-20170412130723,0.5.11-20170412142640,449,1,7,1,8,3,FALSE
composer-runtime-hlf,0.7.4-20170526142135,0.7.4-20170526142254,614,1,35,37,72,3,FALSE
composer-runtime-hlf,0.5.8-20170406224305,0.5.8-20170407092318,429,1,32,14247,14279,4,FALSE
composer-runtime-hlf,0.7.1-20170504160025,0.7.1-20170504194131,524,2,84,27,111,9,FALSE
composer-runtime-hlf,0.7.4-20170530105630,0.7.4-20170530115441,626,1,41,3,44,2,FALSE
composer-runtime-hlf,0.4.5-20170227220209,0.4.5-20170227224333,169,4,31,13,44,15,FALSE
composer-runtime-hlf,0.5.7-20170406212740,0.5.7,426,1,35,37,72,3,FALSE
composer-runtime-hlf,0.7.1-20170503220610,0.7.1-20170503231020,518,1,8,3,11,2,FALSE
composer-runtime-hlf,0.5.6-20170322091842,0.5.6-20170322095319,366,1,147,46,193,3,FALSE
composer-runtime-hlf,0.5.13-20170426161821,0.5.13-20170427111149,486,1,35,37,72,3,FALSE
composer-runtime-hlf,0.4.5-20170307210010,0.4.5-20170307222427,225,6,2554,793,3347,55,FALSE
composer-runtime-hlf,0.4.2-20170209111808,0.4.2-20170209140612,75,4,2967,1058,4025,67,FALSE
composer-runtime-hlf,0.4.5-20170302190028,0.4.5-20170302225038,194,2,273,88531,88804,196,FALSE
composer-runtime-hlf,0.4.2-20170209153456,0.4.2-20170209170941,77,8,3971,1510,5481,97,FALSE
composer-runtime-hlf,0.4.5-20170307153350,0.4.5-20170307161757,220,7,622,339,961,40,FALSE
composer-runtime-hlf,0.4.1-20170201184136,0.4.1-20170202071214,29,6,2266,1887,4153,186,FALSE
composer-runtime-hlf,0.7.3-20170519124107,0.7.3-20170519155658,592,1,574,99,673,11,FALSE
composer-runtime-hlf,0.7.0-20170428144416,0.7.0-20170428194216,497,1,5,6,11,2,FALSE
composer-runtime-hlf,0.7.1-20170505082916,0.7.1-20170505101424,528,1,32,37,69,18,FALSE
composer-runtime-hlf,0.4.5-20170227091408,0.4.5-20170227095701,160,2,6042,1063,7105,201,FALSE
composer-runtime-hlf,0.5.6-20170322153455,0.5.6-20170322165404,370,1,35,37,72,3,FALSE
composer-runtime-hlf,0.5.4-20170317150754,0.5.4-20170317153753,346,1,31,274,305,10,FALSE
composer-runtime-hlf,0.5.2-20170314115729,0.5.2-20170314132030,299,9,6593,899,7492,124,FALSE
composer-runtime-hlf,0.4.1-20170205233716,0.4.1-20170206135056,58,6,272,41,313,17,FALSE
composer-runtime-hlf,0.7.1-20170503100703,0.7.1-20170503150054,514,1,7,5,12,6,FALSE
composer-runtime-hlf,0.7.3-20170518123305,0.7.3-20170518131232,587,1,23,16,39,5,FALSE
composer-runtime-hlf,0.4.5-20170309002603,0.4.5-20170309014012,253,2,680,32,712,8,FALSE
composer-runtime-hlf,0.7.3-20170519191537,0.7.3-20170520185533,594,1,29,0,29,1,FALSE
composer-runtime-hlf,0.4.4-20170217163657,0.4.4-20170217164556,126,1,35,37,72,3,FALSE
composer-runtime-hlf,0.5.2-20170316175024,0.5.2-20170316191301,335,2,32,28,60,10,FALSE
composer-runtime-hlf,0.4.1-20170202095512,0.4.1-20170202095650,32,1,35,37,72,3,FALSE
composer-runtime-hlf,0.5.11-20170412150650,0.5.11-20170412161822,451,1,94,2,96,4,FALSE
composer-runtime-hlf,0.7.1-20170503210021,0.7.1-20170503220610,517,1,12,3,15,6,FALSE
composer-runtime-hlf,0.4.4-20170221163852,0.4.4-20170221173204,137,3,1256,273,1529,822,FALSE
composer-runtime-hlf,0.4.1-20170203123152,0.4.1-20170203133121,46,1,9682,571,10253,22,FALSE
composer-runtime-hlf,0.4.4-20170214153654,0.4.4-20170214163805,104,2,9,9,18,2,FALSE
composer-runtime-hlf,0.5.11-20170418105809,0.5.11-20170418124512,460,1,16,6,22,6,FALSE
composer-runtime-hlf,0.7.4-20170530143521,0.7.4-20170531082238,629,4,151,26,177,26,FALSE
composer-runtime-hlf,0.7.1-20170502132911,0.7.1-20170502142052,509,1,1,1,2,1,FALSE
composer-runtime-hlf,0.5.11-20170413081721,0.5.11-20170414131345,453,1,494,35,529,9,FALSE
composer-runtime-hlf,0.7.2-20170509132635,0.7.2-20170509150231,546,1,77,53,130,7,FALSE
composer-runtime-hlf,0.4.5-20170304194231,0.4.5-20170304220145,205,2,920,502,1422,24,FALSE
composer-runtime-hlf,0.7.3-20170518135130,0.7.3-20170518142623,589,1,289,34,323,11,FALSE
composer-runtime-hlf,0.5.0-20170311165758,0.5.0-20170311181018,273,5,144,49,193,17,FALSE
composer-runtime-hlf,0.5.7-20170403223455,0.5.7-20170404193825,412,1,29,1,30,1,FALSE
composer-runtime-hlf,0.4.5-20170303130657,0.4.5-20170303140812,198,1,213,97,310,18,FALSE
composer-runtime-hlf,0.5.6-20170323175120,0.5.6-20170324122620,377,1,326,46,372,15,FALSE
composer-runtime-hlf,0.7.1-20170503231020,0.7.1-20170503235534,519,1,1788,464,2252,53,FALSE
composer-runtime-hlf,0.4.5-20170228092014,0.4.5-20170228095129,176,1,440,15,455,2,FALSE
composer-runtime-hlf,0.5.6-20170327131316,0.5.6-20170327135819,384,1,79,11,90,5,FALSE
composer-runtime-hlf,0.7.3-20170524235951,0.7.3-20170525082746,607,1,3,3,6,1,FALSE
composer-runtime-hlf,0.3.11-20170130175300,0.3.11-20170130181002,11,1,35,37,72,3,FALSE
composer-runtime-hlf,0.4.1-20170203213537,0.4.1-20170203213935,51,1,35,37,72,3,FALSE
composer-runtime-hlf,0.4.1-20170207100801,0.4.1-20170207100905,63,1,35,37,72,3,FALSE
composer-runtime-hlf,0.4.4-20170213191336,0.4.4-20170214073109,99,7,118,35,153,19,FALSE
composer-runtime-hlf,0.7.3-20170517105923,0.7.3-20170517115303,580,1,21,3,24,3,FALSE
composer-runtime-hlf,0.5.6-20170330150253,0.5.6-20170331093508,401,1,4,4,8,1,FALSE
composer-runtime-hlf,0.5.2-20170314175605,0.5.2-20170314191345,305,3,81,77,158,18,FALSE
composer-runtime-hlf,0.4.5-20170308140018,0.4.5-20170308143124,233,3,345,172,517,24,FALSE
composer-runtime-hlf,0.5.6-20170323162551,0.5.6-20170323175120,376,1,119,14,133,7,FALSE
composer-runtime-hlf,0.5.13-20170427111149,0.5.13-20170427130946,487,1,1,2,3,2,FALSE
composer-runtime-hlf,0.4.5-20170308152046,0.4.5-20170308152715,236,4,81,24,105,12,FALSE
composer-runtime-hlf,0.5.2-20170314104849,0.5.2-20170314115729,298,4,2598,335,2933,38,FALSE
composer-runtime-hlf,0.7.2-20170507111349,0.7.2-20170507130651,537,1,35,37,72,3,FALSE
composer-runtime-hlf,0.7.1-20170502123250,0.7.1-20170502132911,508,1,171,185,356,17,FALSE
composer-runtime-hlf,0.4.4-20170219230928,0.4.4-20170220133531,130,3,26,12,38,4,FALSE
composer-runtime-hlf,0.7.1-20170503150054,0.7.1-20170503192825,515,1,613,358,971,2,FALSE
composer-runtime-hlf,0.4.5-20170224153926,0.4.5-20170226224342,157,17,12269,4322,16591,479,FALSE
composer-runtime-hlf,0.5.6-20170329065851,0.5.6-20170329161359,394,1,359,34,393,16,FALSE
composer-runtime-hlf,0.4.1-20170131180139,0.4.1-20170131180331,18,1,35,37,72,3,FALSE
composer-runtime-hlf,0.5.6-20170321132516,0.5.6-20170321163402,363,1,247,140,387,7,FALSE
composer-runtime-hlf,0.3.11-20170130173458,0.3.11-20170130175300,10,1,37,57,94,28,FALSE
composer-runtime-hlf,0.7.2-20170510103407,0.7.2-20170510135245,552,1,605,379,984,22,FALSE
composer-runtime-hlf,0.5.2-20170316201319,0.5.2,337,1,35,37,72,3,FALSE
composer-runtime-hlf,0.4.4-20170222230901,0.4.4-20170223011633,146,4,203,47,250,7,FALSE
composer-runtime-hlf,0.4.4-20170216154109,0.4.4-20170217094520,121,2,12,12,24,2,FALSE
composer-runtime-hlf,0.4.5-20170228053246,0.4.5-20170228075050,174,2,19,10,29,11,FALSE
composer-runtime-hlf,0.3.10,0.3.11-20170130160915,6,19,11125,1242,12367,501,FALSE
composer-runtime-hlf,0.3.11,0.3.12-20170131190044,13,34,107608,2831,110439,1611,FALSE
composer-runtime-hlf,0.4.4-20170223092750,0.4.4-20170223095537,149,4,90798,754,91552,482,FALSE
composer-runtime-hlf,0.4.1-20170131144110,0.4.1-20170131180139,17,18,1731,1800,3531,220,FALSE
composer-runtime-hlf,0.7.0-20170428090650,0.7.0-20170428111102,494,1,9,5,14,3,FALSE
composer-runtime-hlf,0.4.1-20170202223046,0.4.1-20170203104319,42,8,669,185,854,74,FALSE
composer-runtime-hlf,0.4.5-20170306125832,0.4.5-20170306153357,210,7,752,574,1326,66,FALSE
composer-runtime-hlf,0.7.4-20170530115441,0.7.4-20170530142459,627,1,200,59,259,1,FALSE
composer-runtime-hlf,0.5.2-20170312003519,0.5.2-20170312170113,277,2,51595,227115,278710,2201,FALSE
composer-runtime-hlf,0.4.5-20170227182015,0.4.5-20170227193120,167,3,848,818,1666,42,FALSE
composer-runtime-hlf,0.5.6-20170324170727,0.5.6-20170325121708,379,1,217,45,262,14,FALSE
composer-runtime-hlf,0.4.4-20170215221221,0.4.4-20170215225310,114,2,97,9,106,5,FALSE
composer-runtime-hlf,0.4.5-20170307172308,0.4.5-20170307172449,222,1,35,37,72,3,FALSE
composer-runtime-hlf,0.4.1-20170203233011,0.4.1-20170204102327,53,3,2,2,4,4,FALSE
composer-runtime-hlf,0.5.2-20170316170252,0.5.2-20170316172111,333,2,66,60,126,15,FALSE
composer-runtime-hlf,0.4.1-20170203104408,0.4.1-20170203122454,44,8,148,93,241,65,FALSE
composer-runtime-hlf,0.7.4-20170530052600,0.7.4-20170530074729,623,1,40,17,57,2,FALSE
composer-runtime-hlf,0.4.5-20170308162049,0.4.5-20170308162902,240,1,27,8,35,4,FALSE
composer-runtime-hlf,0.7.0-20170429134507,0.7.0-20170430150534,501,1,5197,428,5625,56,FALSE
composer-runtime-hlf,0.4.4-20170223080308,0.4.4-20170223092750,148,2,703,230,933,20,FALSE
composer-runtime-hlf,0.4.2-20170210072335,0.4.2-20170210112519,81,7,621,518,1139,332,FALSE
composer-runtime-hlf,0.4.4-20170215130619,0.4.4-20170215140741,109,1,3,1,4,1,FALSE
composer-runtime-hlf,0.7.4-20170527112128,0.7.4-20170527115320,616,1,85,107,192,5,FALSE
composer-runtime-hlf,0.5.13-20170425101322,0.5.13-20170425144442,480,1,2,1,3,2,FALSE
composer-runtime-hlf,0.5.2-20170315112253,0.5.2-20170315120404,315,1,13,13,26,4,FALSE
composer-runtime-hlf,0.4.4-20170221173204,0.4.4-20170222142641,138,15,88720,309,89029,452,FALSE
composer-runtime-hlf,0.7.4-20170526042055,0.7.4-20170526142135,613,1,11,0,11,2,FALSE
composer-runtime-hlf,0.4.5-20170228151858,0.4.5-20170228163435,180,4,8077,2277,10354,671,FALSE
composer-runtime-hlf,0.5.6-20170317171321,0.5.6-20170318165009,351,1,35,37,72,3,FALSE
composer-runtime-hlf,0.4.5-20170308233418,0.4.5-20170309002603,252,1,3,2,5,2,FALSE
composer-runtime-hlf,0.5.7-20170405154329,0.5.7-20170405191000,417,1,100,1,101,13,FALSE
composer-runtime-hlf,0.7.2-20170510135245,0.7.2-20170510145522,553,1,31,24,55,83,FALSE
composer-runtime-hlf,0.5.2-20170316141355,0.5.2-20170316144946,329,6,1402,1000,2402,119,FALSE
composer-runtime-hlf,0.5.8-20170407163302,0.5.8-20170408203136,432,1,2,2,4,1,FALSE
composer-runtime-hlf,0.4.5-20170227165156,0.4.5-20170227182015,166,3,423,408,831,22,FALSE
composer-runtime-hlf,0.4.5-20170308230249,0.4.5-20170308233418,251,1,35,37,72,3,FALSE
composer-runtime-hlf,0.4.4-20170213183233,0.4.4-20170213191336,98,2,34,20,54,10,FALSE
composer-runtime-hlf,0.5.6-20170322165404,0.5.6-20170323082204,371,1,712,11,723,27,FALSE
composer-runtime-hlf,0.7.1-20170504214639,0.7.1-20170505075003,526,2,37,37,74,11,FALSE
composer-runtime-hlf,0.5.7-20170405195758,0.5.7-20170405225116,419,1,658,68,726,14,FALSE
composer-runtime-hlf,0.4.1-20170204143115,0.4.1-20170205233716,57,7,49,40,89,13,FALSE
composer-runtime-hlf,0.7.4-20170527115320,0.7.4-20170527142420,617,1,35,37,72,3,FALSE
composer-runtime-hlf,0.4.1-20170203122454,0.4.1-20170203123152,45,1,35,37,72,3,FALSE
composer-runtime-hlf,0.4.5-20170307131531,0.4.5-20170307142217,218,10,2031,207846,209877,640,FALSE
composer-runtime-hlf,0.5.6-20170321163402,0.5.6-20170321165404,364,1,35,37,72,3,FALSE
composer-runtime-hlf,0.5.6-20170330105333,0.5.6-20170330150253,400,1,3,1,4,2,FALSE
composer-runtime-hlf,0.4.2-20170209212225,0.4.2-20170210072335,80,3,264,0,264,15,FALSE
composer-runtime-hlf,0.5.2-20170313164109,0.5.2-20170313164734,293,1,35,37,72,3,FALSE
composer-runtime-hlf,0.4.5-20170304220145,0.4.5-20170305165559,206,1,35,37,72,3,FALSE
composer-runtime-hlf,0.5.3-20170317003003,0.5.3,340,1,35,37,72,3,FALSE
composer-runtime-hlf,0.4.5-20170306113142,0.4.5-20170306125832,209,2,165,36,201,7,FALSE
composer-runtime-hlf,0.7.2-20170510080340,0.7.2-20170510092802,550,1,1707,449,2156,9,FALSE
composer-runtime-hlf,0.7.1-20170504123539,0.7.1-20170504160025,523,1,80,11,91,1,FALSE
composer-runtime-hlf,0.4.5-20170227193120,0.4.5-20170227220209,168,4,7760,12,7772,18,FALSE
composer-runtime-hlf,0.5.6-20170329172715,0.5.6-20170330070544,396,1,292,299,591,16,FALSE
composer-runtime-hlf,0.4.5-20170308224616,0.4.5-20170308230249,250,1,35,37,72,3,FALSE
composer-runtime-hlf,0.5.2-20170316132748,0.5.2-20170316141355,328,3,3002,1768,4770,238,FALSE
composer-runtime-hlf,0.5.2-20170313181004,0.5.2-20170314091451,295,2,440,260,700,29,FALSE
composer-runtime-hlf,0.4.3-20170211170822,0.4.3,92,1,35,37,72,3,FALSE
composer-runtime-hlf,0.5.0-20170310140811,0.5.0-20170310165801,270,9,707,251,958,83,FALSE
composer-runtime-hlf,0.5.7-20170406105358,0.5.7-20170406120956,422,1,1669,516,2185,56,FALSE
composer-runtime-hlf,0.5.2-20170314132030,0.5.2-20170314142206,300,3,1300,89,1389,17,FALSE
composer-runtime-hlf,0.4.5-20170309103452,0.4.5-20170309112355,256,3,135,104,239,15,FALSE
composer-runtime-hlf,0.4.5-20170306165425,0.4.5-20170306171700,212,4,121215,3952,125167,679,FALSE
composer-runtime-hlf,0.4.5-20170308163844,0.4.5-20170308165354,242,1,35,37,72,3,FALSE
composer-runtime-hlf,0.5.13-20170420203045,0.5.13-20170420210947,470,1,233,2,235,2,FALSE
composer-runtime-hlf,0.5.6-20170329161359,0.5.6-20170329172715,395,1,66,29,95,6,FALSE
composer-runtime-hlf,0.4.1-20170131222734,0.4.1-20170131222835,22,1,35,37,72,3,FALSE
composer-runtime-hlf,0.5.13-20170424155417,0.5.13-20170425101322,479,1,147,113,260,12,FALSE
composer-runtime-hlf,0.4.4-20170224133853,0.4.4,155,6,866,1296,2162,121,FALSE
composer-runtime-hlf,0.7.3-20170517185539,0.7.3-20170518103321,585,1,93,80,173,4,FALSE
composer-runtime-hlf,0.7.4-20170529161140,0.7.4-20170530043839,621,1,2184,25,2209,41,FALSE
composer-runtime-hlf,0.4.2-20170206223553,0.4.2-20170207112643,66,7,375,927,1302,76,FALSE
composer-runtime-hlf,0.4.1-20170202071455,0.4.1-20170202095512,31,2,489,96,585,5,FALSE
composer-runtime-hlf,0.5.11-20170411171848,0.5.11-20170412105027,447,1,75,31,106,1,FALSE
composer-runtime-hlf,0.5.13-20170421093118,0.5.13-20170421141512,472,1,68,38,106,1,FALSE
composer-runtime-hlf,0.5.2-20170315133233,0.5.2-20170315145417,317,3,556,286,842,47,FALSE
composer-runtime-hlf,0.5.2-20170312170113,0.5.2-20170312203244,278,4,2436,1765,4201,247,FALSE
composer-runtime-hlf,0.5.2-20170316123938,0.5.2-20170316132748,327,2,1187,719,1906,92,FALSE
composer-runtime-hlf,0.5.2,0.5.3-20170316223823,338,2,174,174,348,50,FALSE
composer-runtime-hlf,0.5.0-20170310095413,0.5.0-20170310140811,269,1,35,37,72,3,FALSE
composer-runtime-hlf,0.4.5-20170228003553,0.4.5-20170228053246,173,1,35,37,72,3,FALSE
composer-runtime-hlf,0.4.4-20170214190006,0.4.4-20170214230354,106,5,1840,8,1848,8,FALSE
composer-runtime-hlf,0.5.2-20170315164951,0.5.2-20170315221517,320,4,87,32,119,16,FALSE
composer-runtime-hlf,0.5.2-20170312210923,0.5.2-20170313083042,280,6,2648,2230,4878,118,FALSE
composer-runtime-hlf,0.4.1-20170131192303,0.4.1-20170131192515,20,1,35,37,72,3,FALSE
composer-runtime-hlf,0.7.0-20170428111102,0.7.0-20170428141114,495,1,124,130,254,12,FALSE
composer-runtime-hlf,0.4.1-20170203104319,0.4.1-20170203104408,43,1,35,37,72,3,FALSE
composer-runtime-hlf,0.5.6-20170331093508,0.5.6-20170331161339,402,1,758,19,777,9,FALSE
composer-runtime-hlf,0.7.2-20170506084056,0.7.2-20170506190618,535,1,87,10,97,4,FALSE
composer-runtime-hlf,0.4.4-20170217094520,0.4.4-20170217111110,122,3,44,6,50,3,FALSE
composer-runtime-hlf,0.5.13-20170427230055,0.7.0-20170428000725,492,1,218,1880,2098,53,FALSE
composer-runtime-hlf,0.4.5-20170301125302,0.4.5-20170301143921,186,4,226,126,352,17,FALSE
composer-runtime-hlf,0.7.0-20170428201639,0.7.0-20170428204746,499,1,8,1,9,1,FALSE
composer-runtime-hlf,0.4.5-20170227230120,0.4.5-20170228000104,171,2,14,5,19,5,FALSE
composer-runtime-hlf,0.4.5-20170309165943,0.4.5-20170309172415,263,1,35,37,72,3,FALSE
composer-runtime-hlf,0.7.2-20170510162533,0.7.2-20170510170851,555,1,11,4,15,2,FALSE
composer-runtime-hlf,0.4.5-20170307102840,0.4.5-20170307114907,216,9,902,5288,6190,205,FALSE
composer-runtime-hlf,0.3.10-20170130140804,0.3.10-20170130152546,4,7,5935,389,6324,278,FALSE
composer-runtime-hlf,0.4.4-20170223011633,0.4.4-20170223080308,147,2,37,13,50,4,FALSE
composer-runtime-hlf,0.4.1-20170203213935,0.4.1-20170203233011,52,3,45,32,77,4,FALSE
composer-runtime-hlf,0.4.5-20170301102843,0.4.5-20170301125302,185,7,41,133,174,15,FALSE
composer-runtime-hlf,0.5.2-20170315092953,0.5.2-20170315095743,311,7,865,270,1135,56,FALSE
composer-runtime-hlf,0.4.1-20170201120902,0.4.1-20170201131837,25,3,2,2,4,2,FALSE
composer-runtime-hlf,0.5.6-20170320125116,0.5.6-20170320143610,356,1,397,38,435,7,FALSE
composer-runtime-hlf,0.5.6-20170322144011,0.5.6-20170322153455,369,1,360,74,434,11,FALSE
composer-runtime-hlf,0.5.6-20170323082204,0.5.6-20170323112438,372,1,91,9,100,1,FALSE
composer-runtime-hlf,0.7.1-20170502083132,0.7.1-20170502123250,507,1,4,4,8,2,FALSE
composer-runtime-hlf,0.4.2-20170207112643,0.4.2-20170207233353,67,4,14020,29,14049,74,FALSE
composer-runtime-hlf,0.5.6-20170321093733,0.5.6-20170321102551,360,1,0,16,16,2,FALSE
composer-runtime-hlf,0.7.1-20170501205612,0.7.1-20170502072833,505,1,36,36,72,3,FALSE
composer-runtime-hlf,0.5.10-20170409232614,0.5.10-20170410103131,438,1,78,32,110,5,FALSE
composer-runtime-hlf,0.7.3-20170523204533,0.7.3-20170524092303,597,1,117,16,133,7,FALSE
composer-runtime-hlf,0.5.3-20170316223823,0.5.3-20170317003003,339,3,52,54,106,8,FALSE
composer-runtime-hlf,0.7.3-20170523201332,0.7.3-20170523204533,596,1,0,151,151,9,FALSE
composer-runtime-hlf,0.4.2-20170209100742,0.4.2-20170209111808,74,14,521,219,740,185,FALSE
composer-runtime-hlf,0.4.5-20170309133051,0.4.5-20170309140844,258,1,181,4,185,13,FALSE
composer-runtime-hlf,0.4.1-20170201183738,0.4.1-20170201184136,28,1,35,37,72,3,FALSE
composer-runtime-hlf,0.4.4-20170214121537,0.4.4-20170214135606,102,3,232,39,271,18,FALSE
composer-runtime-hlf,0.4.5-20170306153357,0.4.5-20170306165425,211,9,1135,613,1748,99,FALSE
composer-runtime-hlf,0.5.0-20170310165801,0.5.0-20170311090653,271,2,155,124,279,30,FALSE
composer-runtime-hlf,0.7.3-20170518131232,0.7.3-20170518135130,588,1,1079,110,1189,5,FALSE
composer-runtime-hlf,0.4.5-20170309201406,0.4.5-20170309212740,265,2,283,37,320,26,FALSE
composer-runtime-hlf,0.4.5-20170303100755,0.4.5-20170303110503,196,3,1016,1976,2992,78,FALSE
composer-runtime-hlf,0.5.6-20170320165206,0.5.6-20170320175009,358,1,202,11,213,2,FALSE
composer-runtime-hlf,0.4.2-20170210173439,0.4.2-20170210181945,86,1,35,37,72,3,FALSE
composer-runtime-hlf,0.4.5-20170306171700,0.4.5-20170306190519,213,3,790,343,1133,55,FALSE
composer-runtime-hlf,0.7.1-20170505101424,0.7.1-20170505135229,529,2,21,8,29,7,FALSE
composer-runtime-hlf,0.3.9-20170130110740,0.3.9-20170130133543,1,3,7862,33,7895,150,FALSE
composer-runtime-hlf,0.4.4-20170215212457,0.4.4-20170215221221,113,2,2455,110,2565,34,FALSE
composer-runtime-hlf,0.7.3-20170516211022,0.7.3-20170517094659,578,1,0,8,8,2,FALSE
composer-runtime-hlf,0.4.2-20170210112519,0.4.2-20170210130108,82,4,977,175509,176486,775,FALSE
composer-runtime-hlf,0.7.2-20170511184348,0.7.2-20170512065403,565,1,35,37,72,3,FALSE
composer-runtime-hlf,0.4.0-20170130215557,0.4.0,15,1,35,37,72,3,FALSE
composer-runtime-hlf,0.5.6-20170401084624,0.5.6-20170401095849,404,1,27,1,28,2,FALSE
composer-runtime-hlf,0.4.4-20170223141017,0.4.4-20170223164152,153,1,26,26,52,26,FALSE
composer-runtime-hlf,0.4.4-20170213191336,0.4.4-20170214073109,99,7,118,35,153,19,TRUE
composer-runtime-hlf,0.5.8-20170407140006,0.5.8-20170407163302,431,1,5,2,7,3,TRUE
composer-runtime-hlf,0.5.2-20170312210923,0.5.2-20170313083042,280,6,2648,2230,4878,118,TRUE
composer-runtime-hlf,0.5.6-20170328172301,0.5.6-20170329065851,393,1,293,1,294,7,TRUE
composer-runtime-hlf,0.4.5-20170307114907,0.4.5-20170307131531,217,6,1903,504,2407,75,TRUE
composer-runtime-hlf,0.4.5-20170228171523,0.4.5-20170301073428,183,6,8903,2710,11613,703,TRUE
composer-runtime-hlf,0.7.3-20170518201536,0.7.3-20170519124107,591,1,5,1,6,1,TRUE
composer-runtime-hlf,0.7.3-20170515142750,0.7.3-20170516211022,577,1,488,40,528,11,TRUE
composer-runtime-hlf,0.4.5-20170307231805,0.4.5-20170308102441,227,4,3076,1128,4204,72,TRUE
composer-runtime-hlf,0.5.8-20170408203136,0.5.8,433,1,35,37,72,3,TRUE
composer-runtime-hlf,0.4.5-20170228123838,0.4.5-20170228133305,178,2,1388,792,2180,55,TRUE
composer-runtime-hlf,0.7.2-20170506190618,0.7.2-20170507111349,536,1,445,6,451,11,TRUE
composer-runtime-hlf,0.7.3-20170513161412,0.7.3-20170514112333,573,1,376,2,378,4,TRUE
composer-runtime-hlf,0.7.3-20170515093334,0.7.3-20170515142750,576,1,1,1,2,1,TRUE
composer-runtime-hlf,0.5.6-20170328152710,0.5.6-20170328172301,392,1,408,39,447,2,TRUE
composer-runtime-hlf,0.5.6-20170401095849,0.5.6-20170402192220,405,1,13,0,13,2,TRUE
composer-runtime-hlf,0.4.5-20170309212740,0.4.5-20170310112516,266,2,190,198,388,50,TRUE
composer-runtime-hlf,0.5.6-20170318165009,0.5.6-20170319165038,352,1,35,37,72,3,TRUE
composer-runtime-hlf,0.4.5-20170301153907,0.4.5-20170301164949,188,4,450,220,670,22,TRUE
composer-runtime-hlf,0.4.5,0.5.0-20170310095413,268,238,590753,2249232,2839985,9949,TRUE
composer-runtime-hlf,0.4.5-20170308210152,0.4.5-20170308223539,247,7,2493,159,2652,101,TRUE
composer-runtime-hlf,0.4.5-20170302190028,0.4.5-20170302225038,194,2,273,88531,88804,196,TRUE
composer-runtime-hlf,0.5.2-20170316175024,0.5.2-20170316191301,335,2,32,28,60,10,TRUE
composer-runtime-hlf,0.5.6-20170330150253,0.5.6-20170331093508,401,1,4,4,8,1,TRUE
composer-runtime-hlf,0.5.6-20170324170727,0.5.6-20170325121708,379,1,217,45,262,14,TRUE
composer-runtime-hlf,0.4.5-20170228151858,0.4.5-20170228163435,180,4,8077,2277,10354,671,TRUE
composer-runtime-hlf,0.5.6-20170322165404,0.5.6-20170323082204,371,1,712,11,723,27,TRUE
composer-runtime-hlf,0.4.5-20170304220145,0.4.5-20170305165559,206,1,35,37,72,3,TRUE
composer-runtime-hlf,0.5.0-20170310165801,0.5.0-20170311090653,271,2,155,124,279,30,TRUE
mservice-social,1.1.0,1.2.0,2,2,6,10,16,4,FALSE
mservice-social,1.0.0,1.1.0,1,14,849,289,1138,68,FALSE
mservice-social,2.0.0,2.1.0,18,2,101,27,128,5,FALSE
mservice-social,2.2.1,2.2.2,27,1,295,267,562,17,FALSE
mservice-social,2.2.0,2.2.1,26,1,5,2,7,2,FALSE
mservice-social,2.2.3,2.3.0,29,1,188,92,280,6,FALSE
mservice-social,2.2.2,2.2.3,28,1,110,9,119,5,FALSE
mservice-social,2.1.2,2.1.3,21,2,151,66,217,3,FALSE
mservice-social,2.1.3,2.1.4,22,1,1,3,4,1,FALSE
mservice-social,2.1.0,2.1.1,19,1,1,1,2,1,FALSE
mservice-social,2.1.1,2.1.2,20,6,12,8,20,6,FALSE
mservice-social,2.1.6,2.2.0,25,1,2469,786,3255,66,FALSE
mservice-social,2.1.4,2.1.5,23,1,5,2,7,1,FALSE
mservice-social,2.1.5,2.1.6,24,1,7,1,8,2,FALSE
mservice-social,1.6.0,1.7.0,9,4,57,39,96,5,FALSE
mservice-social,1.9.1,1.9.2,14,2,21,13,34,3,FALSE
mservice-social,1.9.0,1.9.1,13,2,7,3,10,2,FALSE
mservice-social,1.9.3,1.9.4,16,1,43,23,66,9,FALSE
mservice-social,1.9.2,1.9.3,15,1,25,30,55,2,FALSE
mservice-social,1.8.0,1.9.0,12,1,38,1,39,2,FALSE
mservice-social,1.9.4,2.0.0,17,1,1743,162,1905,44,FALSE
mservice-social,1.7.1,1.8.0,11,2,131,65,196,7,FALSE
mservice-social,1.7.0,1.7.1,10,1,1,6,7,1,FALSE
mservice-social,1.4.0,1.5.0,7,2,111,19,130,6,FALSE
mservice-social,2.3.0,2.3.1,30,1,3,0,3,2,FALSE
mservice-social,2.3.1,2.3.2,31,1,1,1,2,1,FALSE
mservice-social,2.3.2,2.3.3,32,1,91,86,177,11,FALSE
mservice-social,2.3.3,2.4.0,33,1,81,1,82,3,FALSE
mservice-social,1.5.0,1.6.0,8,1,106,6,112,6,FALSE
mservice-social,1.3.1,1.4.0,6,1,67,16,83,5,FALSE
mservice-social,1.3.0,1.3.1,5,1,8,3,11,4,FALSE
mservice-social,1.2.0,1.2.1,3,1,5,5,10,2,FALSE
mservice-social,1.2.1,1.3.0,4,1,9,4,13,3,FALSE
mservice-social,2.4.0,2.5.0,34,1,10,5,15,3,FALSE
mservice-social,2.5.0,2.6.0,35,1,15,11,26,8,FALSE
mservice-social,2.6.1,2.6.2,37,2,18,9,27,4,FALSE
mservice-social,2.6.0,2.6.1,36,1,6,1,7,1,FALSE
mservice-social,2.6.2,2.7.0,38,3,4144,39,4183,23,FALSE
mservice-social,2.7.0,2.7.1,39,1,3,7,10,1,FALSE
mservice-social,2.7.1,2.7.2,40,1,38,15,53,3,FALSE
mservice-social,2.7.2,2.7.3,41,2,27,27,54,2,FALSE
mservice-social,2.7.1,2.7.2,40,1,38,15,53,3,TRUE
mservice-social,2.6.1,2.6.2,37,2,18,9,27,4,TRUE
mservice-social,1.7.1,1.8.0,11,2,131,65,196,7,TRUE
mservice-social,1.9.2,1.9.3,15,1,25,30,55,2,TRUE
mservice-social,2.0.0,2.1.0,18,2,101,27,128,5,TRUE
mservice-social,2.1.1,2.1.2,20,6,12,8,20,6,TRUE
mservice-social,1.9.3,1.9.4,16,1,43,23,66,9,TRUE
mservice-social,2.3.2,2.3.3,32,1,91,86,177,11,TRUE
mservice-social,1.6.0,1.7.0,9,4,57,39,96,5,TRUE
mservice-social,2.6.2,2.7.0,38,3,4144,39,4183,23,TRUE
mservice-social,1.9.4,2.0.0,17,1,1743,162,1905,44,TRUE
volubile-ui,0.0.5,0.0.6,5,4,367,2392,2759,34,FALSE
volubile-ui,0.0.4,0.0.5,4,4,6,15,21,5,FALSE
volubile-ui,0.0.7,0.0.8,7,1,16,21,37,7,FALSE
volubile-ui,0.0.6,0.0.7,6,3,110,25,135,6,FALSE
volubile-ui,0.0.1,0.0.2,1,1,1,1,2,1,FALSE
volubile-ui,0.0.3,0.0.4,3,3,6,6,12,5,FALSE
volubile-ui,0.0.2,0.0.3,2,2,113,2,115,9,FALSE
volubile-ui,0.0.9,0.0.10,9,2,5,82,87,7,FALSE
volubile-ui,0.0.8,0.0.9,8,1,1,1,2,1,FALSE
volubile-ui,0.0.15,0.0.16,14,2,3,3,6,3,FALSE
volubile-ui,0.0.17,0.1.0,16,3,10,5,15,5,FALSE
volubile-ui,0.0.16,0.0.17,15,1,6,3,9,1,FALSE
volubile-ui,0.0.11,0.0.12,11,2,20,2,22,3,FALSE
volubile-ui,0.0.10,0.0.11,10,3,87,17,104,16,FALSE
volubile-ui,0.0.13,0.0.15,13,4,28,16,44,20,FALSE
volubile-ui,0.0.12,0.0.13,12,1,1,1,2,1,FALSE
volubile-ui,0.1.0,0.1.1,17,2,1,7,8,2,FALSE
volubile-ui,0.1.1,0.1.2,18,2,2,2,4,2,FALSE
volubile-ui,0.1.2,0.1.3,19,1,1,1,2,1,FALSE
volubile-ui,0.0.17,0.1.0,16,3,10,5,15,5,TRUE
volubile-ui,0.0.7,0.0.8,7,1,16,21,37,7,TRUE
volubile-ui,0.0.5,0.0.6,5,4,367,2392,2759,34,TRUE
deploy-lambda,1.0.4,1.0.5,7,2,8,33,41,4,FALSE
deploy-lambda,1.0.5,1.1.0,8,3,8,4,12,4,FALSE
deploy-lambda,1.0.0,1.0.1,3,2,4,4,8,3,FALSE
deploy-lambda,1.0.1,1.0.2,4,2,23,2,25,2,FALSE
deploy-lambda,1.0.2,1.0.3,5,5,2670,84,2754,159,FALSE
deploy-lambda,1.0.3,1.0.4,6,5,197,47,244,11,FALSE
deploy-lambda,1.1.0,1.2.0,9,2,7,13,20,6,FALSE
deploy-lambda,0.0.2,1.0.0,2,2,74,16,90,6,FALSE
deploy-lambda,0.0.1,0.0.2,1,12,1363,193,1556,91,FALSE
deploy-lambda,0.0.1,0.0.2,1,12,1363,193,1556,91,TRUE
generator-spira,0.0.0,0.1.0,1,1,1,1,2,1,FALSE
generator-spira,0.3.0,0.3.1,17,3,4,4,8,4,FALSE
generator-spira,0.3.1,0.3.2,18,5,5,5,10,5,FALSE
generator-spira,0.2.7,0.2.8,15,5,7,7,14,6,FALSE
generator-spira,0.2.6,0.2.7,14,4,158,4,162,8,FALSE
generator-spira,0.2.5,0.2.6,13,3,3,1,4,3,FALSE
generator-spira,0.2.4,0.2.5,12,3,17,7,24,3,FALSE
generator-spira,0.2.3,0.2.4,11,3,11,1,12,3,FALSE
generator-spira,0.2.2,0.2.3,10,8,99,31,130,18,FALSE
generator-spira,0.2.1,0.2.2,9,2,6,6,12,4,FALSE
generator-spira,0.2.0,0.2.1,8,4,79,44,123,15,FALSE
generator-spira,0.1.0,0.1.1,2,1,54,49,103,3,FALSE
generator-spira,0.1.1,0.1.2,3,7,20,16,36,9,FALSE
generator-spira,0.1.2,0.1.3,4,3,7,2,9,3,FALSE
generator-spira,0.1.3,0.1.4,5,1,2,7,9,2,FALSE
generator-spira,0.1.4,0.1.5,6,1,3,3,6,2,FALSE
generator-spira,0.1.5,0.2.0,7,5,109,74,183,20,FALSE
generator-spira,0.2.8,0.3.0,16,2,22,12,34,10,FALSE
generator-spira,0.2.4,0.2.5,12,3,17,7,24,3,TRUE
generator-spira,0.2.6,0.2.7,14,4,158,4,162,8,TRUE
lightstream-socket,0.4.1,0.4.2,8,2,37,29,66,4,FALSE
lightstream-socket,0.4.0,0.4.1,7,2,127,15,142,6,FALSE
lightstream-socket,0.4.3,0.4.4,10,2,26,26,52,4,FALSE
lightstream-socket,0.4.2,0.4.3,9,2,3,7,10,2,FALSE
lightstream-socket,0.4.5,0.5.0,12,1,36,2,38,5,FALSE
lightstream-socket,0.4.4,0.4.5,11,3,119,22,141,6,FALSE
lightstream-socket,0.3.2,0.4.0,6,2,107,119,226,5,FALSE
lightstream-socket,0.3.1,0.3.2,5,3,9,30,39,4,FALSE
lightstream-socket,0.1.1,0.2.0,2,2,41,26,67,6,FALSE
lightstream-socket,0.3.0,0.3.1,4,3,137,48,185,9,FALSE
lightstream-socket,0.2.0,0.3.0,3,3,135,97,232,8,FALSE
lightstream-socket,0.1.0,0.1.1,1,2,35,28,63,7,FALSE
lightstream-socket,0.3.1,0.3.2,5,3,9,30,39,4,TRUE
lightstream-socket,0.4.3,0.4.4,10,2,26,26,52,4,TRUE
gcloud,0.15.0,0.16.0,25,42,7515,636,8151,138,FALSE
gcloud,0.19.0,0.19.1,29,7,35,25,60,9,FALSE
gcloud,0.19.1,0.20.0,30,4,22383,1979,24362,71,FALSE
gcloud,0.17.0,0.18.0,27,17,975,1626,2601,145,FALSE
gcloud,0.12.0,0.13.1,21,122,8525,2415,10940,317,FALSE
gcloud,0.14.0,0.15.0,24,102,4867,1993,6860,335,FALSE
gcloud,0.16.0,0.17.0,26,100,17608,5301,22909,398,FALSE
gcloud,0.18.0,0.19.0,28,28,3135,949,4084,152,FALSE
gcloud,0.13.2,0.14.0,23,44,5614,2335,7949,207,FALSE
gcloud,0.13.1,0.13.2,22,6,14,9,23,6,FALSE
gcloud,0.31.0,0.32.0,48,29,4813,3773,8586,189,FALSE
gcloud,0.37.0,0.37.1,54,600,87718,29513,117231,2309,FALSE
gcloud,0.37.1,0.37.2,55,1,1,1,2,1,FALSE
gcloud,0.36.0,0.37.0,53,26,10048,868,10916,81,FALSE
gcloud,0.35.0,0.36.0,52,14,490,115,605,28,FALSE
gcloud,0.34.0,0.35.0,51,7,1368,539,1907,46,FALSE
gcloud,0.20.0,0.21.0,31,38,2669,3655,6324,126,FALSE
gcloud,0.32.0,0.33.0,49,15,956,466,1422,48,FALSE
gcloud,0.23.0,0.24.0,34,13,549,377,926,25,FALSE
gcloud,0.22.0,0.23.0,33,17,409,259,668,35,FALSE
gcloud,0.24.0,0.24.1,35,10,527,55,582,16,FALSE
gcloud,0.24.1,0.25.0,36,38,16901,14045,30946,191,FALSE
gcloud,0.25.1,0.26.0,38,55,3590,1499,5089,131,FALSE
gcloud,0.25.0,0.25.1,37,7,77,29,106,9,FALSE
gcloud,0.21.0,0.22.0,32,19,4662,878,5540,180,FALSE
gcloud,0.29.0,0.30.0,43,36,11868,10050,21918,160,FALSE
gcloud,0.26.0,0.26.1,39,5,73,65,138,23,FALSE
gcloud,0.26.1,0.27.0,40,24,13567,256,13823,113,FALSE
gcloud,0.28.0,0.29.0,42,30,13955,1615,15570,199,FALSE
gcloud,0.27.0,0.28.0,41,62,5449,12514,17963,390,FALSE
gcloud,0.33.0,0.34.0,50,12,2402,533,2935,40,FALSE
gcloud,0.30.3,0.31.0,47,30,4412,375,4787,79,FALSE
gcloud,0.30.2,0.30.3,46,18,990,185,1175,69,FALSE
gcloud,0.30.1,0.30.2,45,8,154,50,204,14,FALSE
gcloud,0.30.0,0.30.1,44,5,149,13,162,7,FALSE
gcloud,0.15.0,0.16.0,25,42,7515,636,8151,138,TRUE
gcloud,0.10.0,0.11.0,19,53,4912,2982,7894,182,FALSE
gcloud,0.11.0,0.12.0,20,39,6331,1919,8250,193,FALSE
gcloud,0.7.0,0.7.1,14,2,2,1,3,2,FALSE
gcloud,0.7.1,0.8.0,15,23,8564,2694,11258,94,FALSE
gcloud,0.9.0,0.10.0,18,17,9166,137,9303,61,FALSE
gcloud,0.8.1,0.9.0,17,22,5792,2257,8049,61,FALSE
gcloud,0.8.0,0.8.1,16,7,1064,584,1648,11,FALSE
gcloud,0.6.0,0.7.0,13,37,2493,5646,8139,152,FALSE
gcloud,0.4.0,0.5.0,11,61,10957,18884,29841,208,FALSE
gcloud,0.5.0,0.6.0,12,33,709,320,1029,57,FALSE
gcloud,0.2.0,0.3.0,9,30,5224,1544,6768,83,FALSE
gcloud,0.1.0,0.1.1,7,27,1197,649,1846,71,FALSE
gcloud,0.1.1,0.2.0,8,32,3330,2681,6011,157,FALSE
gcloud,0.0.5,0.0.6,5,42,2668,227,2895,63,FALSE
gcloud,0.0.6,0.1.0,6,24,522,294,816,47,FALSE
gcloud,0.0.3,0.0.4,3,31,349,104,453,41,FALSE
gcloud,0.0.2,0.0.3,2,8,102,20,122,10,FALSE
gcloud,0.3.0,0.4.0,10,39,20033,2317,22350,154,FALSE
gcloud,0.0.4,0.0.5,4,4,8,12,20,8,FALSE
gcloud,0.10.0,0.11.0,19,53,4912,2982,7894,182,TRUE
gcloud,0.3.0,0.4.0,10,39,20033,2317,22350,154,TRUE
gcloud,0.24.1,0.25.0,36,38,16901,14045,30946,191,TRUE
gcloud,0.23.0,0.24.0,34,13,549,377,926,25,TRUE
gcloud,0.4.0,0.5.0,11,61,10957,18884,29841,208,TRUE
gcloud,0.19.0,0.19.1,29,7,35,25,60,9,TRUE
gcloud,0.21.0,0.22.0,32,19,4662,878,5540,180,TRUE
gcloud,0.30.1,0.30.2,45,8,154,50,204,14,TRUE
gcloud,0.35.0,0.36.0,52,14,490,115,605,28,TRUE
gcloud,0.22.0,0.23.0,33,17,409,259,668,35,TRUE
gcloud,0.18.0,0.19.0,28,28,3135,949,4084,152,TRUE
gcloud,0.0.5,0.0.6,5,42,2668,227,2895,63,TRUE
gcloud,0.11.0,0.12.0,20,39,6331,1919,8250,193,TRUE
gcloud,0.2.0,0.3.0,9,30,5224,1544,6768,83,TRUE
gcloud,0.26.1,0.27.0,40,24,13567,256,13823,113,TRUE
gcloud,0.26.0,0.26.1,39,5,73,65,138,23,TRUE
socket-io-mocks,0.1.2,0.1.3,1,2,5,5,10,2,FALSE
socket-io-mocks,0.1.3,0.1.4,2,3,11,7,18,5,FALSE
socket-io-mocks,0.1.4,0.1.5,3,2,5,3,8,2,FALSE
socket-io-mocks,0.1.3,0.1.4,2,3,11,7,18,5,TRUE
entman,0.3.1,0.3.2,8,24,20656,19544,40200,57,FALSE
entman,0.3.2,0.3.3,9,9,176,90,266,9,FALSE
entman,0.3.3,0.4.0,10,11,1888,1283,3171,43,FALSE
entman,0.3.0,0.3.1,7,2,8,8,16,6,FALSE
entman,0.6.0,1.0.0,16,5,57,15,72,7,FALSE
entman,0.2.5,0.3.0,6,4,76,44,120,14,FALSE
entman,0.2.4,0.2.5,5,5,7,3,10,7,FALSE
entman,0.2.3,0.2.4,4,2,6,2,8,4,FALSE
entman,0.2.2,0.2.3,3,5,83,17,100,14,FALSE
entman,0.2.1,0.2.2,2,8,400,340,740,17,FALSE
entman,0.2.0,0.2.1,1,8,28,34940,34968,17,FALSE
entman,0.4.1,0.4.2,12,2,18,12,30,10,FALSE
entman,0.4.0,0.4.1,11,7,195,99,294,29,FALSE
entman,0.4.3,0.5.0,14,3,27,10,37,5,FALSE
entman,0.4.2,0.4.3,13,3,29,13,42,7,FALSE
entman,0.5.0,0.6.0,15,2,26,12,38,5,FALSE
entman,0.2.1,0.2.2,2,8,400,340,740,17,TRUE
entman,0.2.2,0.2.3,3,5,83,17,100,14,TRUE
entman,0.4.3,0.5.0,14,3,27,10,37,5,TRUE
entman,0.3.2,0.3.3,9,9,176,90,266,9,TRUE
entman,0.4.1,0.4.2,12,2,18,12,30,10,TRUE
entman,0.4.0,0.4.1,11,7,195,99,294,29,TRUE
entman,0.3.3,0.4.0,10,11,1888,1283,3171,43,TRUE
markscript-uservices,0.1.0,0.1.1,1,2,20,7,27,7,FALSE
markscript-uservices,0.1.1,0.2.0,2,1,648,81,729,37,TRUE
markscript-uservices,0.1.1,0.2.0,2,1,648,81,729,37,FALSE
markscript-uservices,0.2.0,0.3.0,3,1,21,23,44,6,FALSE
react-themed,3.0.0,3.1.0,7,6,418,104,522,12,FALSE
react-themed,1.0.0,1.0.1,1,2,36,19,55,2,FALSE
react-themed,1.0.1,2.0.0,2,10,406,114,520,22,FALSE
react-themed,2.0.0,2.1.0,3,3,182,46,228,8,FALSE
react-themed,2.2.1,3.0.0,6,17,1084,703,1787,45,FALSE
react-themed,2.2.0,2.2.1,5,2,305,281,586,9,FALSE
react-themed,2.1.0,2.2.0,4,4,59,55,114,4,FALSE
react-themed,2.1.0,2.2.0,4,4,59,55,114,4,TRUE
react-themed,2.0.0,2.1.0,3,3,182,46,228,8,TRUE
react-themed,1.0.1,2.0.0,2,10,406,114,520,22,TRUE
react-themed,2.2.1,3.0.0,6,17,1084,703,1787,45,TRUE
kettle-ui,1.1.0,2.0.0,3,2,28,64,92,5,FALSE
kettle-ui,3.1.0,3.2.0,19,2,222,12,234,5,FALSE
kettle-ui,1.0.1,1.1.0,2,2,136,14,150,9,TRUE
kettle-ui,3.0.0,3.1.0,18,2,4,1,5,3,FALSE
kettle-ui,2.0.0,2.1.0,4,2,56,11,67,3,FALSE
kettle-ui,2.2.1,2.3.0,8,2,46,9,55,4,FALSE
kettle-ui,2.2.0,2.2.1,7,2,2,1,3,2,TRUE
kettle-ui,2.1.0,2.1.1,5,2,3,2,5,2,FALSE
kettle-ui,2.1.1,2.2.0,6,3,317,29,346,11,FALSE
kettle-ui,3.6.1,3.6.2,26,1,1,1,2,1,FALSE
kettle-ui,2.3.0,2.3.1,9,2,4,3,7,2,FALSE
kettle-ui,2.3.1,2.4.0,10,2,136,9,145,5,FALSE
kettle-ui,2.4.0,2.5.0,11,2,103,2,105,4,FALSE
kettle-ui,2.5.2,2.6.0,14,2,91,2,93,4,FALSE
kettle-ui,2.5.0,2.5.1,12,2,2,2,4,2,FALSE
kettle-ui,2.5.1,2.5.2,13,2,13,4,17,3,FALSE
kettle-ui,3.4.0,3.5.0,23,2,10,2,12,2,FALSE
kettle-ui,2.6.1,2.6.2,16,2,8,1,9,3,FALSE
kettle-ui,2.6.0,2.6.1,15,2,3,3,6,2,FALSE
kettle-ui,2.6.2,3.0.0,17,2,34,83,117,5,FALSE
kettle-ui,3.5.0,3.6.0,24,3,29,1,30,3,FALSE
kettle-ui,3.6.0,3.6.1,25,2,7,7,14,2,FALSE
kettle-ui,3.3.0,3.4.0,22,2,17,4,21,2,FALSE
kettle-ui,3.6.2,3.6.3,27,1,4,4,8,2,FALSE
kettle-ui,3.2.0,3.2.1,20,2,2,2,4,2,FALSE
kettle-ui,3.2.1,3.3.0,21,2,45,1,46,3,FALSE
kettle-ui,1.0.1,1.1.0,2,2,136,14,150,9,FALSE
kettle-ui,2.2.0,2.2.1,7,2,2,1,3,2,FALSE
kettle-ui,3.8.0,3.9.0,34,2,32,8,40,4,FALSE
kettle-ui,3.9.0,3.10.0,35,2,142,98,240,5,FALSE
kettle-ui,3.6.3,3.6.4,28,2,9,6,15,2,FALSE
kettle-ui,3.6.4,3.7.0,29,3,1958,311,2269,13,FALSE
kettle-ui,3.7.1,3.7.2,31,2,5,5,10,3,FALSE
kettle-ui,3.7.0,3.7.1,30,2,13,36,49,4,FALSE
kettle-ui,3.7.3,3.8.0,33,2,3,1,4,3,FALSE
kettle-ui,3.7.2,3.7.3,32,2,2,2,4,2,FALSE
kettle-ui,1.0.0,1.0.1,1,2,16,15,31,2,FALSE
kettle-ui,3.1.0,3.2.0,19,2,222,12,234,5,TRUE
listy,1.0.4,1.0.5,4,2,3,4,7,2,FALSE
listy,1.0.2,1.0.3,2,3,80,20,100,6,FALSE
listy,1.0.3,1.0.4,3,4,28,31,59,4,FALSE
listy,1.0.5,1.0.6,5,1,3,4,7,2,FALSE
listy,1.0.6,1.1.0,6,5,9,8,17,5,FALSE
listy,1.0.1,1.0.2,1,2,22,19,41,6,FALSE
listy,2.0.1,2.0.2,11,2,3,3,6,2,FALSE
listy,1.1.0,1.1.1,7,1,6,2,8,2,FALSE
listy,2.0.0,2.0.1,10,2,95,172,267,10,FALSE
listy,1.1.1,1.2.0,8,2,4,4,8,2,TRUE
listy,1.2.0,2.0.0,9,3,23,4,27,3,FALSE
listy,2.1.0,2.1.1,13,2,4,4,8,2,FALSE
listy,2.0.2,2.1.0,12,9,33,23,56,12,FALSE
listy,1.1.1,1.2.0,8,2,4,4,8,2,FALSE
listy,1.1.0,1.1.1,7,1,6,2,8,2,TRUE
gaer,0.9.0,0.9.2,7,3,14,12,26,7,FALSE
gaer,0.10.0,0.10.1,10,4,42,8,50,4,FALSE
gaer,0.9.2,0.9.3,8,2,2,2,4,2,FALSE
gaer,0.9.3,0.10.0,9,13,288,163,451,28,TRUE
gaer,0.0.1,0.1.0,1,4,126,44,170,6,FALSE
gaer,0.6.0,0.7.0,5,7,54,10,64,12,FALSE
gaer,0.7.0,0.9.0,6,8,70,49,119,14,FALSE
gaer,0.10.2,0.11.0,12,3,6,4,10,3,FALSE
gaer,0.1.0,0.4.0,2,12,149,120,269,16,FALSE
gaer,0.4.0,0.5.0,3,3,58,32,90,4,FALSE
gaer,0.5.0,0.6.0,4,5,81,11,92,7,FALSE
gaer,0.10.1,0.10.2,11,2,2,2,4,2,FALSE
gaer,0.9.3,0.10.0,9,13,288,163,451,28,FALSE
d3-funnel,0.6.9,0.6.10,7,8,1925,1956,3881,21,FALSE
d3-funnel,0.6.8,0.6.9,6,12,528,438,966,40,FALSE
d3-funnel,1.0.0,1.0.1,21,30,24395,1271,25666,67,FALSE
d3-funnel,0.7.6,0.7.7,18,7,1071,313,1384,20,FALSE
d3-funnel,0.7.7,0.8.0,19,16,655,279,934,50,FALSE
d3-funnel,0.7.4,0.7.5,16,18,246,116,362,35,FALSE
d3-funnel,0.7.5,0.7.6,17,40,828,438,1266,76,FALSE
d3-funnel,0.7.2,0.7.3,14,1,17,17,34,3,FALSE
d3-funnel,0.7.3,0.7.4,15,11,1255,1084,2339,22,FALSE
d3-funnel,0.7.0,0.7.1,12,26,356,122,478,35,FALSE
d3-funnel,0.7.1,0.7.2,13,24,469,327,796,33,FALSE
d3-funnel,0.8.0,1.0.0,20,11,3641,147,3788,26,FALSE
d3-funnel,0.6.13,0.7.0,11,22,1639,1031,2670,74,FALSE
d3-funnel,0.6.12,0.6.13,10,30,819,382,1201,56,FALSE
d3-funnel,0.6.11,0.6.12,9,50,3027,2037,5064,116,FALSE
d3-funnel,0.6.10,0.6.11,8,42,648,390,1038,73,FALSE
d3-funnel,0.7.2,0.7.3,14,1,17,17,34,3,TRUE
d3-funnel,0.6.3,0.6.4,1,13,1212,166,1378,38,FALSE
d3-funnel,0.6.7,0.6.8,5,9,605,593,1198,18,FALSE
d3-funnel,0.6.6,0.6.7,4,6,435,277,712,21,FALSE
d3-funnel,0.6.5,0.6.6,3,1,3,6,9,3,FALSE
d3-funnel,0.6.4,0.6.5,2,3,7,10,17,3,FALSE
d3-funnel,0.8.0,1.0.0,20,11,3641,147,3788,26,TRUE
d3-funnel,0.7.7,0.8.0,19,16,655,279,934,50,TRUE
typescript-map,0.0.1,0.0.2,1,1,56,56,112,6,FALSE
typescript-map,0.0.2,0.0.3,2,1,309,39,348,8,FALSE
typescript-map,0.0.2,0.0.3,2,1,309,39,348,8,TRUE
aurelia-ux,0.1.12,0.1.13,13,2,95,50,145,26,FALSE
aurelia-ux,0.1.13,0.1.14,14,3,31,31,62,25,FALSE
aurelia-ux,0.1.10,0.1.11,11,3,5048,111,5159,92,FALSE
aurelia-ux,0.1.11,0.1.12,12,2,27,2,29,3,FALSE
aurelia-ux,0.1.16,0.1.17,17,18,8697,2590,11287,452,FALSE
aurelia-ux,0.1.17,0.1.18,18,12,4244,73,4317,146,FALSE
aurelia-ux,0.1.14,0.1.15,15,14,561,49,610,66,FALSE
aurelia-ux,0.1.15,0.1.16,16,10,3878,44,3922,127,FALSE
aurelia-ux,0.1.18,0.1.19,19,19,3081,648,3729,120,FALSE
aurelia-ux,0.1.19,0.2.0,20,8,28022,78,28100,94,FALSE
aurelia-ux,0.1.8,0.1.9,9,3,81,55,136,17,FALSE
aurelia-ux,0.1.9,0.1.10,10,2,12,12,24,12,FALSE
aurelia-ux,0.1.0,0.1.1,1,7,650,2244,2894,102,FALSE
aurelia-ux,0.1.1,0.1.2,2,1,7,7,14,7,FALSE
aurelia-ux,0.1.2,0.1.3,3,2,140,8,148,7,FALSE
aurelia-ux,0.1.3,0.1.4,4,2,7,7,14,7,FALSE
aurelia-ux,0.1.4,0.1.5,5,2,17,17,34,7,FALSE
aurelia-ux,0.1.5,0.1.6,6,2,91,5,96,12,FALSE
aurelia-ux,0.1.6,0.1.7,7,1,7,7,14,3,FALSE
aurelia-ux,0.1.7,0.1.8,8,4,18,14,32,8,FALSE
aurelia-ux,0.1.18,0.1.19,19,19,3081,648,3729,120,TRUE
aurelia-ux,0.1.12,0.1.13,13,2,95,50,145,26,TRUE
aurelia-ux,0.1.10,0.1.11,11,3,5048,111,5159,92,TRUE
aurelia-ux,0.1.16,0.1.17,17,18,8697,2590,11287,452,TRUE
aurelia-ux,0.1.14,0.1.15,15,14,561,49,610,66,TRUE
aurelia-ux,0.1.15,0.1.16,16,10,3878,44,3922,127,TRUE
aurelia-ux,0.1.19,0.2.0,20,8,28022,78,28100,94,TRUE
aurelia-ux,0.1.8,0.1.9,9,3,81,55,136,17,TRUE
aurelia-ux,0.1.0,0.1.1,1,7,650,2244,2894,102,TRUE
aurelia-ux,0.1.6,0.1.7,7,1,7,7,14,3,TRUE
bookshelf-modelbase-plus,1.0.4,1.0.5,4,7,18,5,23,9,FALSE
bookshelf-modelbase-plus,1.0.5,2.0.1,5,5,384,22,406,14,FALSE
bookshelf-modelbase-plus,1.0.0,1.0.1,1,3,94,48,142,5,FALSE
bookshelf-modelbase-plus,1.0.1,1.0.3,2,2,38,10,48,4,FALSE
bookshelf-modelbase-plus,2.0.1,2.0.2,6,1,2,2,4,2,FALSE
bookshelf-modelbase-plus,1.0.3,1.0.4,3,6,307,23,330,13,FALSE
bookshelf-modelbase-plus,2.0.3,2.1.0,8,1,21,3,24,2,FALSE
bookshelf-modelbase-plus,2.1.0,2.1.1,9,1,7,6,13,2,FALSE
bookshelf-modelbase-plus,2.0.2,2.0.3,7,1,3,3,6,2,FALSE
bookshelf-modelbase-plus,1.0.3,1.0.4,3,6,307,23,330,13,TRUE
insight,0.6.0,0.7.0,16,8,161,56,217,21,FALSE
insight,0.3.1,0.4.0,7,9,164,43,207,23,FALSE
insight,0.8.1,0.8.2,19,2,2,2,4,2,FALSE
insight,0.8.0,0.8.1,18,2,7,3,10,2,FALSE
insight,0.7.0,0.8.0,17,4,129,22,151,9,FALSE
insight,0.8.2,0.8.3,20,2,2,2,4,2,FALSE
insight,0.8.3,0.8.4,21,4,60,63,123,17,FALSE
insight,0.4.1,0.4.2,9,6,218,99,317,20,FALSE
insight,0.4.0,0.4.1,8,4,14,25,39,4,FALSE
insight,0.4.3,0.5.0,11,4,27,21,48,5,FALSE
insight,0.4.2,0.4.3,10,4,82,99,181,20,FALSE
insight,0.5.0,0.5.1,12,4,6,6,12,4,FALSE
insight,0.5.1,0.5.2,13,2,2,2,4,2,FALSE
insight,0.5.2,0.5.3,14,3,6,3,9,3,FALSE
insight,0.5.3,0.6.0,15,3,16,4,20,4,FALSE
insight,0.2.0,0.3.0,5,2,33,20,53,4,FALSE
insight,0.1.0,0.1.1,1,3,17,33,50,5,FALSE
insight,0.1.1,0.1.2,2,3,4,5,9,3,FALSE
insight,0.1.2,0.1.3,3,8,372,72,444,20,FALSE
insight,0.1.3,0.2.0,4,4,94,8,102,10,FALSE
insight,0.3.0,0.3.1,6,10,33,28,61,13,FALSE
insight,0.5.0,0.5.1,12,4,6,6,12,4,TRUE
insight,0.3.1,0.4.0,7,9,164,43,207,23,TRUE
insight,0.4.0,0.4.1,8,4,14,25,39,4,TRUE
layabout,0.3.1,0.4.0,5,3,222,100,322,10,FALSE
layabout,0.6.2,0.7.0,13,3,24,10,34,6,FALSE
layabout,0.3.0,0.3.1,4,1,0,0,0,1,FALSE
layabout,0.6.0,0.6.1,11,1,26,15,41,3,FALSE
layabout,0.5.1,0.5.2,8,1,0,0,0,1,FALSE
layabout,0.7.0,0.7.1,14,2,21,22,43,12,FALSE
layabout,0.7.1,0.7.2,15,1,2127,1594,3721,19,FALSE
layabout,0.2.2,0.3.0,3,2,135,96,231,9,FALSE
layabout,0.2.1,0.2.2,2,1,0,0,0,1,FALSE
layabout,0.2.0,0.2.1,1,1,0,0,0,1,FALSE
layabout,0.4.0,0.5.0,6,4,356,179,535,19,FALSE
layabout,0.5.0,0.5.1,7,1,0,0,0,1,FALSE
layabout,0.6.1,0.6.2,12,2,2,2,4,2,FALSE
layabout,0.5.2,0.5.3,9,4,156,4,160,13,FALSE
layabout,0.5.3,0.6.0,10,6,618,454,1072,62,FALSE
layabout,0.3.1,0.4.0,5,3,222,100,322,10,TRUE
react-scrollable-anchor,0.1.0,0.1.1,1,4,355,14,369,18,FALSE
react-scrollable-anchor,0.1.1,0.1.2,2,3,583,18,601,19,FALSE
react-scrollable-anchor,0.1.2,0.2.0,3,11,333,165,498,24,FALSE
react-scrollable-anchor,0.2.0,0.3.0,4,2,34,12,46,4,FALSE
react-scrollable-anchor,0.3.0,0.4.0,5,2,4,4,8,2,FALSE
react-scrollable-anchor,0.4.1,0.4.2,7,3,32,16,48,9,FALSE
react-scrollable-anchor,0.4.0,0.4.1,6,2,2,2,4,2,FALSE
react-scrollable-anchor,0.4.1,0.4.2,7,3,32,16,48,9,TRUE
meek,0.15.0,0.16.0,22,2,158,149,307,5,FALSE
meek,0.10.0,0.11.0,17,2,133,127,260,5,FALSE
meek,0.14.0,0.15.0,21,2,306,199,505,5,FALSE
meek,0.3.0,0.4.0,10,2,2298,1367,3665,7,FALSE
meek,0.6.0,0.7.0,13,2,520,727,1247,10,FALSE
meek,0.11.0,0.12.0,18,2,356,330,686,5,FALSE
meek,0.8.0,0.9.0,15,2,391,348,739,5,FALSE
meek,0.7.0,0.8.0,14,1,35,35,70,4,FALSE
meek,0.12.0,0.13.0,19,2,197,204,401,5,FALSE
meek,0.9.0,0.10.0,16,2,324,319,643,5,FALSE
meek,0.16.0,0.17.0,23,3,122,72,194,6,FALSE
meek,0.4.0,0.5.0,11,1,1577,493,2070,8,FALSE
meek,0.5.0,0.6.0,12,1,531,141,672,7,FALSE
meek,0.13.0,0.14.0,20,2,151,95,246,5,FALSE
meek,0.2.0,0.3.0,9,4,411,8,419,9,FALSE
meek,0.3.0,0.4.0,10,2,2298,1367,3665,7,TRUE
meek,0.14.0,0.15.0,21,2,306,199,505,5,TRUE
brush-java,4.0.0,4.0.1,1,2,3,3,6,2,FALSE
brush-java,4.0.0,4.0.1,1,2,3,3,6,2,TRUE
generator-aip-science-app,0.3.2,0.4.0,15,5,17572,1546,19118,9,FALSE
generator-aip-science-app,0.4.0,0.5.0,16,14,258,403,661,36,FALSE
generator-aip-science-app,0.3.0,0.3.1,13,2,2,1,3,2,FALSE
generator-aip-science-app,0.3.1,0.3.2,14,4,11,3,14,4,FALSE
generator-aip-science-app,0.2.7,0.2.8,10,2,7,3,10,3,FALSE
generator-aip-science-app,0.2.6,0.2.7,9,8,717,11,728,10,FALSE
generator-aip-science-app,0.2.5,0.2.6,8,2,6,2,8,3,FALSE
generator-aip-science-app,0.2.4,0.2.5,7,6,16,5,21,7,FALSE
generator-aip-science-app,0.2.3,0.2.4,6,6,52,37,89,7,FALSE
generator-aip-science-app,0.2.2,0.2.3,5,1,1,1,2,1,FALSE
generator-aip-science-app,0.2.1,0.2.2,4,1,1,1,2,1,FALSE
generator-aip-science-app,0.2.0,0.2.1,3,11,6824,4974,11798,19,FALSE
generator-aip-science-app,0.1.0,0.1.1,1,1,1,1,2,1,FALSE
generator-aip-science-app,0.1.1,0.2.0,2,12,22953,13196,36149,105,FALSE
generator-aip-science-app,0.2.9,0.3.0,12,29,3960,13302,17262,114,FALSE
generator-aip-science-app,0.2.8,0.2.9,11,6,13,3,16,8,FALSE
generator-aip-science-app,0.2.9,0.3.0,12,29,3960,13302,17262,114,TRUE
generator-aip-science-app,0.4.0,0.5.0,16,14,258,403,661,36,TRUE
dude-sms,0.3.11,0.3.12,5,1,2,1,3,1,FALSE
dude-sms,0.3.8,0.3.9,2,1,9,9,18,3,FALSE
dude-sms,0.3.9,0.3.10,3,1,9,2,11,3,FALSE
dude-sms,0.3.7,0.3.8,1,2,30,35,65,6,FALSE
dude-sms,0.3.10,0.3.11,4,1,13,9,22,3,FALSE
dude-sms,0.3.7,0.3.8,1,2,30,35,65,6,TRUE
sms506,0.1.1,0.1.2,1,7,85,47,132,15,FALSE
sms506,0.1.2,0.1.3,2,2,23,9,32,3,FALSE
sms506,0.1.2,0.1.3,2,2,23,9,32,3,TRUE
jrg,0.0.5,0.0.6,5,5,8,6,14,4,FALSE
jrg,0.0.4,0.0.5,4,4,18,8,26,4,FALSE
jrg,0.0.7,0.0.8,7,4,92,94,186,12,FALSE
jrg,0.0.6,0.0.7,6,2,18,24,42,4,FALSE
jrg,0.0.1,0.0.2,1,1,2,4,6,1,FALSE
jrg,0.0.3,0.0.4,3,2,4,2,6,4,FALSE
jrg,0.0.2,0.0.3,2,2,19,7,26,8,FALSE
jrg,0.0.9,0.1.0,9,2,80,66,146,34,FALSE
jrg,0.0.8,0.0.9,8,3,4,6,10,6,FALSE
jrg,0.1.0,0.1.1,10,5,25,25,50,19,FALSE
jrg,0.1.1,0.2.0,11,4,14754,854,15608,111,FALSE
jrg,0.0.9,0.1.0,9,2,80,66,146,34,TRUE
chrome-manifest-iconify,3.0.4,3.0.5,9,2,50,42,92,6,FALSE
chrome-manifest-iconify,1.0.0,1.0.1,2,1,52,19,71,4,FALSE
chrome-manifest-iconify,1.0.1,1.0.2,3,1,35,21,56,2,FALSE
chrome-manifest-iconify,3.0.0,3.0.1,6,1,15,1,16,3,FALSE
chrome-manifest-iconify,2.0.0,3.0.0,5,1,22,22,44,6,FALSE
chrome-manifest-iconify,3.0.1,3.0.3,7,2,11,8,19,4,FALSE
chrome-manifest-iconify,0.0.1,1.0.0,1,1,29,5,34,3,FALSE
chrome-manifest-iconify,1.0.2,2.0.0,4,6,406,253,659,17,FALSE
chrome-manifest-iconify,3.0.3,3.0.4,8,1,7,0,7,1,FALSE
chrome-manifest-iconify,3.0.4,3.0.5,9,2,50,42,92,6,TRUE
chrome-manifest-iconify,3.0.1,3.0.3,7,2,11,8,19,4,TRUE
rxr-react,0.1.0,0.1.1,1,5,20,42,62,8,FALSE
rxr-react,0.1.1,0.1.2,2,4,5,5,10,4,FALSE
rxr-react,0.1.0,0.1.1,1,5,20,42,62,8,TRUE
rxr-react,0.1.1,0.1.2,2,4,5,5,10,4,TRUE
redux-socket-cluster,0.0.1,0.0.2,1,1,1,1,2,1,FALSE
redux-socket-cluster,0.0.3,0.1.0,3,2,4,5,9,4,FALSE
redux-socket-cluster,0.0.2,0.0.3,2,1,1,1,2,1,FALSE
redux-socket-cluster,0.1.0,0.1.1,4,2,8,4,12,4,FALSE
redux-socket-cluster,0.1.1,0.1.2,5,1,3,3,6,2,FALSE
redux-socket-cluster,0.6.0,0.7.0,16,2,32,14,46,4,FALSE
redux-socket-cluster,0.2.2,0.3.0,10,4,99,88,187,6,FALSE
redux-socket-cluster,0.2.1,0.2.2,9,1,2,0,2,1,FALSE
redux-socket-cluster,0.2.0,0.2.1,8,2,71,73,144,5,FALSE
redux-socket-cluster,0.1.2,0.1.3,6,1,5,6,11,3,FALSE
redux-socket-cluster,0.1.3,0.2.0,7,1,1,1,2,1,FALSE
redux-socket-cluster,0.10.1,0.10.2,25,1,3526,3,3529,2,FALSE
redux-socket-cluster,0.10.0,0.10.1,24,2,4,4,8,2,FALSE
redux-socket-cluster,0.10.2,0.10.3,26,2,5,3,8,3,FALSE
redux-socket-cluster,0.3.0,0.3.1,11,1,21,12,33,2,FALSE
redux-socket-cluster,0.3.1,0.4.0,12,2,256,99,355,12,FALSE
redux-socket-cluster,0.7.0,0.8.0,17,4,217,160,377,10,FALSE
redux-socket-cluster,0.4.0,0.5.0,13,3,57,34,91,5,FALSE
redux-socket-cluster,0.5.0,0.5.1,14,1,1,1,2,1,FALSE
redux-socket-cluster,0.5.1,0.6.0,15,4,73,63,136,8,FALSE
redux-socket-cluster,0.9.0,0.9.1,21,2,10,8,18,2,FALSE
redux-socket-cluster,0.9.1,0.9.2,22,2,9,6,15,2,FALSE
redux-socket-cluster,0.9.2,0.10.0,23,3,68,46,114,3,FALSE
redux-socket-cluster,0.8.1,0.8.2,19,2,2,3,5,2,FALSE
redux-socket-cluster,0.8.0,0.8.1,18,2,4,3,7,3,FALSE
redux-socket-cluster,0.8.2,0.9.0,20,2,36,29,65,2,FALSE
redux-socket-cluster,0.5.1,0.6.0,15,4,73,63,136,8,TRUE
redux-socket-cluster,0.8.0,0.8.1,18,2,4,3,7,3,TRUE
redux-socket-cluster,0.1.3,0.2.0,7,1,1,1,2,1,TRUE
possum,0.2.7,0.2.8,34,4,1741,484,2225,27,TRUE
possum,0.2.6,0.2.7,33,2,1391,459,1850,9,FALSE
possum,0.2.4,0.2.6,32,5,8727,8716,17443,16,FALSE
possum,0.2.3,0.2.4,31,1,482,18,500,5,FALSE
possum,0.2.2,0.2.3,30,2,10,2,12,3,FALSE
possum,0.2.1,0.2.2,29,13,80,8744,8824,27,FALSE
possum,0.2.0,0.2.1,28,3,518,505,1023,12,FALSE
possum,0.1.0,0.1.1,25,3,157,33,190,6,FALSE
possum,0.1.1,0.1.2,26,1,26,6,32,3,FALSE
possum,0.1.2,0.2.0,27,3,930,788,1718,9,FALSE
possum,0.2.8,0.2.9,35,2,2,1534,1536,8,FALSE
possum,1.0.0,1.0.2,43,4,60,27,87,8,FALSE
possum,0.0.13,0.0.14,12,2,105,14,119,6,FALSE
possum,1.0.2,1.0.4,44,4,72,4,76,4,FALSE
possum,0.0.9,0.0.10,8,2,9,9,18,4,FALSE
possum,0.0.12,0.0.13,11,2,9,4,13,3,FALSE
possum,0.2.7,0.2.8,34,4,1741,484,2225,27,FALSE
possum,0.0.14,0.0.15,13,2,10,3,13,3,FALSE
possum,0.0.17,0.0.18,16,2,64,34,98,6,FALSE
possum,0.0.16,0.0.17,15,3,45,49,94,9,FALSE
possum,0.0.11,0.0.12,10,2,2,2,4,2,FALSE
possum,0.0.10,0.0.11,9,4,576,212,788,25,FALSE
possum,0.0.19,0.0.20,18,2,22,22,44,4,FALSE
possum,0.0.18,0.0.19,17,2,11,11,22,3,FALSE
possum,0.2.9,0.3.0,36,1,11,10,21,2,FALSE
possum,0.0.5,0.0.6,5,2,16,1,17,2,FALSE
possum,0.0.4,0.0.5,4,2,11,8,19,4,FALSE
possum,0.0.6,0.0.8,6,3,15,11,26,4,FALSE
possum,0.0.1,0.0.2,1,4,8257,16097,24354,13,FALSE
possum,0.0.3,0.0.4,3,2,58,13,71,3,FALSE
possum,0.0.2,0.0.3,2,1,54,4,58,4,FALSE
possum,0.3.2,0.3.4,39,2,3197,67,3264,8,FALSE
possum,0.3.0,0.3.1,37,1,3,3,6,2,FALSE
possum,0.3.1,0.3.2,38,1,3,3,6,1,FALSE
possum,0.3.6,1.0.0,42,2,276,914,1190,13,FALSE
possum,0.0.8,0.0.9,7,2,38,16,54,3,FALSE
possum,0.3.4,0.3.5,40,1,1,3,4,1,FALSE
possum,0.3.5,0.3.6,41,3,36,34,70,4,FALSE
possum,0.0.20,0.0.21,19,2,24,4,28,3,FALSE
possum,0.0.21,0.0.22,20,2,92,20,112,6,FALSE
possum,0.0.22,0.0.23,21,1,2,2,4,1,FALSE
possum,0.0.23,0.0.24,22,2,30,11,41,8,FALSE
possum,0.0.24,0.0.25,23,2,3,3,6,2,FALSE
possum,0.0.25,0.1.0,24,14,20304,6208,26512,89,FALSE
possum,0.0.15,0.0.16,14,4,136,86,222,21,FALSE
possum,0.0.21,0.0.22,20,2,92,20,112,6,TRUE
possum,0.3.2,0.3.4,39,2,3197,67,3264,8,TRUE
possum,0.2.1,0.2.2,29,13,80,8744,8824,27,TRUE
possum,0.3.5,0.3.6,41,3,36,34,70,4,TRUE
possum,0.0.9,0.0.10,8,2,9,9,18,4,TRUE
possum,0.0.5,0.0.6,5,2,16,1,17,2,TRUE
possum,0.0.4,0.0.5,4,2,11,8,19,4,TRUE
possum,0.0.6,0.0.8,6,3,15,11,26,4,TRUE
nativescript-sonos,0.1.0,0.2.0,1,7,1114,105,1219,35,FALSE
nativescript-sonos,0.3.0,0.4.0,3,4,534,69,603,14,FALSE
nativescript-sonos,0.2.0,0.3.0,2,5,329,26,355,13,FALSE
nativescript-sonos,0.1.0,0.2.0,1,7,1114,105,1219,35,TRUE
nativescript-sonos,0.3.0,0.4.0,3,4,534,69,603,14,TRUE
react-bluekit,0.0.13,0.0.14,1,1,13,668,681,6,FALSE
react-bluekit,0.4.0-typescript02,0.4.0-typescript03,56,1,2,2,4,1,FALSE
react-bluekit,0.4.0-typescript03,0.4.0-typescript04,57,1,13,668,681,6,FALSE
react-bluekit,0.0.15,0.0.16,3,1,13,668,681,6,FALSE
react-bluekit,0.0.14,0.0.15,2,1,13,668,681,6,FALSE
react-bluekit,0.0.17,0.0.18,5,1,13,668,681,6,FALSE
react-bluekit,0.0.16,0.0.17,4,1,13,668,681,6,FALSE
react-bluekit,0.2.3,0.2.4,40,1,9,3,12,1,FALSE
react-bluekit,0.2.2,0.2.3,39,3,3,3,6,3,FALSE
react-bluekit,0.2.1,0.2.2,38,2,15,10,25,3,FALSE
react-bluekit,0.2.0,0.2.1,37,105,12023,13236,25259,986,FALSE
react-bluekit,0.1.0,0.1.1,20,1,13,668,681,6,FALSE
react-bluekit,0.1.1,0.1.2,21,1,13,668,681,6,FALSE
react-bluekit,0.1.2,0.1.3-cli,22,1,13,668,681,6,FALSE
react-bluekit,0.1.3,0.1.4,24,1,13,668,681,6,FALSE
react-bluekit,0.1.4,0.1.5,25,1,13,668,681,6,FALSE
react-bluekit,0.0.18,0.0.19,6,1,13,668,681,6,FALSE
react-bluekit,0.0.31,0.1.0,19,1,13,668,681,6,FALSE
react-bluekit,0.0.30,0.0.31,18,1,13,668,681,6,FALSE
react-bluekit,0.0.19,0.0.20,7,1,13,668,681,6,FALSE
react-bluekit,0.3.0,0.3.1,51,9,39,22,61,11,FALSE
react-bluekit,0.3.1,0.3.2,52,5,440,338,778,13,FALSE
react-bluekit,0.1.5,0.1.6,26,1,13,668,681,6,FALSE
react-bluekit,0.2.6,0.2.7,43,4,3,5,8,5,FALSE
react-bluekit,0.1.6,0.1.7,27,1,13,668,681,6,FALSE
react-bluekit,0.2.9,0.2.10,46,5,182,119,301,20,FALSE
react-bluekit,0.4.1,0.4.2,63,2,11,6,17,2,FALSE
react-bluekit,0.4.0,0.4.1,62,1,128,23,151,12,FALSE
react-bluekit,0.1.7,0.1.8,28,1,13,668,681,6,FALSE
react-bluekit,0.1.13,0.1.14,34,1,13,668,681,6,FALSE
react-bluekit,0.2.13,0.3.0,50,21,21219,757,21976,82,FALSE
react-bluekit,0.2.12,0.2.13,49,2,270,162,432,22,FALSE
react-bluekit,0.2.11,0.2.12,48,4,40,26,66,22,FALSE
react-bluekit,0.2.10,0.2.11,47,2,4,2,6,4,FALSE
react-bluekit,0.0.20,0.0.21,8,1,13,668,681,6,FALSE
react-bluekit,0.0.21,0.0.22,9,1,13,668,681,6,FALSE
react-bluekit,0.0.22,0.0.23,10,1,13,668,681,6,FALSE
react-bluekit,0.0.23,0.0.24,11,1,13,668,681,6,FALSE
react-bluekit,0.0.24,0.0.25,12,1,13,668,681,6,FALSE
react-bluekit,0.0.25,0.0.26,13,1,13,668,681,6,FALSE
react-bluekit,0.0.26,0.0.27,14,1,13,668,681,6,FALSE
react-bluekit,0.0.27,0.0.28,15,1,13,668,681,6,FALSE
react-bluekit,0.0.28,0.0.29,16,1,13,668,681,6,FALSE
react-bluekit,0.1.9,0.1.10,30,1,13,668,681,6,FALSE
react-bluekit,0.0.29,0.0.30,17,1,13,668,681,6,FALSE
react-bluekit,0.1.12,0.1.13,33,1,13,668,681,6,FALSE
react-bluekit,0.2.7,0.2.8,44,6,372,46,418,64,FALSE
react-bluekit,0.1.10,0.1.11,31,1,13,668,681,6,FALSE
react-bluekit,0.1.11,0.1.12,32,1,13,668,681,6,FALSE
react-bluekit,0.1.14,0.1.15,35,1,13,668,681,6,FALSE
react-bluekit,0.1.15,0.2.0,36,1,13,668,681,6,FALSE
react-bluekit,0.4.0-typescript06,0.4.0-typescript07,60,1,13,668,681,6,FALSE
react-bluekit,0.4.0-typescript04,0.4.0-typescript05,58,1,13,668,681,6,FALSE
react-bluekit,0.4.0-typescript05,0.4.0-typescript06,59,2,4,4,8,2,FALSE
react-bluekit,0.4.0-typescript,0.4.0-typescript01,54,1,13,668,681,6,FALSE
react-bluekit,0.2.5,0.2.6,42,6,31,10,41,6,FALSE
react-bluekit,0.4.0-typescript01,0.4.0-typescript02,55,1,13,668,681,6,FALSE
react-bluekit,0.4.2,0.4.3,64,7,3128,428,3556,96,FALSE
react-bluekit,0.1.8,0.1.9,29,1,13,668,681,6,FALSE
react-bluekit,0.2.4,0.2.5,41,11,1328,253,1581,64,FALSE
react-bluekit,0.2.8,0.2.9,45,11,379,176,555,40,FALSE
react-bluekit,0.4.2,0.4.3,64,7,3128,428,3556,96,TRUE
react-bluekit,0.3.1,0.3.2,52,5,440,338,778,13,TRUE
react-bluekit,0.4.0-typescript02,0.4.0-typescript03,56,1,2,2,4,1,TRUE
react-bluekit,0.2.7,0.2.8,44,6,372,46,418,64,TRUE
react-bluekit,0.4.0-typescript03,0.4.0-typescript04,57,1,13,668,681,6,TRUE
react-bluekit,0.0.23,0.0.24,11,1,13,668,681,6,TRUE
pouchdb-access,1.1.0,1.2.0,4,3,28,10,38,5,FALSE
pouchdb-access,2.0.1,2.1.0,7,3,90,78,168,4,FALSE
pouchdb-access,1.0.0,1.0.1,1,1,1,1,2,1,FALSE
pouchdb-access,1.0.1,1.0.2,2,2,2,2,4,3,FALSE
pouchdb-access,1.0.2,1.1.0,3,2,3,1,4,2,FALSE
pouchdb-access,2.0.0,2.0.1,6,3,56,40,96,7,FALSE
pouchdb-access,1.2.0,2.0.0,5,5,89,51,140,9,FALSE
pouchdb-access,2.1.0,2.1.1,8,4,72,74,146,21,TRUE
pouchdb-access,2.1.1,2.2.0,9,3,36,6,42,4,FALSE
pouchdb-access,2.0.1,2.1.0,7,3,90,78,168,4,TRUE
pouchdb-access,2.1.0,2.1.1,8,4,72,74,146,21,FALSE
pouchdb-access,1.2.0,2.0.0,5,5,89,51,140,9,TRUE
teasim-icon,0.4.16,0.5.0,26,1,72,83,155,9,FALSE
teasim-icon,0.6.3,0.6.15,29,1,72,83,155,9,FALSE
teasim-icon,0.6.0,0.6.3,28,1,72,83,155,9,FALSE
teasim-icon,0.5.0,0.6.0,27,1,72,83,155,9,FALSE
teasim-icon,0.6.16,0.7.0,31,1,72,83,155,9,FALSE
teasim-icon,0.6.15,0.6.16,30,1,72,83,155,9,FALSE
teasim-icon,0.4.13,0.4.15,24,1,72,83,155,9,FALSE
teasim-icon,0.4.15,0.4.16,25,1,72,83,155,9,FALSE
teasim-icon,0.3.1,0.3.3,8,1,72,83,155,9,FALSE
teasim-icon,1.0.0,1.0.1,39,7,545,45,590,20,FALSE
teasim-icon,1.0.1,1.0.2,40,2,5312,5595,10907,258,FALSE
teasim-icon,0.7.2,0.8.0,34,1,72,83,155,9,FALSE
teasim-icon,0.2.4,0.3.0,6,1,72,83,155,9,FALSE
teasim-icon,0.2.2,0.2.4,5,1,72,83,155,9,FALSE
teasim-icon,0.2.1,0.2.2,4,1,72,83,155,9,FALSE
teasim-icon,0.2.0,0.2.1,3,1,72,83,155,9,FALSE
teasim-icon,0.1.1,0.2.0,2,1,72,83,155,9,FALSE
teasim-icon,0.7.1,0.7.2,33,1,72,83,155,9,FALSE
teasim-icon,0.0.1,0.1.1,1,1,72,83,155,9,FALSE
teasim-icon,0.3.3,0.3.4,9,1,72,83,155,9,FALSE
teasim-icon,0.3.0,0.3.1,7,1,72,83,155,9,FALSE
teasim-icon,0.3.6,0.3.7,12,1,72,83,155,9,FALSE
teasim-icon,0.3.7,0.4.0,13,1,72,83,155,9,FALSE
teasim-icon,0.7.0,0.7.1,32,1,72,83,155,9,FALSE
teasim-icon,0.3.5,0.3.6,11,1,72,83,155,9,FALSE
teasim-icon,0.4.9,0.4.10,22,1,72,83,155,9,FALSE
teasim-icon,0.4.8,0.4.9,21,1,72,83,155,9,FALSE
teasim-icon,0.4.1,0.4.2,15,1,72,83,155,9,FALSE
teasim-icon,0.4.0,0.4.1,14,1,72,83,155,9,FALSE
teasim-icon,0.3.4,0.3.5,10,1,72,83,155,9,FALSE
teasim-icon,0.4.4,0.4.5,17,1,72,83,155,9,FALSE
teasim-icon,0.4.7,0.4.8,20,1,72,83,155,9,FALSE
teasim-icon,0.4.6,0.4.7,19,1,72,83,155,9,FALSE
teasim-icon,0.4.10,0.4.13,23,1,72,83,155,9,TRUE
teasim-icon,0.8.4,1.0.0,38,1,18625,0,18625,326,FALSE
teasim-icon,0.8.1,0.8.3,36,1,72,83,155,9,FALSE
teasim-icon,0.8.0,0.8.1,35,1,31,0,31,2,FALSE
teasim-icon,0.8.3,0.8.4,37,1,72,83,155,9,FALSE
teasim-icon,0.4.2,0.4.4,16,1,72,83,155,9,FALSE
teasim-icon,0.4.5,0.4.6,18,1,72,83,155,9,FALSE
teasim-icon,1.1.1,1.1.2,44,1,72,83,155,9,FALSE
teasim-icon,1.1.2,1.1.4,45,1,72,83,155,9,FALSE
teasim-icon,1.0.2,1.0.3,41,2,807,695,1502,79,TRUE
teasim-icon,1.0.3,1.0.9,42,1,72,83,155,9,FALSE
teasim-icon,1.0.9,1.1.1,43,1,72,83,155,9,FALSE
teasim-icon,3.0.0-1,3.0.1-alpha.1,52,1,72,83,155,9,FALSE
teasim-icon,3.0.0-0,3.0.0-1,51,1,72,83,155,9,FALSE
teasim-icon,1.1.4,1.1.5,46,1,72,83,155,9,FALSE
teasim-icon,2.1.0-0,3.0.0-0,50,1,72,83,155,9,FALSE
teasim-icon,1.1.5,2.0.0-alpha.0,47,8,55116,12112,67228,433,FALSE
teasim-icon,2.0.0,2.1.0-0,49,2,532,1,533,9,FALSE
teasim-icon,1.1.4,1.1.5,46,1,72,83,155,9,TRUE
teasim-icon,1.0.2,1.0.3,41,2,807,695,1502,79,FALSE
teasim-icon,3.0.0-1,3.0.1-alpha.1,52,1,72,83,155,9,TRUE
teasim-icon,0.4.10,0.4.13,23,1,72,83,155,9,FALSE
teasim-icon,0.7.1,0.7.2,33,1,72,83,155,9,TRUE
teasim-icon,0.4.0,0.4.1,14,1,72,83,155,9,TRUE
teasim-icon,0.4.6,0.4.7,19,1,72,83,155,9,TRUE
teasim-icon,0.3.3,0.3.4,9,1,72,83,155,9,TRUE
teasim-icon,0.0.1,0.1.1,1,1,72,83,155,9,TRUE
teasim-icon,0.2.1,0.2.2,4,1,72,83,155,9,TRUE
teasim-icon,0.3.7,0.4.0,13,1,72,83,155,9,TRUE
teasim-icon,3.0.0-0,3.0.0-1,51,1,72,83,155,9,TRUE
teasim-icon,0.7.2,0.8.0,34,1,72,83,155,9,TRUE
teasim-icon,0.8.0,0.8.1,35,1,31,0,31,2,TRUE
teasim-icon,0.6.3,0.6.15,29,1,72,83,155,9,TRUE
teasim-icon,1.0.1,1.0.2,40,2,5312,5595,10907,258,TRUE
teasim-icon,1.0.0,1.0.1,39,7,545,45,590,20,TRUE
teasim-icon,0.8.4,1.0.0,38,1,18625,0,18625,326,TRUE
teasim-icon,2.0.0,2.1.0-0,49,2,532,1,533,9,TRUE
teasim-icon,0.3.6,0.3.7,12,1,72,83,155,9,TRUE
teasim-icon,0.4.16,0.5.0,26,1,72,83,155,9,TRUE
google-libphonenumber,1.0.8,1.0.9,19,3,5250,5287,10537,17,FALSE
google-libphonenumber,1.0.9,1.0.10,20,3,585,540,1125,15,FALSE
google-libphonenumber,1.0.10,1.0.11,21,5,1208,1198,2406,21,FALSE
google-libphonenumber,1.0.11,1.0.12,22,3,255,286,541,11,FALSE
google-libphonenumber,1.0.4,1.0.5,15,3,723,728,1451,17,FALSE
google-libphonenumber,1.0.5,1.0.6,16,5,686,676,1362,17,FALSE
google-libphonenumber,1.0.6,1.0.7,17,3,767,748,1515,15,FALSE
google-libphonenumber,1.0.7,1.0.8,18,6,640,874,1514,27,FALSE
google-libphonenumber,1.0.0,1.0.1,11,5,22,22,44,9,FALSE
google-libphonenumber,1.0.1,1.0.2,12,2,546,648,1194,34,FALSE
google-libphonenumber,1.0.2,1.0.3,13,8,9559,67,9626,24,FALSE
google-libphonenumber,1.0.3,1.0.4,14,3,1427,1505,2932,15,FALSE
google-libphonenumber,1.0.16,1.0.17,27,13,504,360,864,25,FALSE
google-libphonenumber,1.0.17,1.0.18,28,3,253,232,485,11,FALSE
google-libphonenumber,1.0.14,1.0.15,25,5,175,175,350,13,FALSE
google-libphonenumber,1.0.15,1.0.16,26,7,426,383,809,17,FALSE
google-libphonenumber,1.0.12,1.0.13,23,12,655,607,1262,35,FALSE
google-libphonenumber,1.0.13,1.0.14,24,3,81,72,153,11,FALSE
google-libphonenumber,1.0.11,1.0.12,22,3,255,286,541,11,TRUE
google-libphonenumber,1.0.18,1.0.19,29,3,322,309,631,11,FALSE
google-libphonenumber,1.0.19,1.0.20,30,3,119,114,233,4,FALSE
google-libphonenumber,1.0.26,1.0.27,37,3,369,332,701,11,FALSE
google-libphonenumber,1.0.25,1.0.26,36,3,207,190,397,7,FALSE
google-libphonenumber,1.0.24,1.0.25,35,3,220,213,433,11,FALSE
google-libphonenumber,1.0.23,1.0.24,34,3,215,206,421,11,FALSE
google-libphonenumber,1.0.22,1.0.23,33,3,330,325,655,11,FALSE
google-libphonenumber,1.0.21,1.0.22,32,3,120,113,233,11,FALSE
google-libphonenumber,1.0.20,1.0.21,31,3,499,284,783,11,FALSE
google-libphonenumber,1.0.2,1.0.3,13,8,9559,67,9626,24,TRUE
google-libphonenumber,2.0.5,2.0.6,47,5,12400,12481,24881,36,FALSE
google-libphonenumber,2.0.7,2.0.8,49,5,442,442,884,11,FALSE
google-libphonenumber,2.0.8,2.0.9,50,3,386,381,767,11,FALSE
google-libphonenumber,1.1.2,2.0.0,41,7,68,9644,9712,22,FALSE
google-libphonenumber,0.2.2,1.0.0,10,5,11388,1160,12548,91,FALSE
google-libphonenumber,0.2.0,0.2.2,9,8,747,738,1485,22,FALSE
google-libphonenumber,0.1.0,0.1.1,6,6,353,410,763,13,FALSE
google-libphonenumber,0.1.1,0.1.2,7,3,178,179,357,8,FALSE
google-libphonenumber,0.1.2,0.2.0,8,8,1800,955,2755,42,FALSE
google-libphonenumber,2.0.10,2.0.11,52,3,447,186,633,13,FALSE
google-libphonenumber,2.0.2,2.0.3,44,2,83,68,151,8,FALSE
google-libphonenumber,0.0.5,0.1.0,5,2,24864,3,24867,28,FALSE
google-libphonenumber,0.0.4,0.0.5,4,1,1389,1381,2770,3,FALSE
google-libphonenumber,0.0.1,0.0.2,1,1,1389,1381,2770,3,FALSE
google-libphonenumber,2.0.1,2.0.2,43,3,24666,12934,37600,17,FALSE
google-libphonenumber,0.0.3,0.0.4,3,1,1389,1381,2770,3,FALSE
google-libphonenumber,0.0.2,0.0.3,2,1,1389,1381,2770,3,FALSE
google-libphonenumber,2.0.0,2.0.1,42,3,128,123,251,4,FALSE
google-libphonenumber,2.0.6,2.0.7,48,4,347,309,656,17,FALSE
google-libphonenumber,2.0.3,2.0.4,45,3,548,454,1002,11,FALSE
google-libphonenumber,1.1.1,1.1.2,40,3,782,773,1555,15,FALSE
google-libphonenumber,2.0.9,2.0.10,51,3,284,210,494,13,FALSE
google-libphonenumber,1.1.0,1.1.1,39,3,424,381,805,13,FALSE
google-libphonenumber,2.0.14,2.0.15,56,3,514,467,981,15,FALSE
google-libphonenumber,2.0.4,2.0.5,46,5,2980,3039,6019,37,FALSE
google-libphonenumber,2.0.13,2.0.14,55,3,3514,1468,4982,21,FALSE
google-libphonenumber,2.0.12,2.0.13,54,3,509,560,1069,9,FALSE
google-libphonenumber,2.0.11,2.0.12,53,3,198,150,348,13,FALSE
google-libphonenumber,1.0.27,1.1.0,38,7,202,195,397,19,FALSE
google-libphonenumber,2.0.5,2.0.6,47,5,12400,12481,24881,36,TRUE
google-libphonenumber,1.0.13,1.0.14,24,3,81,72,153,11,TRUE
google-libphonenumber,2.0.6,2.0.7,48,4,347,309,656,17,TRUE
google-libphonenumber,1.0.27,1.1.0,38,7,202,195,397,19,TRUE
tslint-config-wix,1.0.16,1.0.17,17,1,1,0,1,1,FALSE
tslint-config-wix,1.0.17,1.0.18,18,2,107,23,130,9,FALSE
tslint-config-wix,1.0.15,1.0.16,16,1,1,0,1,1,FALSE
tslint-config-wix,1.0.18,1.0.19,19,1,12,5,17,1,FALSE
tslint-config-wix,1.0.19,1.0.20,20,1,1,0,1,1,FALSE
tslint-config-wix,1.0.22,1.0.23,23,1,1,0,1,1,FALSE
tslint-config-wix,1.0.21,1.0.22,22,1,1,0,1,1,FALSE
tslint-config-wix,1.0.20,1.0.21,21,1,1,0,1,1,FALSE
tslint-config-wix,1.0.4,1.0.5,5,1,1,1,2,1,FALSE
tslint-config-wix,1.0.5,1.0.6,6,1,0,16,16,3,FALSE
tslint-config-wix,1.0.6,1.0.7,7,2,0,5,5,3,FALSE
tslint-config-wix,1.0.7,1.0.8,8,1,21,0,21,1,FALSE
tslint-config-wix,1.0.0,1.0.1,1,1,128,16,144,48,FALSE
tslint-config-wix,1.0.1,1.0.2,2,1,185,0,185,43,FALSE
tslint-config-wix,1.0.2,1.0.3,3,1,1,1,2,1,FALSE
tslint-config-wix,1.0.3,1.0.4,4,1,7,8,15,5,FALSE
tslint-config-wix,1.0.8,1.0.9,9,3,440,329,769,9,FALSE
tslint-config-wix,1.0.9,1.0.10,10,1,1,0,1,1,FALSE
tslint-config-wix,1.0.14,1.0.15,15,1,3,2,5,1,FALSE
tslint-config-wix,1.0.12,1.0.13,13,1,1,0,1,1,FALSE
tslint-config-wix,1.0.13,1.0.14,14,1,1,0,1,1,FALSE
tslint-config-wix,1.0.10,1.0.11,11,1,1,0,1,1,FALSE
tslint-config-wix,1.0.11,1.0.12,12,1,1,0,1,1,FALSE
tslint-config-wix,1.0.1,1.0.2,2,1,185,0,185,43,TRUE
tslint-config-wix,1.0.3,1.0.4,4,1,7,8,15,5,TRUE
tslint-config-wix,1.0.21,1.0.22,22,1,1,0,1,1,TRUE
tslint-config-wix,1.0.18,1.0.19,19,1,12,5,17,1,TRUE
ct-register-microservice-node,1.0.4,1.0.5,5,1,4,1,5,2,FALSE
ct-register-microservice-node,1.0.5,1.1.0,6,3,38,13,51,6,FALSE
ct-register-microservice-node,1.1.1,1.1.2,8,1,7,2,9,2,FALSE
ct-register-microservice-node,1.0.0,1.0.1,1,1,9,17,26,2,FALSE
ct-register-microservice-node,1.0.1,1.0.2,2,2,10,9,19,3,FALSE
ct-register-microservice-node,1.0.2,1.0.3,3,1,4,1,5,2,FALSE
ct-register-microservice-node,1.0.3,1.0.4,4,1,3,3,6,2,FALSE
ct-register-microservice-node,1.1.0,1.1.1,7,3,47,60,107,5,FALSE
ct-register-microservice-node,2.0.0,2.0.1,10,3,19,24,43,7,FALSE
ct-register-microservice-node,2.0.1,2.1.0,11,2,47,42,89,3,FALSE
ct-register-microservice-node,2.1.0,2.1.1,12,2,23,11,34,3,FALSE
ct-register-microservice-node,2.1.1,2.1.2,13,1,6,2,8,2,FALSE
ct-register-microservice-node,2.1.1,2.1.2,13,1,6,2,8,2,TRUE
toy-peers,0.1.0,0.2.0,1,4,408,18,426,12,FALSE
toy-peers,0.2.1,0.3.1,3,2,39,42,81,7,FALSE
toy-peers,0.2.0,0.2.1,2,1,2,2,4,2,FALSE
toy-peers,0.1.0,0.2.0,1,4,408,18,426,12,TRUE
react-socket-context,1.1.0,1.1.2,1,5,4,4,8,6,FALSE
react-socket-context,1.1.2,1.1.3,2,3,9,6,15,4,FALSE
react-socket-context,1.1.2,1.1.3,2,3,9,6,15,4,TRUE
react-conform,0.0.1,0.1.0,1,7,51,31,82,11,FALSE
react-conform,0.0.1,0.1.0,1,7,51,31,82,11,TRUE
lighter,0.0.7,0.0.8,8,1,123,39,162,8,FALSE
lighter,0.0.9,0.1.0,10,1,6,6,12,2,FALSE
lighter,0.0.8,0.0.9,9,1,65,44,109,5,FALSE
lighter,0.1.0,0.1.2,11,1,282,274,556,15,FALSE
lighter,0.1.2,0.1.3,12,1,260,187,447,3,FALSE
lighter,0.0.5,0.0.6,6,2,40,28,68,5,FALSE
lighter,0.0.4,0.0.5,5,1,2,2,4,2,FALSE
lighter,0.0.6,0.0.7,7,1,15,0,15,1,FALSE
lighter,0.0.3,0.0.4,4,1,2,2,4,1,FALSE
lighter,0.0.2,0.0.3,3,1,210,43,253,5,FALSE
lighter,0.1.3,0.1.4,13,1,123,92,215,4,FALSE
lighter,0.1.4,0.1.5,14,1,482,571,1053,9,FALSE
lighter,0.1.5,0.1.6,15,1,3,2,5,1,FALSE
lighter,0.1.6,0.1.7,16,1,2,2,4,1,FALSE
lighter,0.1.7,0.1.8,17,1,163,135,298,5,FALSE
lighter,0.0.0,0.0.1,1,4,653,59,712,28,FALSE
lighter,0.1.37,0.1.38,46,1,4,4,8,1,FALSE
lighter,0.1.27,0.1.28,36,2,6,6,12,2,FALSE
lighter,0.1.53,0.1.54,61,1,13,2,15,2,FALSE
lighter,0.1.26,0.1.27,35,1,4,4,8,1,FALSE
lighter,0.2.6,0.2.7,85,2,4,4,8,3,FALSE
lighter,0.2.4,0.2.6,84,4,6,6,12,3,FALSE
lighter,0.2.3,0.2.4,83,3,5,5,10,3,FALSE
lighter,0.2.2,0.2.3,82,4,4,4,8,4,FALSE
lighter,0.2.1,0.2.2,81,3,20,10,30,4,FALSE
lighter,0.2.0,0.2.1,80,3,802,148,950,16,FALSE
lighter,0.1.29,0.1.30,38,1,5,5,10,1,FALSE
lighter,0.1.28,0.1.29,37,1,15,0,15,1,FALSE
lighter,0.1.63,0.1.64,71,3,39,32,71,5,FALSE
lighter,0.1.62,0.1.63,70,2,2,2,4,2,FALSE
lighter,0.1.61,0.1.62,69,2,4,4,8,2,FALSE
lighter,0.1.60,0.1.61,68,2,26,6,32,4,FALSE
lighter,0.1.23,0.1.24,32,1,5,5,10,1,FALSE
lighter,0.1.22,0.1.23,31,1,2,2,4,1,FALSE
lighter,0.1.21,0.1.22,30,1,1,1,2,2,FALSE
lighter,0.1.20,0.1.21,29,1,194,110,304,8,FALSE
lighter,0.1.25,0.1.26,34,2,7,7,14,2,FALSE
lighter,0.1.24,0.1.25,33,1,2,2,4,1,FALSE
lighter,0.1.49,0.1.50,57,1,2,2,4,1,FALSE
lighter,0.1.45,0.1.46,54,1,4,4,8,2,FALSE
lighter,0.1.44,0.1.45,53,1,15,0,15,1,FALSE
lighter,0.1.47,0.1.49,56,9,77,18,95,14,FALSE
lighter,0.1.46,0.1.47,55,1,28,3,31,2,FALSE
lighter,0.1.41,0.1.42,50,1,11,3,14,2,FALSE
lighter,0.1.40,0.1.41,49,1,15,0,15,1,FALSE
lighter,0.1.43,0.1.44,52,2,41,13,54,7,FALSE
lighter,0.1.42,0.1.43,51,1,26,15,41,2,FALSE
lighter,0.1.67,0.1.68,75,1,15,0,15,1,FALSE
lighter,0.1.66,0.1.67,74,4,73,561,634,14,FALSE
lighter,0.1.59,0.1.60,67,4,44,44,88,12,FALSE
lighter,0.1.56,0.1.57,64,3,4,4,8,3,FALSE
lighter,0.1.64,0.1.65,72,2,6,6,12,2,FALSE
lighter,0.1.65,0.1.66,73,9,881,112,993,24,FALSE
lighter,0.1.57,0.1.58,65,5,27,30,57,8,FALSE
lighter,0.1.38,0.1.39,47,2,16,14,30,3,FALSE
lighter,0.1.68,0.1.69,76,2,19,22,41,6,FALSE
lighter,0.1.17,0.1.18,26,1,74,74,148,8,FALSE
lighter,0.1.12,0.1.13,22,1,3,3,6,1,FALSE
lighter,0.1.13,0.1.14,23,1,15,0,15,1,FALSE
lighter,0.1.10,0.1.11,20,1,3,3,6,2,FALSE
lighter,0.1.11,0.1.12,21,1,25,6,31,2,FALSE
lighter,0.1.16,0.1.17,25,1,15,0,15,1,FALSE
lighter,0.1.39,0.1.40,48,1,2,2,4,1,FALSE
lighter,0.1.14,0.1.16,24,2,11,10,21,3,FALSE
lighter,0.1.9,0.1.10,19,1,63,129,192,10,FALSE
lighter,0.1.34,0.1.35,43,1,20,9,29,2,FALSE
lighter,0.1.35,0.1.36,44,1,113,74,187,5,FALSE
lighter,0.1.18,0.1.19,27,2,9,7,16,4,FALSE
lighter,0.1.19,0.1.20,28,6,574,7,581,11,FALSE
lighter,0.1.30,0.1.31,39,1,21,2,23,2,FALSE
lighter,0.1.31,0.1.32,40,1,52,8,60,2,FALSE
lighter,0.1.32,0.1.33,41,2,9,3,12,3,FALSE
lighter,0.1.33,0.1.34,42,1,41,9,50,4,FALSE
lighter,0.1.8,0.1.9,18,1,182,117,299,10,FALSE
lighter,0.1.58,0.1.59,66,2,4,4,8,4,FALSE
lighter,0.1.69,0.1.70,77,3,213,208,421,13,FALSE
lighter,0.1.70,0.1.71,78,1,15,0,15,1,FALSE
lighter,0.1.71,0.2.0,79,6,779,471,1250,26,FALSE
lighter,0.1.54,0.1.55,62,2,61,25,86,7,FALSE
lighter,0.1.55,0.1.56,63,1,49,26,75,2,FALSE
lighter,0.1.52,0.1.53,60,1,15,0,15,1,FALSE
lighter,0.1.36,0.1.37,45,1,15,0,15,1,FALSE
lighter,0.1.50,0.1.51,58,2,25,19,44,4,FALSE
lighter,0.1.51,0.1.52,59,1,4,4,8,1,FALSE
lighter,0.1.33,0.1.34,42,1,41,9,50,4,TRUE
lighter,0.1.3,0.1.4,13,1,123,92,215,4,TRUE
lighter,0.0.6,0.0.7,7,1,15,0,15,1,TRUE
lighter,0.0.1,0.0.2,2,4,34,15,49,5,FALSE
lighter,0.3.0,0.3.1,87,1,15,0,15,1,FALSE
lighter,0.3.1,0.3.2,88,1,15,0,15,1,FALSE
lighter,0.1.34,0.1.35,43,1,20,9,29,2,TRUE
lighter,0.2.7,0.3.0,86,2,30,0,30,2,FALSE
lighter,0.1.12,0.1.13,22,1,3,3,6,1,TRUE
lighter,0.1.18,0.1.19,27,2,9,7,16,4,TRUE
lighter,0.1.19,0.1.20,28,6,574,7,581,11,TRUE
lighter,0.1.24,0.1.25,33,1,2,2,4,1,TRUE
lighter,0.1.16,0.1.17,25,1,15,0,15,1,TRUE
image-q,1.1.0,1.1.1,9,1,42,27,69,2,FALSE
image-q,1.0.1,1.1.0,8,12,3913,4011,7924,103,FALSE
image-q,0.0.5,0.1.0,2,1,146,589,735,179,FALSE
image-q,0.0.1,0.0.5,1,1,353,602,955,15,FALSE
image-q,1.0.1,1.1.0,8,12,3913,4011,7924,103,TRUE
image-q,0.1.0,0.1.1,3,5,1822,797,2619,52,FALSE
image-q,0.1.1,0.1.2,4,1,19595,2,19597,48,FALSE
image-q,0.1.2,0.1.3,5,3,364,20958,21322,82,FALSE
image-q,0.1.4,1.0.1,7,22,9191,8351,17542,220,FALSE
reactive-var-std,1.1.5,1.1.6,7,8,109,18,127,10,FALSE
reactive-var-std,1.1.4,1.1.5,6,4,1580,4,1584,13,FALSE
reactive-var-std,1.1.1,1.1.2,3,3,19,3,22,4,FALSE
reactive-var-std,1.1.0,1.1.1,2,2,4,4,8,2,FALSE
reactive-var-std,1.1.3,1.1.4,5,1,2,1,3,1,FALSE
reactive-var-std,1.1.2,1.1.3,4,1,3,3,6,1,FALSE
reactive-var-std,1.0.0,1.1.0,1,6,987,77,1064,20,FALSE
reactive-var-std,1.0.0,1.1.0,1,6,987,77,1064,20,TRUE
reactive-var-std,1.1.1,1.1.2,3,3,19,3,22,4,TRUE
torrentflix,1.0.6,1.0.7,1,2,13,6,19,5,FALSE
torrentflix,1.0.7,2.0.0,2,3,96,10,106,6,FALSE
torrentflix,2.0.1,3.0.0,4,5,190,52,242,9,FALSE
torrentflix,2.0.0,2.0.1,3,2,4,4,8,2,FALSE
torrentflix,6.0.0,7.0.0,15,16,469,27,496,24,FALSE
torrentflix,5.0.0,5.0.5,12,3,62,42,104,3,FALSE
torrentflix,4.0.1,4.5.0,9,6,96,62,158,8,FALSE
torrentflix,4.0.0,4.0.1,8,2,21,1,22,2,FALSE
torrentflix,8.5.0,8.5.1,22,4,185,5,190,11,FALSE
torrentflix,3.0.0,3.5.0,5,2,207,14,221,6,FALSE
torrentflix,8.5.2,8.5.3,24,8,37,14,51,11,FALSE
torrentflix,8.5.3,8.6.0,25,2,17,13,30,3,FALSE
torrentflix,4.6.0,5.0.0,11,8,314,51,365,19,FALSE
torrentflix,7.0.2,7.0.3,18,2,2,2,4,2,FALSE
torrentflix,8.5.1,8.5.2,23,2,12,4,16,4,FALSE
torrentflix,4.5.0,4.6.0,10,3,133,84,217,5,FALSE
torrentflix,7.0.3,8.0.0,19,5,124,345,469,12,FALSE
torrentflix,7.0.0,7.0.1,16,12,1014,1056,2070,19,FALSE
torrentflix,7.0.1,7.0.2,17,2,2,2,4,2,FALSE
torrentflix,5.0.5,5.0.6,13,10,449,86,535,24,FALSE
torrentflix,5.0.6,6.0.0,14,6,1183,885,2068,13,FALSE
torrentflix,8.0.1,8.5.0,21,11,1350,2279,3629,28,FALSE
torrentflix,8.0.0,8.0.1,20,6,136,130,266,8,FALSE
torrentflix,3.5.1,4.0.0,7,6,311,169,480,15,FALSE
torrentflix,3.5.0,3.5.1,6,3,5,5,10,3,FALSE
torrentflix,8.6.2,9.0.0,28,31,1136,1185,2321,99,FALSE
torrentflix,8.6.1,8.6.2,27,8,379,91,470,21,FALSE
torrentflix,8.6.0,8.6.1,26,5,15,15,30,5,FALSE
torrentflix,7.0.3,8.0.0,19,5,124,345,469,12,TRUE
torrentflix,7.0.2,7.0.3,18,2,2,2,4,2,TRUE
torrentflix,7.0.1,7.0.2,17,2,2,2,4,2,TRUE
apeman-react-radio,1.1.0,2.0.0,3,3,339,318,657,35,FALSE
apeman-react-radio,3.1.0,3.1.1,13,2,62,21,83,9,FALSE
apeman-react-radio,1.0.0,1.0.1,1,3,30077,11023,41100,7,FALSE
apeman-react-radio,2.0.2,2.0.3,6,2,313,925,1238,16,FALSE
apeman-react-radio,2.0.1,2.0.2,5,1,162,857,1019,4,FALSE
apeman-react-radio,2.0.0,2.0.1,4,3,541,487,1028,16,FALSE
apeman-react-radio,3.0.1,3.1.0,12,2,2226,1639,3865,17,FALSE
apeman-react-radio,3.0.0,3.0.1,11,3,4796,2913,7709,21,FALSE
apeman-react-radio,2.1.2,3.0.0,10,2,681,22848,23529,39,FALSE
apeman-react-radio,2.0.3,2.1.0,7,4,5411,338,5749,30,FALSE
apeman-react-radio,2.1.0,2.1.1,8,4,285,606,891,27,TRUE
apeman-react-radio,2.1.1,2.1.2,9,1,7583,5788,13371,5,FALSE
apeman-react-radio,1.0.1,1.1.0,2,4,1356,26468,27824,40,FALSE
apeman-react-radio,3.1.3,3.1.4,16,2,2775,5427,8202,17,FALSE
apeman-react-radio,4.0.1,4.0.2,24,2,28,27,55,8,FALSE
apeman-react-radio,4.0.3,4.0.4,26,1,3,3,6,2,FALSE
apeman-react-radio,4.0.2,4.0.3,25,2,102,109,211,12,FALSE
apeman-react-radio,3.1.6,3.1.7,19,6,187,159,346,24,FALSE
apeman-react-radio,3.1.5,3.1.6,18,2,15,15,30,2,FALSE
apeman-react-radio,4.0.0,4.0.1,23,2,6,6,12,4,FALSE
apeman-react-radio,3.1.9,4.0.0,22,3,215,306,521,29,FALSE
apeman-react-radio,3.1.4,3.1.5,17,4,33,3463,3496,13,FALSE
apeman-react-radio,3.1.2,3.1.3,15,2,2129,2071,4200,40,FALSE
apeman-react-radio,3.1.8,3.1.9,21,2,80,96,176,12,FALSE
apeman-react-radio,3.1.7,3.1.8,20,2,76,90,166,10,FALSE
apeman-react-radio,4.0.4,4.0.5,27,3,24,24,48,5,FALSE
apeman-react-radio,3.1.1,3.1.2,14,2,2132,2076,4208,40,FALSE
apeman-react-radio,3.1.0,3.1.1,13,2,62,21,83,9,TRUE
apeman-react-radio,2.1.0,2.1.1,8,4,285,606,891,27,FALSE
apeman-react-radio,2.0.0,2.0.1,4,3,541,487,1028,16,TRUE
apeman-react-radio,4.0.1,4.0.2,24,2,28,27,55,8,TRUE
apeman-react-radio,3.1.8,3.1.9,21,2,80,96,176,12,TRUE
apeman-react-radio,3.1.4,3.1.5,17,4,33,3463,3496,13,TRUE
apeman-react-radio,2.1.1,2.1.2,9,1,7583,5788,13371,5,TRUE
apeman-react-radio,3.1.5,3.1.6,18,2,15,15,30,2,TRUE
apeman-react-radio,1.1.0,2.0.0,3,3,339,318,657,35,TRUE
apeman-react-radio,3.1.2,3.1.3,15,2,2129,2071,4200,40,TRUE
apeman-react-radio,2.0.3,2.1.0,7,4,5411,338,5749,30,TRUE
apeman-react-radio,3.1.1,3.1.2,14,2,2132,2076,4208,40,TRUE
apeman-react-radio,2.1.2,3.0.0,10,2,681,22848,23529,39,TRUE
apeman-react-radio,4.0.4,4.0.5,27,3,24,24,48,5,TRUE
apeman-react-radio,2.0.2,2.0.3,6,2,313,925,1238,16,TRUE
apeman-react-radio,3.1.7,3.1.8,20,2,76,90,166,10,TRUE
yuntongxun-sdk,1.1.0,1.2.0,8,3,3,3,6,3,FALSE
yuntongxun-sdk,0.3.0,0.4.0,3,10,250,40,290,16,FALSE
yuntongxun-sdk,0.6.0,0.6.1,6,2,4,3,7,3,FALSE
yuntongxun-sdk,1.2.0,1.3.0,9,6,41,62,103,10,FALSE
yuntongxun-sdk,0.2.0,0.3.0,2,5,153,87,240,7,FALSE
yuntongxun-sdk,0.1.0,0.2.0,1,4,223,33,256,11,FALSE
yuntongxun-sdk,0.4.0,0.5.0,4,5,11,14,25,7,FALSE
yuntongxun-sdk,0.5.0,0.6.0,5,4,6,3,9,4,FALSE
yuntongxun-sdk,0.6.1,1.1.0,7,6,457,280,737,34,FALSE
yuntongxun-sdk,1.4.0,1.5.0,11,4,66,12,78,6,FALSE
yuntongxun-sdk,1.3.0,1.4.0,10,2,121,225,346,17,FALSE
yuntongxun-sdk,1.4.0,1.5.0,11,4,66,12,78,6,TRUE
immutability-skinable-component,1.1.0,1.1.1,2,1,2,4,6,1,FALSE
immutability-skinable-component,1.0.0,1.1.0,1,18,537,495,1032,48,FALSE
immutability-skinable-component,1.0.0,1.1.0,1,18,537,495,1032,48,TRUE
karma-coverage-istanbul-reporter,1.1.0,1.2.0,9,11,849,101,950,21,FALSE
karma-coverage-istanbul-reporter,1.2.1,1.3.0,11,5,261,113,374,14,FALSE
karma-coverage-istanbul-reporter,1.0.0,1.1.0,8,6,4625,128,4753,12,FALSE
karma-coverage-istanbul-reporter,1.2.0,1.2.1,10,9,197,169,366,10,FALSE
karma-coverage-istanbul-reporter,0.3.0,0.3.1,6,6,149,23,172,12,FALSE
karma-coverage-istanbul-reporter,0.3.1,1.0.0,7,2,31,12,43,4,FALSE
karma-coverage-istanbul-reporter,0.2.3,0.3.0,5,9,132,30,162,12,FALSE
karma-coverage-istanbul-reporter,0.2.2,0.2.3,4,5,20,10,30,9,FALSE
karma-coverage-istanbul-reporter,0.2.1,0.2.2,3,6,39,26,65,6,FALSE
karma-coverage-istanbul-reporter,0.2.0,0.2.1,2,8,48,12,60,8,FALSE
karma-coverage-istanbul-reporter,0.1.0,0.2.0,1,2,49,4,53,8,FALSE
karma-coverage-istanbul-reporter,1.2.1,1.3.0,11,5,261,113,374,14,TRUE
karma-coverage-istanbul-reporter,1.1.0,1.2.0,9,11,849,101,950,21,TRUE
karma-coverage-istanbul-reporter,1.0.0,1.1.0,8,6,4625,128,4753,12,TRUE
karma-coverage-istanbul-reporter,1.2.0,1.2.1,10,9,197,169,366,10,TRUE
karma-coverage-istanbul-reporter,0.3.0,0.3.1,6,6,149,23,172,12,TRUE
karma-coverage-istanbul-reporter,0.2.2,0.2.3,4,5,20,10,30,9,TRUE
karma-coverage-istanbul-reporter,0.2.0,0.2.1,2,8,48,12,60,8,TRUE
hiromi,0.3.6,0.3.7,28,6,31,17,48,6,FALSE
hiromi,0.3.7,0.3.8,29,3,10,10,20,4,FALSE
hiromi,0.2.6,0.3.0,21,4,261,13,274,14,FALSE
hiromi,0.2.5,0.2.6,20,3,122,16,138,7,FALSE
hiromi,0.2.4,0.2.5,19,2,6,6,12,4,FALSE
hiromi,0.2.3,0.2.4,18,2,4,4,8,4,FALSE
hiromi,0.0.10,0.0.11,10,5,438,296,734,31,FALSE
hiromi,0.0.13,0.1.0,13,7,14,10,24,8,FALSE
hiromi,0.0.12,0.0.13,12,5,329,13,342,17,FALSE
hiromi,0.1.0,0.1.1,14,3,14,12,26,8,FALSE
hiromi,0.1.1,0.1.2,15,6,21,7,28,9,FALSE
hiromi,0.1.2,0.1.3,16,4,36,34,70,8,FALSE
hiromi,0.1.3,0.2.3,17,6,218,30,248,11,FALSE
hiromi,0.0.5,0.0.6,5,1,154,5,159,15,FALSE
hiromi,0.0.4,0.0.5,4,1,247,11,258,9,FALSE
hiromi,0.3.8,0.3.9,30,4,4,4,8,4,FALSE
hiromi,0.0.6,0.0.7,6,1,37,2,39,6,FALSE
hiromi,0.0.1,0.0.2,1,2,2,2,4,2,FALSE
hiromi,0.0.3,0.0.4,3,1,85,13,98,8,FALSE
hiromi,0.0.2,0.0.3,2,1,268,10,278,11,FALSE
hiromi,0.3.2,0.3.3,24,3,28,14,42,5,FALSE
hiromi,0.3.3,0.3.4,25,3,6,6,12,4,FALSE
hiromi,0.3.0,0.3.1,22,3,6,6,12,4,FALSE
hiromi,0.3.1,0.3.2,23,3,6,6,12,4,FALSE
hiromi,0.0.9,0.0.10,9,2,112,2,114,6,FALSE
hiromi,0.0.8,0.0.9,8,1,198,2,200,9,FALSE
hiromi,0.3.4,0.3.5,26,2,22,18,40,4,FALSE
hiromi,0.3.5,0.3.6,27,7,9,9,18,7,FALSE
hiromi,0.3.10,0.3.11,32,3,4,4,8,4,FALSE
hiromi,0.3.11,0.3.12,33,7,19,19,38,8,FALSE
hiromi,0.3.12,0.3.13,34,6,143,57,200,70,FALSE
hiromi,0.3.13,0.4.0,35,4,9,3,12,7,FALSE
hiromi,0.0.7,0.0.8,7,1,114,2,116,5,FALSE
hiromi,0.3.9,0.3.10,31,3,40,14,54,6,FALSE
hiromi,0.0.11,0.0.12,11,3,246,7,253,12,FALSE
hiromi,0.3.9,0.3.10,31,3,40,14,54,6,TRUE
hiromi,0.1.2,0.1.3,16,4,36,34,70,8,TRUE
hiromi,0.3.1,0.3.2,23,3,6,6,12,4,TRUE
hiromi,0.0.10,0.0.11,10,5,438,296,734,31,TRUE
hiromi,0.3.2,0.3.3,24,3,28,14,42,5,TRUE
hiromi,0.3.3,0.3.4,25,3,6,6,12,4,TRUE
hiromi,0.0.3,0.0.4,3,1,85,13,98,8,TRUE
homebridge-melcloud,0.3.2,0.3.3,5,5,16,14,30,5,TRUE
homebridge-melcloud,0.3.3,0.3.4,6,4,85,63,148,4,FALSE
homebridge-melcloud,0.3.0,0.3.1,3,2,7,1,8,2,FALSE
homebridge-melcloud,0.3.1,0.3.2,4,2,2,2,4,2,FALSE
homebridge-melcloud,0.2.0,0.3.0,2,5,109,66,175,7,FALSE
homebridge-melcloud,0.1.0,0.2.0,1,2,2,1,3,2,FALSE
react-webpack-node,2.0.0,2.0.1,44,2,46,69,115,11,FALSE
react-webpack-node,1.6.2,1.7.0,26,10,820,42,862,46,FALSE
react-webpack-node,1.6.0,1.6.1,24,5,1258,1031,2289,88,FALSE
react-webpack-node,1.6.1,1.6.2,25,18,903,204,1107,84,FALSE
react-webpack-node,1.7.9,1.7.10,35,4,7,3,10,4,FALSE
react-webpack-node,1.7.8,1.7.9,34,6,275,239,514,42,FALSE
react-webpack-node,1.7.7,1.7.8,33,4,93,19,112,10,FALSE
react-webpack-node,1.7.6,1.7.7,32,12,68,66,134,37,FALSE
react-webpack-node,1.7.5,1.7.6,31,4,5,1,6,12,FALSE
react-webpack-node,1.7.4,1.7.5,30,3,11,3,14,6,FALSE
react-webpack-node,1.7.3,1.7.4,29,5,34,49,83,5,FALSE
react-webpack-node,1.7.1,1.7.3,28,11,90,58,148,12,FALSE
react-webpack-node,1.7.0,1.7.1,27,1,7,1,8,3,FALSE
react-webpack-node,1.7.17,2.0.0,43,13,402,329,731,32,FALSE
react-webpack-node,1.7.16,1.7.17,42,165,1399,1118,2517,251,FALSE
react-webpack-node,1.7.15,1.7.16,41,3,22,12,34,3,FALSE
react-webpack-node,1.7.14,1.7.15,40,18,1297,568,1865,58,FALSE
react-webpack-node,1.7.13,1.7.14,39,14,163,26,189,22,FALSE
react-webpack-node,1.7.12,1.7.13,38,4,305,35,340,8,FALSE
react-webpack-node,1.7.11,1.7.12,37,3,129,56,185,4,FALSE
react-webpack-node,1.7.10,1.7.11,36,8,314,201,515,15,FALSE
react-webpack-node,1.5.4,1.6.0,23,7,97,59,156,27,FALSE
react-webpack-node,1.5.1,1.5.2,20,4,46,14,60,6,FALSE
react-webpack-node,1.5.0,1.5.1,19,4,14,4,18,5,FALSE
react-webpack-node,1.5.3,1.5.4,22,10,451,220,671,41,FALSE
react-webpack-node,1.5.2,1.5.3,21,5,226,198,424,53,FALSE
react-webpack-node,1.1.1,1.1.2,2,25,1793,1665,3458,204,FALSE
react-webpack-node,1.1.3,1.1.4,4,27,987,379,1366,67,FALSE
react-webpack-node,1.1.2,1.1.3,3,3,31,4,35,4,FALSE
react-webpack-node,1.1.5,1.1.6,6,5,94,92,186,12,FALSE
react-webpack-node,1.1.4,1.1.5,5,10,475,385,860,40,FALSE
react-webpack-node,2.0.1,2.1.0,45,7,397,360,757,82,FALSE
react-webpack-node,1.1.6,1.2.0,7,18,421,469,890,137,FALSE
react-webpack-node,2.2.5,2.2.6,51,1,17,10,27,6,FALSE
react-webpack-node,2.2.4,2.2.5,50,3,28,24,52,7,FALSE
react-webpack-node,2.2.0,2.2.3,48,3,58,39,97,16,FALSE
react-webpack-node,2.2.3,2.2.4,49,1,15,9,24,3,FALSE
react-webpack-node,2.1.0,2.1.1,46,1,10,5,15,3,FALSE
react-webpack-node,2.1.1,2.2.0,47,1,63,90,153,26,FALSE
react-webpack-node,1.4.5,1.5.0,18,14,1401,1017,2418,128,FALSE
react-webpack-node,3.0.0,3.1.0,53,5,71,144,215,15,FALSE
react-webpack-node,1.4.0,1.4.1,13,2,8,4,12,4,FALSE
react-webpack-node,1.4.1,1.4.2,14,19,936,742,1678,82,FALSE
react-webpack-node,1.4.2,1.4.3,15,17,677,363,1040,69,FALSE
react-webpack-node,1.4.3,1.4.4,16,5,656,811,1467,68,FALSE
react-webpack-node,1.4.4,1.4.5,17,13,287,95,382,48,FALSE
react-webpack-node,1.3.3,1.4.0,12,24,520,574,1094,85,FALSE
react-webpack-node,1.3.2,1.3.3,11,36,1469,569,2038,121,FALSE
react-webpack-node,1.3.1,1.3.2,10,5,407,474,881,36,FALSE
react-webpack-node,1.2.0,1.3.0,8,33,1640,726,2366,174,FALSE
react-webpack-node,3.1.0,3.2.0,54,3,7306,158,7464,34,FALSE
react-webpack-node,1.3.0,1.3.1,9,45,1700,2581,4281,169,FALSE
react-webpack-node,2.2.6,3.0.0,52,5,347,403,750,29,FALSE
react-webpack-node,3.2.0,3.2.1,55,5,67,2,69,5,FALSE
react-webpack-node,3.2.1,3.3.0,56,3,512,333,845,13,FALSE
react-webpack-node,1.1.0,1.1.1,1,69,3932,2440,6372,457,FALSE
react-webpack-node,1.1.4,1.1.5,5,10,475,385,860,40,TRUE
react-webpack-node,1.7.13,1.7.14,39,14,163,26,189,22,TRUE
react-webpack-node,2.1.1,2.2.0,47,1,63,90,153,26,TRUE
react-webpack-node,1.6.2,1.7.0,26,10,820,42,862,46,TRUE
react-webpack-node,1.4.3,1.4.4,16,5,656,811,1467,68,TRUE
react-webpack-node,1.2.0,1.3.0,8,33,1640,726,2366,174,TRUE
react-webpack-node,1.4.5,1.5.0,18,14,1401,1017,2418,128,TRUE
react-webpack-node,1.1.3,1.1.4,4,27,987,379,1366,67,TRUE
react-webpack-node,2.2.0,2.2.3,48,3,58,39,97,16,TRUE
react-webpack-node,1.7.1,1.7.3,28,11,90,58,148,12,TRUE
react-webpack-node,1.3.3,1.4.0,12,24,520,574,1094,85,TRUE
react-webpack-node,1.7.14,1.7.15,40,18,1297,568,1865,58,TRUE
react-webpack-node,1.4.2,1.4.3,15,17,677,363,1040,69,TRUE
react-webpack-node,1.7.4,1.7.5,30,3,11,3,14,6,TRUE
react-webpack-node,1.5.4,1.6.0,23,7,97,59,156,27,TRUE
react-webpack-node,1.5.3,1.5.4,22,10,451,220,671,41,TRUE
react-webpack-node,2.0.0,2.0.1,44,2,46,69,115,11,TRUE
react-webpack-node,1.7.7,1.7.8,33,4,93,19,112,10,TRUE
react-webpack-node,1.7.5,1.7.6,31,4,5,1,6,12,TRUE
react-webpack-node,1.7.16,1.7.17,42,165,1399,1118,2517,251,TRUE
react-webpack-node,3.0.0,3.1.0,53,5,71,144,215,15,TRUE
react-webpack-node,1.7.10,1.7.11,36,8,314,201,515,15,TRUE
react-webpack-node,1.7.3,1.7.4,29,5,34,49,83,5,TRUE
react-webpack-node,1.7.8,1.7.9,34,6,275,239,514,42,TRUE
react-webpack-node,1.1.2,1.1.3,3,3,31,4,35,4,TRUE
react-webpack-node,1.4.0,1.4.1,13,2,8,4,12,4,TRUE
react-webpack-node,1.6.1,1.6.2,25,18,903,204,1107,84,TRUE
react-webpack-node,1.7.0,1.7.1,27,1,7,1,8,3,TRUE
react-webpack-node,1.7.15,1.7.16,41,3,22,12,34,3,TRUE
react-webpack-node,1.3.1,1.3.2,10,5,407,474,881,36,TRUE
react-webpack-node,3.2.0,3.2.1,55,5,67,2,69,5,TRUE
react-webpack-node,1.7.11,1.7.12,37,3,129,56,185,4,TRUE
react-webpack-node,1.4.4,1.4.5,17,13,287,95,382,48,TRUE
react-webpack-node,1.7.6,1.7.7,32,12,68,66,134,37,TRUE
react-webpack-node,2.2.4,2.2.5,50,3,28,24,52,7,TRUE
gulp-blink,0.1.1,0.1.2,3,1,2,2,4,1,FALSE
gulp-blink,0.1.0,0.1.1,2,1,33,45,78,3,FALSE
gulp-blink,0.1.0-alpha,0.1.0,1,2,12,20,32,12,FALSE
gulp-blink,0.1.2,0.1.3,4,2,2,2,4,2,FALSE
gulp-blink,0.1.3,0.1.4,5,2,2,2,4,2,FALSE
gulp-blink,0.1.3,0.1.4,5,2,2,2,4,2,TRUE
paradigm-documents,0.0.59,0.0.60,57,1,2,4,6,2,FALSE
paradigm-documents,0.0.58,0.0.59,56,1,2,4,6,2,FALSE
paradigm-documents,0.0.51,0.0.52,49,1,2,4,6,2,FALSE
paradigm-documents,0.0.50,0.0.51,48,2,86,54,140,5,FALSE
paradigm-documents,0.0.53,0.0.54,51,1,2,4,6,2,FALSE
paradigm-documents,0.0.52,0.0.53,50,1,2,2,4,2,FALSE
paradigm-documents,0.0.55,0.0.56,53,1,22,18,40,4,FALSE
paradigm-documents,0.0.54,0.0.55,52,1,2,4,6,2,FALSE
paradigm-documents,0.0.57,0.0.58,55,1,2,4,6,2,FALSE
paradigm-documents,0.0.56,0.0.57,54,1,99,21,120,4,FALSE
paradigm-documents,0.1.14-a3,0.1.14-a4,164,1,2,4,6,2,FALSE
paradigm-documents,0.1.14-a2,0.1.14-a3,163,1,2,4,6,2,FALSE
paradigm-documents,0.1.14-a1,0.1.14-a2,162,1,2,4,6,2,FALSE
paradigm-documents,0.1.14-a5,0.1.14,166,1,2,4,6,2,FALSE
paradigm-documents,0.1.14-a4,0.1.14-a5,165,1,2,4,6,2,FALSE
paradigm-documents,0.0.64,0.0.65,62,2,247,48,295,5,FALSE
paradigm-documents,0.0.65,0.0.66,63,1,64,8,72,4,FALSE
paradigm-documents,0.0.66,0.0.67,64,1,224,12,236,9,FALSE
paradigm-documents,0.0.67,0.0.68,65,1,25,2,27,3,FALSE
paradigm-documents,0.0.60,0.0.61,58,2,103,14,117,6,FALSE
paradigm-documents,0.0.61,0.0.62,59,2,7,6,13,4,FALSE
paradigm-documents,0.0.62,0.0.63,60,2,2,2,4,2,FALSE
paradigm-documents,0.0.63,0.0.64,61,1,266,115,381,6,FALSE
paradigm-documents,0.0.68,0.0.69,66,1,35,14,49,3,FALSE
paradigm-documents,0.0.69,0.0.70,67,1,1,11,12,2,FALSE
paradigm-documents,0.1.38,0.1.39-a1,190,1,2,4,6,2,FALSE
paradigm-documents,0.1.34,0.1.35,186,1,2,4,6,2,FALSE
paradigm-documents,0.1.35,0.1.36,187,1,2,4,6,2,FALSE
paradigm-documents,0.1.36,0.1.37,188,1,2,4,6,2,FALSE
paradigm-documents,0.1.37,0.1.38,189,1,2,4,6,2,FALSE
paradigm-documents,0.1.30,0.1.32,183,4,165,126,291,12,FALSE
paradigm-documents,0.1.32,0.1.33,184,1,3,3,6,2,FALSE
paradigm-documents,0.1.33,0.1.34,185,1,10,1,11,2,FALSE
paradigm-documents,0.0.73,0.0.74,71,1,3,3,6,2,FALSE
paradigm-documents,0.0.72,0.0.73,70,1,88,4,92,5,FALSE
paradigm-documents,0.0.71,0.0.72,69,3,235,92,327,16,FALSE
paradigm-documents,0.0.70,0.0.71,68,1,6,1,7,2,FALSE
paradigm-documents,0.0.77,0.0.78,75,1,140,188,328,2,FALSE
paradigm-documents,0.0.76,0.0.77,74,2,3,3,6,2,FALSE
paradigm-documents,0.0.75,0.0.76,73,2,152,4,156,5,FALSE
paradigm-documents,0.0.74,0.0.75,72,1,88,18,106,4,FALSE
paradigm-documents,0.0.79,0.0.80,77,1,2,4,6,2,FALSE
paradigm-documents,0.0.78,0.0.79,76,1,2,4,6,2,FALSE
paradigm-documents,0.1.29,0.1.30,182,1,2,4,6,2,FALSE
paradigm-documents,0.1.28,0.1.29,181,1,62,53,115,3,FALSE
paradigm-documents,0.1.23,0.1.24,176,1,18,10,28,4,FALSE
paradigm-documents,0.1.22,0.1.23,175,1,91,124,215,4,FALSE
paradigm-documents,0.1.21,0.1.22,174,1,2,4,6,2,FALSE
paradigm-documents,0.1.20,0.1.21,173,1,41,251,292,4,FALSE
paradigm-documents,0.1.27,0.1.28,180,1,2,2,4,2,FALSE
paradigm-documents,0.1.26,0.1.27,179,1,18,2,20,2,FALSE
paradigm-documents,0.1.25,0.1.26,178,1,9,6,15,2,FALSE
paradigm-documents,0.1.24,0.1.25,177,1,6,6,12,3,FALSE
paradigm-documents,0.0.88,0.0.89,85,2,27,1,28,5,FALSE
paradigm-documents,0.0.89,0.0.90-b,86,3,398,243,641,14,FALSE
paradigm-documents,0.0.86,0.0.88,84,2,138,145,283,5,FALSE
paradigm-documents,0.0.84,0.0.85,82,1,3,3,6,2,FALSE
paradigm-documents,0.0.85,0.0.86,83,1,2,2,4,2,FALSE
paradigm-documents,0.0.82,0.0.83,80,1,2,1,3,2,FALSE
paradigm-documents,0.0.83,0.0.84,81,1,20,32,52,5,FALSE
paradigm-documents,0.0.80,0.0.81,78,2,14,10,24,4,FALSE
paradigm-documents,0.0.81,0.0.82,79,1,12,10,22,2,FALSE
paradigm-documents,0.0.37,0.0.38,35,1,69,2,71,4,FALSE
paradigm-documents,0.0.49,0.0.50,47,1,2,4,6,2,FALSE
paradigm-documents,0.0.91,0.0.92,89,1,2,2,4,2,FALSE
paradigm-documents,0.0.90,0.0.91,88,1,392,239,631,10,FALSE
paradigm-documents,0.0.15,0.0.16,14,1,3,3,6,2,FALSE
paradigm-documents,0.0.14,0.0.15,13,1,1,2,3,2,FALSE
paradigm-documents,0.0.17,0.0.19,16,1,14,13,27,2,FALSE
paradigm-documents,0.0.16,0.0.17,15,1,104,6,110,4,FALSE
paradigm-documents,0.0.11,0.0.12,10,1,5,1,6,2,FALSE
paradigm-documents,0.0.10,0.0.11,9,1,1,3,4,2,FALSE
paradigm-documents,0.0.13,0.0.14,12,1,1,2,3,2,FALSE
paradigm-documents,0.0.12,0.0.13,11,1,8,8,16,3,FALSE
paradigm-documents,0.0.19,0.0.20,17,1,4,2,6,2,FALSE
paradigm-documents,0.1.41,0.1.42,193,1,6,3,9,2,FALSE
paradigm-documents,0.1.40,0.1.41,192,3,102,13,115,10,FALSE
paradigm-documents,0.1.42,0.1.43,194,1,3,4,7,2,FALSE
paradigm-documents,0.0.20,0.0.21,18,1,8,2,10,2,FALSE
paradigm-documents,0.0.21,0.0.22,19,1,178,27,205,6,FALSE
paradigm-documents,0.0.22,0.0.23,20,1,3,2,5,2,FALSE
paradigm-documents,0.0.23,0.0.24,21,1,2,2,4,2,FALSE
paradigm-documents,0.0.24,0.0.25,22,1,83,1,84,4,FALSE
paradigm-documents,0.0.25,0.0.26,23,1,247,38,285,10,FALSE
paradigm-documents,0.0.26,0.0.27,24,1,74,12,86,3,FALSE
paradigm-documents,0.0.27,0.0.28,25,1,2,2,4,1,FALSE
paradigm-documents,0.0.28,0.0.29,26,1,29,14,43,2,FALSE
paradigm-documents,0.0.29,0.0.30,27,1,2,4,6,2,FALSE
paradigm-documents,0.0.36,0.0.37,34,1,3,3,6,2,FALSE
paradigm-documents,0.0.35,0.0.36,33,1,5,1,6,2,FALSE
paradigm-documents,0.1.8,0.1.9,156,1,17,2,19,2,FALSE
paradigm-documents,0.1.9,0.1.10,157,1,6,216,222,2,FALSE
paradigm-documents,0.0.39,0.0.40,37,1,2,2,4,2,FALSE
paradigm-documents,0.0.38,0.0.39,36,1,109,7,116,5,FALSE
paradigm-documents,0.1.0,0.1.1,148,1,2,4,6,2,FALSE
paradigm-documents,0.1.1,0.1.2,149,1,2,4,6,2,FALSE
paradigm-documents,0.1.2,0.1.3,150,1,101,16,117,4,FALSE
paradigm-documents,0.0.34,0.0.35,32,1,4,4,8,3,FALSE
paradigm-documents,0.0.33,0.0.34,31,1,3,2,5,2,FALSE
paradigm-documents,0.1.5,0.1.6,153,1,2,2,4,1,FALSE
paradigm-documents,0.0.31,0.0.32,29,1,184,48,232,5,FALSE
paradigm-documents,0.0.30,0.0.31,28,1,2,4,6,2,FALSE
paradigm-documents,0.0.5,0.0.6,4,1,147,2,149,6,FALSE
paradigm-documents,0.0.4,0.0.5,3,1,264,15,279,5,FALSE
paradigm-documents,0.0.7,0.0.8,6,1,113,47,160,6,FALSE
paradigm-documents,0.1.3,0.1.4,151,1,2,2,4,2,FALSE
paradigm-documents,0.0.3,0.0.4,2,1,108,5,113,5,FALSE
paradigm-documents,0.0.2,0.0.3,1,1,207,99,306,7,FALSE
paradigm-documents,0.1.4,0.1.5,152,1,164,7,171,3,FALSE
paradigm-documents,0.0.9,0.0.10,8,1,2,4,6,2,FALSE
paradigm-documents,0.0.8,0.0.9,7,1,37,46,83,5,FALSE
paradigm-documents,0.0.32,0.0.33,30,1,5,5,10,3,FALSE
paradigm-documents,0.1.6,0.1.7,154,1,3,3,6,2,FALSE
paradigm-documents,0.1.7,0.1.8,155,2,2,1,3,2,FALSE
paradigm-documents,0.0.48,0.0.49,46,1,3,3,6,2,FALSE
paradigm-documents,0.0.6,0.0.7,5,1,2,4,6,2,FALSE
paradigm-documents,0.0.42,0.0.43,40,1,4,4,8,3,FALSE
paradigm-documents,0.0.43,0.0.44,41,1,15,3,18,2,FALSE
paradigm-documents,0.0.40,0.0.41,38,1,3,3,6,2,FALSE
paradigm-documents,0.0.41,0.0.42,39,1,2,4,6,2,FALSE
paradigm-documents,0.0.46,0.0.47,44,1,2,4,6,2,FALSE
paradigm-documents,0.0.47,0.0.48,45,2,86,16,102,6,FALSE
paradigm-documents,0.0.44,0.0.45,42,1,116,2,118,3,FALSE
paradigm-documents,0.0.45,0.0.46,43,1,2,4,6,2,FALSE
paradigm-documents,0.1.12,0.1.13,160,1,26,2,28,2,FALSE
paradigm-documents,0.1.13,0.1.14-a1,161,1,2,4,6,2,FALSE
paradigm-documents,0.1.10,0.1.11,158,1,2,4,6,2,FALSE
paradigm-documents,0.1.11,0.1.12,159,1,2,4,6,2,FALSE
paradigm-documents,0.1.16,0.1.17,169,1,2,4,6,2,FALSE
paradigm-documents,0.1.17,0.1.18,170,1,2,4,6,2,FALSE
paradigm-documents,0.1.14,0.1.15,167,1,2,4,6,2,FALSE
paradigm-documents,0.1.15,0.1.16,168,1,2,4,6,2,FALSE
paradigm-documents,0.1.18,0.1.19,171,2,266,45,311,5,FALSE
paradigm-documents,0.1.19,0.1.20,172,1,1,1,2,1,FALSE
paradigm-documents,0.1.39-a1,0.1.40,191,1,2,4,6,2,FALSE
paradigm-documents,0.0.61,0.0.62,59,2,7,6,13,4,TRUE
paradigm-documents,0.0.45,0.0.46,43,1,2,4,6,2,TRUE
paradigm-documents,0.1.22,0.1.23,175,1,91,124,215,4,TRUE
paradigm-documents,0.0.47,0.0.48,45,2,86,16,102,6,TRUE
paradigm-documents,0.0.139,0.0.140,137,1,2,4,6,2,FALSE
paradigm-documents,0.0.138,0.0.139,136,1,2,4,6,2,FALSE
paradigm-documents,0.1.32,0.1.33,184,1,3,3,6,2,TRUE
paradigm-documents,0.0.137,0.0.138,135,1,2,4,6,2,FALSE
paradigm-documents,0.0.136,0.0.137,134,1,2,4,6,2,FALSE
paradigm-documents,0.0.135,0.0.136,133,1,2,4,6,2,FALSE
paradigm-documents,0.0.134,0.0.135,132,1,2,4,6,2,FALSE
paradigm-documents,0.0.99,0.0.100,97,1,3,2,5,2,FALSE
paradigm-documents,0.0.98,0.0.99,96,1,15,6,21,3,FALSE
paradigm-documents,0.0.131,0.0.132,129,3,89,18,107,6,FALSE
paradigm-documents,0.0.130,0.0.131,128,1,2,4,6,2,FALSE
paradigm-documents,0.0.95,0.0.96,93,1,22,8,30,4,FALSE
paradigm-documents,0.0.94,0.0.95,92,1,76,57,133,5,FALSE
paradigm-documents,0.0.97,0.0.98,95,1,36,24,60,2,FALSE
paradigm-documents,0.0.96,0.0.97,94,1,7,4,11,3,FALSE
paradigm-documents,0.0.93,0.0.94,91,1,22,26,48,2,FALSE
paradigm-documents,0.0.92,0.0.93,90,1,2,4,6,2,FALSE
paradigm-documents,0.0.142,0.0.143,140,1,45,7,52,3,FALSE
paradigm-documents,0.0.143,0.0.144,141,1,2,4,6,2,FALSE
paradigm-documents,0.0.140,0.0.141,138,1,30,12,42,4,FALSE
paradigm-documents,0.0.141,0.0.142,139,1,2,4,6,2,FALSE
paradigm-documents,0.0.146,0.0.147,144,2,33,19,52,4,FALSE
paradigm-documents,0.0.147,0.0.148,145,1,2,4,6,2,FALSE
paradigm-documents,0.0.144,0.0.145,142,1,2,4,6,2,FALSE
paradigm-documents,0.0.145,0.0.146,143,1,2,4,6,2,FALSE
paradigm-documents,0.0.148,0.0.149,146,1,9,1,10,2,FALSE
paradigm-documents,0.0.149,0.1.0,147,1,172,173,345,8,FALSE
paradigm-documents,0.0.124,0.0.125,122,1,18,2,20,2,FALSE
paradigm-documents,0.0.125,0.0.126,123,1,2,4,6,2,FALSE
paradigm-documents,0.0.126,0.0.127,124,2,12,3,15,4,FALSE
paradigm-documents,0.0.127,0.0.128,125,1,2,4,6,2,FALSE
paradigm-documents,0.0.120,0.0.121,118,1,17,6,23,2,FALSE
paradigm-documents,0.0.121,0.0.122,119,1,6,4,10,2,FALSE
paradigm-documents,0.0.122,0.0.123,120,1,16,2,18,2,FALSE
paradigm-documents,0.0.123,0.0.124,121,1,3,3,6,2,FALSE
paradigm-documents,0.0.128,0.0.129,126,1,2,4,6,2,FALSE
paradigm-documents,0.0.129,0.0.130,127,2,17,23,40,4,FALSE
paradigm-documents,0.0.111,0.0.112,109,1,48,10,58,3,FALSE
paradigm-documents,0.0.110,0.0.111,108,3,30,76,106,5,FALSE
paradigm-documents,0.0.113,0.0.114,111,1,5,1,6,2,FALSE
paradigm-documents,0.0.112,0.0.113,110,1,10,3,13,2,FALSE
paradigm-documents,0.0.115,0.0.116,113,1,2,4,6,2,FALSE
paradigm-documents,0.0.114,0.0.115,112,1,6,5,11,2,FALSE
paradigm-documents,0.0.117,0.0.118,115,1,8,2,10,2,FALSE
paradigm-documents,0.0.116,0.0.117,114,2,151,14,165,7,FALSE
paradigm-documents,0.0.119,0.0.120,117,1,2,2,4,2,FALSE
paradigm-documents,0.0.118,0.0.119,116,1,13,7,20,3,FALSE
paradigm-documents,0.0.133,0.0.134,131,1,2,2,4,2,FALSE
paradigm-documents,0.0.132,0.0.133,130,2,9,9,18,3,FALSE
paradigm-documents,0.0.108,0.0.109,106,1,15,12,27,3,FALSE
paradigm-documents,0.0.109,0.0.110,107,1,2,4,6,2,FALSE
paradigm-documents,0.0.106,0.0.107,104,1,2,2,4,2,FALSE
paradigm-documents,0.0.107,0.0.108,105,1,7,1,8,2,FALSE
paradigm-documents,0.0.104,0.0.105,102,1,5,2,7,2,FALSE
paradigm-documents,0.0.105,0.0.106,103,1,243,20,263,4,FALSE
paradigm-documents,0.0.102,0.0.103,100,1,11,1,12,2,FALSE
paradigm-documents,0.0.103,0.0.104,101,1,1,1,2,1,FALSE
paradigm-documents,0.0.100,0.0.101,98,1,38,29,67,2,FALSE
paradigm-documents,0.0.101,0.0.102,99,1,17,140,157,5,FALSE
paradigm-documents,0.1.18,0.1.19,171,2,266,45,311,5,TRUE
paradigm-documents,0.0.110,0.0.111,108,3,30,76,106,5,TRUE
paradigm-documents,0.0.103,0.0.104,101,1,1,1,2,1,TRUE
paradigm-documents,0.0.6,0.0.7,5,1,2,4,6,2,TRUE
paradigm-documents,0.0.2,0.0.3,1,1,207,99,306,7,TRUE
paradigm-documents,0.1.38,0.1.39-a1,190,1,2,4,6,2,TRUE
paradigm-documents,0.1.28,0.1.29,181,1,62,53,115,3,TRUE
paradigm-documents,0.1.4,0.1.5,152,1,164,7,171,3,TRUE
paradigm-documents,0.1.6,0.1.7,154,1,3,3,6,2,TRUE
paradigm-documents,0.1.11,0.1.12,159,1,2,4,6,2,TRUE
paradigm-documents,0.1.20,0.1.21,173,1,41,251,292,4,TRUE
paradigm-documents,0.1.41,0.1.42,193,1,6,3,9,2,TRUE
paradigm-documents,0.1.10,0.1.11,158,1,2,4,6,2,TRUE
paradigm-documents,0.0.104,0.0.105,102,1,5,2,7,2,TRUE
paradigm-documents,0.0.65,0.0.66,63,1,64,8,72,4,TRUE
paradigm-documents,0.0.67,0.0.68,65,1,25,2,27,3,TRUE
paradigm-documents,0.0.17,0.0.19,16,1,14,13,27,2,TRUE
paradigm-documents,0.0.127,0.0.128,125,1,2,4,6,2,TRUE
paradigm-documents,0.0.26,0.0.27,24,1,74,12,86,3,TRUE
paradigm-documents,0.1.3,0.1.4,151,1,2,2,4,2,TRUE
sh-input-email,0.2.0,0.3.0,7,3,80,73,153,17,FALSE
sh-input-email,0.1.0,0.1.1,1,2,4,2,6,4,FALSE
sh-input-email,0.1.1,0.1.2,2,2,12,8,20,4,FALSE
sh-input-email,0.1.2,0.1.3,3,4,116,62,178,14,FALSE
sh-input-email,0.1.3,0.1.4,4,2,4,4,8,2,FALSE
sh-input-email,0.1.4,0.1.5,5,1,1,1,2,1,FALSE
sh-input-email,0.1.5,0.2.0,6,1,1,1,2,1,FALSE
sh-input-email,0.1.3,0.1.4,4,2,4,4,8,2,TRUE
sh-input-email,0.1.2,0.1.3,3,4,116,62,178,14,TRUE
relate-js,0.2.7,0.2.8,13,2,7,2,9,2,FALSE
relate-js,0.2.6,0.2.7,12,2,36,9,45,2,FALSE
relate-js,0.2.4,0.2.6,11,4,35,21,56,5,FALSE
relate-js,0.2.3,0.2.4,10,3,39,6,45,4,FALSE
relate-js,0.2.2,0.2.3,9,2,52,36,88,2,TRUE
relate-js,0.2.1,0.2.2,8,3,8,3,11,3,FALSE
relate-js,0.2.0,0.2.1,7,3,3,3,6,3,FALSE
relate-js,0.1.0,0.1.1,3,16,586,202,788,17,FALSE
relate-js,0.1.1,0.1.2,4,14,1142,155,1297,50,FALSE
relate-js,0.1.2,0.1.3,5,7,1463,113,1576,37,FALSE
relate-js,0.1.3,0.2.0,6,9,856,575,1431,42,FALSE
relate-js,0.2.9,0.3.0,15,3,10,9,19,5,FALSE
relate-js,0.2.8,0.2.9,14,2,9,5,14,2,FALSE
relate-js,0.6.9,0.6.10,40,3,55,23,78,13,FALSE
relate-js,0.6.8,0.6.9,39,2,26,7,33,2,FALSE
relate-js,0.0.1,0.1.0,2,4,16,11,27,4,FALSE
relate-js,0.0.0,0.0.1,1,24,3598,1612,5210,151,FALSE
relate-js,0.6.3,0.6.4,34,3,18,4,22,4,FALSE
relate-js,0.3.0,0.4.0,16,3,118,30,148,10,FALSE
relate-js,0.6.0,0.6.1,32,2,7,3,10,3,FALSE
relate-js,0.6.7,0.6.8,38,2,22,18,40,2,FALSE
relate-js,0.6.6,0.6.7,37,2,17,10,27,2,FALSE
relate-js,0.6.5,0.6.6,36,3,576,22,598,5,FALSE
relate-js,0.6.4,0.6.5,35,4,89,8,97,8,FALSE
relate-js,0.5.8,0.5.9,30,2,4,4,8,2,FALSE
relate-js,0.5.9,0.6.0,31,8,542,233,775,25,FALSE
relate-js,0.5.4,0.5.5,26,2,59,13,72,11,FALSE
relate-js,0.5.5,0.5.6,27,2,15,3,18,2,FALSE
relate-js,0.5.6,0.5.7,28,2,10,3,13,3,FALSE
relate-js,0.5.7,0.5.8,29,2,22,8,30,2,FALSE
relate-js,0.5.0,0.5.1,22,2,2,239,241,3,FALSE
relate-js,0.5.1,0.5.2,23,4,84,14,98,8,FALSE
relate-js,0.5.2,0.5.3,24,3,31,7,38,5,FALSE
relate-js,0.5.3,0.5.4,25,1,1,1,2,1,FALSE
relate-js,0.4.1,0.4.2,18,2,20,13,33,2,FALSE
relate-js,0.4.0,0.4.1,17,2,37,25,62,3,FALSE
relate-js,0.4.3,0.4.4,20,2,7,4,11,2,FALSE
relate-js,0.4.2,0.4.3,19,2,14,2,16,2,FALSE
relate-js,0.4.4,0.5.0,21,18,839,377,1216,45,FALSE
relate-js,0.6.12,0.6.13,43,5,54,43,97,5,FALSE
relate-js,0.6.11,0.6.12,42,2,81,5,86,5,FALSE
relate-js,0.6.10,0.6.11,41,2,2,2,4,2,FALSE
relate-js,0.6.1,0.6.3,33,4,51,75,126,9,FALSE
relate-js,0.2.2,0.2.3,9,2,52,36,88,2,FALSE
relate-js,0.7.4,0.7.5,49,2,17,12,29,2,FALSE
relate-js,0.7.5,0.7.6,50,2,16,8,24,2,FALSE
relate-js,0.7.2,0.7.3,47,2,1,4,5,3,FALSE
relate-js,0.7.3,0.7.4,48,2,6,1,7,2,FALSE
relate-js,0.7.0,0.7.1,45,2,2,2,4,2,FALSE
relate-js,0.7.1,0.7.2,46,2,15,15,30,12,FALSE
relate-js,0.1.3,0.2.0,6,9,856,575,1431,42,TRUE
relate-js,0.1.2,0.1.3,5,7,1463,113,1576,37,TRUE
relate-js,0.6.13,0.7.0,44,2,65,44,109,14,FALSE
relate-js,0.0.0,0.0.1,1,24,3598,1612,5210,151,TRUE
relate-js,0.5.9,0.6.0,31,8,542,233,775,25,TRUE
relate-js,0.6.12,0.6.13,43,5,54,43,97,5,TRUE
relate-js,0.6.1,0.6.3,33,4,51,75,126,9,TRUE
relate-js,0.1.0,0.1.1,3,16,586,202,788,17,TRUE
relate-js,0.6.5,0.6.6,36,3,576,22,598,5,TRUE
relate-js,0.6.4,0.6.5,35,4,89,8,97,8,TRUE
relate-js,0.5.2,0.5.3,24,3,31,7,38,5,TRUE
relate-js,0.7.0,0.7.1,45,2,2,2,4,2,TRUE
relate-js,0.6.9,0.6.10,40,3,55,23,78,13,TRUE
sprity-lwip,1.0.4,1.0.5,5,2,2,2,4,2,FALSE
sprity-lwip,1.0.5,1.0.6,6,6,22,6,28,7,FALSE
sprity-lwip,1.0.6,1.0.7,7,2,2,2,4,2,FALSE
sprity-lwip,1.0.0,1.0.1,1,2,22,7,29,4,FALSE
sprity-lwip,1.0.1,1.0.2,2,2,5,2,7,3,FALSE
sprity-lwip,1.0.2,1.0.3,3,2,9,6,15,3,FALSE
sprity-lwip,1.0.3,1.0.4,4,6,38,14,52,10,FALSE
sprity-lwip,1.0.1,1.0.2,2,2,5,2,7,3,TRUE
sprity-lwip,1.0.2,1.0.3,3,2,9,6,15,3,TRUE
react-module-loader,1.0.4,1.0.5,5,1,0,1,1,1,FALSE
react-module-loader,1.0.5,1.0.7,6,1,0,1,1,1,FALSE
react-module-loader,1.0.7,1.0.8,7,1,0,1,1,1,FALSE
react-module-loader,1.0.0,1.0.1,1,1,531,0,531,14,FALSE
react-module-loader,1.0.1,1.0.2,2,2,49,44,93,2,FALSE
react-module-loader,1.0.2,1.0.3,3,1,1,1,2,1,FALSE
react-module-loader,1.0.3,1.0.4,4,1,0,1,1,1,FALSE
react-module-loader,1.0.8,1.0.9,8,1,3,8,11,2,FALSE
react-module-loader,1.0.9,1.0.10,9,4,26,14,40,4,FALSE
react-module-loader,1.0.2,1.0.3,3,1,1,1,2,1,TRUE
react-module-loader,1.0.1,1.0.2,2,2,49,44,93,2,TRUE
react-module-loader,1.0.8,1.0.9,8,1,3,8,11,2,TRUE
json-touch-patch,0.8.0,0.9.0,1,4,514,245,759,12,FALSE
json-touch-patch,0.10.1,0.10.2,4,5,171,49,220,13,FALSE
json-touch-patch,0.10.0,0.10.1,3,5,249,49,298,14,FALSE
json-touch-patch,0.9.0,0.10.0,2,7,1502,348,1850,55,FALSE
json-touch-patch,0.11.0,0.11.1,6,2,8,7,15,3,FALSE
json-touch-patch,0.10.2,0.11.0,5,9,3308,1154,4462,122,FALSE
json-touch-patch,0.10.2,0.11.0,5,9,3308,1154,4462,122,TRUE
json-touch-patch,0.10.1,0.10.2,4,5,171,49,220,13,TRUE
gitlab-radiator,1.1.1,1.1.2,4,2,17,2,19,5,FALSE
gitlab-radiator,1.1.0,1.1.1,3,3,6,3,9,3,FALSE
gitlab-radiator,1.1.3,1.1.4,6,2,463,3,466,4,FALSE
gitlab-radiator,1.1.2,1.1.3,5,6,26,9,35,6,FALSE
gitlab-radiator,1.0.0,1.0.1,1,3,16,2,18,3,FALSE
gitlab-radiator,1.0.1,1.1.0,2,25,436,193,629,37,FALSE
gitlab-radiator,1.1.7,1.1.8,10,9,327,21,348,18,FALSE
gitlab-radiator,1.1.6,1.1.7,9,3,6,6,12,3,FALSE
gitlab-radiator,1.1.9,1.1.10,12,3,4,4,8,3,FALSE
gitlab-radiator,1.1.8,1.1.9,11,3,10,2,12,3,FALSE
gitlab-radiator,1.1.13,1.1.14,16,2,5,5,10,2,FALSE
gitlab-radiator,1.1.11,1.1.12,14,2,19,18,37,3,FALSE
gitlab-radiator,1.1.10,1.1.11,13,3,6,6,12,3,FALSE
gitlab-radiator,1.1.5,1.1.6,8,4,7,6,13,4,FALSE
gitlab-radiator,1.1.12,1.1.13,15,5,7,6,13,5,FALSE
gitlab-radiator,1.1.4,1.1.5,7,2,6,6,12,2,FALSE
gitlab-radiator,1.1.12,1.1.13,15,5,7,6,13,5,TRUE
gitlab-radiator,1.1.13,1.1.14,16,2,5,5,10,2,TRUE
gitlab-radiator,1.1.6,1.1.7,9,3,6,6,12,3,TRUE
gitlab-radiator,1.1.10,1.1.11,13,3,6,6,12,3,TRUE
react-dnd-treeview,0.1.0,0.2.0,1,8,1374,31734,33108,17,FALSE
react-dnd-treeview,0.4.0,0.4.1,4,1,11137,5058,16195,6,FALSE
react-dnd-treeview,0.3.0,0.4.0,3,1,40,10221,10261,24,FALSE
react-dnd-treeview,0.2.0,0.3.0,2,2,770,1258,2028,16,FALSE
react-dnd-treeview,0.2.0,0.3.0,2,2,770,1258,2028,16,TRUE
react-dnd-treeview,0.4.0,0.4.1,4,1,11137,5058,16195,6,TRUE
react-dnd-treeview,0.3.0,0.4.0,3,1,40,10221,10261,24,TRUE
solfegejs-server-router,2.0.0,2.0.1,10,1,78,18,96,17,TRUE
solfegejs-server-router,1.4.0,1.4.1,7,1,31,1,32,4,FALSE
solfegejs-server-router,1.4.1,1.4.2,8,1,78,18,96,17,FALSE
solfegejs-server-router,1.3.0,1.4.0,6,2,518,50,568,27,FALSE
solfegejs-server-router,1.2.0,1.3.0,5,1,992,347,1339,17,FALSE
solfegejs-server-router,2.0.0,2.0.1,10,1,78,18,96,17,FALSE
waliyun,2.0.1,2.0.2,20,1,11,3,14,2,FALSE
waliyun,1.0.0,2.0.0,18,5,217,770,987,55,FALSE
waliyun,2.0.2,3.0.0,21,2,75,28,103,10,FALSE
waliyun,2.0.0,2.0.1,19,1,2,2,4,2,FALSE
waliyun,0.4.1,0.4.2,13,1,897,1,898,2,FALSE
waliyun,0.4.3,0.4.4,15,1,1,0,1,1,FALSE
waliyun,0.4.2,0.4.3,14,1,3,895,898,2,FALSE
waliyun,0.4.5,1.0.0,17,2,28,7,35,4,FALSE
waliyun,0.4.4,0.4.5,16,2,9,6,15,2,FALSE
waliyun,0.2.4,0.3.0,8,2,48,6,54,6,FALSE
waliyun,0.2.3,0.2.4,7,3,51,15,66,4,FALSE
waliyun,0.2.2,0.2.3,6,2,3,3,6,3,FALSE
waliyun,0.2.1,0.2.2,5,2,189,2,191,11,FALSE
waliyun,0.2.0,0.2.1,4,2,65,42,107,13,FALSE
waliyun,0.1.1,0.1.2,1,1,94,11,105,12,FALSE
waliyun,0.1.2,0.1.3,2,1,7,4,11,2,FALSE
waliyun,0.1.3,0.2.0,3,6,170,10,180,15,FALSE
waliyun,0.3.2,0.4.0,11,1,7,3,10,2,FALSE
waliyun,0.3.0,0.3.1,9,1,2,2,4,2,FALSE
waliyun,0.3.1,0.3.2,10,2,11,10,21,3,FALSE
waliyun,0.4.0,0.4.1,12,2,6,1,7,2,FALSE
waliyun,0.2.1,0.2.2,5,2,189,2,191,11,TRUE
waliyun,2.0.0,2.0.1,19,1,2,2,4,2,TRUE
chainable-stub,1.1.0,1.1.1,2,1,3,3,6,2,FALSE
chainable-stub,1.0.0,1.1.0,1,2,77,40,117,10,FALSE
chainable-stub,1.1.0,1.1.1,2,1,3,3,6,2,TRUE
lodash-webpack-plugin,0.11.2,0.11.3,28,6,578,586,1164,11,FALSE
lodash-webpack-plugin,0.2.1,0.3.0,4,9,66,13,79,24,FALSE
lodash-webpack-plugin,0.2.0,0.2.1,3,8,14,12,26,11,TRUE
lodash-webpack-plugin,0.1.0,0.1.1,1,8,18,15,33,9,FALSE
lodash-webpack-plugin,0.1.1,0.2.0,2,7,55,28,83,9,FALSE
lodash-webpack-plugin,0.10.1,0.10.2,19,4,10,17,27,7,TRUE
lodash-webpack-plugin,0.10.0,0.10.1,18,18,53,32,85,19,TRUE
lodash-webpack-plugin,0.10.3,0.10.4,21,10,216,47,263,28,FALSE
lodash-webpack-plugin,0.10.2,0.10.3,20,9,2668,430,3098,13,TRUE
lodash-webpack-plugin,0.10.5,0.10.6,23,4,12,11,23,6,TRUE
lodash-webpack-plugin,0.10.4,0.10.5,22,6,41,5,46,16,FALSE
lodash-webpack-plugin,0.10.7,0.11.0,25,8,101,79,180,10,FALSE
lodash-webpack-plugin,0.10.6,0.10.7,24,5,369,428,797,10,FALSE
lodash-webpack-plugin,0.3.0,0.4.0,5,13,88,27,115,24,FALSE
lodash-webpack-plugin,0.6.0,0.7.0,8,5,53,10,63,14,FALSE
lodash-webpack-plugin,0.11.0,0.11.1,26,5,826,436,1262,14,FALSE
lodash-webpack-plugin,0.11.1,0.11.2,27,2,245,239,484,4,FALSE
lodash-webpack-plugin,0.7.0,0.8.0,9,5,13,5,18,6,FALSE
lodash-webpack-plugin,0.11.3,0.11.4,29,3,53,48,101,6,FALSE
lodash-webpack-plugin,0.4.0,0.5.0,6,10,119,54,173,22,FALSE
lodash-webpack-plugin,0.5.0,0.6.0,7,9,45,48,93,13,FALSE
lodash-webpack-plugin,0.9.0,0.9.1,13,7,44,22,66,21,FALSE
lodash-webpack-plugin,0.9.1,0.9.2,14,6,18,7,25,6,FALSE
lodash-webpack-plugin,0.9.2,0.9.3,15,8,21,21,42,11,TRUE
lodash-webpack-plugin,0.9.3,0.9.4,16,10,27,17,44,12,TRUE
lodash-webpack-plugin,0.9.4,0.10.0,17,11,39,23,62,15,TRUE
lodash-webpack-plugin,0.8.1,0.8.2,11,3,20,2,22,8,FALSE
lodash-webpack-plugin,0.8.0,0.8.1,10,10,38,16,54,14,TRUE
lodash-webpack-plugin,0.8.2,0.9.0,12,11,41,35,76,13,FALSE
lodash-webpack-plugin,0.2.0,0.2.1,3,8,14,12,26,11,FALSE
lodash-webpack-plugin,0.10.1,0.10.2,19,4,10,17,27,7,FALSE
lodash-webpack-plugin,0.10.0,0.10.1,18,18,53,32,85,19,FALSE
lodash-webpack-plugin,0.10.2,0.10.3,20,9,2668,430,3098,13,FALSE
lodash-webpack-plugin,0.10.5,0.10.6,23,4,12,11,23,6,FALSE
lodash-webpack-plugin,0.9.2,0.9.3,15,8,21,21,42,11,FALSE
lodash-webpack-plugin,0.9.3,0.9.4,16,10,27,17,44,12,FALSE
lodash-webpack-plugin,0.9.4,0.10.0,17,11,39,23,62,15,FALSE
lodash-webpack-plugin,0.8.0,0.8.1,10,10,38,16,54,14,FALSE
lodash-webpack-plugin,0.5.0,0.6.0,7,9,45,48,93,13,TRUE
lodash-webpack-plugin,0.2.1,0.3.0,4,9,66,13,79,24,TRUE
lodash-webpack-plugin,0.11.3,0.11.4,29,3,53,48,101,6,TRUE
lodash-webpack-plugin,0.8.1,0.8.2,11,3,20,2,22,8,TRUE
lodash-webpack-plugin,0.10.6,0.10.7,24,5,369,428,797,10,TRUE
lodash-webpack-plugin,0.7.0,0.8.0,9,5,13,5,18,6,TRUE
mini-routerjs,1.1.1,1.1.2,4,5,97,81,178,7,FALSE
mini-routerjs,1.1.0,1.1.1,3,4,19,10,29,5,FALSE
mini-routerjs,1.1.3,1.1.5,6,2,35,12,47,5,FALSE
mini-routerjs,1.1.2,1.1.3,5,5,62,23,85,7,FALSE
mini-routerjs,1.0.0,1.0.1,1,3,4,4,8,3,FALSE
mini-routerjs,1.0.1,1.1.0,2,6,60,44,104,7,FALSE
mini-routerjs,1.1.3,1.1.5,6,2,35,12,47,5,TRUE
mini-routerjs,1.1.2,1.1.3,5,5,62,23,85,7,TRUE
apprun,0.6.3,0.7.0,11,13,260,209,469,49,FALSE
apprun,0.6.2,0.6.3,10,11,303,20865,21168,28,FALSE
apprun,0.3.0,0.3.1,3,3,817,236,1053,10,FALSE
apprun,0.3.1,0.4.0,4,5,169,218,387,18,FALSE
apprun,0.7.0,0.7.1,12,3,48,60,108,9,FALSE
apprun,0.7.1,0.8.0,13,4,3257,7,3264,7,FALSE
apprun,0.2.0,0.3.0,2,10,19757,110,19867,41,FALSE
apprun,0.1.0,0.2.0,1,20,68529,47618,116147,85,FALSE
apprun,0.4.0,0.5.0,5,3,538,178,716,4,FALSE
apprun,0.6.1,0.6.2,9,10,5787,48551,54338,26,FALSE
apprun,0.5.0,0.5.1,6,11,58379,55417,113796,58,FALSE
apprun,0.5.1,0.5.2,7,2,2,2,4,2,FALSE
apprun,0.5.2,0.6.1,8,7,61252,40881,102133,66,FALSE
apprun,0.6.3,0.7.0,11,13,260,209,469,49,TRUE
apprun,0.3.1,0.4.0,4,5,169,218,387,18,TRUE
apprun,0.7.1,0.8.0,13,4,3257,7,3264,7,TRUE
apprun,0.2.0,0.3.0,2,10,19757,110,19867,41,TRUE
apprun,0.1.0,0.2.0,1,20,68529,47618,116147,85,TRUE
apprun,0.4.0,0.5.0,5,3,538,178,716,4,TRUE
apprun,0.6.1,0.6.2,9,10,5787,48551,54338,26,TRUE
apprun,0.5.1,0.5.2,7,2,2,2,4,2,TRUE
apprun,0.5.2,0.6.1,8,7,61252,40881,102133,66,TRUE
scalejs.metadatafactory-common,1.0.4,1.0.5,5,11,3862,1509,5371,126,FALSE
scalejs.metadatafactory-common,1.0.5,1.0.6,6,1,9,1,10,2,FALSE
scalejs.metadatafactory-common,1.0.6,1.0.7,7,9,329,312,641,80,FALSE
scalejs.metadatafactory-common,1.0.7,1.0.8,8,6,1402,65,1467,54,FALSE
scalejs.metadatafactory-common,1.0.0,1.0.1,1,1,20,27,47,11,FALSE
scalejs.metadatafactory-common,1.0.1,1.0.2,2,40,135306,15644,150950,205,FALSE
scalejs.metadatafactory-common,1.0.2,1.0.3,3,1,332,2,334,2,FALSE
scalejs.metadatafactory-common,1.0.3,1.0.4,4,12,275,331,606,24,FALSE
scalejs.metadatafactory-common,1.0.147,1.0.148,138,2,27,22,49,10,FALSE
scalejs.metadatafactory-common,1.0.8,1.0.9,9,1,1206,84,1290,46,FALSE
scalejs.metadatafactory-common,1.0.9,1.0.10,10,1,9,1,10,2,FALSE
scalejs.metadatafactory-common,1.0.146,1.0.147,137,3,358,371,729,39,FALSE
scalejs.metadatafactory-common,1.0.165,1.0.166,155,2,377,378,755,4,FALSE
scalejs.metadatafactory-common,1.0.164,1.0.165,154,1,2,2,4,1,FALSE
scalejs.metadatafactory-common,1.0.167,1.0.168,157,2,36,8,44,4,FALSE
scalejs.metadatafactory-common,1.0.166,1.0.167,156,2,21,9,30,4,FALSE
scalejs.metadatafactory-common,1.0.161,1.0.162,151,2,20,15,35,8,FALSE
scalejs.metadatafactory-common,1.0.160,1.0.161,150,1,1,3,4,3,FALSE
scalejs.metadatafactory-common,1.0.163,1.0.164,153,1,2,2,4,1,FALSE
scalejs.metadatafactory-common,1.0.162,1.0.163,152,2,51,38,89,7,FALSE
scalejs.metadatafactory-common,1.0.169,1.0.170,159,2,3,3,6,3,FALSE
scalejs.metadatafactory-common,1.0.168,1.0.169,158,3,24,4,28,7,FALSE
scalejs.metadatafactory-common,1.0.98,1.0.99,92,2,4,4,8,4,FALSE
scalejs.metadatafactory-common,1.0.99,1.0.100,93,2,22,15,37,4,FALSE
scalejs.metadatafactory-common,1.0.96,1.0.97,90,1,18,6,24,6,FALSE
scalejs.metadatafactory-common,1.0.97,1.0.98,91,2,20,8,28,4,FALSE
scalejs.metadatafactory-common,1.0.94,1.0.95,88,2,137,110,247,48,FALSE
scalejs.metadatafactory-common,1.0.95,1.0.96,89,2,118,114,232,49,FALSE
scalejs.metadatafactory-common,1.0.92,1.0.93,86,2,12,2,14,2,FALSE
scalejs.metadatafactory-common,1.0.93,1.0.94,87,2,64,55,119,51,FALSE
scalejs.metadatafactory-common,1.0.90,1.0.91,84,2,53,1,54,3,FALSE
scalejs.metadatafactory-common,1.0.91,1.0.92,85,3,54,3,57,4,FALSE
scalejs.metadatafactory-common,1.0.16,1.0.17,17,13,25359,24660,50019,68,FALSE
scalejs.metadatafactory-common,1.0.17,1.0.18,18,3,178,180,358,27,FALSE
scalejs.metadatafactory-common,1.0.14,1.0.15,15,6,695,613,1308,98,FALSE
scalejs.metadatafactory-common,1.0.15,1.0.16,16,11,427,418,845,19,FALSE
scalejs.metadatafactory-common,1.0.12,1.0.13,13,2,10,7,17,5,FALSE
scalejs.metadatafactory-common,1.0.13,1.0.14,14,6,39394,16155,55549,154,FALSE
scalejs.metadatafactory-common,1.0.10,1.0.11,11,2,37,37,74,37,FALSE
scalejs.metadatafactory-common,1.0.11,1.0.12,12,1,36,37,73,35,FALSE
scalejs.metadatafactory-common,1.0.18,1.0.19,19,6,41,16,57,13,FALSE
scalejs.metadatafactory-common,1.0.19,1.0.20,20,3,77,62,139,46,FALSE
scalejs.metadatafactory-common,1.0.172,1.0.173,162,2,7,1,8,2,FALSE
scalejs.metadatafactory-common,1.0.173,1.0.174,163,2,135,126,261,3,FALSE
scalejs.metadatafactory-common,1.0.170,1.0.171,160,2,46,50,96,3,FALSE
scalejs.metadatafactory-common,1.0.171,1.0.172,161,2,2,2,4,2,FALSE
scalejs.metadatafactory-common,1.0.176,1.0.177,166,2,69,68,137,16,FALSE
scalejs.metadatafactory-common,1.0.177,1.0.178,167,1,2,2,4,2,FALSE
scalejs.metadatafactory-common,1.0.174,1.0.175,164,1,4,4,8,2,FALSE
scalejs.metadatafactory-common,1.0.175,1.0.176,165,1,2,2,4,2,FALSE
scalejs.metadatafactory-common,1.0.178,1.0.179,168,1,15,3,18,3,FALSE
scalejs.metadatafactory-common,1.0.179,1.0.180,169,2,125,90,215,7,FALSE
scalejs.metadatafactory-common,1.0.89,1.0.90,83,2,5,3,8,3,FALSE
scalejs.metadatafactory-common,1.0.81,1.0.82,80,2,600,582,1182,8,FALSE
scalejs.metadatafactory-common,1.0.80,1.0.81,79,2,18,16,34,6,FALSE
scalejs.metadatafactory-common,1.0.83,1.0.89,82,2,2,7,9,2,FALSE
scalejs.metadatafactory-common,1.0.82,1.0.83,81,1,67,64,131,50,FALSE
scalejs.metadatafactory-common,1.0.189,1.0.190,178,4,11504,1754,13258,122,FALSE
scalejs.metadatafactory-common,1.0.188,1.0.189,177,1,18,7,25,7,FALSE
scalejs.metadatafactory-common,1.0.187,1.0.188,176,1,954,381,1335,10,FALSE
scalejs.metadatafactory-common,1.0.185,1.0.187,175,3,56323,35167,91490,94,FALSE
scalejs.metadatafactory-common,1.0.184,1.0.185,174,1,5,2,7,2,FALSE
scalejs.metadatafactory-common,1.0.183,1.0.184,173,1,2,2,4,2,FALSE
scalejs.metadatafactory-common,1.0.182,1.0.183,172,1,3,3,6,2,FALSE
scalejs.metadatafactory-common,1.0.181,1.0.182,171,1,10,8,18,2,FALSE
scalejs.metadatafactory-common,1.0.180,1.0.181,170,1,5,3,8,2,FALSE
scalejs.metadatafactory-common,1.0.107,1.0.108,101,3,20,21,41,4,FALSE
scalejs.metadatafactory-common,1.0.106,1.0.107,100,2,4,2,6,2,FALSE
scalejs.metadatafactory-common,1.0.105,1.0.106,99,1,22,5,27,4,FALSE
scalejs.metadatafactory-common,1.0.104,1.0.105,98,1,23,4,27,2,FALSE
scalejs.metadatafactory-common,1.0.103,1.0.104,97,1,28,11,39,11,FALSE
scalejs.metadatafactory-common,1.0.102,1.0.103,96,4,25,14,39,5,FALSE
scalejs.metadatafactory-common,1.0.101,1.0.102,95,2,14,8,22,2,FALSE
scalejs.metadatafactory-common,1.0.100,1.0.101,94,2,79,35,114,4,FALSE
scalejs.metadatafactory-common,1.0.109,1.0.110,103,2,5,1,6,2,FALSE
scalejs.metadatafactory-common,1.0.108,1.0.109,102,2,23,12,35,2,FALSE
scalejs.metadatafactory-common,1.0.30,1.0.31,30,2,2,2,4,2,FALSE
scalejs.metadatafactory-common,1.0.31,1.0.32,31,6,450,409,859,15,FALSE
scalejs.metadatafactory-common,1.0.32,1.0.33,32,5,193,132,325,12,FALSE
scalejs.metadatafactory-common,1.0.33,1.0.34,33,4,91,31,122,11,FALSE
scalejs.metadatafactory-common,1.0.34,1.0.35,34,5,49789,48298,98087,15,FALSE
scalejs.metadatafactory-common,1.0.35,1.0.36,35,2,914,5,919,17,FALSE
scalejs.metadatafactory-common,1.0.36,1.0.37,36,2,3,3,6,3,FALSE
scalejs.metadatafactory-common,1.0.37,1.0.38,37,4,46,15,61,7,FALSE
scalejs.metadatafactory-common,1.0.38,1.0.39,38,2,11,29,40,5,FALSE
scalejs.metadatafactory-common,1.0.39,1.0.40,39,4,120,20,140,6,FALSE
scalejs.metadatafactory-common,1.0.152,1.0.153,143,2,5,2,7,2,FALSE
scalejs.metadatafactory-common,1.0.198,1.0.199,187,4,3967,142,4109,84,FALSE
scalejs.metadatafactory-common,1.0.199,1.0.200,188,1,3,2,5,2,FALSE
scalejs.metadatafactory-common,1.0.194,1.0.195,183,1,13,2,15,2,FALSE
scalejs.metadatafactory-common,1.0.195,1.0.196,184,1,7,3,10,2,FALSE
scalejs.metadatafactory-common,1.0.196,1.0.197,185,1,2,1,3,2,FALSE
scalejs.metadatafactory-common,1.0.197,1.0.198,186,2,2,2,4,2,FALSE
scalejs.metadatafactory-common,1.0.190,1.0.191,179,1,123,108,231,66,FALSE
scalejs.metadatafactory-common,1.0.191,1.0.192,180,2,7,2,9,2,FALSE
scalejs.metadatafactory-common,1.0.192,1.0.193,181,2,908,182,1090,102,FALSE
scalejs.metadatafactory-common,1.0.193,1.0.194,182,2,1,4,5,2,FALSE
scalejs.metadatafactory-common,1.0.114,1.0.115,108,4,8,2,10,4,FALSE
scalejs.metadatafactory-common,1.0.115,1.0.117,109,4,260,53,313,20,FALSE
scalejs.metadatafactory-common,1.0.117,1.0.118,110,2,8,12,20,4,FALSE
scalejs.metadatafactory-common,1.0.110,1.0.111,104,3,3,3,6,3,FALSE
scalejs.metadatafactory-common,1.0.111,1.0.112,105,2,76,1,77,4,FALSE
scalejs.metadatafactory-common,1.0.112,1.0.113,106,3,6,4,10,3,FALSE
scalejs.metadatafactory-common,1.0.113,1.0.114,107,2,2,2,4,2,FALSE
scalejs.metadatafactory-common,1.0.118,1.0.119,111,2,9,2,11,4,FALSE
scalejs.metadatafactory-common,1.0.119,1.0.120,112,2,2,2,4,2,FALSE
scalejs.metadatafactory-common,1.0.29,1.0.30,29,7,434,365,799,27,FALSE
scalejs.metadatafactory-common,1.0.27,1.0.29,28,9,913,56,969,39,FALSE
scalejs.metadatafactory-common,1.0.26,1.0.27,27,7,1118,290,1408,104,FALSE
scalejs.metadatafactory-common,1.0.25,1.0.26,26,1,3,3,6,3,FALSE
scalejs.metadatafactory-common,1.0.24,1.0.25,25,3,153,119,272,14,FALSE
scalejs.metadatafactory-common,1.0.23,1.0.24,24,1,121,106,227,4,FALSE
scalejs.metadatafactory-common,1.0.22,1.0.23,23,1,8,2,10,5,FALSE
scalejs.metadatafactory-common,1.0.21,1.0.22,22,3,107,12,119,13,FALSE
scalejs.metadatafactory-common,1.0.20,1.0.21,21,3,89,12,101,9,FALSE
scalejs.metadatafactory-common,1.0.204,1.0.205,193,1,5,4,9,4,FALSE
scalejs.metadatafactory-common,1.0.205,1.0.206,194,1,6,4,10,4,FALSE
scalejs.metadatafactory-common,1.0.206,1.0.207,195,2,5,3,8,2,FALSE
scalejs.metadatafactory-common,1.0.200,1.0.201,189,1,4,1,5,2,FALSE
scalejs.metadatafactory-common,1.0.201,1.0.202,190,1,3,2,5,2,FALSE
scalejs.metadatafactory-common,1.0.202,1.0.203,191,2,9,2,11,2,FALSE
scalejs.metadatafactory-common,1.0.203,1.0.204,192,2,189,211,400,76,FALSE
scalejs.metadatafactory-common,1.0.121,1.0.122,114,2,251,5,256,6,FALSE
scalejs.metadatafactory-common,1.0.120,1.0.121,113,2,8,8,16,6,FALSE
scalejs.metadatafactory-common,1.0.123,1.0.124,116,2,8,4,12,4,FALSE
scalejs.metadatafactory-common,1.0.122,1.0.123,115,3,407,104,511,110,FALSE
scalejs.metadatafactory-common,1.0.125,1.0.126,118,2,56,36,92,5,FALSE
scalejs.metadatafactory-common,1.0.124,1.0.125,117,3,22,13,35,3,FALSE
scalejs.metadatafactory-common,1.0.127,1.0.128,120,2,2,1,3,2,FALSE
scalejs.metadatafactory-common,1.0.126,1.0.127,119,1,5,5,10,2,FALSE
scalejs.metadatafactory-common,1.0.129,1.0.130,122,2,8,2,10,2,FALSE
scalejs.metadatafactory-common,1.0.128,1.0.129,121,7,162,140,302,81,FALSE
scalejs.metadatafactory-common,1.0.58,1.0.59,57,1,17,1,18,1,FALSE
scalejs.metadatafactory-common,1.0.59,1.0.60,58,2,127,108,235,99,FALSE
scalejs.metadatafactory-common,1.0.52,1.0.53,51,2,235,254,489,33,FALSE
scalejs.metadatafactory-common,1.0.53,1.0.54,52,1,32,31,63,2,FALSE
scalejs.metadatafactory-common,1.0.50,1.0.51,49,1,7,7,14,3,FALSE
scalejs.metadatafactory-common,1.0.51,1.0.52,50,15,747,534,1281,35,FALSE
scalejs.metadatafactory-common,1.0.56,1.0.57,55,1,18,15,33,7,FALSE
scalejs.metadatafactory-common,1.0.57,1.0.58,56,5,5305,3129,8434,89,FALSE
scalejs.metadatafactory-common,1.0.54,1.0.55,53,3,47,42,89,5,FALSE
scalejs.metadatafactory-common,1.0.55,1.0.56,54,1,8,4,12,2,FALSE
scalejs.metadatafactory-common,1.0.158,1.0.160,149,3,17,15,32,8,FALSE
scalejs.metadatafactory-common,1.0.138,1.0.139,129,1,5,4,9,2,FALSE
scalejs.metadatafactory-common,1.0.139,1.0.140,130,1,2,2,4,2,FALSE
scalejs.metadatafactory-common,1.0.136,1.0.137,127,2,4,6,10,4,FALSE
scalejs.metadatafactory-common,1.0.137,1.0.138,128,1,2,2,4,2,FALSE
scalejs.metadatafactory-common,1.0.134,1.0.135,125,2,6,4,10,4,FALSE
scalejs.metadatafactory-common,1.0.135,1.0.136,126,2,5,3,8,5,FALSE
scalejs.metadatafactory-common,1.0.132,1.0.134,124,4,46,25,71,8,FALSE
scalejs.metadatafactory-common,1.0.130,1.0.132,123,4,50,17,67,31,FALSE
scalejs.metadatafactory-common,1.0.49,1.0.50,48,1,4,4,8,4,FALSE
scalejs.metadatafactory-common,1.0.48,1.0.49,47,1,17,1,18,4,FALSE
scalejs.metadatafactory-common,1.0.41,1.0.43,41,3,20,13,33,9,FALSE
scalejs.metadatafactory-common,1.0.40,1.0.41,40,2,229,194,423,11,FALSE
scalejs.metadatafactory-common,1.0.43,1.0.44,42,1,5,4,9,3,FALSE
scalejs.metadatafactory-common,1.0.45,1.0.46,44,1,30,26,56,6,FALSE
scalejs.metadatafactory-common,1.0.44,1.0.45,43,1,8,8,16,6,FALSE
scalejs.metadatafactory-common,1.0.47,1.0.48,46,1,3,3,6,3,FALSE
scalejs.metadatafactory-common,1.0.46,1.0.47,45,2,13,4,17,4,FALSE
scalejs.metadatafactory-common,1.0.153,1.0.154,144,2,12,6,18,2,FALSE
scalejs.metadatafactory-common,1.0.74,1.0.75,73,1,29,1,30,1,FALSE
scalejs.metadatafactory-common,1.0.75,1.0.76,74,3,190,16,206,8,FALSE
scalejs.metadatafactory-common,1.0.76,1.0.77,75,1,2,2,4,2,FALSE
scalejs.metadatafactory-common,1.0.77,1.0.78,76,2,26,2,28,3,FALSE
scalejs.metadatafactory-common,1.0.70,1.0.71,69,1,3,2,5,2,FALSE
scalejs.metadatafactory-common,1.0.71,1.0.72,70,4,156,96,252,54,FALSE
scalejs.metadatafactory-common,1.0.72,1.0.73,71,1,99,55,154,49,FALSE
scalejs.metadatafactory-common,1.0.73,1.0.74,72,2,33,49,82,3,FALSE
scalejs.metadatafactory-common,1.0.143,1.0.144,134,4,728,737,1465,19,FALSE
scalejs.metadatafactory-common,1.0.142,1.0.143,133,3,112,58,170,7,FALSE
scalejs.metadatafactory-common,1.0.141,1.0.142,132,1,2,2,4,2,FALSE
scalejs.metadatafactory-common,1.0.140,1.0.141,131,1,2,2,4,2,FALSE
scalejs.metadatafactory-common,1.0.78,1.0.79,77,2,3779,1535,5314,63,FALSE
scalejs.metadatafactory-common,1.0.79,1.0.80,78,2,6,4,10,4,FALSE
scalejs.metadatafactory-common,1.0.145,1.0.146,136,2,6,6,12,2,FALSE
scalejs.metadatafactory-common,1.0.144,1.0.145,135,2,7,3,10,3,FALSE
scalejs.metadatafactory-common,1.0.149,1.0.150,140,4,135,17,152,9,FALSE
scalejs.metadatafactory-common,1.0.148,1.0.149,139,3,23,20,43,5,FALSE
scalejs.metadatafactory-common,1.0.63,1.0.64,62,1,9,1,10,2,FALSE
scalejs.metadatafactory-common,1.0.62,1.0.63,61,1,2656,2811,5467,10,FALSE
scalejs.metadatafactory-common,1.0.61,1.0.62,60,2,71,63,134,50,FALSE
scalejs.metadatafactory-common,1.0.60,1.0.61,59,2,19,10,29,4,FALSE
scalejs.metadatafactory-common,1.0.67,1.0.68,66,1,11,5,16,4,FALSE
scalejs.metadatafactory-common,1.0.66,1.0.67,65,2,2632,2825,5457,5,FALSE
scalejs.metadatafactory-common,1.0.65,1.0.66,64,4,87,66,153,62,FALSE
scalejs.metadatafactory-common,1.0.64,1.0.65,63,1,2865,2657,5522,55,FALSE
scalejs.metadatafactory-common,1.0.150,1.0.151,141,3,4,4,8,3,FALSE
scalejs.metadatafactory-common,1.0.151,1.0.152,142,1,2,1,3,2,FALSE
scalejs.metadatafactory-common,1.0.69,1.0.70,68,2,14,2,16,2,FALSE
scalejs.metadatafactory-common,1.0.68,1.0.69,67,3,60,56,116,53,FALSE
scalejs.metadatafactory-common,1.0.154,1.0.155,145,2,2,2,4,2,FALSE
scalejs.metadatafactory-common,1.0.155,1.0.156,146,2,2114,21,2135,55,FALSE
scalejs.metadatafactory-common,1.0.156,1.0.157,147,2,47,24,71,9,FALSE
scalejs.metadatafactory-common,1.0.157,1.0.158,148,2,45,4,49,7,FALSE
scalejs.metadatafactory-common,1.0.146,1.0.147,137,3,358,371,729,39,TRUE
scalejs.metadatafactory-common,1.0.99,1.0.100,93,2,22,15,37,4,TRUE
scalejs.metadatafactory-common,1.0.152,1.0.153,143,2,5,2,7,2,TRUE
scalejs.metadatafactory-common,1.0.190,1.0.191,179,1,123,108,231,66,TRUE
scalejs.metadatafactory-common,1.0.147,1.0.148,138,2,27,22,49,10,TRUE
scalejs.metadatafactory-common,1.0.98,1.0.99,92,2,4,4,8,4,TRUE
scalejs.metadatafactory-common,1.0.101,1.0.102,95,2,14,8,22,2,TRUE
scalejs.metadatafactory-common,1.0.122,1.0.123,115,3,407,104,511,110,TRUE
scalejs.metadatafactory-common,1.0.52,1.0.53,51,2,235,254,489,33,TRUE
scalejs.metadatafactory-common,1.0.71,1.0.72,70,4,156,96,252,54,TRUE
scalejs.metadatafactory-common,1.0.143,1.0.144,134,4,728,737,1465,19,TRUE
scalejs.metadatafactory-common,1.0.148,1.0.149,139,3,23,20,43,5,TRUE
scalejs.metadatafactory-common,1.0.100,1.0.101,94,2,79,35,114,4,TRUE
scalejs.metadatafactory-common,1.0.29,1.0.30,29,7,434,365,799,27,TRUE
scalejs.metadatafactory-common,1.0.161,1.0.162,151,2,20,15,35,8,TRUE
scalejs.metadatafactory-common,1.0.178,1.0.179,168,1,15,3,18,3,TRUE
scalejs.metadatafactory-common,1.0.179,1.0.180,169,2,125,90,215,7,TRUE
scalejs.metadatafactory-common,1.0.75,1.0.76,74,3,190,16,206,8,TRUE
scalejs.metadatafactory-common,1.0.141,1.0.142,132,1,2,2,4,2,TRUE
scalejs.metadatafactory-common,1.0.189,1.0.190,178,4,11504,1754,13258,122,TRUE
scalejs.metadatafactory-common,1.0.145,1.0.146,136,2,6,6,12,2,TRUE
scalejs.metadatafactory-common,1.0.158,1.0.160,149,3,17,15,32,8,TRUE
scalejs.metadatafactory-common,1.0.3,1.0.4,4,12,275,331,606,24,TRUE
scalejs.metadatafactory-common,1.0.160,1.0.161,150,1,1,3,4,3,TRUE
scalejs.metadatafactory-common,1.0.118,1.0.119,111,2,9,2,11,4,TRUE
scalejs.metadatafactory-common,1.0.149,1.0.150,140,4,135,17,152,9,TRUE
scalejs.metadatafactory-common,1.0.193,1.0.194,182,2,1,4,5,2,TRUE
scalejs.metadatafactory-common,1.0.154,1.0.155,145,2,2,2,4,2,TRUE
scalejs.metadatafactory-common,1.0.54,1.0.55,53,3,47,42,89,5,TRUE
scalejs.metadatafactory-common,1.0.117,1.0.118,110,2,8,12,20,4,TRUE
scalejs.metadatafactory-common,1.0.70,1.0.71,69,1,3,2,5,2,TRUE
scalejs.metadatafactory-common,1.0.93,1.0.94,87,2,64,55,119,51,TRUE
scalejs.metadatafactory-common,1.0.181,1.0.182,171,1,10,8,18,2,TRUE
scalejs.metadatafactory-common,1.0.80,1.0.81,79,2,18,16,34,6,TRUE
scalejs.metadatafactory-common,1.0.97,1.0.98,91,2,20,8,28,4,TRUE
scalejs.metadatafactory-common,1.0.51,1.0.52,50,15,747,534,1281,35,TRUE
slack-promise,1.0.4,1.0.5,5,3,121,425,546,108,FALSE
slack-promise,1.0.0,1.0.1,1,1,107,107,214,104,FALSE
slack-promise,1.0.1,1.0.2,2,1,1,1,2,1,FALSE
slack-promise,1.0.2,1.0.3,3,2,2193,844,3037,115,FALSE
slack-promise,1.0.3,1.0.4,4,2,107,107,214,107,FALSE
slack-promise,1.0.4,1.0.5,5,3,121,425,546,108,TRUE
slack-promise,1.0.1,1.0.2,2,1,1,1,2,1,TRUE
update-it,0.0.1,0.1.0,1,3,732,115,847,12,FALSE
update-it,0.1.8,0.1.9,10,41,71,84,155,43,FALSE
update-it,0.1.9,0.2.0,11,16,668,611,1279,25,FALSE
update-it,0.2.1,0.2.2,13,20,27,25,52,21,FALSE
update-it,0.2.0,0.2.1,12,2,3,3,6,3,FALSE
update-it,0.1.0,0.1.1,2,7,7,6,13,7,TRUE
update-it,0.1.1,0.1.2,3,5,16,11,27,6,FALSE
update-it,0.1.2,0.1.3,4,2,2,2,4,2,TRUE
update-it,0.1.3,0.1.4,5,2,10,10,20,2,TRUE
update-it,0.1.4,0.1.5,6,21,26,26,52,21,FALSE
update-it,0.1.5,0.1.6,7,29,37,37,74,29,TRUE
update-it,0.1.6,0.1.7,8,2,3,3,6,2,TRUE
update-it,0.1.7,0.1.8,9,5,5,4,9,5,TRUE
update-it,0.1.0,0.1.1,2,7,7,6,13,7,FALSE
update-it,0.1.2,0.1.3,4,2,2,2,4,2,FALSE
update-it,0.1.3,0.1.4,5,2,10,10,20,2,FALSE
update-it,0.1.5,0.1.6,7,29,37,37,74,29,FALSE
update-it,0.1.6,0.1.7,8,2,3,3,6,2,FALSE
update-it,0.1.7,0.1.8,9,5,5,4,9,5,FALSE
update-it,0.1.1,0.1.2,3,5,16,11,27,6,TRUE
update-it,0.1.4,0.1.5,6,21,26,26,52,21,TRUE
percy-client,1.0.4,1.1.0,8,3,13,1,14,5,FALSE
percy-client,1.1.0,1.1.1,9,4,7,6,13,4,FALSE
percy-client,1.1.1,1.1.2,10,2,4,4,8,3,FALSE
percy-client,1.1.2,1.1.3,11,2,3,3,6,2,TRUE
percy-client,1.0.0,1.0.1,4,2,2,2,4,2,FALSE
percy-client,1.0.1,1.0.2,5,2,10,17,27,3,FALSE
percy-client,1.0.2,1.0.3,6,2,2,2,4,2,FALSE
percy-client,1.0.3,1.0.4,7,2,14,5,19,3,FALSE
percy-client,2.0.0,2.0.1,16,4,11,3,14,5,FALSE
percy-client,1.1.3,1.1.4,12,2,2,1,3,2,TRUE
percy-client,1.3.0,2.0.0,15,5,25,9,34,7,FALSE
percy-client,0.2.0,1.0.0,3,8,384,14,398,12,FALSE
percy-client,0.1.1,0.2.0,2,18,425,69,494,32,FALSE
percy-client,1.1.5,1.3.0,14,7,163,40,203,12,FALSE
percy-client,1.1.4,1.1.5,13,2,3,3,6,2,FALSE
percy-client,1.1.2,1.1.3,11,2,3,3,6,2,FALSE
percy-client,1.1.3,1.1.4,12,2,2,1,3,2,FALSE
percy-client,1.1.5,1.3.0,14,7,163,40,203,12,TRUE
percy-client,1.0.1,1.0.2,5,2,10,17,27,3,TRUE
react-simple-image,0.1.0,0.1.1,1,11,199,175,374,20,FALSE
react-simple-image,0.1.1,0.1.2,2,55,2517,548,3065,104,FALSE
react-simple-image,0.1.2,0.1.3,3,7,17,7,24,13,FALSE
react-simple-image,0.1.3,0.1.4,4,31,7270,2916,10186,95,FALSE
react-simple-image,0.1.4,0.2.0,5,1,0,7,7,1,FALSE
react-simple-image,0.1.3,0.1.4,4,31,7270,2916,10186,95,TRUE
talend-icons,0.76.0,0.77.0,85,1,1650,29,1679,6,FALSE
talend-icons,0.3.0,0.4.0,6,1,3,0,3,1,TRUE
talend-icons,0.71.0,0.71.1,72,1,1650,29,1679,6,FALSE
talend-icons,0.74.2,0.75.0,82,1,1650,29,1679,6,FALSE
talend-icons,0.74.1,0.74.2,81,1,1650,29,1679,6,FALSE
talend-icons,0.74.0,0.74.1,80,1,1650,29,1679,6,FALSE
talend-icons,0.68.0,0.68.1,67,1,1650,29,1679,6,FALSE
talend-icons,0.68.1,0.69.0,68,1,1650,29,1679,6,FALSE
talend-icons,0.16.4,0.16.5,39,1,3,2,5,1,FALSE
talend-icons,0.62.0,0.63.0,56,1,1650,29,1679,6,FALSE
talend-icons,0.5.2,0.5.3,10,1,9,0,9,1,FALSE
talend-icons,0.5.3,0.5.4,11,1,6,0,6,1,FALSE
talend-icons,0.71.2,0.72.0,74,1,1650,29,1679,6,FALSE
talend-icons,0.16.7,0.16.8,42,1,2,2,4,1,FALSE
talend-icons,0.16.6,0.16.7,41,1,3,1,4,1,FALSE
talend-icons,0.16.5,0.16.6,40,1,2,2,4,1,FALSE
talend-icons,0.71.1,0.71.2,73,1,1650,29,1679,6,FALSE
talend-icons,0.16.3,0.16.4,38,1,78,78,156,2,FALSE
talend-icons,0.16.2,0.16.3,37,1,0,0,0,1,FALSE
talend-icons,0.16.1,0.16.2,36,1,2,2,4,1,FALSE
talend-icons,0.16.0,0.16.1,35,1,2,2,4,1,FALSE
talend-icons,0.16.8,0.60.1,43,1,1650,29,1679,6,FALSE
talend-icons,0.15.0,0.16.0,34,1,4,0,4,1,FALSE
talend-icons,0.69.0,0.70.0,69,1,1650,29,1679,6,FALSE
talend-icons,0.63.1,0.64.0,58,1,1650,29,1679,6,FALSE
talend-icons,0.63.0,0.63.1,57,1,1650,29,1679,6,FALSE
talend-icons,0.60.1,0.60.2,44,1,1650,29,1679,6,FALSE
talend-icons,0.60.2,0.60.3,45,1,1650,29,1679,6,FALSE
talend-icons,0.60.3,0.60.4,46,1,1650,29,1679,6,FALSE
talend-icons,0.60.4,0.60.5,47,1,1650,29,1679,6,FALSE
talend-icons,0.60.5,0.60.6,48,1,1650,29,1679,6,FALSE
talend-icons,0.60.6,0.60.7,49,1,1650,29,1679,6,FALSE
talend-icons,0.60.7,0.61.0,50,1,1650,29,1679,6,FALSE
talend-icons,0.6.0,0.7.0,14,1,100,61,161,30,FALSE
talend-icons,0.11.0,0.11.1,25,1,6,19,25,6,FALSE
talend-icons,0.11.1,0.11.2,26,1,0,3,3,2,FALSE
talend-icons,0.11.2,0.12.0,27,1,6,0,6,2,FALSE
talend-icons,0.70.1,0.71.0,71,1,1650,29,1679,6,FALSE
talend-icons,0.70.0,0.70.1,70,1,1650,29,1679,6,FALSE
talend-icons,0.4.0,0.5.0,7,1,5,0,5,1,FALSE
talend-icons,0.13.0,0.13.1,29,1,0,0,0,2,FALSE
talend-icons,0.13.1,0.14.0,30,1,61,9,70,11,FALSE
talend-icons,0.73.0,0.74.0,79,1,1650,29,1679,6,FALSE
talend-icons,0.14.1,0.14.2,32,1,10,4,14,1,FALSE
talend-icons,0.14.0,0.14.1,31,1,6,3,9,2,FALSE
talend-icons,0.14.2,0.15.0,33,1,73,0,73,1,FALSE
talend-icons,0.8.1,0.8.2,17,1,12,42,54,12,FALSE
talend-icons,0.8.0,0.8.1,16,1,1,4,5,1,FALSE
talend-icons,0.8.3,0.9.0,19,1,2,0,2,2,FALSE
talend-icons,0.8.2,0.8.3,18,1,0,0,0,2,FALSE
talend-icons,0.64.0,0.65.0,59,1,1650,29,1679,6,FALSE
talend-icons,0.66.4,0.67.0,65,1,1650,29,1679,6,FALSE
talend-icons,0.66.2,0.66.3,63,1,1650,29,1679,6,FALSE
talend-icons,0.66.3,0.66.4,64,1,1650,29,1679,6,FALSE
talend-icons,0.66.0,0.66.1,61,1,1650,29,1679,6,FALSE
talend-icons,0.66.1,0.66.2,62,1,1650,29,1679,6,FALSE
talend-icons,0.61.4,0.62.0,55,1,1650,29,1679,6,FALSE
talend-icons,0.61.1,0.61.2,52,1,1650,29,1679,6,TRUE
talend-icons,0.61.0,0.61.1,51,1,1650,29,1679,6,FALSE
talend-icons,0.61.3,0.61.4,54,1,1650,29,1679,6,FALSE
talend-icons,0.61.2,0.61.3,53,1,1650,29,1679,6,FALSE
talend-icons,0.2.0,0.3.0,5,1,4,0,4,1,FALSE
talend-icons,0.1.0,0.2.0,4,1,4,0,4,1,FALSE
talend-icons,0.10.1,0.11.0,24,1,25,7,32,21,FALSE
talend-icons,0.10.0,0.10.1,23,1,0,3,3,1,FALSE
talend-icons,0.0.1,0.0.2,2,4,1155,2168,3323,7,FALSE
talend-icons,0.0.0,0.0.1,1,1,1650,29,1679,6,FALSE
talend-icons,0.0.2,0.1.0,3,4,85,55,140,10,FALSE
talend-icons,0.77.0,0.78.0,86,1,1650,29,1679,6,FALSE
talend-icons,0.7.0,0.8.0,15,1,3,0,3,1,FALSE
talend-icons,0.12.0,0.13.0,28,5,37,16,53,13,FALSE
talend-icons,0.5.4,0.5.5,12,1,8,26,34,28,FALSE
talend-icons,0.5.5,0.6.0,13,1,4,0,4,1,FALSE
talend-icons,0.5.0,0.5.1,8,1,6,0,6,1,FALSE
talend-icons,0.5.1,0.5.2,9,1,4,0,4,1,FALSE
talend-icons,0.75.0,0.75.1,83,1,1650,29,1679,6,FALSE
talend-icons,0.75.1,0.76.0,84,1,1650,29,1679,6,FALSE
talend-icons,0.9.0,0.9.1,20,1,1,3,4,1,FALSE
talend-icons,0.9.1,0.9.2,21,1,39,9,48,6,FALSE
talend-icons,0.9.2,0.10.0,22,1,3,0,3,3,FALSE
talend-icons,0.72.1,0.72.2,76,1,1650,29,1679,6,FALSE
talend-icons,0.72.0,0.72.1,75,1,1650,29,1679,6,FALSE
talend-icons,0.72.3,0.73.0,78,1,1650,29,1679,6,FALSE
talend-icons,0.72.2,0.72.3,77,1,1650,29,1679,6,FALSE
talend-icons,0.65.0,0.66.0,60,1,1650,29,1679,6,FALSE
talend-icons,0.67.0,0.68.0,66,1,1650,29,1679,6,FALSE
talend-icons,0.3.0,0.4.0,6,1,3,0,3,1,FALSE
talend-icons,0.60.2,0.60.3,45,1,1650,29,1679,6,TRUE
talend-icons,0.60.3,0.60.4,46,1,1650,29,1679,6,TRUE
talend-icons,0.61.1,0.61.2,52,1,1650,29,1679,6,FALSE
talend-icons,0.61.2,0.61.3,53,1,1650,29,1679,6,TRUE
talend-icons,0.64.0,0.65.0,59,1,1650,29,1679,6,TRUE
talend-icons,0.65.0,0.66.0,60,1,1650,29,1679,6,TRUE
talend-icons,0.70.0,0.70.1,70,1,1650,29,1679,6,TRUE
talend-icons,0.0.0,0.0.1,1,1,1650,29,1679,6,TRUE
kero-fetch,1.0.0,3.1.25,1,6,125,9,134,8,FALSE
kero-fetch,3.1.25,3.1.26,2,4,1715,153,1868,39,FALSE
kero-fetch,3.2.0,3.2.1,4,6,787,449,1236,31,FALSE
kero-fetch,3.2.1,3.2.2,5,5,1270,548,1818,24,FALSE
kero-fetch,3.1.26,3.2.0,3,4,730,2649,3379,31,FALSE
kero-fetch,3.2.1,3.2.2,5,5,1270,548,1818,24,TRUE
lambda-formation,0.1.8,0.1.9,8,4,93,26,119,13,FALSE
lambda-formation,0.1.0,0.1.1,1,11,57,41,98,17,FALSE
lambda-formation,0.1.1,0.1.2,2,4,19,27,46,9,FALSE
lambda-formation,0.1.2,0.1.3,3,4,7,11,18,5,FALSE
lambda-formation,0.1.3,0.1.4,4,14,95,21,116,19,FALSE
lambda-formation,0.1.4,0.1.5,5,6,17,10,27,7,FALSE
lambda-formation,0.1.5,0.1.7,6,11,406,124,530,35,FALSE
lambda-formation,0.1.7,0.1.8,7,3,32,20,52,7,FALSE
lambda-formation,0.1.3,0.1.4,4,14,95,21,116,19,TRUE
lambda-formation,0.1.1,0.1.2,2,4,19,27,46,9,TRUE
react-popconfirm,0.1.0,0.1.1,2,1,2,2,4,2,TRUE
react-popconfirm,0.0.8,0.1.0,1,1,127,59,186,7,FALSE
react-popconfirm,0.1.0,0.1.1,2,1,2,2,4,2,FALSE
dash-styles,0.0.4,0.0.5,3,2,222,3,225,6,FALSE
dash-styles,0.0.3,0.0.4,2,1,1,1,2,1,FALSE
dash-styles,0.0.2,0.0.3,1,5,19,5,24,6,FALSE
dash-styles,0.0.2,0.0.3,1,5,19,5,24,6,TRUE
dash-styles,0.0.7,0.0.8,6,2,7,1,8,7,FALSE
dash-styles,0.0.6,0.0.7,5,3,141,14,155,11,FALSE
nordnet-next-api,3.1.1,3.2.0,17,5,42,6,48,7,FALSE
nordnet-next-api,3.1.0,3.1.1,16,2,5,3,8,2,FALSE
nordnet-next-api,1.0.0,1.0.1,1,8,33,11,44,8,FALSE
nordnet-next-api,1.0.1,1.0.2,2,2,8,1,9,2,FALSE
nordnet-next-api,1.0.2,1.0.3,3,5,13,10,23,6,FALSE
nordnet-next-api,2.0.0,2.1.0,5,2,15,4,19,3,FALSE
nordnet-next-api,5.1.0-beta.1,5.1.0,26,9,45,28,73,12,FALSE
nordnet-next-api,2.2.1,2.3.0,8,3,37,14,51,14,FALSE
nordnet-next-api,2.2.0,2.2.1,7,9,1059,959,2018,37,FALSE
nordnet-next-api,2.1.0,2.2.0,6,3,63,23,86,4,FALSE
nordnet-next-api,4.1.4,4.2.0,23,3,103,49,152,5,FALSE
nordnet-next-api,4.0.0,4.1.0,20,5,14,6,20,9,FALSE
nordnet-next-api,4.1.0,4.1.1,21,6,108,30,138,13,FALSE
nordnet-next-api,3.0.0,3.1.0,15,10,108,11,119,16,FALSE
nordnet-next-api,1.0.3,2.0.0,4,3,75,45,120,6,FALSE
nordnet-next-api,2.3.0,2.3.1,9,3,35,16,51,4,FALSE
nordnet-next-api,2.3.1,2.3.2,10,4,47,46,93,15,FALSE
nordnet-next-api,2.3.2,2.3.3,11,2,2,6,8,3,FALSE
nordnet-next-api,2.3.3,2.3.4,12,2,2,2,4,3,FALSE
nordnet-next-api,2.3.4,2.4.0,13,8,156,25,181,13,FALSE
nordnet-next-api,2.4.0,3.0.0,14,4,90,35,125,8,FALSE
nordnet-next-api,4.1.1,4.1.4,22,8,28,22,50,8,FALSE
nordnet-next-api,5.0.0,5.1.0-beta.1,25,4,42,2,44,5,FALSE
nordnet-next-api,3.3.0,4.0.0,19,2,2,21,23,2,FALSE
nordnet-next-api,4.2.0,5.0.0,24,6,60,44,104,9,FALSE
nordnet-next-api,3.2.0,3.3.0,18,3,79,1,80,11,FALSE
nordnet-next-api,2.2.1,2.3.0,8,3,37,14,51,14,TRUE
nordnet-next-api,1.0.0,1.0.1,1,8,33,11,44,8,TRUE
nordnet-next-api,1.0.2,1.0.3,3,5,13,10,23,6,TRUE
nordnet-next-api,3.1.0,3.1.1,16,2,5,3,8,2,TRUE
nordnet-next-api,4.1.1,4.1.4,22,8,28,22,50,8,TRUE
nordnet-next-api,2.0.0,2.1.0,5,2,15,4,19,3,TRUE
eslint-config-angular-lazy,0.1.0,0.1.1,1,1,8,4,12,2,FALSE
eslint-config-angular-lazy,0.2.0,0.2.1,3,2,6,2,8,2,FALSE
eslint-config-angular-lazy,0.1.1,0.2.0,2,5,914,8,922,7,TRUE
qenya,0.3.2,0.3.3,9,1,28,6,34,7,FALSE
qenya,0.3.3,0.3.4,10,1,28,6,34,7,FALSE
qenya,0.3.0,0.3.1,7,1,28,6,34,7,FALSE
qenya,0.3.1,0.3.2,8,1,28,6,34,7,FALSE
qenya,0.3.4,0.3.5,11,1,178,69,247,20,FALSE
qenya,0.3.5,0.3.6,12,1,28,6,34,7,FALSE
qenya,0.2.5,0.3.0,6,4,3194,1956,5150,101,FALSE
qenya,0.2.4,0.2.5,5,1,28,6,34,7,FALSE
qenya,0.2.3,0.2.4,4,1,28,6,34,7,FALSE
qenya,0.2.2,0.2.3,3,1,28,6,34,7,FALSE
qenya,0.2.1,0.2.2,2,1,28,6,34,7,FALSE
qenya,0.2.0,0.2.1,1,1,28,6,34,7,FALSE
qenya,0.2.5,0.3.0,6,4,3194,1956,5150,101,TRUE
qenya,0.3.4,0.3.5,11,1,178,69,247,20,TRUE
qenya,0.3.2,0.3.3,9,1,28,6,34,7,TRUE
vk-api-util,1.1.0,1.1.1,2,4,22,22,44,7,TRUE
vk-api-util,1.0.0,1.1.0,1,2,57,1,58,5,FALSE
video-react,0.7.5,0.7.7,27,2,43,33,76,27,FALSE
video-react,0.2.4,0.3.1,10,17,717,75,792,35,FALSE
video-react,0.2.3,0.2.4,9,6,116,103,219,16,FALSE
video-react,0.2.2,0.2.3,8,2,5,6,11,2,FALSE
video-react,0.2.1,0.2.2,7,1,24,9435,9459,88,FALSE
video-react,0.1.1,0.1.2,3,1,25,3,28,3,FALSE
video-react,0.1.2,0.1.3,4,1,4,1,5,2,FALSE
video-react,0.1.3,0.1.4,5,3,19,7,26,5,FALSE
video-react,0.1.4,0.2.1,6,27,22269,4097,26366,313,FALSE
video-react,0.7.8,0.8.2,29,5,250,112,362,47,FALSE
video-react,0.0.2,0.1.1,2,27,11724,1604,13328,149,FALSE
video-react,0.3.2,0.3.3,12,6,746,73,819,32,FALSE
video-react,0.6.2,0.6.3,20,7,330,217,547,19,FALSE
video-react,0.6.1,0.6.2,19,4,49,34,83,10,FALSE
video-react,0.3.1,0.3.2,11,5,71,10,81,8,FALSE
video-react,0.7.2,0.7.3,25,5,25,19,44,9,FALSE
video-react,0.7.3,0.7.5,26,13,21510,14339,35849,22,FALSE
video-react,0.7.0,0.7.1,23,1,1,1,2,1,FALSE
video-react,0.6.4,0.7.0,22,9,739,436,1175,62,FALSE
video-react,0.4.1,0.4.2,14,7,546,34,580,25,FALSE
video-react,0.4.3,0.4.4,16,7,72,19,91,23,FALSE
video-react,0.4.2,0.4.3,15,7,324,55,379,26,FALSE
video-react,0.5.1,0.6.1,18,11,1359,171,1530,35,FALSE
video-react,0.8.2,0.8.3,30,2,122,9,131,9,FALSE
video-react,0.7.7,0.7.8,28,2,14,6,20,5,FALSE
video-react,0.4.4,0.5.1,17,9,487,249,736,57,FALSE
video-react,0.6.3,0.6.4,21,4,47,32,79,13,FALSE
video-react,0.3.3,0.4.1,13,10,819,428,1247,32,FALSE
video-react,0.7.1,0.7.2,24,4,30,17,47,11,FALSE
video-react,0.0.1,0.0.2,1,13,5353,684,6037,92,FALSE
video-react,0.2.4,0.3.1,10,17,717,75,792,35,TRUE
video-react,0.3.3,0.4.1,13,10,819,428,1247,32,TRUE
video-react,0.7.5,0.7.7,27,2,43,33,76,27,TRUE
video-react,0.2.3,0.2.4,9,6,116,103,219,16,TRUE
video-react,0.0.2,0.1.1,2,27,11724,1604,13328,149,TRUE
video-react,0.0.1,0.0.2,1,13,5353,684,6037,92,TRUE
video-react,0.7.3,0.7.5,26,13,21510,14339,35849,22,TRUE
infinite-tree,1.7.3,1.8.0,38,8,288,148,436,14,FALSE
infinite-tree,1.10.0,1.11.0,43,5,217,8,225,14,FALSE
infinite-tree,1.8.1,1.8.2,40,4,442,405,847,10,FALSE
infinite-tree,1.6.0,1.7.0,34,16,77,68,145,17,FALSE
infinite-tree,1.7.1,1.7.2,36,2,42,14,56,4,FALSE
infinite-tree,1.9.0,1.10.0,42,5,63,18,81,8,FALSE
infinite-tree,1.8.0,1.8.1,39,12,3063,12989,16052,62,FALSE
infinite-tree,1.7.2,1.7.3,37,4,139,118,257,7,FALSE
infinite-tree,1.8.2,1.9.0,41,5,252,66,318,11,FALSE
infinite-tree,1.7.0,1.7.1,35,3,120,69,189,7,FALSE
infinite-tree,1.1.1,1.1.2,26,18,194,46,240,26,FALSE
infinite-tree,1.1.0,1.1.1,25,7,26,24,50,11,FALSE
infinite-tree,1.1.2,1.2.0,27,10,414,166,580,26,FALSE
infinite-tree,1.0.0,1.0.1,23,6,20112,64,20176,52,FALSE
infinite-tree,1.0.1,1.1.0,24,11,444,200,644,26,FALSE
infinite-tree,0.2.4,0.3.0,10,35,2927,504,3431,48,FALSE
infinite-tree,0.2.3,0.2.4,9,12,323,159,482,29,FALSE
infinite-tree,0.2.2,0.2.3,8,2,2,2,4,2,FALSE
infinite-tree,0.2.1,0.2.2,7,11,13,9,22,13,FALSE
infinite-tree,0.2.0,0.2.1,6,8,127,112,239,20,FALSE
infinite-tree,0.1.0,0.1.1,1,6,113,89,202,11,FALSE
infinite-tree,0.1.1,0.1.3,2,31,485,308,793,47,FALSE
infinite-tree,0.1.3,0.1.4,3,31,253,118,371,57,FALSE
infinite-tree,0.1.4,0.1.5,4,11,126,79,205,20,FALSE
infinite-tree,0.1.5,0.2.0,5,5,115,37,152,9,FALSE
infinite-tree,0.5.0,0.6.0,13,22,377,339,716,44,FALSE
infinite-tree,0.6.3,0.7.0,17,5,354,72,426,22,FALSE
infinite-tree,0.6.2,0.6.3,16,18,152,80,232,28,FALSE
infinite-tree,0.3.0,0.4.0,11,26,983,627,1610,33,FALSE
infinite-tree,0.6.0,0.6.1,14,4,165,203,368,15,FALSE
infinite-tree,0.7.0,0.8.0,18,3,230,188,418,12,FALSE
infinite-tree,1.7.1,1.7.2,36,2,42,14,56,4,TRUE
infinite-tree,1.4.0,1.5.0,31,29,1427,273,1700,41,FALSE
infinite-tree,0.8.1,0.8.2,20,12,60,32,92,22,FALSE
infinite-tree,1.5.1,1.6.0,33,25,1789,1437,3226,102,FALSE
infinite-tree,1.5.0,1.5.1,32,9,274,114,388,15,FALSE
infinite-tree,0.8.0,0.8.1,19,25,394,216,610,40,FALSE
infinite-tree,1.3.1,1.4.0,30,5,2904,2831,5735,23,FALSE
infinite-tree,1.3.0,1.3.1,29,7,166,68,234,19,FALSE
infinite-tree,1.2.0,1.3.0,28,18,408,160,568,35,FALSE
infinite-tree,0.4.0,0.5.0,12,9,590,293,883,17,FALSE
infinite-tree,0.8.2,0.9.0,21,45,7933,1409,9342,178,FALSE
infinite-tree,0.9.0,1.0.0,22,24,840,522,1362,73,FALSE
infinite-tree,0.6.1,0.6.2,15,10,3665,3711,7376,37,FALSE
infinite-tree,1.8.0,1.8.1,39,12,3063,12989,16052,62,TRUE
infinite-tree,0.2.3,0.2.4,9,12,323,159,482,29,TRUE
infinite-tree,0.6.2,0.6.3,16,18,152,80,232,28,TRUE
infinite-tree,0.8.2,0.9.0,21,45,7933,1409,9342,178,TRUE
infinite-tree,1.1.1,1.1.2,26,18,194,46,240,26,TRUE
infinite-tree,0.4.0,0.5.0,12,9,590,293,883,17,TRUE
infinite-tree,1.8.1,1.8.2,40,4,442,405,847,10,TRUE
infinite-tree,1.7.0,1.7.1,35,3,120,69,189,7,TRUE
infinite-tree,1.7.2,1.7.3,37,4,139,118,257,7,TRUE
infinite-tree,1.1.2,1.2.0,27,10,414,166,580,26,TRUE
infinite-tree,1.4.0,1.5.0,31,29,1427,273,1700,41,TRUE
dougs-sequelize,3.21.0,3.23.2-1,7,58,1525,1235,2760,176,FALSE
dougs-sequelize,3.21.0-4,3.21.0-5,4,1,75,62,137,8,FALSE
dougs-sequelize,3.21.0-1,3.21.0-2,1,1,75,62,137,8,FALSE
dougs-sequelize,3.21.0-3,3.21.0-4,3,9,112,37,149,21,FALSE
dougs-sequelize,3.21.0-2,3.21.0-3,2,1,75,62,137,8,FALSE
dougs-sequelize,3.21.0-5,3.21.0-6,5,1,75,62,137,8,FALSE
dougs-sequelize,3.23.2,3.27.0,11,280,30304,25281,55585,1148,FALSE
dougs-sequelize,3.23.2-1,3.23.2-2,8,13,225,203,428,53,FALSE
dougs-sequelize,3.23.2-2,3.23.2-3,9,243,28598,24471,53069,1013,FALSE
dougs-sequelize,3.23.2-1,3.23.2-2,8,13,225,203,428,53,TRUE
lpio-server,0.2.1,0.2.3,8,3,29,8,37,6,FALSE
lpio-server,0.2.0,0.2.1,7,1,4,8,12,2,FALSE
lpio-server,0.1.0,0.1.1,1,3,5,5,10,4,FALSE
lpio-server,0.1.1,0.1.2,2,1,22,6,28,3,FALSE
lpio-server,0.1.2,0.1.3,3,2,36,8,44,3,FALSE
lpio-server,0.1.3,0.1.4,4,1,15,16,31,4,FALSE
lpio-server,0.1.4,0.1.5,5,1,73,17,90,3,FALSE
lpio-server,0.1.5,0.2.0,6,4,116,66,182,11,FALSE
lpio-server,0.1.2,0.1.3,3,2,36,8,44,3,TRUE
lpio-server,0.2.0,0.2.1,7,1,4,8,12,2,TRUE
kronos-adapter-outbound-http,1.0.4,1.0.5,5,49,53,51,104,49,FALSE
kronos-adapter-outbound-http,1.0.5,1.0.6,6,5,5,5,10,5,FALSE
kronos-adapter-outbound-http,1.0.6,1.0.7,7,3,6,6,12,3,FALSE
kronos-adapter-outbound-http,1.0.7,1.0.8,8,27,39,39,78,27,FALSE
kronos-adapter-outbound-http,1.0.0,1.0.1,1,44,82,77,159,45,FALSE
kronos-adapter-outbound-http,1.0.1,1.0.2,2,5,5,5,10,5,FALSE
kronos-adapter-outbound-http,1.0.2,1.0.3,3,15,17,17,34,15,FALSE
kronos-adapter-outbound-http,1.0.3,1.0.4,4,1,3,3,6,1,FALSE
kronos-adapter-outbound-http,1.0.8,1.0.9,9,15,36,13,49,12,FALSE
kronos-adapter-outbound-http,1.0.9,1.0.10,10,13,16,16,32,12,FALSE
kronos-adapter-outbound-http,1.0.10,1.0.11,11,22,78,77,155,25,FALSE
kronos-adapter-outbound-http,1.0.0,1.0.1,1,44,82,77,159,45,TRUE
kronos-adapter-outbound-http,1.0.7,1.0.8,8,27,39,39,78,27,TRUE
kronos-adapter-outbound-http,1.0.4,1.0.5,5,49,53,51,104,49,TRUE
kronos-adapter-outbound-http,1.0.9,1.0.10,10,13,16,16,32,12,TRUE
sro,0.1.0,0.1.1,1,3,3,2,5,3,FALSE
sro,0.1.1,0.1.2,2,2,42,8,50,3,FALSE
sro,0.1.2,0.1.3,3,9,109,20,129,11,FALSE
sro,0.1.3,0.1.4,4,3,9,2,11,4,FALSE
sro,0.1.4,0.1.5,5,9,265,23,288,18,FALSE
sro,0.1.5,0.1.6,6,13,1313,1308,2621,76,FALSE
sro,0.1.2,0.1.3,3,9,109,20,129,11,TRUE
barbel,0.0.5,0.0.6,5,2,1110,4,1114,18,TRUE
barbel,0.0.4,0.0.5,4,2,13,6,19,4,FALSE
barbel,0.0.7,0.0.8,7,1,3,3,6,2,FALSE
barbel,0.0.6,0.0.7,6,1,4,2,6,1,FALSE
barbel,0.0.1,0.0.2,1,6,172,169,341,15,FALSE
barbel,0.0.3,0.0.4,3,4,35,46,81,10,FALSE
barbel,0.0.2,0.0.3,2,12,414,534,948,49,FALSE
barbel,0.0.8,0.0.9,8,2,4,4,8,3,FALSE
barbel,0.0.5,0.0.6,5,2,1110,4,1114,18,FALSE
wechat-jssdk,1.1.1,1.1.2,3,2,2,2,4,2,FALSE
wechat-jssdk,1.1.0,1.1.1,2,3,28,29,57,5,FALSE
wechat-jssdk,3.0.4,3.0.5,26,1,2,2,4,2,FALSE
wechat-jssdk,1.1.2,1.1.10,4,2,159,60,219,6,FALSE
wechat-jssdk,1.0.0,1.1.0,1,4,221,37,258,11,FALSE
wechat-jssdk,2.0.2,2.0.3,11,1,5,5,10,2,FALSE
wechat-jssdk,3.0.0,3.0.1,22,1,4,2,6,2,FALSE
wechat-jssdk,2.0.0,2.0.1,9,2,38,34,72,4,FALSE
wechat-jssdk,3.0.0-beta.4,3.0.0-beta.5,19,7,617,121,738,26,FALSE
wechat-jssdk,3.0.0-beta.5,3.0.0-rc.1,20,24,790,365,1155,68,FALSE
wechat-jssdk,3.0.0-beta.1,3.0.0-beta.2,16,15,583,238,821,30,FALSE
wechat-jssdk,3.0.0-beta.2,3.0.0-beta.3,17,4,122,51,173,8,FALSE
wechat-jssdk,3.0.0-beta.3,3.0.0-beta.4,18,7,70,38,108,14,FALSE
wechat-jssdk,2.0.4,2.1.0,13,5,167,109,276,8,FALSE
wechat-jssdk,3.0.7,3.0.8,29,1,1,1,2,1,FALSE
wechat-jssdk,2.0.3,2.0.4,12,1,2,1,3,2,FALSE
wechat-jssdk,2.1.0,2.2.0,14,76,3212,1749,4961,173,FALSE
wechat-jssdk,3.0.3,3.0.4,25,4,15,23,38,6,FALSE
wechat-jssdk,2.0.1,2.0.2,10,2,30,10,40,2,FALSE
wechat-jssdk,3.0.1,3.0.2,23,3,22,15,37,4,FALSE
wechat-jssdk,3.0.6,3.0.7,28,10,783,156,939,36,FALSE
wechat-jssdk,3.0.5,3.0.6,27,1,8,3,11,3,FALSE
wechat-jssdk,3.0.8,3.0.9,30,21,933,104,1037,55,FALSE
wechat-jssdk,3.0.2,3.0.3,24,3,3074,3,3077,3,FALSE
wechat-jssdk,3.0.0-rc.1,3.0.0,21,3,9,21,30,6,FALSE
wechat-jssdk,1.1.11,1.1.12,6,3,31,9,40,3,FALSE
wechat-jssdk,1.1.10,1.1.11,5,5,30,6,36,7,FALSE
wechat-jssdk,1.1.13,2.0.0,8,8,182,165,347,12,FALSE
wechat-jssdk,1.1.12,1.1.13,7,3,53,18,71,5,FALSE
wechat-jssdk,3.0.6,3.0.7,28,10,783,156,939,36,TRUE
wechat-jssdk,3.0.0-beta.3,3.0.0-beta.4,18,7,70,38,108,14,TRUE
wechat-jssdk,3.0.8,3.0.9,30,21,933,104,1037,55,TRUE
wechat-jssdk,3.0.0,3.0.1,22,1,4,2,6,2,TRUE
wechat-jssdk,3.0.0-beta.4,3.0.0-beta.5,19,7,617,121,738,26,TRUE
wechat-jssdk,2.0.4,2.1.0,13,5,167,109,276,8,TRUE
wechat-jssdk,2.1.0,2.2.0,14,76,3212,1749,4961,173,TRUE
wechat-jssdk,3.0.0-rc.1,3.0.0,21,3,9,21,30,6,TRUE
wechat-jssdk,1.1.1,1.1.2,3,2,2,2,4,2,TRUE
node-impala,1.0.2,1.0.3,1,1,1,1,2,2,FALSE
node-impala,1.1.1,1.1.2,4,3,9,9,18,4,FALSE
node-impala,1.1.0,1.1.1,3,6,32,17,49,7,FALSE
node-impala,1.1.2,2.0.0,5,4,466,213,679,8,FALSE
node-impala,2.0.1,2.0.4,7,8,296,265,561,22,FALSE
node-impala,2.0.0,2.0.1,6,2,23,11,34,3,FALSE
node-impala,1.0.3,1.1.0,2,22,637,438,1075,32,FALSE
node-impala,2.0.1,2.0.4,7,8,296,265,561,22,TRUE
node-impala,1.1.2,2.0.0,5,4,466,213,679,8,TRUE
node-impala,2.0.0,2.0.1,6,2,23,11,34,3,TRUE
webcompiler,6.0.3,6.1.0,104,2,157,124,281,24,FALSE
webcompiler,6.0.2,6.0.3,103,4,17,8,25,7,FALSE
webcompiler,3.0.4,3.0.5,50,4,52,48,100,21,FALSE
webcompiler,3.1.0,3.2.0,52,2,101,12,113,10,FALSE
webcompiler,6.1.2,6.2.0,107,6,250,115,365,26,FALSE
webcompiler,3.0.3,3.0.4,49,4,316,247,563,42,FALSE
webcompiler,6.1.0,6.1.1,105,3,13,6,19,4,FALSE
webcompiler,6.1.1,6.1.2,106,2,78,98,176,13,FALSE
webcompiler,3.5.3,3.6.0,65,3,344,45,389,11,FALSE
webcompiler,6.0.1,6.0.2,102,3,162,44,206,28,FALSE
webcompiler,5.1.0,5.1.1,94,3,49,28,77,20,FALSE
webcompiler,3.0.5,3.1.0,51,9,867,153,1020,62,FALSE
webcompiler,3.0.2,3.0.3,48,3,16,8,24,8,FALSE
webcompiler,6.4.0,6.5.0,112,5,161,174,335,13,FALSE
webcompiler,3.10.3,3.11.0,79,2,610,25,635,11,FALSE
webcompiler,4.0.5,4.0.6,86,2,23,3,26,5,FALSE
webcompiler,4.0.1,4.0.2,82,2,10,1,11,3,FALSE
webcompiler,4.0.0,4.0.1,81,2,996,1042,2038,47,FALSE
webcompiler,4.0.3,4.0.4,84,2,9,1,10,3,FALSE
webcompiler,4.0.2,4.0.3,83,2,11,1,12,3,FALSE
webcompiler,4.1.0,4.1.1,90,5,371,137,508,47,FALSE
webcompiler,4.1.1,5.0.0,91,3,1348,658,2006,39,FALSE
webcompiler,4.0.7,4.0.8,88,2,26,20,46,9,FALSE
webcompiler,3.3.0,3.3.1,57,2,13,5,18,3,FALSE
webcompiler,3.10.0,3.10.1,76,2,142,76,218,42,FALSE
webcompiler,3.10.1,3.10.2,77,2,58,29,87,12,FALSE
webcompiler,3.10.2,3.10.3,78,2,8,2,10,3,FALSE
webcompiler,3.0.1,3.0.2,47,2,18,1,19,3,FALSE
webcompiler,3.11.0,4.0.0,80,3,5661,3799,9460,88,FALSE
webcompiler,3.0.0,3.0.1,46,2,9,1,10,3,FALSE
webcompiler,6.7.0,6.8.0,116,7,692,121,813,62,FALSE
webcompiler,4.0.8,4.1.0,89,5,90,171,261,37,FALSE
webcompiler,6.8.1,6.8.2,118,4,53,30,83,11,FALSE
webcompiler,6.8.4,7.0.0,121,7,912,719,1631,78,FALSE
webcompiler,4.0.4,4.0.5,85,2,32,5,37,10,FALSE
webcompiler,6.3.1,6.3.2,110,2,12,5,17,6,FALSE
webcompiler,5.0.0,5.0.1,92,2,164,66,230,8,FALSE
webcompiler,6.3.2,6.4.0,111,7,693,814,1507,56,FALSE
webcompiler,6.8.0,6.8.1,117,3,43,23,66,7,FALSE
webcompiler,6.3.0,6.3.1,109,4,88,67,155,10,FALSE
webcompiler,6.0.0,6.0.1,101,2,12,5,17,6,FALSE
webcompiler,7.0.0,7.0.1,122,4,55,38,93,11,FALSE
webcompiler,5.2.2,5.2.3,98,2,1259,143,1402,31,FALSE
webcompiler,5.2.3,5.2.4,99,2,1604,1338,2942,56,FALSE
webcompiler,5.2.0,5.2.1,96,2,35,21,56,10,FALSE
webcompiler,5.2.1,5.2.2,97,3,102,135,237,5,FALSE
webcompiler,5.2.4,6.0.0,100,19,23246,153662,176908,194,FALSE
webcompiler,6.8.3,6.8.4,120,6,93,78,171,11,FALSE
webcompiler,6.8.2,6.8.3,119,3,11,4,15,5,FALSE
webcompiler,3.8.4,3.9.0,74,3,921,69,990,33,FALSE
webcompiler,3.9.0,3.10.0,75,2,49,449,498,13,FALSE
webcompiler,3.8.2,3.8.3,72,2,13,4,17,4,FALSE
webcompiler,3.8.3,3.8.4,73,2,76,12,88,15,FALSE
webcompiler,3.8.0,3.8.1,70,2,16,10,26,5,FALSE
webcompiler,3.8.1,3.8.2,71,2,10,3,13,3,FALSE
webcompiler,3.4.2,3.5.0,61,2,4091,932,5023,84,FALSE
webcompiler,5.0.1,5.1.0,93,2,1332,65,1397,47,FALSE
webcompiler,6.5.0,6.6.0,113,4,35,9,44,10,FALSE
webcompiler,3.4.1,3.4.2,60,2,513,1892,2405,26,FALSE
webcompiler,3.7.1,3.8.0,69,2,421,265,686,70,FALSE
webcompiler,4.0.6,4.0.7,87,2,77,29,106,10,FALSE
webcompiler,5.1.1,5.2.0,95,4,216,371,587,33,FALSE
webcompiler,3.5.2,3.5.3,64,2,198,68,266,10,FALSE
webcompiler,3.5.1,3.5.2,63,2,9,2,11,3,FALSE
webcompiler,3.5.0,3.5.1,62,2,19,11,30,8,FALSE
webcompiler,3.6.0,3.6.1,66,4,172,99,271,32,FALSE
webcompiler,6.2.0,6.3.0,108,7,523,241,764,70,FALSE
webcompiler,3.2.0,3.2.1,53,3,89,29,118,22,FALSE
webcompiler,3.2.1,3.2.2,54,2,64,30,94,14,FALSE
webcompiler,3.2.2,3.2.3,55,3,28,7,35,9,FALSE
webcompiler,3.2.3,3.3.0,56,4,579,132,711,31,FALSE
webcompiler,3.4.0,3.4.1,59,2,71,49,120,13,FALSE
webcompiler,3.3.1,3.4.0,58,3,883,1335,2218,69,FALSE
webcompiler,3.6.1,3.7.0,67,2,130,25,155,9,FALSE
webcompiler,6.6.1,6.7.0,115,8,1596,1170,2766,82,FALSE
webcompiler,6.6.0,6.6.1,114,5,86,23,109,14,FALSE
webcompiler,3.7.0,3.7.1,68,2,11,2,13,4,FALSE
webcompiler,1.0.0,1.0.1,15,1,30,28,58,22,FALSE
webcompiler,1.0.1,1.0.2,16,1,81,124,205,37,FALSE
webcompiler,1.0.2,1.0.3,17,1,125,157,282,35,FALSE
webcompiler,1.0.3,1.1.0,18,1,1224,383,1607,31,FALSE
webcompiler,0.3.2,0.3.3,11,1,11,11,22,32,FALSE
webcompiler,0.3.3,0.3.4,12,1,68,68,136,34,FALSE
webcompiler,0.3.4,0.3.5,13,1,18,17,35,37,FALSE
webcompiler,0.3.5,1.0.0,14,3,10385,887,11272,145,FALSE
webcompiler,1.1.1,1.2.0,20,1,432,596,1028,28,FALSE
webcompiler,4.1.0,4.1.1,90,5,371,137,508,47,TRUE
webcompiler,0.3.0,0.3.1,9,1,488,734,1222,44,TRUE
webcompiler,2.0.7,2.0.8,42,4,22,7,29,8,FALSE
webcompiler,2.0.6,2.0.7,41,2,4343,371,4714,24,FALSE
webcompiler,2.0.5,2.0.6,40,2,106,58,164,19,FALSE
webcompiler,2.0.4,2.0.5,39,2,69,55,124,5,FALSE
webcompiler,2.0.3,2.0.4,38,2,12,1,13,6,FALSE
webcompiler,2.0.2,2.0.3,37,2,9,2,11,4,FALSE
webcompiler,2.0.1,2.0.2,36,2,9,2,11,3,FALSE
webcompiler,1.1.0,1.1.1,19,1,288,104,392,28,FALSE
webcompiler,2.0.9,2.0.10,44,2,8,4,12,3,FALSE
webcompiler,2.0.8,2.0.9,43,2,23,2,25,3,FALSE
webcompiler,1.5.4,2.0.0,34,6,1010,226,1236,44,FALSE
webcompiler,1.5.1,1.5.2,31,2,10,2,12,4,FALSE
webcompiler,1.5.0,1.5.1,30,2,11,4,15,4,FALSE
webcompiler,1.5.3,1.5.4,33,2,13,22,35,4,FALSE
webcompiler,1.5.2,1.5.3,32,2,9,2,11,3,FALSE
webcompiler,1.3.2,1.4.0,26,1,1796,49,1845,31,FALSE
webcompiler,1.3.1,1.3.2,25,1,6,2,8,3,FALSE
webcompiler,1.3.0,1.3.1,24,1,21,22,43,22,FALSE
webcompiler,0.3.1,0.3.2,10,1,9,10,19,32,FALSE
webcompiler,0.2.1,0.3.0,8,1,15100,127,15227,44,FALSE
webcompiler,0.2.0,0.2.1,7,1,6,6,12,3,FALSE
webcompiler,0.1.0,0.2.0,6,1,84,44,128,4,FALSE
webcompiler,0.0.4,0.1.0,5,1,33,9,42,7,FALSE
webcompiler,0.0.1,0.0.2,2,1,4,1,5,1,FALSE
webcompiler,0.0.0,0.0.1,1,1,2,1,3,1,FALSE
webcompiler,0.0.3,0.0.4,4,1,5,5,10,3,FALSE
webcompiler,0.0.2,0.0.3,3,1,3,2,5,1,FALSE
webcompiler,1.4.0,1.4.1,27,1,36,32,68,27,FALSE
webcompiler,1.4.1,1.4.2,28,1,25,25,50,24,FALSE
webcompiler,1.4.2,1.5.0,29,11,580,5024,5604,112,FALSE
webcompiler,1.2.2,1.3.0,23,1,613,550,1163,54,FALSE
webcompiler,1.2.0,1.2.1,21,1,39,35,74,25,TRUE
webcompiler,1.2.1,1.2.2,22,1,33,29,62,22,FALSE
webcompiler,2.0.0,2.0.1,35,2,9,2,11,3,FALSE
webcompiler,2.0.10,3.0.0,45,9,150307,23233,173540,238,FALSE
webcompiler,3.5.1,3.5.2,63,2,9,2,11,3,TRUE
webcompiler,1.0.0,1.0.1,15,1,30,28,58,22,TRUE
webcompiler,6.8.0,6.8.1,117,3,43,23,66,7,TRUE
webcompiler,0.3.0,0.3.1,9,1,488,734,1222,44,FALSE
webcompiler,1.2.1,1.2.2,22,1,33,29,62,22,TRUE
webcompiler,3.8.4,3.9.0,74,3,921,69,990,33,TRUE
webcompiler,5.1.1,5.2.0,95,4,216,371,587,33,TRUE
webcompiler,3.2.2,3.2.3,55,3,28,7,35,9,TRUE
webcompiler,1.0.2,1.0.3,17,1,125,157,282,35,TRUE
webcompiler,0.2.1,0.3.0,8,1,15100,127,15227,44,TRUE
webcompiler,0.1.0,0.2.0,6,1,84,44,128,4,TRUE
webcompiler,1.2.0,1.2.1,21,1,39,35,74,25,FALSE
webcompiler,2.0.4,2.0.5,39,2,69,55,124,5,TRUE
webcompiler,3.5.2,3.5.3,64,2,198,68,266,10,TRUE
webcompiler,2.0.7,2.0.8,42,4,22,7,29,8,TRUE
webcompiler,1.1.1,1.2.0,20,1,432,596,1028,28,TRUE
webcompiler,3.8.2,3.8.3,72,2,13,4,17,4,TRUE
webcompiler,6.8.4,7.0.0,121,7,912,719,1631,78,TRUE
webcompiler,6.1.0,6.1.1,105,3,13,6,19,4,TRUE
webcompiler,3.10.0,3.10.1,76,2,142,76,218,42,TRUE
webcompiler,3.10.3,3.11.0,79,2,610,25,635,11,TRUE
webcompiler,3.4.0,3.4.1,59,2,71,49,120,13,TRUE
webcompiler,3.3.1,3.4.0,58,3,883,1335,2218,69,TRUE
webcompiler,6.0.2,6.0.3,103,4,17,8,25,7,TRUE
webcompiler,3.8.3,3.8.4,73,2,76,12,88,15,TRUE
webcompiler,3.2.0,3.2.1,53,3,89,29,118,22,TRUE
webcompiler,3.0.4,3.0.5,50,4,52,48,100,21,TRUE
webcompiler,3.0.5,3.1.0,51,9,867,153,1020,62,TRUE
webcompiler,3.7.0,3.7.1,68,2,11,2,13,4,TRUE
webcompiler,4.0.6,4.0.7,87,2,77,29,106,10,TRUE
webcompiler,6.8.3,6.8.4,120,6,93,78,171,11,TRUE
webcompiler,3.2.3,3.3.0,56,4,579,132,711,31,TRUE
webcompiler,4.0.5,4.0.6,86,2,23,3,26,5,TRUE
webcompiler,1.0.1,1.0.2,16,1,81,124,205,37,TRUE
webcompiler,4.0.7,4.0.8,88,2,26,20,46,9,TRUE
webcompiler,5.2.0,5.2.1,96,2,35,21,56,10,TRUE
webcompiler,5.0.1,5.1.0,93,2,1332,65,1397,47,TRUE
webcompiler,1.3.2,1.4.0,26,1,1796,49,1845,31,TRUE
webcompiler,0.2.0,0.2.1,7,1,6,6,12,3,TRUE
webcompiler,3.8.0,3.8.1,70,2,16,10,26,5,TRUE
webcompiler,4.1.1,5.0.0,91,3,1348,658,2006,39,TRUE
webcompiler,5.0.0,5.0.1,92,2,164,66,230,8,TRUE
webcompiler,6.4.0,6.5.0,112,5,161,174,335,13,TRUE
webcompiler,3.6.1,3.7.0,67,2,130,25,155,9,TRUE
webcompiler,3.0.2,3.0.3,48,3,16,8,24,8,TRUE
webcompiler,3.6.0,3.6.1,66,4,172,99,271,32,TRUE
webcompiler,6.0.1,6.0.2,102,3,162,44,206,28,TRUE
webcompiler,6.2.0,6.3.0,108,7,523,241,764,70,TRUE
webcompiler,6.3.2,6.4.0,111,7,693,814,1507,56,TRUE
webcompiler,7.0.0,7.0.1,122,4,55,38,93,11,TRUE
webcompiler,6.3.0,6.3.1,109,4,88,67,155,10,TRUE
webcompiler,3.11.0,4.0.0,80,3,5661,3799,9460,88,TRUE
webcompiler,3.8.1,3.8.2,71,2,10,3,13,3,TRUE
webcompiler,2.0.6,2.0.7,41,2,4343,371,4714,24,TRUE
webcompiler,0.0.2,0.0.3,3,1,3,2,5,1,TRUE
webcompiler,3.4.2,3.5.0,61,2,4091,932,5023,84,TRUE
webcompiler,5.1.0,5.1.1,94,3,49,28,77,20,TRUE
webcompiler,5.2.3,5.2.4,99,2,1604,1338,2942,56,TRUE
webcompiler,3.7.1,3.8.0,69,2,421,265,686,70,TRUE
webcompiler,6.8.1,6.8.2,118,4,53,30,83,11,TRUE
webcompiler,1.3.1,1.3.2,25,1,6,2,8,3,TRUE
webcompiler,5.2.1,5.2.2,97,3,102,135,237,5,TRUE
webcompiler,3.4.1,3.4.2,60,2,513,1892,2405,26,TRUE
webcompiler,1.4.0,1.4.1,27,1,36,32,68,27,TRUE
webcompiler,6.0.3,6.1.0,104,2,157,124,281,24,TRUE
cpass,1.1.0,2.0.0,4,1,292,2113,2405,16,FALSE
cpass,1.0.0,1.0.1,1,1,3,3,6,2,FALSE
cpass,1.0.1,1.0.2,2,1,2,1,3,2,FALSE
cpass,1.0.2,1.1.0,3,1,2286,2706,4992,15,FALSE
cpass,1.1.0,2.0.0,4,1,292,2113,2405,16,TRUE
react-boxen,0.0.5,0.0.6,5,3,28,3,31,6,FALSE
react-boxen,0.0.4,0.0.5,4,2,841,810,1651,84,FALSE
react-boxen,0.0.7,0.0.8,7,2,5,4,9,2,FALSE
react-boxen,0.0.6,0.0.7,6,2,3,1,4,2,FALSE
react-boxen,0.0.1,0.0.2,1,19,3569,2327,5896,156,FALSE
react-boxen,0.0.3,0.0.4,3,1,6,2,8,2,FALSE
react-boxen,0.0.2,0.0.3,2,1,10,8,18,3,FALSE
react-boxen,0.0.9,0.0.10,9,2,3,3,6,2,FALSE
react-boxen,0.0.8,0.0.9,8,3,2,5,7,3,FALSE
react-boxen,0.0.15,0.0.16,14,2,7,6,13,2,FALSE
react-boxen,0.0.17,0.0.18,16,2,102,42,144,17,FALSE
react-boxen,0.0.16,0.0.17,15,2,37,21,58,7,FALSE
react-boxen,0.0.11,0.0.12,11,1,1,1,2,1,FALSE
react-boxen,0.0.10,0.0.11,10,2,213,303,516,24,FALSE
react-boxen,0.0.13,0.0.15,13,3,41,7,48,5,FALSE
react-boxen,0.0.12,0.0.13,12,2,14,7,21,6,FALSE
react-boxen,0.0.19,0.0.20,18,2,27,4,31,6,FALSE
react-boxen,0.0.18,0.0.19,17,3,20,15,35,6,FALSE
react-boxen,0.0.20,0.0.21,19,2,31,63,94,6,FALSE
react-boxen,1.1.1,1.1.2,37,2,5,2,7,4,FALSE
react-boxen,1.1.0,1.1.1,36,2,4,4,8,2,FALSE
react-boxen,1.0.0,1.1.0,35,1,17,4,21,5,FALSE
react-boxen,0.0.35,1.0.0,34,4,1309,769,2078,116,FALSE
react-boxen,0.0.34,0.0.35,33,2,4,3,7,3,FALSE
react-boxen,0.0.33,0.0.34,32,2,3,3,6,2,FALSE
react-boxen,0.0.32,0.0.33,31,2,3,3,6,2,FALSE
react-boxen,0.0.31,0.0.32,30,2,2,1,3,2,FALSE
react-boxen,0.0.30,0.0.31,29,2,8,2,10,2,FALSE
react-boxen,0.0.25,0.0.26,24,4,112,63,175,14,FALSE
react-boxen,0.0.26,0.0.27,25,3,39,17,56,4,FALSE
react-boxen,0.0.27,0.0.28,26,2,12,6,18,3,FALSE
react-boxen,0.0.28,0.0.29,27,2,20,11,31,3,FALSE
react-boxen,0.0.29,0.0.30,28,2,3,3,6,3,FALSE
react-boxen,0.0.21,0.0.22,20,2,14,11,25,5,FALSE
react-boxen,0.0.22,0.0.23,21,2,570,574,1144,3,FALSE
react-boxen,0.0.23,0.0.24,22,2,288,290,578,3,FALSE
react-boxen,0.0.24,0.0.25,23,2,517,643,1160,70,FALSE
react-boxen,0.0.13,0.0.15,13,3,41,7,48,5,TRUE
react-boxen,0.0.4,0.0.5,4,2,841,810,1651,84,TRUE
react-boxen,0.0.20,0.0.21,19,2,31,63,94,6,TRUE
react-boxen,0.0.17,0.0.18,16,2,102,42,144,17,TRUE
react-boxen,0.0.10,0.0.11,10,2,213,303,516,24,TRUE
react-boxen,0.0.9,0.0.10,9,2,3,3,6,2,TRUE
react-boxen,0.0.16,0.0.17,15,2,37,21,58,7,TRUE
react-boxen,0.0.3,0.0.4,3,1,6,2,8,2,TRUE
ensure-request,1.0.4,1.0.5,4,2,48,25,73,5,FALSE
ensure-request,1.0.5,1.1.0,5,2,39,3,42,3,FALSE
ensure-request,2.0.4,3.0.0,11,2,138,119,257,5,FALSE
ensure-request,2.0.3,2.0.4,10,2,994,26,1020,5,FALSE
ensure-request,1.0.1,1.0.2,1,2,7,3,10,3,FALSE
ensure-request,2.0.1,2.0.2,8,2,2,2,4,2,FALSE
ensure-request,1.1.0,1.2.0,6,2,55,55,110,3,FALSE
ensure-request,1.0.3,1.0.4,3,2,59,56,115,6,FALSE
ensure-request,3.0.1,3.1.0,13,2,67,8,75,3,FALSE
ensure-request,3.0.0,3.0.1,12,2,69,60,129,5,FALSE
ensure-request,3.1.0,3.2.0,14,2,68,4,72,3,FALSE
ensure-request,3.2.0,3.2.1,15,2,270,4,274,3,FALSE
ensure-request,3.2.1,4.0.0,16,2,648,565,1213,13,FALSE
ensure-request,1.2.0,2.0.1,7,2,1568,82,1650,5,FALSE
ensure-request,1.0.2,1.0.3,2,2,18,1,19,2,FALSE
ensure-request,2.0.2,2.0.3,9,2,15,2,17,3,FALSE
ensure-request,3.2.1,4.0.0,16,2,648,565,1213,13,TRUE
ensure-request,1.2.0,2.0.1,7,2,1568,82,1650,5,TRUE
ensure-request,1.1.0,1.2.0,6,2,55,55,110,3,TRUE
generator-polymer,0.6.0,0.6.1,18,8,98,32,130,13,FALSE
generator-polymer,0.3.0,0.3.1,11,3,503,503,1006,16,FALSE
generator-polymer,0.3.1,0.4.0-1,12,22,386,145,531,42,FALSE
generator-polymer,0.5.1,0.6.0,17,33,507,475,982,83,FALSE
generator-polymer,0.2.2,0.3.0,10,7,21937,127,22064,99,FALSE
generator-polymer,0.4.1,0.5.0,15,7,320,9518,9838,37,FALSE
generator-polymer,0.4.0,0.4.1,14,1,1,1,2,1,FALSE
generator-polymer,0.6.1,0.6.2,19,16,299,309,608,38,FALSE
generator-polymer,0.5.0,0.5.1,16,1,13,2,15,2,FALSE
generator-polymer,0.4.0-1,0.4.0,13,2,7,7,14,2,FALSE
generator-polymer,1.0.4,1.0.5-rc1,29,14,204,1959,2163,62,FALSE
generator-polymer,1.0.5,1.1.0,31,12,542,18,560,20,FALSE
generator-polymer,1.0.0,1.0.1,25,3,2302,9,2311,47,FALSE
generator-polymer,1.0.1,1.0.2,26,2,17,3,20,3,FALSE
generator-polymer,1.0.2,1.0.3,27,2,16,25,41,2,FALSE
generator-polymer,1.0.3,1.0.4,28,4,506,968,1474,23,FALSE
generator-polymer,0.6.3,0.7.0,21,25,600,264,864,57,FALSE
generator-polymer,0.6.2,0.6.3,20,3,3,3,6,3,FALSE
generator-polymer,0.7.2,1.0.0,24,15,1121,3161,4282,111,FALSE
generator-polymer,0.7.0,0.7.1,22,14,288,112,400,31,FALSE
generator-polymer,0.7.1,0.7.2,23,2,17,17,34,7,FALSE
generator-polymer,1.2.10,1.3.0,43,10,11,15,26,10,FALSE
generator-polymer,1.0.5-rc1,1.0.5,30,2,2,2,4,2,FALSE
generator-polymer,1.2.6,1.2.7,39,11,62,18,80,15,FALSE
generator-polymer,1.2.7,1.2.8,40,2,10,2,12,3,FALSE
generator-polymer,1.2.4,1.2.5,37,2,3,2,5,2,FALSE
generator-polymer,1.2.5,1.2.6,38,5,15,3,18,5,FALSE
generator-polymer,1.2.2,1.2.3,35,2,3,3,6,2,FALSE
generator-polymer,1.2.3,1.2.4,36,5,5,3,8,5,FALSE
generator-polymer,1.2.0,1.2.1,33,9,45,47,92,20,FALSE
generator-polymer,1.2.1,1.2.2,34,4,622,541,1163,16,FALSE
generator-polymer,1.2.8,1.2.9,41,12,107,57,164,29,FALSE
generator-polymer,1.2.9,1.2.10,42,2,2,2,4,2,TRUE
generator-polymer,1.1.0,1.2.0,32,4,95,10,105,5,FALSE
generator-polymer,1.2.9,1.2.10,42,2,2,2,4,2,FALSE
generator-polymer,0.0.9,0.1.1,8,17,26,32,58,21,FALSE
generator-polymer,0.1.1,0.2.2,9,17,771,22957,23728,104,FALSE
generator-polymer,0.0.5,0.0.6,4,3,3,4,7,3,FALSE
generator-polymer,0.0.4,0.0.5,3,6,12,41,53,6,FALSE
generator-polymer,0.0.7,0.0.8,6,19,313,114,427,27,FALSE
generator-polymer,0.0.6,0.0.7,5,15,74,36,110,22,FALSE
generator-polymer,0.0.3,0.0.4,2,7,83,22,105,9,FALSE
generator-polymer,0.0.2,0.0.3,1,9,171,69,240,10,FALSE
generator-polymer,0.0.8,0.0.9,7,7,176,67,243,15,FALSE
generator-polymer,0.3.0,0.3.1,11,3,503,503,1006,16,TRUE
generator-polymer,0.7.2,1.0.0,24,15,1121,3161,4282,111,TRUE
robe-react-commons,1.0.74,1.0.75,70,2,7,4,11,3,FALSE
robe-react-commons,1.0.72,1.0.73,68,4,19,8,27,6,FALSE
robe-react-commons,1.0.73,1.0.74,69,2,201,9,210,6,FALSE
robe-react-commons,1.0.4,1.0.5,2,8,27,140,167,20,FALSE
robe-react-commons,1.0.5,1.0.6,3,9,163,108,271,22,FALSE
robe-react-commons,1.0.6,1.0.7,4,2,181,8,189,5,FALSE
robe-react-commons,1.0.7,1.0.8,5,2,5,3,8,2,FALSE
robe-react-commons,1.0.55,1.0.56,53,4,86,64,150,8,FALSE
robe-react-commons,1.0.2,1.0.4,1,4,129,33,162,10,FALSE
robe-react-commons,1.0.45,1.0.46,42,1,1,2,3,2,FALSE
robe-react-commons,1.0.8,1.0.9,6,1,7,2,9,2,FALSE
robe-react-commons,1.0.9,1.0.10,7,1,9,9,18,2,FALSE
robe-react-commons,1.0.34,1.0.35,31,1,2,2,4,1,FALSE
robe-react-commons,1.0.46,1.0.47,43,1,34,4,38,3,FALSE
robe-react-commons,1.0.41,1.0.42,38,1,9,9,18,2,FALSE
robe-react-commons,1.0.47,1.0.48,44,1,104,15,119,8,FALSE
robe-react-commons,1.0.59,1.0.61,57,7,99,70,169,23,FALSE
robe-react-commons,1.0.82,1.0.83,78,2,10,5,15,6,FALSE
robe-react-commons,1.0.16,1.0.17,14,85,4501,1716,6217,262,FALSE
robe-react-commons,1.0.76,1.0.77,72,1,214,4,218,6,FALSE
robe-react-commons,1.0.77,1.0.78,73,3,31,380,411,7,TRUE
robe-react-commons,1.0.70,1.0.71,66,1,14,232,246,4,FALSE
robe-react-commons,1.0.71,1.0.72,67,3,152,87,239,9,FALSE
robe-react-commons,1.0.17,1.0.18,15,6,111,119,230,10,FALSE
robe-react-commons,1.0.78,1.0.79,74,1,9,9,18,2,FALSE
robe-react-commons,1.0.79,1.0.80,75,1,23,6,29,3,FALSE
robe-react-commons,1.0.40,1.0.41,37,2,4,4,8,3,FALSE
robe-react-commons,1.0.30,1.0.31,28,1,9,9,18,2,FALSE
robe-react-commons,1.0.31,1.0.32,29,1,7,6,13,2,FALSE
robe-react-commons,1.0.32,1.0.34,30,2,98,57,155,13,FALSE
robe-react-commons,1.0.15,1.0.16,13,2,175,44,219,14,FALSE
robe-react-commons,1.0.12,1.0.13,10,3,136,143,279,5,FALSE
robe-react-commons,1.0.13,1.0.14,11,1,5,1,6,2,FALSE
robe-react-commons,1.0.10,1.0.11,8,2,16,15,31,5,FALSE
robe-react-commons,1.0.11,1.0.12,9,3,398,5,403,4,FALSE
robe-react-commons,1.0.38,1.0.39,35,5,278,244,522,10,FALSE
robe-react-commons,1.0.53,1.0.54,51,1,7,5,12,4,FALSE
robe-react-commons,1.0.50,1.0.51,47,4,204,105,309,21,FALSE
robe-react-commons,1.0.51,1.0.52,48,1,6,17,23,5,FALSE
robe-react-commons,1.0.56,1.0.57,54,1,9,9,18,2,FALSE
robe-react-commons,1.0.57,1.0.58,55,1,9,9,18,2,FALSE
robe-react-commons,1.0.54,1.0.55,52,1,26,26,52,1,FALSE
robe-react-commons,1.0.19,1.0.20,17,4,199,29,228,8,FALSE
robe-react-commons,1.0.36,1.0.37,33,1,1,1,2,1,FALSE
robe-react-commons,1.0.75,1.0.76,71,2,113,139,252,12,FALSE
robe-react-commons,1.0.37,1.0.38,34,4,16,16,32,5,FALSE
robe-react-commons,1.0.53-beta,1.0.53,50,1,9,9,18,2,FALSE
robe-react-commons,1.0.14,1.0.15,12,1,52,4,56,5,FALSE
robe-react-commons,1.0.52,1.0.53-beta,49,1,9,9,18,2,FALSE
robe-react-commons,1.0.86,1.0.87,82,1,5,2,7,2,FALSE
robe-react-commons,1.0.35,1.0.36,32,1,2,2,4,2,FALSE
robe-react-commons,1.0.39,1.0.40,36,1,35,1,36,4,FALSE
robe-react-commons,1.0.43,1.0.44,40,8,186,159,345,23,FALSE
robe-react-commons,1.0.63,1.0.64,60,6,140,121,261,13,FALSE
robe-react-commons,1.0.62,1.0.63,59,1,94,104,198,7,FALSE
robe-react-commons,1.0.61,1.0.62,58,4,376,311,687,52,FALSE
robe-react-commons,1.0.24,1.0.25,22,1,4,3,7,3,FALSE
robe-react-commons,1.0.67,1.0.68,64,3,261,103,364,18,FALSE
robe-react-commons,1.0.66,1.0.67,63,5,181,27,208,15,FALSE
robe-react-commons,1.0.65,1.0.66,62,1,160,62,222,6,FALSE
robe-react-commons,1.0.58,1.0.59,56,1,9,9,18,2,FALSE
robe-react-commons,1.0.85,1.0.86,81,1,13,12,25,2,FALSE
robe-react-commons,1.0.84,1.0.85,80,3,248,67,315,8,FALSE
robe-react-commons,1.0.87,1.0.88,83,1,9,9,18,2,FALSE
robe-react-commons,1.0.68,1.0.70,65,10,1685,400,2085,67,FALSE
robe-react-commons,1.0.81,1.0.82,77,1,9,9,18,2,FALSE
robe-react-commons,1.0.80,1.0.81,76,3,59,36,95,11,FALSE
robe-react-commons,1.0.83,1.0.84,79,1,9,3,12,3,FALSE
robe-react-commons,1.0.44,1.0.45,41,2,43,18,61,4,FALSE
robe-react-commons,1.0.49,1.0.50,46,1,3,3,6,2,FALSE
robe-react-commons,1.0.48,1.0.49,45,1,10,9,19,3,FALSE
robe-react-commons,1.0.64,1.0.65,61,3,168,31,199,7,FALSE
robe-react-commons,1.0.18,1.0.19,16,1,9,9,18,2,FALSE
robe-react-commons,1.0.29,1.0.30,27,1,1,1,2,1,FALSE
robe-react-commons,1.0.28,1.0.29,26,1,2,5,7,2,FALSE
robe-react-commons,1.0.27,1.0.28,25,1,1,1,2,1,FALSE
robe-react-commons,1.0.26,1.0.27,24,1,2,2,4,2,FALSE
robe-react-commons,1.0.25,1.0.26,23,1,37,1,38,4,FALSE
robe-react-commons,1.0.42,1.0.43,39,24,1555,1027,2582,60,FALSE
robe-react-commons,1.0.23,1.0.24,21,1,1,1,2,1,FALSE
robe-react-commons,1.0.22,1.0.23,20,1,328,68,396,13,FALSE
robe-react-commons,1.0.21,1.0.22,19,8,63,16,79,12,FALSE
robe-react-commons,1.0.20,1.0.21,18,1,1,1,2,1,FALSE
robe-react-commons,1.0.77,1.0.78,73,3,31,380,411,7,FALSE
robe-react-commons,1.0.88,1.0.89,84,7,43,16,59,16,FALSE
robe-react-commons,1.0.32,1.0.34,30,2,98,57,155,13,TRUE
robe-react-commons,1.0.42,1.0.43,39,24,1555,1027,2582,60,TRUE
robe-react-commons,1.0.62,1.0.63,59,1,94,104,198,7,TRUE
sgmap.ludwig,0.3.0,0.5.0,3,1,228,75,303,10,FALSE
sgmap.ludwig,0.2.0,0.3.0,2,1,228,75,303,10,FALSE
sgmap.ludwig,0.3.0,0.5.0,3,1,228,75,303,10,TRUE
sgmap.ludwig,0.1.0,0.2.0,1,1,228,75,303,10,FALSE
careen,0.1.0,0.1.1,1,5,58,3,61,6,FALSE
careen,0.1.0,0.1.1,1,5,58,3,61,6,TRUE
react-heatpack,1.4.0,1.4.1,6,8,127,29,156,20,FALSE
react-heatpack,1.1.0,1.2.0,3,7,94,57,151,12,FALSE
react-heatpack,1.4.1,1.5.0,7,3,20,16,36,4,FALSE
react-heatpack,1.3.0,1.4.0,5,12,136,27,163,17,FALSE
react-heatpack,1.2.0,1.3.0,4,13,174,124,298,18,FALSE
react-heatpack,2.0.0-1,2.0.0,9,6,95,52,147,18,FALSE
react-heatpack,3.0.0,3.0.1,11,5,17,3,20,8,FALSE
react-heatpack,2.0.0,3.0.0,10,5,239,196,435,20,FALSE
react-heatpack,1.0.0,1.0.1,1,1,12,3,15,4,FALSE
react-heatpack,1.0.1,1.1.0,2,12,100,29,129,19,FALSE
react-heatpack,1.0.1,1.1.0,2,12,100,29,129,19,TRUE
react-heatpack,1.3.0,1.4.0,5,12,136,27,163,17,TRUE
react-heatpack,2.0.0,3.0.0,10,5,239,196,435,20,TRUE
react-highlighted-text,1.0.0,1.0.1,6,2,3,3,6,2,FALSE
react-highlighted-text,1.0.1,1.0.2,7,4,12,10,22,5,FALSE
react-highlighted-text,0.1.0,0.1.1,3,1,1,1,2,1,FALSE
react-highlighted-text,0.0.71,0.1.0,2,7,236,19,255,10,FALSE
react-highlighted-text,0.2.0-rc,1.0.0,5,26,910,602,1512,53,FALSE
react-highlighted-text,0.1.1,0.2.0-rc,4,13,835,872,1707,54,FALSE
react-highlighted-text,0.2.0-rc,1.0.0,5,26,910,602,1512,53,TRUE
react-highlighted-text,0.0.71,0.1.0,2,7,236,19,255,10,TRUE
vue-msgbox,2.0.1,2.0.2,24,2,35,30,65,3,FALSE
vue-msgbox,2.0.0,2.0.1,23,2,103,110,213,2,FALSE
vue-msgbox,0.2.13,0.2.14,21,6,345,334,679,9,FALSE
vue-msgbox,0.2.12,0.2.13,20,1,1,1,2,1,FALSE
vue-msgbox,0.2.11,0.2.12,19,2,6,2,8,4,TRUE
vue-msgbox,0.2.10,0.2.11,18,2,2,2,4,2,FALSE
vue-msgbox,0.2.7,0.2.8,15,2,14,2,16,2,FALSE
vue-msgbox,0.2.6,0.2.7,14,2,12,50,62,3,FALSE
vue-msgbox,0.2.5,0.2.6,13,2,7,1,8,2,FALSE
vue-msgbox,0.2.4,0.2.5,12,2,19,19,38,2,FALSE
vue-msgbox,0.2.3,0.2.4,11,2,4,4,8,3,FALSE
vue-msgbox,0.2.2,0.2.3,10,2,30,37,67,4,FALSE
vue-msgbox,0.2.1,0.2.2,9,4,151,86,237,7,FALSE
vue-msgbox,0.2.9,0.2.10,17,2,2,2,4,2,FALSE
vue-msgbox,0.2.8,0.2.9,16,2,10,8,18,2,FALSE
vue-msgbox,0.2.11,0.2.12,19,2,6,2,8,4,FALSE
vue-msgbox,0.2.0,0.2.1,8,2,5,6,11,3,FALSE
vue-msgbox,0.1.1,0.1.2,5,5,16,10,26,9,FALSE
vue-msgbox,0.1.2,0.1.3,6,2,4,6,10,4,FALSE
vue-msgbox,0.1.3,0.2.0,7,2,72,20,92,5,FALSE
vue-msgbox,0.1.0,0.1.1,4,4,554,50,604,30,TRUE
vue-msgbox,0.1.1,0.1.2,5,5,16,10,26,9,TRUE
vue-msgbox,0.0.1,0.0.2,1,3,4,4,8,3,FALSE
vue-msgbox,0.0.3,0.1.0,3,1,183,25,208,4,FALSE
vue-msgbox,0.0.2,0.0.3,2,2,32,16,48,2,FALSE
vue-msgbox,0.1.0,0.1.1,4,4,554,50,604,30,FALSE
vue-msgbox,0.1.3,0.2.0,7,2,72,20,92,5,TRUE
vue-msgbox,0.2.12,0.2.13,20,1,1,1,2,1,TRUE
vue-msgbox,0.2.9,0.2.10,17,2,2,2,4,2,TRUE
vue-msgbox,0.0.2,0.0.3,2,2,32,16,48,2,TRUE
vt-radio,1.0.0,1.0.1,1,1,2052,66,2118,8,FALSE
vt-radio,1.0.0,1.0.1,1,1,2052,66,2118,8,TRUE
wsdm-slider,1.4.0,1.4.1,14,3,74,39,113,5,FALSE
wsdm-slider,1.4.1,1.5.0,15,2,43,9,52,4,FALSE
wsdm-slider,1.0.0,1.1.0,3,2,120,24,144,6,FALSE
wsdm-slider,1.3.5,1.3.6,11,4,200,93,293,9,FALSE
wsdm-slider,1.1.0,1.2.0,4,5,138,97,235,10,FALSE
wsdm-slider,1.5.1,1.5.2,17,2,3,1,4,3,FALSE
wsdm-slider,1.5.0,1.5.1,16,2,11688,9631,21319,4,FALSE
wsdm-slider,1.5.2,1.5.3,18,2,28,18,46,3,FALSE
wsdm-slider,1.3.3,1.3.4,9,2,26,11,37,5,FALSE
wsdm-slider,1.3.2,1.3.3,8,3,59,22,81,6,FALSE
wsdm-slider,1.3.1,1.3.2,7,7,17072,321,17393,18,FALSE
wsdm-slider,1.3.0,1.3.1,6,2,2,3,5,2,FALSE
wsdm-slider,1.3.7,1.4.0,13,3,302,265,567,8,FALSE
wsdm-slider,1.3.6,1.3.7,12,2,16,11,27,4,FALSE
wsdm-slider,1.2.0,1.3.0,5,2,4,2,6,2,FALSE
wsdm-slider,1.3.4,1.3.5,10,6,223,60,283,16,FALSE
wsdm-slider,0.0.4,0.0.5,1,1,3,2,5,1,FALSE
wsdm-slider,1.5.0,1.5.1,16,2,11688,9631,21319,4,TRUE
redux-devtools-test-generator,0.0.5,0.0.6,5,3,48,1,49,5,FALSE
redux-devtools-test-generator,0.0.4,0.0.5,4,1,1,1,2,1,FALSE
redux-devtools-test-generator,0.2.0-alpha-1,0.2.0-alpha-2,8,1,1,1,2,1,FALSE
redux-devtools-test-generator,0.0.6,0.1.0,6,6,264,42,306,26,FALSE
redux-devtools-test-generator,0.2.0-alpha-7,0.2.0,14,3,63,36,99,4,FALSE
redux-devtools-test-generator,0.2.0-alpha-6,0.2.0-alpha-7,13,1,1,1,2,1,FALSE
redux-devtools-test-generator,0.0.3,0.0.4,3,10,266,72,338,26,FALSE
redux-devtools-test-generator,0.0.2,0.0.3,2,2,267,2,269,13,FALSE
redux-devtools-test-generator,0.3.2,0.4.0,20,1,6,34,40,2,FALSE
redux-devtools-test-generator,0.3.0,0.3.1,18,2,45,11,56,5,FALSE
redux-devtools-test-generator,0.3.1,0.3.2,19,2,2,2,4,2,FALSE
redux-devtools-test-generator,0.2.0-alpha-5,0.2.0-alpha-6,12,1,1,1,2,1,FALSE
redux-devtools-test-generator,0.2.0,0.2.1,15,1,1,1,2,1,FALSE
redux-devtools-test-generator,0.2.0-alpha-4,0.2.0-alpha-5,11,1,1,1,2,1,FALSE
redux-devtools-test-generator,0.2.2,0.3.0,17,5,64,17,81,14,FALSE
redux-devtools-test-generator,0.2.1,0.2.2,16,1,1,1,2,1,FALSE
redux-devtools-test-generator,0.2.0-alpha-2,0.2.0-alpha-3,9,2,42,38,80,16,FALSE
redux-devtools-test-generator,0.1.0,0.2.0-alpha-1,7,7,263,82,345,22,FALSE
redux-devtools-test-generator,0.2.0-alpha-3,0.2.0-alpha-4,10,1,1,1,2,1,FALSE
redux-devtools-test-generator,0.0.1,0.0.2,1,1,1,1,2,1,FALSE
redux-devtools-test-generator,0.3.2,0.4.0,20,1,6,34,40,2,TRUE
redux-devtools-test-generator,0.4.1,0.5.0,22,16,7698,632,8330,40,FALSE
redux-devtools-test-generator,0.4.0,0.4.1,21,3,203,101,304,10,FALSE
redux-devtools-test-generator,0.2.0-alpha-7,0.2.0,14,3,63,36,99,4,TRUE
redux-devtools-test-generator,0.0.5,0.0.6,5,3,48,1,49,5,TRUE
moddle,0.3.1,0.4.0,6,2,20,4,24,3,FALSE
moddle,0.6.3,0.6.4,13,4,572,384,956,8,FALSE
moddle,0.6.2,0.6.3,12,2,143,19,162,5,FALSE
moddle,0.3.0,0.3.1,5,2,2,2,4,2,FALSE
moddle,0.6.0,0.6.1,10,2,2,2,4,2,FALSE
moddle,0.8.0,1.0.0,16,3,95,10,105,8,FALSE
moddle,0.7.0,0.8.0,15,1,1,1,2,1,FALSE
moddle,0.6.4,0.7.0,14,2,79,37,116,10,FALSE
moddle,0.2.0,0.3.0,4,2,5,5,10,2,FALSE
moddle,0.1.0,0.2.0,3,3,920,915,1835,25,FALSE
moddle,0.4.0,0.5.0,7,3,152,172,324,11,FALSE
moddle,0.6.1,0.6.2,11,3,82,27,109,8,FALSE
moddle,0.5.0,0.5.1,8,6,17,34,51,7,FALSE
moddle,0.5.1,0.6.0,9,7,237,50,287,22,TRUE
moddle,0.0.5,0.1.0,2,7,164,2363,2527,23,FALSE
moddle,0.0.2,0.0.5,1,8,186,50,236,12,FALSE
moddle,0.5.1,0.6.0,9,7,237,50,287,22,FALSE
generator-hapiest,0.0.5,0.0.6,5,1,1651,146,1797,39,FALSE
generator-hapiest,0.0.4,0.0.5,4,3,962,62,1024,24,FALSE
generator-hapiest,0.0.7,0.0.8,7,2,1725,22,1747,39,FALSE
generator-hapiest,0.0.6,0.0.7,6,1,207,254,461,11,TRUE
generator-hapiest,0.0.1,0.0.2,1,3,26,2,28,3,FALSE
generator-hapiest,0.0.3,0.0.4,3,3,58,25,83,10,FALSE
generator-hapiest,0.0.2,0.0.3,2,1,3,4,7,1,FALSE
generator-hapiest,0.0.9,0.0.10,9,1,12,6,18,3,FALSE
generator-hapiest,0.0.8,0.0.9,8,1,3,3,6,3,FALSE
generator-hapiest,0.0.11,0.0.12,11,1,19,6,25,4,FALSE
generator-hapiest,0.0.10,0.0.11,10,1,22,609,631,14,FALSE
generator-hapiest,0.0.6,0.0.7,6,1,207,254,461,11,FALSE
generator-hapiest,0.0.5,0.0.6,5,1,1651,146,1797,39,TRUE
shadowsocks-manager,0.5.52,0.5.53,168,2,32,28,60,8,FALSE
shadowsocks-manager,0.5.53,0.5.54,169,1,4,4,8,4,FALSE
shadowsocks-manager,0.3.81,0.4.0,126,3,133,63,196,22,FALSE
shadowsocks-manager,0.3.80,0.3.81,125,8,666,133,799,49,FALSE
shadowsocks-manager,0.5.54,0.5.55,170,1,58,50,108,6,FALSE
shadowsocks-manager,0.5.55,0.5.58,171,4,74,13904,13978,215,FALSE
shadowsocks-manager,0.5.58,0.5.59,172,1,6,2,8,3,FALSE
shadowsocks-manager,0.5.59,0.5.60,173,1,6,2,8,3,FALSE
shadowsocks-manager,0.5.38,0.5.40,162,7,432,244,676,58,FALSE
shadowsocks-manager,0.5.50,0.5.52,167,2,24,26,50,16,FALSE
shadowsocks-manager,0.3.53,0.3.54,101,3,764,75,839,20,FALSE
shadowsocks-manager,0.3.9,0.3.10,68,1,6,2,8,2,FALSE
shadowsocks-manager,0.3.14,0.3.20,73,7,870,45,915,55,FALSE
shadowsocks-manager,0.5.8,0.5.10,145,14,6540,5520,12060,207,FALSE
shadowsocks-manager,0.3.10,0.3.11,69,2,109,39,148,12,FALSE
shadowsocks-manager,0.3.11,0.3.12,70,1,6,2,8,3,FALSE
shadowsocks-manager,0.3.12,0.3.13,71,2,14,34,48,8,FALSE
shadowsocks-manager,0.3.13,0.3.14,72,1,10,28,38,4,FALSE
shadowsocks-manager,0.5.40,0.5.42,163,3,429,38,467,42,FALSE
shadowsocks-manager,0.5.42,0.5.45,164,4,2532,106,2638,47,FALSE
shadowsocks-manager,0.5.45,0.5.49,165,4,204,105,309,44,FALSE
shadowsocks-manager,0.3.78,0.3.79,123,1,12,20,32,4,FALSE
shadowsocks-manager,0.3.79,0.3.80,124,3,96,70,166,18,FALSE
shadowsocks-manager,0.3.76,0.3.77,121,2,3823,56,3879,79,FALSE
shadowsocks-manager,0.3.77,0.3.78,122,1,124,19,143,17,FALSE
shadowsocks-manager,0.3.74,0.3.75,119,4,207,58,265,23,FALSE
shadowsocks-manager,0.3.75,0.3.76,120,1,6,2,8,3,FALSE
shadowsocks-manager,0.3.72,0.3.73,117,7,4125,4106,8231,133,FALSE
shadowsocks-manager,0.3.73,0.3.74,118,18,725,3086,3811,76,FALSE
shadowsocks-manager,0.3.70,0.3.71,115,7,248,4000,4248,83,FALSE
shadowsocks-manager,0.3.71,0.3.72,116,2,3910,17,3927,53,FALSE
shadowsocks-manager,0.5.6,0.5.7,143,2,99,37,136,13,FALSE
shadowsocks-manager,0.3.39,0.3.41,89,2,288,19,307,22,FALSE
shadowsocks-manager,0.1.34,0.1.35,25,1,6,2,8,3,FALSE
shadowsocks-manager,0.1.35,0.1.36,26,1,6,2,8,3,FALSE
shadowsocks-manager,0.1.36,0.1.43,27,10,444,2608,3052,71,FALSE
shadowsocks-manager,0.1.32,0.1.33,23,1,6,2,8,3,FALSE
shadowsocks-manager,0.1.33,0.1.34,24,1,2491,5,2496,42,FALSE
shadowsocks-manager,0.5.27,0.5.28,156,2,76,31,107,20,FALSE
shadowsocks-manager,0.3.69,0.3.70,114,11,800,412,1212,47,TRUE
shadowsocks-manager,0.5.79,0.5.80,192,1,3,8,11,3,FALSE
shadowsocks-manager,0.3.59,0.3.60,105,1,155,8,163,4,FALSE
shadowsocks-manager,0.5.74,0.5.75,187,1,10,6,16,4,FALSE
shadowsocks-manager,0.5.75,0.5.76,188,1,10,8,18,4,FALSE
shadowsocks-manager,0.5.76,0.5.77,189,1,6,2,8,3,FALSE
shadowsocks-manager,0.5.77,0.5.78,190,1,16,9,25,9,FALSE
shadowsocks-manager,0.3.61,0.3.62,107,5,361,43,404,28,FALSE
shadowsocks-manager,0.5.71,0.5.73,185,3,306,75,381,15,FALSE
shadowsocks-manager,0.3.63,0.3.64,109,7,380,178,558,39,FALSE
shadowsocks-manager,0.5.73,0.5.74,186,1,112,4,116,5,FALSE
shadowsocks-manager,0.4.12,0.4.23,137,60,11587,9469,21056,708,FALSE
shadowsocks-manager,0.1.29,0.1.32,22,12,137,225,362,21,FALSE
shadowsocks-manager,0.3.37,0.3.38,87,1,36,18,54,7,FALSE
shadowsocks-manager,0.1.22,0.1.24,18,9,539,246,785,27,FALSE
shadowsocks-manager,0.1.21,0.1.22,17,1,9,9,18,3,FALSE
shadowsocks-manager,0.1.20,0.1.21,16,1,62,47,109,2,FALSE
shadowsocks-manager,0.1.27,0.1.29,21,2,2,2,4,2,FALSE
shadowsocks-manager,0.6.19,0.6.20,218,2,12,9,21,8,FALSE
shadowsocks-manager,0.1.25,0.1.27,20,2,109,289,398,8,FALSE
shadowsocks-manager,0.1.24,0.1.25,19,1,60,2,62,3,FALSE
shadowsocks-manager,0.6.23,0.6.24,221,1,5,5,10,4,FALSE
shadowsocks-manager,0.6.20,0.6.21,219,1,10,4,14,5,FALSE
shadowsocks-manager,0.6.21,0.6.23,220,4,119,38,157,15,FALSE
shadowsocks-manager,0.6.26,0.6.27,223,1,6,2,8,3,FALSE
shadowsocks-manager,0.6.27,0.6.28,224,4,36,17,53,12,FALSE
shadowsocks-manager,0.6.24,0.6.26,222,5,91,21,112,23,FALSE
shadowsocks-manager,0.3.51,0.3.52,99,2,224,34,258,17,FALSE
shadowsocks-manager,0.6.28,0.6.29,225,1,12,6,18,4,FALSE
shadowsocks-manager,0.6.29,0.6.30,226,1,16,21,37,14,FALSE
shadowsocks-manager,0.5.61,0.5.62,175,1,6,2,8,3,FALSE
shadowsocks-manager,0.3.42,0.3.43,91,5,288,187,475,18,FALSE
shadowsocks-manager,0.3.58,0.3.59,104,4,1030,628,1658,39,FALSE
shadowsocks-manager,0.4.10,0.4.12,136,14,4754,4330,9084,154,FALSE
shadowsocks-manager,0.5.69,0.5.70,183,1,5,5,10,4,FALSE
shadowsocks-manager,0.5.68,0.5.69,182,1,9,9,18,4,FALSE
shadowsocks-manager,0.5.63,0.5.64,177,1,9,5,14,1,FALSE
shadowsocks-manager,0.5.62,0.5.63,176,2,22,50,72,4,FALSE
shadowsocks-manager,0.3.52,0.3.53,100,3,667,988,1655,36,FALSE
shadowsocks-manager,0.5.60,0.5.61,174,1,6,2,8,3,FALSE
shadowsocks-manager,0.5.67,0.5.68,181,1,3,2,5,3,FALSE
shadowsocks-manager,0.5.66,0.5.67,180,3,70,9,79,11,FALSE
shadowsocks-manager,0.3.56,0.3.58,103,8,574,42,616,50,FALSE
shadowsocks-manager,0.5.64,0.5.65,178,1,6,2,8,3,FALSE
shadowsocks-manager,0.5.65,0.5.66,179,1,6,2,8,3,FALSE
shadowsocks-manager,0.1.8,0.1.10,9,3,41,18,59,7,FALSE
shadowsocks-manager,0.6.10,0.6.11,209,1,16,13,29,6,FALSE
shadowsocks-manager,0.5.37,0.5.38,161,3,218,130,348,28,FALSE
shadowsocks-manager,0.5.49,0.5.50,166,2,14,12,26,6,FALSE
shadowsocks-manager,0.5.26,0.5.27,155,3,52,5,57,5,FALSE
shadowsocks-manager,0.6.31,0.6.32,228,1,6,2,8,3,FALSE
shadowsocks-manager,0.6.30,0.6.31,227,1,6,2,8,3,FALSE
shadowsocks-manager,0.6.33,0.6.34,230,2,77,19,96,18,FALSE
shadowsocks-manager,0.6.32,0.6.33,229,2,21,17,38,10,FALSE
shadowsocks-manager,0.6.15,0.6.16,214,1,8,9,17,8,FALSE
shadowsocks-manager,0.1.56,0.1.63,34,6,180,37,217,17,FALSE
shadowsocks-manager,0.3.48,0.3.49,96,2,126,11,137,12,FALSE
shadowsocks-manager,0.1.51,0.1.55,32,8,64,20,84,17,FALSE
shadowsocks-manager,0.4.26,0.5.0,139,9,597,229,826,114,FALSE
shadowsocks-manager,0.4.23,0.4.26,138,8,118,24,142,28,FALSE
shadowsocks-manager,0.5.16,0.5.17,150,2,14,12,26,8,FALSE
shadowsocks-manager,0.5.17,0.5.21,151,5,284,249,533,45,FALSE
shadowsocks-manager,0.5.14,0.5.15,148,4,113,66,179,27,FALSE
shadowsocks-manager,0.5.15,0.5.16,149,3,124,61,185,25,FALSE
shadowsocks-manager,0.5.12,0.5.14,147,3,96,58,154,32,FALSE
shadowsocks-manager,0.5.10,0.5.12,146,7,555,96,651,68,FALSE
shadowsocks-manager,0.6.9,0.6.10,208,1,6,2,8,3,FALSE
shadowsocks-manager,0.6.8,0.6.9,207,1,18,2,20,6,FALSE
shadowsocks-manager,0.4.8,0.4.9,134,6,829,342,1171,115,FALSE
shadowsocks-manager,0.6.3,0.6.4,202,1,8,3,11,3,FALSE
shadowsocks-manager,0.6.2,0.6.3,201,2,48,10,58,12,FALSE
shadowsocks-manager,0.6.1,0.6.2,200,1,3,3,6,3,FALSE
shadowsocks-manager,0.6.0,0.6.1,199,1,8,10,18,3,FALSE
shadowsocks-manager,0.6.7,0.6.8,206,5,69,39,108,17,FALSE
shadowsocks-manager,0.6.6,0.6.7,205,1,8,8,16,5,FALSE
shadowsocks-manager,0.6.5,0.6.6,204,2,10,9,19,7,FALSE
shadowsocks-manager,0.6.4,0.6.5,203,1,6,2,8,3,FALSE
shadowsocks-manager,0.4.9,0.4.10,135,6,624,241,865,89,FALSE
shadowsocks-manager,0.3.65,0.3.66,111,1,113,89,202,9,FALSE
shadowsocks-manager,0.1.49,0.1.51,31,3,54,41,95,10,FALSE
shadowsocks-manager,0.1.48,0.1.49,30,1,24,2,26,2,FALSE
shadowsocks-manager,0.3.64,0.3.65,110,1,6,2,8,3,FALSE
shadowsocks-manager,0.4.1,0.4.2,128,4,426,131,557,39,FALSE
shadowsocks-manager,0.4.0,0.4.1,127,12,499,183,682,89,FALSE
shadowsocks-manager,0.1.47,0.1.48,29,1,8,3,11,3,FALSE
shadowsocks-manager,0.4.2,0.4.3,129,2,35,8,43,6,FALSE
shadowsocks-manager,0.4.5,0.4.6,131,4,439,136,575,42,FALSE
shadowsocks-manager,0.3.67,0.3.69,113,7,453,253,706,33,FALSE
shadowsocks-manager,0.1.43,0.1.47,28,6,71,14,85,15,FALSE
shadowsocks-manager,0.4.6,0.4.7,132,2,120,78,198,18,FALSE
shadowsocks-manager,0.3.66,0.3.67,112,2,189,9,198,16,FALSE
shadowsocks-manager,0.5.70,0.5.71,184,1,7,7,14,3,TRUE
shadowsocks-manager,0.2.11,0.2.12,57,1,27,1,28,2,FALSE
shadowsocks-manager,0.3.60,0.3.61,106,4,102,29,131,20,FALSE
shadowsocks-manager,0.3.62,0.3.63,108,1,54,9,63,8,FALSE
shadowsocks-manager,0.3.50,0.3.51,98,1,6,2,8,3,FALSE
shadowsocks-manager,0.4.3,0.4.5,130,1,27,12,39,11,FALSE
shadowsocks-manager,0.5.85,0.6.0,198,2,12,7,19,6,FALSE
shadowsocks-manager,0.5.84,0.5.85,197,1,2,1,3,1,FALSE
shadowsocks-manager,0.5.81,0.5.82,194,1,31,30,61,8,FALSE
shadowsocks-manager,0.5.80,0.5.81,193,3,26,8,34,9,FALSE
shadowsocks-manager,0.5.83,0.5.84,196,1,3,3,6,3,FALSE
shadowsocks-manager,0.5.82,0.5.83,195,1,23,9,32,5,FALSE
shadowsocks-manager,0.3.47,0.3.48,95,1,70,16,86,11,FALSE
shadowsocks-manager,0.3.46,0.3.47,94,1,6,2,8,3,FALSE
shadowsocks-manager,0.3.45,0.3.46,93,2,132,32,164,22,FALSE
shadowsocks-manager,0.6.18,0.6.19,217,1,11,11,22,7,FALSE
shadowsocks-manager,0.3.43,0.3.45,92,2,143,71,214,9,FALSE
shadowsocks-manager,0.4.7,0.4.8,133,2,74,10,84,16,FALSE
shadowsocks-manager,0.3.41,0.3.42,90,2,179,14,193,11,FALSE
shadowsocks-manager,0.6.13,0.6.14,212,2,91,82,173,13,FALSE
shadowsocks-manager,0.6.12,0.6.13,211,1,2,9,11,3,FALSE
shadowsocks-manager,0.6.11,0.6.12,210,2,30,14,44,10,FALSE
shadowsocks-manager,0.1.73,0.1.81,37,18,595,291,886,67,FALSE
shadowsocks-manager,0.6.17,0.6.18,216,1,6,2,8,3,FALSE
shadowsocks-manager,0.6.16,0.6.17,215,4,7,7,14,7,FALSE
shadowsocks-manager,0.3.49,0.3.50,97,6,830,104,934,33,FALSE
shadowsocks-manager,0.6.14,0.6.15,213,1,32,8,40,4,FALSE
shadowsocks-manager,0.1.92,0.1.94,44,7,386,749,1135,23,FALSE
shadowsocks-manager,0.1.7,0.1.8,8,2,100,8,108,8,FALSE
shadowsocks-manager,0.1.94,0.1.95,45,2,16,21,37,4,FALSE
shadowsocks-manager,0.1.95,0.2.0,46,1,6,2,8,3,FALSE
shadowsocks-manager,0.2.7,0.2.8,53,2,26,8,34,6,FALSE
shadowsocks-manager,0.2.6,0.2.7,52,1,6,2,8,3,FALSE
shadowsocks-manager,0.2.5,0.2.6,51,1,14,3,17,5,FALSE
shadowsocks-manager,0.2.4,0.2.5,50,1,5,5,10,5,FALSE
shadowsocks-manager,0.2.3,0.2.4,49,1,24,13,37,3,FALSE
shadowsocks-manager,0.2.1,0.2.3,48,4,41,18,59,10,FALSE
shadowsocks-manager,0.2.0,0.2.1,47,5,53,61,114,11,FALSE
shadowsocks-manager,0.1.0,0.1.1,4,3,261,230,491,26,FALSE
shadowsocks-manager,0.1.1,0.1.2,5,1,6,2,8,3,FALSE
shadowsocks-manager,0.1.2,0.1.6,6,10,173,41,214,38,FALSE
shadowsocks-manager,0.5.33,0.5.37,160,8,91,93,184,85,FALSE
shadowsocks-manager,0.5.32,0.5.33,159,2,103,34,137,19,FALSE
shadowsocks-manager,0.2.9,0.2.10,55,1,22,1,23,3,FALSE
shadowsocks-manager,0.2.8,0.2.9,54,1,11,3,14,3,FALSE
shadowsocks-manager,0.1.65,0.1.73,36,28,831,315,1146,103,FALSE
shadowsocks-manager,0.1.63,0.1.65,35,4,535,11,546,23,FALSE
shadowsocks-manager,0.5.78,0.5.79,191,2,12,12,24,7,FALSE
shadowsocks-manager,0.3.32,0.3.33,83,8,793,140,933,45,FALSE
shadowsocks-manager,0.3.33,0.3.34,84,2,372,133,505,33,FALSE
shadowsocks-manager,0.3.30,0.3.31,81,1,68,19,87,4,FALSE
shadowsocks-manager,0.3.31,0.3.32,82,1,45,18,63,8,FALSE
shadowsocks-manager,0.3.36,0.3.37,86,2,72,16,88,12,FALSE
shadowsocks-manager,0.1.6,0.1.7,7,3,247,24,271,9,FALSE
shadowsocks-manager,0.3.34,0.3.36,85,1,21,17,38,10,FALSE
shadowsocks-manager,0.3.38,0.3.39,88,2,25,1,26,8,FALSE
shadowsocks-manager,0.5.7,0.5.8,144,2,22,21,43,14,FALSE
shadowsocks-manager,0.5.0,0.5.1,140,1,69,17,86,8,FALSE
shadowsocks-manager,0.5.1,0.5.2,141,3,165,107,272,18,FALSE
shadowsocks-manager,0.5.2,0.5.6,142,6,655,327,982,91,FALSE
shadowsocks-manager,0.6.34,0.6.35,231,1,6,2,8,3,FALSE
shadowsocks-manager,0.1.89,0.1.92,43,7,147,87,234,20,FALSE
shadowsocks-manager,0.1.88,0.1.89,42,3,2165,1665,3830,23,FALSE
shadowsocks-manager,0.5.24,0.5.26,154,2,118,39,157,16,FALSE
shadowsocks-manager,0.5.22,0.5.24,153,5,353,37,390,36,FALSE
shadowsocks-manager,0.5.21,0.5.22,152,1,6,6,12,6,FALSE
shadowsocks-manager,0.1.81,0.1.83,38,8,222,48,270,26,FALSE
shadowsocks-manager,0.1.83,0.1.84,39,3,37,5,42,6,FALSE
shadowsocks-manager,0.1.85,0.1.88,41,10,186,83,269,27,FALSE
shadowsocks-manager,0.1.84,0.1.85,40,6,79,58,137,14,FALSE
shadowsocks-manager,0.5.29,0.5.32,158,3,41,24,65,22,FALSE
shadowsocks-manager,0.5.28,0.5.29,157,2,38,348,386,25,FALSE
shadowsocks-manager,0.3.54,0.3.56,102,5,310,43,353,30,FALSE
shadowsocks-manager,0.0.42,0.0.45,1,1,6,2,8,3,TRUE
shadowsocks-manager,0.2.10,0.2.11,56,1,5,2,7,2,FALSE
shadowsocks-manager,0.0.46,0.1.0,3,7,1824,6945,8769,128,FALSE
shadowsocks-manager,0.0.45,0.0.46,2,1,6,2,8,3,FALSE
shadowsocks-manager,0.1.12,0.1.13,11,1,9,1,10,3,FALSE
shadowsocks-manager,0.1.13,0.1.15,12,3,116,176,292,8,FALSE
shadowsocks-manager,0.1.10,0.1.12,10,4,56,25,81,10,FALSE
shadowsocks-manager,0.1.55,0.1.56,33,3,76,26,102,5,FALSE
shadowsocks-manager,0.1.16,0.1.17,14,4,15,5,20,6,FALSE
shadowsocks-manager,0.1.17,0.1.20,15,3,106,61,167,4,FALSE
shadowsocks-manager,0.1.15,0.1.16,13,1,6,10,16,2,FALSE
shadowsocks-manager,0.3.20,0.3.23,74,5,300,120,420,23,FALSE
shadowsocks-manager,0.3.23,0.3.24,75,1,6,2,8,3,FALSE
shadowsocks-manager,0.3.25,0.3.27,77,2,23,4,27,8,FALSE
shadowsocks-manager,0.3.24,0.3.25,76,1,4,2,6,4,FALSE
shadowsocks-manager,0.3.27,0.3.28,78,1,38,5,43,8,FALSE
shadowsocks-manager,0.3.29,0.3.30,80,2,94,26,120,9,FALSE
shadowsocks-manager,0.3.28,0.3.29,79,1,63,25,88,10,FALSE
shadowsocks-manager,0.3.8,0.3.9,67,1,6,2,8,3,FALSE
shadowsocks-manager,0.3.2,0.3.3,61,1,6,2,8,3,FALSE
shadowsocks-manager,0.3.3,0.3.4,62,1,40,22,62,4,FALSE
shadowsocks-manager,0.3.0,0.3.1,59,1,19,3,22,5,FALSE
shadowsocks-manager,0.3.1,0.3.2,60,1,2,13,15,4,FALSE
shadowsocks-manager,0.3.6,0.3.7,65,2,53,7,60,7,FALSE
shadowsocks-manager,0.3.7,0.3.8,66,2,26,11,37,6,FALSE
shadowsocks-manager,0.3.4,0.3.5,63,1,18,18,36,4,FALSE
shadowsocks-manager,0.3.5,0.3.6,64,1,6,2,8,3,FALSE
shadowsocks-manager,0.3.69,0.3.70,114,11,800,412,1212,47,FALSE
shadowsocks-manager,0.5.70,0.5.71,184,1,7,7,14,3,FALSE
shadowsocks-manager,0.2.12,0.3.0,58,2,4127,13,4140,86,FALSE
shadowsocks-manager,0.3.42,0.3.43,91,5,288,187,475,18,TRUE
shadowsocks-manager,0.0.42,0.0.45,1,1,6,2,8,3,FALSE
shadowsocks-manager,0.5.33,0.5.37,160,8,91,93,184,85,TRUE
shadowsocks-manager,0.5.79,0.5.80,192,1,3,8,11,3,TRUE
shadowsocks-manager,0.1.85,0.1.88,41,10,186,83,269,27,TRUE
shadowsocks-manager,0.2.10,0.2.11,56,1,5,2,7,2,TRUE
shadowsocks-manager,0.1.25,0.1.27,20,2,109,289,398,8,TRUE
shadowsocks-manager,0.1.48,0.1.49,30,1,24,2,26,2,TRUE
shadowsocks-manager,0.5.50,0.5.52,167,2,24,26,50,16,TRUE
shadowsocks-manager,0.4.10,0.4.12,136,14,4754,4330,9084,154,TRUE
shadowsocks-manager,0.1.2,0.1.6,6,10,173,41,214,38,TRUE
shadowsocks-manager,0.1.10,0.1.12,10,4,56,25,81,10,TRUE
shadowsocks-manager,0.1.17,0.1.20,15,3,106,61,167,4,TRUE
shadowsocks-manager,0.5.8,0.5.10,145,14,6540,5520,12060,207,TRUE
shadowsocks-manager,0.3.71,0.3.72,116,2,3910,17,3927,53,TRUE
shadowsocks-manager,0.6.20,0.6.21,219,1,10,4,14,5,TRUE
shadowsocks-manager,0.5.1,0.5.2,141,3,165,107,272,18,TRUE
shadowsocks-manager,0.5.26,0.5.27,155,3,52,5,57,5,TRUE
shadowsocks-manager,0.5.55,0.5.58,171,4,74,13904,13978,215,TRUE
shadowsocks-manager,0.6.21,0.6.23,220,4,119,38,157,15,TRUE
shadowsocks-manager,0.5.38,0.5.40,162,7,432,244,676,58,TRUE
shadowsocks-manager,0.5.45,0.5.49,165,4,204,105,309,44,TRUE
shadowsocks-manager,0.1.22,0.1.24,18,9,539,246,785,27,TRUE
shadowsocks-manager,0.1.73,0.1.81,37,18,595,291,886,67,TRUE
shadowsocks-manager,0.2.8,0.2.9,54,1,11,3,14,3,TRUE
shadowsocks-manager,0.4.26,0.5.0,139,9,597,229,826,114,TRUE
shadowsocks-manager,0.6.3,0.6.4,202,1,8,3,11,3,TRUE
shadowsocks-manager,0.5.27,0.5.28,156,2,76,31,107,20,TRUE
shadowsocks-manager,0.3.80,0.3.81,125,8,666,133,799,49,TRUE
shadowsocks-manager,0.5.2,0.5.6,142,6,655,327,982,91,TRUE
shadowsocks-manager,0.1.84,0.1.85,40,6,79,58,137,14,TRUE
shadowsocks-manager,0.1.55,0.1.56,33,3,76,26,102,5,TRUE
shadowsocks-manager,0.1.51,0.1.55,32,8,64,20,84,17,TRUE
shadowsocks-manager,0.1.92,0.1.94,44,7,386,749,1135,23,TRUE
shadowsocks-manager,0.1.88,0.1.89,42,3,2165,1665,3830,23,TRUE
shadowsocks-manager,0.1.29,0.1.32,22,12,137,225,362,21,TRUE
shadowsocks-manager,0.5.15,0.5.16,149,3,124,61,185,25,TRUE
shadowsocks-manager,0.2.1,0.2.3,48,4,41,18,59,10,TRUE
shadowsocks-manager,0.5.7,0.5.8,144,2,22,21,43,14,TRUE
shadowsocks-manager,0.3.67,0.3.69,113,7,453,253,706,33,TRUE
shadowsocks-manager,0.3.7,0.3.8,66,2,26,11,37,6,TRUE
shadowsocks-manager,0.4.6,0.4.7,132,2,120,78,198,18,TRUE
shadowsocks-manager,0.4.8,0.4.9,134,6,829,342,1171,115,TRUE
shadowsocks-manager,0.4.7,0.4.8,133,2,74,10,84,16,TRUE
straylab-ui,0.1.10,0.1.11,11,1,13,13,26,7,FALSE
straylab-ui,0.1.8,0.1.9,9,1,94,12,106,12,FALSE
straylab-ui,0.1.9,0.1.10,10,1,4,4,8,4,FALSE
straylab-ui,0.1.0,0.1.1,1,4,79,6,85,11,FALSE
straylab-ui,0.1.1,0.1.2,2,2,67,15,82,10,FALSE
straylab-ui,0.1.2,0.1.3,3,4,309,52,361,16,FALSE
straylab-ui,0.1.3,0.1.4,4,1,59,9,68,12,FALSE
straylab-ui,0.1.4,0.1.5,5,1,133,42,175,13,FALSE
straylab-ui,0.1.5,0.1.6,6,7,13559,434,13993,30,FALSE
straylab-ui,0.1.6,0.1.7,7,2,110,20,130,13,FALSE
straylab-ui,0.1.7,0.1.8,8,2,49,54,103,11,FALSE
straylab-ui,0.1.3,0.1.4,4,1,59,9,68,12,TRUE
straylab-ui,0.1.19,0.1.20,20,1,14,21,35,12,FALSE
straylab-ui,0.1.16,0.1.17,17,1,48,21,69,8,FALSE
straylab-ui,0.1.17,0.1.18,18,1,41,12,53,5,FALSE
straylab-ui,0.1.14,0.1.15,15,1,10,4,14,5,FALSE
straylab-ui,0.1.15,0.1.16,16,1,30,28,58,5,FALSE
straylab-ui,0.1.18,0.1.19,19,1,79,40,119,10,FALSE
straylab-ui,0.1.12,0.1.13,13,1,26,14,40,6,FALSE
straylab-ui,0.1.13,0.1.14,14,1,191,5,196,11,FALSE
straylab-ui,0.1.11,0.1.12,12,2,97,9,106,5,FALSE
straylab-ui,0.1.17,0.1.18,18,1,41,12,53,5,TRUE
straylab-ui,0.1.11,0.1.12,12,2,97,9,106,5,TRUE
straylab-ui,0.1.19,0.1.20,20,1,14,21,35,12,TRUE
hudson-taylor,5.0.0,5.0.1,26,2,13,10,23,3,FALSE
hudson-taylor,4.0.0,5.0.0,25,3,292,37,329,6,FALSE
hudson-taylor,3.1.0,3.3.0,23,4,652,403,1055,8,FALSE
hudson-taylor,3.0.0,3.1.0,22,1,10,3,13,4,FALSE
hudson-taylor,2.0.0,2.3.0,13,13,2273,228,2501,42,FALSE
hudson-taylor,2.3.0,2.4.0,14,1,97,64,161,6,FALSE
hudson-taylor,3.3.0,4.0.0,24,4,521,155,676,20,FALSE
hudson-taylor,5.2.0,5.3.0,28,8,86,27,113,16,FALSE
hudson-taylor,5.3.0,5.3.1,29,2,12,13,25,4,FALSE
hudson-taylor,5.0.1,5.2.0,27,9,364,50,414,16,FALSE
hudson-taylor,2.4.3,2.4.4,18,2,10,2,12,3,FALSE
hudson-taylor,2.4.2,2.4.3,17,1,2,2,4,2,FALSE
hudson-taylor,2.4.1,2.4.2,16,5,164,37,201,11,FALSE
hudson-taylor,2.4.0,2.4.1,15,5,163,1,164,7,FALSE
hudson-taylor,2.4.6,3.0.0,21,1,9,31,40,5,FALSE
hudson-taylor,2.4.5,2.4.6,20,2,43,39,82,9,FALSE
hudson-taylor,2.4.4,2.4.5,19,2,10,3,13,4,FALSE
hudson-taylor,2.0.0,2.3.0,13,13,2273,228,2501,42,TRUE
hudson-taylor,6.1.2,6.1.3,42,2,41,5,46,6,FALSE
hudson-taylor,6.1.3,6.2.0,43,2,102,3,105,4,FALSE
hudson-taylor,6.2.0,6.3.0,44,7,62,35,97,16,FALSE
hudson-taylor,6.3.4,6.3.5,49,4,54,4,58,7,FALSE
hudson-taylor,6.3.5,6.3.6,50,2,3,1,4,3,FALSE
hudson-taylor,6.3.6,6.4.0,51,14,5695,2581,8276,26,FALSE
hudson-taylor,6.3.0,6.3.1,45,8,90,2852,2942,51,FALSE
hudson-taylor,6.3.1,6.3.2,46,5,601,619,1220,13,FALSE
hudson-taylor,6.3.2,6.3.3,47,2,45,3,48,3,FALSE
hudson-taylor,6.3.3,6.3.4,48,2,2,2,4,2,FALSE
hudson-taylor,6.0.3,6.0.4,35,2,15,7,22,3,FALSE
hudson-taylor,6.0.2,6.0.3,34,3,422,394,816,3,FALSE
hudson-taylor,6.0.1,6.0.2,33,2,8,4,12,3,FALSE
hudson-taylor,6.0.7,6.1.0,39,4,69,27,96,7,FALSE
hudson-taylor,6.0.6,6.0.7,38,2,33,4,37,3,FALSE
hudson-taylor,6.1.1,6.1.2,41,2,10,1,11,4,FALSE
hudson-taylor,6.0.0,6.0.1,32,5,88,147,235,15,FALSE
hudson-taylor,6.0.5,6.0.6,37,2,28,1,29,4,FALSE
hudson-taylor,6.0.4,6.0.5,36,3,76,54,130,7,FALSE
hudson-taylor,5.3.2,6.0.0,31,6,108,361,469,16,FALSE
hudson-taylor,5.3.1,5.3.2,30,4,23,21,44,7,FALSE
hudson-taylor,6.1.0,6.1.1,40,2,105,14,119,4,FALSE
hudson-taylor,0.0.11,0.0.12,10,21,1322,1362,2684,83,FALSE
hudson-taylor,0.0.12,0.0.13,11,24,2745,423,3168,80,FALSE
hudson-taylor,0.0.9,0.0.11,9,3,42,18,60,6,FALSE
hudson-taylor,6.1.2,6.1.3,42,2,41,5,46,6,TRUE
hudson-taylor,6.1.1,6.1.2,41,2,10,1,11,4,TRUE
hudson-taylor,2.4.6,3.0.0,21,1,9,31,40,5,TRUE
hudson-taylor,6.3.1,6.3.2,46,5,601,619,1220,13,TRUE
hudson-taylor,5.0.0,5.0.1,26,2,13,10,23,3,TRUE
hudson-taylor,0.0.5,0.0.6,5,1,1,1,2,1,FALSE
hudson-taylor,0.0.7,0.0.8,7,1,50,6,56,4,FALSE
hudson-taylor,0.0.6,0.0.7,6,1,39,4,43,4,FALSE
hudson-taylor,0.0.3,0.0.4,3,1,2,2,4,1,FALSE
hudson-taylor,0.0.2,0.0.3,2,3,377,38,415,8,FALSE
hudson-taylor,0.0.8,0.0.9,8,3,71,33,104,11,FALSE
hudson-taylor,0.0.4,0.0.5,4,2,17,10,27,4,FALSE
hudson-taylor,2.4.5,2.4.6,20,2,43,39,82,9,TRUE
hudson-taylor,2.4.3,2.4.4,18,2,10,2,12,3,TRUE
jsdoc-to-assert,2.6.1,2.6.2,28,2,21,8,29,4,FALSE
jsdoc-to-assert,2.6.0,2.6.1,27,2,7,9,16,4,FALSE
jsdoc-to-assert,2.6.2,2.7.0,29,2,20,15,35,3,FALSE
jsdoc-to-assert,2.7.0,2.7.1,30,2,10,2,12,3,FALSE
jsdoc-to-assert,2.7.1,2.8.0,31,2,118,92,210,5,FALSE
jsdoc-to-assert,2.5.2,2.5.3,25,2,15,1,16,3,FALSE
jsdoc-to-assert,2.5.3,2.6.0,26,2,81,7,88,4,FALSE
jsdoc-to-assert,1.1.1,1.1.2,3,2,15,1,16,3,FALSE
jsdoc-to-assert,1.1.0,1.1.1,2,2,2,2,4,2,FALSE
jsdoc-to-assert,1.0.1,1.1.0,1,4,37,32,69,15,FALSE
jsdoc-to-assert,1.1.2,2.0.0,4,3,105,90,195,12,FALSE
jsdoc-to-assert,2.0.1,2.0.2,6,2,17,4,21,4,FALSE
jsdoc-to-assert,2.0.0,2.0.1,5,3,39,16,55,5,FALSE
jsdoc-to-assert,2.2.1,2.3.0,14,2,113,45,158,3,FALSE
jsdoc-to-assert,2.2.0,2.2.1,13,2,4,9,13,3,FALSE
jsdoc-to-assert,2.1.2,2.1.3,10,5,7,5,12,5,FALSE
jsdoc-to-assert,2.1.3,2.1.4,11,2,5,5,10,3,FALSE
jsdoc-to-assert,2.1.0,2.1.1,8,2,18,5,23,3,FALSE
jsdoc-to-assert,2.1.1,2.1.2,9,2,45,21,66,3,FALSE
jsdoc-to-assert,2.1.4,2.2.0,12,7,55,13,68,9,FALSE
jsdoc-to-assert,2.0.2,2.1.0,7,3,65,45,110,8,FALSE
jsdoc-to-assert,2.4.5,2.5.0,22,5,173,29,202,10,FALSE
jsdoc-to-assert,2.4.4,2.4.5,21,2,8,6,14,3,FALSE
jsdoc-to-assert,2.3.0,2.3.1,15,2,2,2,4,2,FALSE
jsdoc-to-assert,2.3.1,2.4.0,16,2,22,3,25,2,FALSE
jsdoc-to-assert,2.4.3,2.4.4,20,2,5,5,10,3,FALSE
jsdoc-to-assert,2.4.2,2.4.3,19,2,6,6,12,3,FALSE
jsdoc-to-assert,2.4.1,2.4.2,18,3,4,4,8,3,FALSE
jsdoc-to-assert,2.4.0,2.4.1,17,2,26,4,30,3,FALSE
jsdoc-to-assert,2.5.0,2.5.1,23,4,110,28,138,8,FALSE
jsdoc-to-assert,2.5.1,2.5.2,24,2,7,7,14,3,FALSE
jsdoc-to-assert,2.4.2,2.4.3,19,2,6,6,12,3,TRUE
jsdoc-to-assert,2.1.4,2.2.0,12,7,55,13,68,9,TRUE
jsdoc-to-assert,2.6.0,2.6.1,27,2,7,9,16,4,TRUE
react-custom-render,0.0.5,0.0.6,6,1,21,6,27,2,FALSE
react-custom-render,0.0.4,0.0.5,5,1,62,5,67,4,FALSE
react-custom-render,0.0.3,0.0.4,4,1,2,2,4,1,FALSE
react-custom-render,0.0.1,0.0.2,2,1,2,1,3,1,FALSE
react-custom-render,0.0.0,0.0.1,1,1,17,6,23,4,FALSE
react-custom-render,0.0.2,0.0.3,3,1,3,5,8,1,FALSE
react-custom-render,0.0.3,0.0.4,4,1,2,2,4,1,TRUE
react-custom-render,0.0.0,0.0.1,1,1,17,6,23,4,TRUE
hoctable,0.0.5,0.0.6,5,10,456,109,565,34,FALSE
hoctable,0.0.4,0.0.5,4,7,451,107,558,16,FALSE
hoctable,0.0.7,0.0.8,7,33,1820,429,2249,68,FALSE
hoctable,0.0.6,0.0.7,6,28,1802,557,2359,119,FALSE
hoctable,0.0.1,0.0.2,1,7,308,384,692,26,FALSE
hoctable,0.0.3,0.0.4,3,16,1274,663,1937,57,FALSE
hoctable,0.0.2,0.0.3,2,11,1493,470,1963,130,FALSE
hoctable,0.0.9,0.0.10,9,2,30,20,50,4,FALSE
hoctable,0.0.8,0.0.9,8,2,26,4,30,4,FALSE
hoctable,0.0.11,0.0.12,11,10,105,71,176,15,FALSE
hoctable,0.0.10,0.0.11,10,14,220,94,314,26,FALSE
hoctable,0.0.12,0.0.13,12,17,101,75,176,34,FALSE
hoctable,0.0.7,0.0.8,7,33,1820,429,2249,68,TRUE
hoctable,0.0.10,0.0.11,10,14,220,94,314,26,TRUE
hoctable,0.0.6,0.0.7,6,28,1802,557,2359,119,TRUE
hoctable,0.0.11,0.0.12,11,10,105,71,176,15,TRUE
hoctable,0.0.5,0.0.6,5,10,456,109,565,34,TRUE
hoctable,0.0.4,0.0.5,4,7,451,107,558,16,TRUE
hoctable,0.0.12,0.0.13,12,17,101,75,176,34,TRUE
apeiron,1.0.4,1.0.5,4,5,2460,584,3044,14,FALSE
apeiron,1.0.0,1.0.1,1,4,17,17,34,7,TRUE
apeiron,1.0.1,1.0.2,2,2,6,6,12,3,FALSE
apeiron,1.0.2,1.0.4,3,3,11,10,21,7,FALSE
apeiron,1.0.0,1.0.1,1,4,17,17,34,7,FALSE
ts-pwgen,1.1.1,1.1.2,6,6,177,27,204,20,FALSE
ts-pwgen,1.1.0,1.1.1,5,4,239,5,244,11,FALSE
ts-pwgen,1.1.3,1.1.4,8,2,127,3,130,5,FALSE
ts-pwgen,1.1.2,1.1.3,7,6,118,26,144,15,FALSE
ts-pwgen,1.0.0,1.0.1,1,3,177,1,178,3,FALSE
ts-pwgen,1.0.1,1.0.2,2,8,283,162,445,25,FALSE
ts-pwgen,1.0.2,1.0.3,3,3,116,23,139,10,FALSE
ts-pwgen,1.0.3,1.1.0,4,15,638,338,976,43,FALSE
ts-pwgen,1.1.6,1.1.7,11,3,5,5,10,4,FALSE
ts-pwgen,1.1.5,1.1.6,10,1,7,450,457,8,FALSE
ts-pwgen,1.1.4,1.1.5,9,3,17,2,19,5,FALSE
ts-pwgen,1.1.1,1.1.2,6,6,177,27,204,20,TRUE
ts-pwgen,1.1.0,1.1.1,5,4,239,5,244,11,TRUE
ts-pwgen,1.1.3,1.1.4,8,2,127,3,130,5,TRUE
ts-pwgen,1.0.3,1.1.0,4,15,638,338,976,43,TRUE
ts-pwgen,1.1.5,1.1.6,10,1,7,450,457,8,TRUE
sanji-core-ui,1.0.4,1.0.5,5,4,93,17,110,12,FALSE
sanji-core-ui,1.0.5,1.0.6,6,1,1,1,2,1,FALSE
sanji-core-ui,1.0.6,1.0.7,7,2,2,2,4,2,FALSE
sanji-core-ui,1.0.7,1.0.8,8,2,5,3,8,3,FALSE
sanji-core-ui,1.0.0,1.0.1,2,2,8,1,9,2,FALSE
sanji-core-ui,1.0.1,1.0.2,3,2,11,3,14,4,FALSE
sanji-core-ui,1.0.2,1.0.4,4,4,108,7,115,10,FALSE
sanji-core-ui,3.1.2,3.1.3,132,1,4,4,8,2,FALSE
sanji-core-ui,3.1.9,3.1.10,139,1,7,0,7,1,FALSE
sanji-core-ui,3.1.8,3.1.9,138,1,42,49,91,1,FALSE
sanji-core-ui,1.0.8,1.0.9,9,2,2,2,4,2,FALSE
sanji-core-ui,1.0.9,1.0.10,10,1,97,32,129,4,TRUE
sanji-core-ui,3.1.0,3.1.1,130,1,1,1,2,1,FALSE
sanji-core-ui,3.1.7,3.1.8,137,1,13,7,20,3,FALSE
sanji-core-ui,1.15.22,1.16.0,88,4,30,31,61,13,FALSE
sanji-core-ui,1.15.20,1.15.21,86,3,115,66,181,18,FALSE
sanji-core-ui,1.15.21,1.15.22,87,4,128,84,212,20,FALSE
sanji-core-ui,3.1.5,3.1.6,135,1,2,2,4,1,FALSE
sanji-core-ui,3.1.4,3.1.5,134,1,44,4,48,4,FALSE
sanji-core-ui,1.6.0,1.7.0,34,1,8,0,8,3,FALSE
sanji-core-ui,1.0.10,1.1.0,11,5,92,136,228,13,FALSE
sanji-core-ui,1.12.0,1.12.1,61,2,133167,10,133177,6,FALSE
sanji-core-ui,1.12.1,1.13.0,62,4,226918,84751,311669,18,FALSE
sanji-core-ui,1.10.2,1.10.3,50,3,125560,1193,126753,12,FALSE
sanji-core-ui,1.10.3,1.11.0,51,3,124289,20,124309,10,FALSE
sanji-core-ui,1.10.0,1.10.1,48,3,129862,4027,133889,11,FALSE
sanji-core-ui,1.10.1,1.10.2,49,6,248550,46,248596,20,FALSE
sanji-core-ui,1.16.0,1.16.1,89,4,17,20,37,12,FALSE
sanji-core-ui,1.16.1,1.16.2,90,4,18,15,33,8,FALSE
sanji-core-ui,1.16.2,1.16.3,91,4,25,24,49,10,FALSE
sanji-core-ui,1.16.3,1.17.0,92,3,19,19,38,7,FALSE
sanji-core-ui,3.0.0,3.1.0,129,1,37,23,60,3,FALSE
sanji-core-ui,1.14.0,1.15.0,65,3,253,134159,134412,22,FALSE
sanji-core-ui,1.3.3,1.3.4,21,1,2,1,3,1,FALSE
sanji-core-ui,1.13.1,1.14.0,64,4,135129,330,135459,24,FALSE
sanji-core-ui,1.13.0,1.13.1,63,3,133498,68,133566,13,FALSE
sanji-core-ui,3.1.3,3.1.4,133,1,2,2,4,1,FALSE
sanji-core-ui,1.15.3,1.15.4,69,4,16,5,21,10,FALSE
sanji-core-ui,1.11.3,1.11.4,55,1,4,1,5,1,FALSE
sanji-core-ui,1.11.2,1.11.3,54,5,32,20,52,8,FALSE
sanji-core-ui,1.11.1,1.11.2,53,4,8,8,16,4,FALSE
sanji-core-ui,1.11.0,1.11.1,52,3,17,17,34,3,TRUE
sanji-core-ui,1.11.7,1.11.8,59,1,4,1,5,2,FALSE
sanji-core-ui,1.11.6,1.11.7,58,1,2,2,4,1,FALSE
sanji-core-ui,1.11.5,1.11.6,57,1,1,1,2,1,FALSE
sanji-core-ui,1.11.4,1.11.5,56,1,5,3,8,3,TRUE
sanji-core-ui,1.11.8,1.12.0,60,1,8,8,16,1,FALSE
sanji-core-ui,1.17.5,1.17.6,98,4,38,34,72,7,FALSE
sanji-core-ui,1.17.4,1.17.5,97,3,41,36,77,7,FALSE
sanji-core-ui,1.17.7,1.17.8,100,4,10,25,35,6,FALSE
sanji-core-ui,1.17.6,1.17.7,99,3,27,44,71,6,FALSE
sanji-core-ui,1.17.1,1.17.2,94,3,16,14,30,8,FALSE
sanji-core-ui,1.17.0,1.17.1,93,5,15,11,26,8,FALSE
sanji-core-ui,1.17.3,1.17.4,96,4,96,102,198,14,FALSE
sanji-core-ui,1.17.2,1.17.3,95,4,71,82,153,12,FALSE
sanji-core-ui,1.17.9,1.17.10,102,4,17,7,24,8,FALSE
sanji-core-ui,1.17.8,1.17.9,101,4,12,8,20,8,FALSE
sanji-core-ui,2.0.7,2.0.8,121,3,33,34,67,7,FALSE
sanji-core-ui,2.0.6,2.0.7,120,3,15,261,276,11,FALSE
sanji-core-ui,2.0.5,2.0.6,119,3,269,264,533,15,FALSE
sanji-core-ui,2.0.4,2.0.5,118,3,257,13,270,11,FALSE
sanji-core-ui,2.0.3,2.0.4,117,3,30,7,37,8,FALSE
sanji-core-ui,2.0.2,2.0.3,116,3,31,8,39,8,FALSE
sanji-core-ui,2.0.1,2.0.2,115,3,84,52,136,23,FALSE
sanji-core-ui,2.0.0,2.0.1,114,1,2,2,4,1,FALSE
sanji-core-ui,2.0.9,2.0.10,123,3,21,19,40,6,FALSE
sanji-core-ui,2.0.8,2.0.9,122,3,32,31,63,5,FALSE
sanji-core-ui,3.1.1,3.1.2,131,2,4,43,47,6,FALSE
sanji-core-ui,1.15.7,1.15.8,73,4,18,13,31,8,FALSE
sanji-core-ui,1.15.6,1.15.7,72,3,11,6,17,9,FALSE
sanji-core-ui,1.15.5,1.15.6,71,4,15,7,22,9,FALSE
sanji-core-ui,1.15.4,1.15.5,70,3,12,7,19,8,FALSE
sanji-core-ui,1.17.20,2.0.0,113,5,97,60,157,27,FALSE
sanji-core-ui,1.15.2,1.15.3,68,3,10,4,14,7,FALSE
sanji-core-ui,1.15.1,1.15.2,67,3,17,5,22,5,FALSE
sanji-core-ui,1.15.0,1.15.1,66,4,63,195,258,14,FALSE
sanji-core-ui,1.15.9,1.15.10,75,3,11,8,19,8,FALSE
sanji-core-ui,1.15.8,1.15.9,74,3,16,14,30,8,FALSE
sanji-core-ui,1.9.9,1.10.0,47,3,146932,23971,170903,12,TRUE
sanji-core-ui,1.9.8,1.9.9,46,3,122569,94,122663,12,FALSE
sanji-core-ui,1.9.1,1.9.2,39,1,10,25,35,2,FALSE
sanji-core-ui,1.9.0,1.9.1,38,3,19,16,35,4,FALSE
sanji-core-ui,1.9.3,1.9.4,41,3,122111,4,122115,7,FALSE
sanji-core-ui,1.9.2,1.9.3,40,2,122109,3,122112,6,FALSE
sanji-core-ui,1.9.5,1.9.6,43,3,122112,6,122118,10,FALSE
sanji-core-ui,1.9.4,1.9.5,42,3,122140,30,122170,10,FALSE
sanji-core-ui,1.9.7,1.9.8,45,5,244443,9,244452,15,FALSE
sanji-core-ui,1.9.6,1.9.7,44,3,122152,7,122159,11,FALSE
sanji-core-ui,1.5.0,1.6.0,33,1,11,5,16,2,FALSE
sanji-core-ui,1.15.17,1.15.18,83,4,56,47,103,20,FALSE
sanji-core-ui,1.15.16,1.15.17,82,4,22,12,34,11,FALSE
sanji-core-ui,1.15.15,1.15.16,81,6,31,13,44,14,FALSE
sanji-core-ui,1.3.0,1.3.1,18,1,42,4,46,3,FALSE
sanji-core-ui,1.3.7,1.3.8,25,1,14,5,19,2,FALSE
sanji-core-ui,1.15.12,1.15.13,78,4,15,9,24,11,FALSE
sanji-core-ui,1.3.5,1.3.6,23,1,10,6,16,1,FALSE
sanji-core-ui,1.3.4,1.3.5,22,1,3,2,5,1,FALSE
sanji-core-ui,1.3.9,1.3.10,27,1,3,3,6,1,FALSE
sanji-core-ui,1.3.8,1.3.9,26,1,7,3,10,1,FALSE
sanji-core-ui,1.15.19,1.15.20,85,3,31,6,37,8,FALSE
sanji-core-ui,1.15.18,1.15.19,84,3,72,47,119,18,FALSE
sanji-core-ui,1.17.11,1.17.12,104,3,39,6,45,8,FALSE
sanji-core-ui,1.17.10,1.17.11,103,3,44,6,50,8,FALSE
sanji-core-ui,1.17.13,1.17.14,106,4,32,12,44,11,FALSE
sanji-core-ui,1.17.12,1.17.13,105,4,13,8,21,8,FALSE
sanji-core-ui,1.17.15,1.17.16,108,4,22,13,35,9,FALSE
sanji-core-ui,1.17.14,1.17.15,107,4,40,13,53,10,FALSE
sanji-core-ui,1.17.17,1.17.18,110,5,66,34,100,13,FALSE
sanji-core-ui,1.17.16,1.17.17,109,4,28,22,50,12,FALSE
sanji-core-ui,1.17.19,1.17.20,112,4,22,10,32,8,FALSE
sanji-core-ui,1.17.18,1.17.19,111,3,54,19,73,9,FALSE
sanji-core-ui,3.1.6,3.1.7,136,1,3,0,3,2,FALSE
sanji-core-ui,1.3.2,1.3.3,20,1,2,0,2,2,FALSE
sanji-core-ui,1.1.1,1.1.2,13,1,4,4,8,1,FALSE
sanji-core-ui,1.1.0,1.1.1,12,2,45,26,71,2,FALSE
sanji-core-ui,1.1.3,1.1.4,15,3,170,12,182,4,FALSE
sanji-core-ui,1.1.2,1.1.3,14,4,271,10,281,5,FALSE
sanji-core-ui,1.1.4,1.2.0,16,4,119,115,234,5,FALSE
sanji-core-ui,1.3.10,1.4.0,28,1,15,0,15,3,FALSE
sanji-core-ui,1.8.0,1.8.1,36,1,2,0,2,1,FALSE
sanji-core-ui,1.8.1,1.9.0,37,1,3,0,3,2,FALSE
sanji-core-ui,1.7.0,1.8.0,35,1,5,4,9,1,FALSE
sanji-core-ui,1.4.0,1.4.1,29,1,6,3,9,1,FALSE
sanji-core-ui,1.4.1,1.4.2,30,1,50,2,52,3,FALSE
sanji-core-ui,1.4.2,1.4.3,31,2,19,24,43,2,FALSE
sanji-core-ui,1.4.3,1.5.0,32,2,15,13,28,2,FALSE
sanji-core-ui,1.15.11,1.15.12,77,4,28,13,41,11,FALSE
sanji-core-ui,1.2.0,1.3.0,17,2,28,7,35,7,FALSE
sanji-core-ui,3.1.13,3.1.14,143,1,3,0,3,1,TRUE
sanji-core-ui,3.1.12,3.1.13,142,1,3,1,4,1,FALSE
sanji-core-ui,3.1.11,3.1.12,141,1,3,0,3,1,FALSE
sanji-core-ui,3.1.10,3.1.11,140,1,0,7,7,1,FALSE
sanji-core-ui,3.1.14,3.1.15,144,1,1,0,1,1,FALSE
sanji-core-ui,1.3.1,1.3.2,19,1,32,25,57,1,FALSE
sanji-core-ui,1.15.10,1.15.11,76,4,28,13,41,11,FALSE
sanji-core-ui,1.15.14,1.15.15,80,3,24,10,34,10,FALSE
sanji-core-ui,1.3.6,1.3.7,24,2,5,0,5,3,FALSE
sanji-core-ui,1.15.13,1.15.14,79,3,15,9,24,9,FALSE
sanji-core-ui,2.0.14,3.0.0,128,1,3,6,9,2,FALSE
sanji-core-ui,2.0.13,2.0.14,127,4,195,91,286,12,FALSE
sanji-core-ui,2.0.12,2.0.13,126,5,298,176,474,14,FALSE
sanji-core-ui,2.0.11,2.0.12,125,3,10,9,19,7,FALSE
sanji-core-ui,2.0.10,2.0.11,124,4,25,23,48,8,FALSE
sanji-core-ui,1.11.0,1.11.1,52,3,17,17,34,3,FALSE
sanji-core-ui,1.11.4,1.11.5,56,1,5,3,8,3,FALSE
sanji-core-ui,1.9.9,1.10.0,47,3,146932,23971,170903,12,FALSE
sanji-core-ui,3.1.13,3.1.14,143,1,3,0,3,1,FALSE
sanji-core-ui,1.0.9,1.0.10,10,1,97,32,129,4,FALSE
sanji-core-ui,1.11.3,1.11.4,55,1,4,1,5,1,TRUE
sanji-core-ui,1.11.1,1.11.2,53,4,8,8,16,4,TRUE
sanji-core-ui,1.0.6,1.0.7,7,2,2,2,4,2,TRUE
sanji-core-ui,1.15.4,1.15.5,70,3,12,7,19,8,TRUE
sanji-core-ui,1.0.0,1.0.1,2,2,8,1,9,2,TRUE
sanji-core-ui,1.6.0,1.7.0,34,1,8,0,8,3,TRUE
sanji-core-ui,1.9.0,1.9.1,38,3,19,16,35,4,TRUE
sanji-core-ui,1.15.19,1.15.20,85,3,31,6,37,8,TRUE
sanji-core-ui,3.1.11,3.1.12,141,1,3,0,3,1,TRUE
sanji-core-ui,1.0.4,1.0.5,5,4,93,17,110,12,TRUE
sanji-core-ui,1.17.17,1.17.18,110,5,66,34,100,13,TRUE
sanji-core-ui,1.17.19,1.17.20,112,4,22,10,32,8,TRUE
sanji-core-ui,1.4.1,1.4.2,30,1,50,2,52,3,TRUE
sanji-core-ui,1.17.1,1.17.2,94,3,16,14,30,8,TRUE
sanji-core-ui,1.1.3,1.1.4,15,3,170,12,182,4,TRUE
sanji-core-ui,2.0.11,2.0.12,125,3,10,9,19,7,TRUE
sanji-core-ui,2.0.1,2.0.2,115,3,84,52,136,23,TRUE
sanji-core-ui,1.15.21,1.15.22,87,4,128,84,212,20,TRUE
sanji-core-ui,1.7.0,1.8.0,35,1,5,4,9,1,TRUE
sanji-core-ui,1.17.10,1.17.11,103,3,44,6,50,8,TRUE
sanji-core-ui,3.1.2,3.1.3,132,1,4,4,8,2,TRUE
sanji-core-ui,2.0.4,2.0.5,118,3,257,13,270,11,TRUE
sanji-core-ui,1.3.0,1.3.1,18,1,42,4,46,3,TRUE
sanji-core-ui,1.12.0,1.12.1,61,2,133167,10,133177,6,TRUE
sanji-core-ui,2.0.5,2.0.6,119,3,269,264,533,15,TRUE
sanji-core-ui,1.4.3,1.5.0,32,2,15,13,28,2,TRUE
sanji-core-ui,1.10.1,1.10.2,49,6,248550,46,248596,20,TRUE
sanji-core-ui,1.5.0,1.6.0,33,1,11,5,16,2,TRUE
sanji-core-ui,1.1.4,1.2.0,16,4,119,115,234,5,TRUE
sanji-core-ui,3.1.3,3.1.4,133,1,2,2,4,1,TRUE
sanji-core-ui,1.17.4,1.17.5,97,3,41,36,77,7,TRUE
sanji-core-ui,3.1.7,3.1.8,137,1,13,7,20,3,TRUE
sanji-core-ui,1.17.2,1.17.3,95,4,71,82,153,12,TRUE
pully,1.1.0,1.2.0,5,12,1321,1087,2408,47,FALSE
pully,1.0.0,1.0.1,1,2,82,21,103,5,FALSE
pully,1.0.1,1.0.2,2,1,3,1,4,1,FALSE
pully,1.0.2,1.0.3,3,1,7,3,10,2,FALSE
pully,1.0.3,1.1.0,4,7,3812,449,4261,35,FALSE
pully,1.2.2,1.2.3,8,2,20,9,29,4,FALSE
pully,1.2.3,1.2.5,9,3,3,3,6,3,FALSE
pully,1.2.0,1.2.1,6,6,19,7,26,10,FALSE
pully,1.2.1,1.2.2,7,2,22,5,27,4,FALSE
pully,2.0.1,2.1.0,13,10,401,180,581,28,FALSE
pully,2.0.0,2.0.1,12,3,7,3,10,3,FALSE
pully,2.0.0-beta.0,2.0.0,11,2,178,132,310,4,FALSE
pully,2.1.2,2.1.3,16,2,2,1,3,2,FALSE
pully,2.1.3,2.1.4,17,4,14,10,24,4,FALSE
pully,2.1.0,2.1.1,14,4,177,16,193,7,FALSE
pully,2.1.1,2.1.2,15,2,14,5,19,3,FALSE
pully,1.2.5,2.0.0-beta.0,10,12,6035,5070,11105,114,FALSE
pully,2.0.1,2.1.0,13,10,401,180,581,28,TRUE
pully,2.1.2,2.1.3,16,2,2,1,3,2,TRUE
pully,2.1.3,2.1.4,17,4,14,10,24,4,TRUE
pully,2.1.0,2.1.1,14,4,177,16,193,7,TRUE
pully,2.1.1,2.1.2,15,2,14,5,19,3,TRUE
koa-bouncer,3.1.0,3.2.0,25,6,733,6,739,10,FALSE
koa-bouncer,1.0.0,1.0.1,21,1,7,5,12,2,FALSE
koa-bouncer,1.0.1,2.0.0,22,4,263,127,390,10,FALSE
koa-bouncer,3.0.0,3.1.0,24,9,428,115,543,12,FALSE
koa-bouncer,2.0.0,3.0.0,23,2,242,78,320,3,FALSE
koa-bouncer,0.0.15,0.0.16,15,1,2,2,4,2,FALSE
koa-bouncer,0.0.14,0.0.15,14,1,12,1,13,2,FALSE
koa-bouncer,0.0.17,0.0.18,17,1,16,5,21,2,FALSE
koa-bouncer,0.0.16,0.0.17,16,1,12,3,15,2,FALSE
koa-bouncer,0.0.11,0.0.12,11,1,10,1,11,2,FALSE
koa-bouncer,0.0.10,0.0.11,10,4,21,8,29,4,FALSE
koa-bouncer,0.0.13,0.0.14,13,4,15,7,22,4,FALSE
koa-bouncer,0.0.12,0.0.13,12,1,3,3,6,2,FALSE
koa-bouncer,0.0.19,0.0.20,19,1,4,3,7,2,FALSE
koa-bouncer,0.0.18,0.0.19,18,1,5,2,7,2,FALSE
koa-bouncer,4.0.1,4.0.2,29,1,2,2,4,2,FALSE
koa-bouncer,0.0.4,0.0.5,4,1,7,1,8,2,FALSE
koa-bouncer,0.0.7,0.0.8,7,2,5,2,7,2,FALSE
koa-bouncer,0.0.6,0.0.7,6,5,22,4,26,5,FALSE
koa-bouncer,4.1.0,4.2.0,31,2,66,5,71,3,FALSE
koa-bouncer,0.0.3,0.0.4,3,3,12,1,13,3,FALSE
koa-bouncer,0.0.2,0.0.3,2,2,94,202,296,6,FALSE
koa-bouncer,0.0.9,0.0.10,9,1,2,2,4,2,FALSE
koa-bouncer,0.0.8,0.0.9,8,3,23,8,31,3,FALSE
koa-bouncer,0.0.5,0.0.6,5,1,18,1,19,2,FALSE
koa-bouncer,4.0.0,4.0.1,28,3,41,13,54,4,FALSE
koa-bouncer,0.0.20,1.0.0,20,8,1410,122,1532,13,FALSE
koa-bouncer,4.0.2,4.1.0,30,5,108,3,111,7,FALSE
koa-bouncer,0.0.1,0.0.2,1,1,2,2,4,2,FALSE
koa-bouncer,5.0.0,5.0.1,33,2,5,5,10,3,FALSE
koa-bouncer,5.0.1,5.1.0,34,6,1373,13,1386,11,FALSE
koa-bouncer,5.1.0,6.0.0,35,1,2,2,4,2,FALSE
koa-bouncer,3.3.0,4.0.0,27,11,221,70,291,18,FALSE
koa-bouncer,4.2.0,5.0.0,32,1,83,7,90,4,FALSE
koa-bouncer,3.2.0,3.3.0,26,7,354,275,629,11,FALSE
koa-bouncer,0.0.4,0.0.5,4,1,7,1,8,2,TRUE
koa-bouncer,4.1.0,4.2.0,31,2,66,5,71,3,TRUE
provide-user,1.0.0-rc.12,1.0.0-rc.13,12,2,4,4,8,2,FALSE
provide-user,1.0.0-rc.11,1.0.0-rc.12,11,3,190,342,532,7,FALSE
provide-user,1.0.0-rc.10,1.0.0-rc.11,10,2,10,5,15,3,FALSE
provide-user,1.0.0-rc.7,1.0.0-rc.8,7,1,2,2,4,2,FALSE
provide-user,1.0.0-rc.6,1.0.0-rc.7,6,2,79,66,145,3,FALSE
provide-user,1.0.0-rc.5,1.0.0-rc.6,5,2,3,3,6,2,FALSE
provide-user,1.0.0-rc.4,1.0.0-rc.5,4,2,38,3,41,2,FALSE
provide-user,1.0.0-rc.3,1.0.0-rc.4,3,2,2,2,4,2,FALSE
provide-user,1.0.0-rc.2,1.0.0-rc.3,2,2,10,6,16,2,FALSE
provide-user,1.0.0-rc.1,1.0.0-rc.2,1,2,9,12,21,2,FALSE
provide-user,1.0.0-rc.9,1.0.0-rc.10,9,1,2,2,4,2,FALSE
provide-user,1.0.0-rc.8,1.0.0-rc.9,8,1,1,1,2,1,FALSE
provide-user,1.0.0-rc.7,1.0.0-rc.8,7,1,2,2,4,2,TRUE
light-tts,1.2.2,1.2.3,3,1,118,83,201,3,TRUE
light-tts,1.2.0,1.2.1,1,2,2,2,4,2,FALSE
light-tts,1.2.1,1.2.2,2,1,14,7,21,3,FALSE
react-loopback,0.3.0,0.3.1,4,2,32,6,38,3,FALSE
react-loopback,0.3.1,0.4.0,5,2,57,10,67,4,FALSE
react-loopback,0.2.1,0.3.0,3,3,97,25,122,5,FALSE
react-loopback,0.2.0,0.2.1,2,2,3,3,6,2,FALSE
react-loopback,0.1.0,0.2.0,1,4,272,42,314,8,FALSE
react-loopback,0.2.0,0.2.1,2,2,3,3,6,2,TRUE
react-loopback,0.2.1,0.3.0,3,3,97,25,122,5,TRUE
react-d3-components,0.4.1,0.4.2,14,2,287,103,390,7,FALSE
react-d3-components,0.3.2,0.3.3,8,2,85,38,123,7,FALSE
react-d3-components,0.3.3,0.3.4,9,3,431,194,625,16,FALSE
react-d3-components,0.3.0,0.3.1,6,1,37,16,53,2,FALSE
react-d3-components,0.3.1,0.3.2,7,1,3,2,5,1,FALSE
react-d3-components,0.3.6,0.3.7,12,4,1325,84,1409,18,FALSE
react-d3-components,0.3.7,0.4.1,13,3,10,8,18,6,FALSE
react-d3-components,0.3.4,0.3.5,10,5,1328,1069,2397,31,FALSE
react-d3-components,0.3.5,0.3.6,11,1,5,5,10,4,FALSE
react-d3-components,0.2.3,0.3.0,5,6,1762,302,2064,45,FALSE
react-d3-components,0.2.2,0.2.3,4,2,7,13,20,2,FALSE
react-d3-components,0.2.1,0.2.2,3,12,693,581,1274,32,FALSE
react-d3-components,0.2.0,0.2.1,2,3,2663,29112,31775,41,FALSE
react-d3-components,0.1.0,0.2.0,1,9,921,547,1468,49,FALSE
react-d3-components,0.4.3,0.4.4,16,7,577,4643,5220,77,FALSE
react-d3-components,0.4.2,0.4.3,15,3,2251,2249,4500,7,FALSE
react-d3-components,0.4.5,0.4.6,18,6,191,80,271,28,FALSE
react-d3-components,0.4.4,0.4.5,17,2,16,13,29,7,FALSE
react-d3-components,0.4.7,0.4.8,20,1,7,6,13,7,FALSE
react-d3-components,0.4.6,0.4.7,19,3,40,39,79,7,FALSE
react-d3-components,0.6.0,0.6.1,25,9,2104,292,2396,33,FALSE
react-d3-components,0.6.3,0.6.4,28,3,8,7,15,4,FALSE
react-d3-components,0.6.5,0.6.6,30,5,75,81,156,19,FALSE
react-d3-components,0.6.4,0.6.5,29,19,4761,4594,9355,86,FALSE
react-d3-components,0.4.8,0.5.0,21,22,4583,4124,8707,98,FALSE
react-d3-components,0.5.1,0.5.2,23,1,9,4,13,5,FALSE
react-d3-components,0.5.2,0.6.0,24,31,1158,445,1603,111,FALSE
react-d3-components,0.5.0,0.5.1,22,1,149,144,293,5,FALSE
react-d3-components,0.6.2,0.6.3,27,3,12,5,17,4,FALSE
react-d3-components,0.6.1,0.6.2,26,3,1382,2257,3639,14,FALSE
react-d3-components,0.6.0,0.6.1,25,9,2104,292,2396,33,TRUE
react-d3-components,0.5.2,0.6.0,24,31,1158,445,1603,111,TRUE
react-d3-components,0.3.6,0.3.7,12,4,1325,84,1409,18,TRUE
react-d3-components,0.4.7,0.4.8,20,1,7,6,13,7,TRUE
lynchburg,2.0.1,2.1.0,2,4,128,102,230,9,FALSE
lynchburg,2.0.0,2.0.1,1,4,4,4,8,4,FALSE
lynchburg,2.1.2,2.1.3,5,5,53,33,86,10,FALSE
lynchburg,2.1.3,2.1.4,6,4,10,28,38,8,FALSE
lynchburg,2.1.0,2.1.1,3,8,182,120,302,9,FALSE
lynchburg,2.1.1,2.1.2,4,1,2,2,4,1,FALSE
lynchburg,2.1.4,2.1.5,7,2,4,4,8,4,FALSE
lynchburg,2.1.5,2.1.6,8,3,14,3,17,3,FALSE
lynchburg,2.0.1,2.1.0,2,4,128,102,230,9,TRUE
lynchburg,2.0.0,2.0.1,1,4,4,4,8,4,TRUE
lynchburg,2.1.5,2.1.6,8,3,14,3,17,3,TRUE
react-modular-ui,0.3.1,0.3.2,15,1,620,4,624,7,FALSE
react-modular-ui,0.3.6,0.4.0,20,1,208,1,209,12,FALSE
react-modular-ui,0.1.8,0.1.9,9,1,133,2,135,5,FALSE
react-modular-ui,0.1.9,0.2.0,10,2,679,295,974,31,FALSE
react-modular-ui,0.2.2,0.3.0,13,1,972,40,1012,19,FALSE
react-modular-ui,0.2.1,0.2.2,12,1,107,408,515,6,FALSE
react-modular-ui,0.2.0,0.2.1,11,1,58,4,62,5,FALSE
react-modular-ui,0.1.0,0.1.1,1,1,31,1871,1902,20,FALSE
react-modular-ui,0.1.1,0.1.2,2,1,900,6,906,14,FALSE
react-modular-ui,0.1.2,0.1.3,3,3,92,4,96,5,FALSE
react-modular-ui,0.1.3,0.1.4,4,1,22,18,40,4,FALSE
react-modular-ui,0.1.4,0.1.5,5,1,11,2,13,3,FALSE
react-modular-ui,0.1.5,0.1.6,6,1,114,5,119,5,FALSE
react-modular-ui,0.1.6,0.1.7,7,1,452,191,643,12,FALSE
react-modular-ui,0.1.7,0.1.8,8,1,118,1,119,6,FALSE
react-modular-ui,0.10.1,0.10.2,48,1,42,3,45,4,FALSE
react-modular-ui,0.10.0,0.10.1,47,2,33,6,39,6,FALSE
react-modular-ui,0.6.9,0.6.10,33,1,1,4,5,4,FALSE
react-modular-ui,0.10.2,0.10.3,49,2,7,5,12,4,FALSE
react-modular-ui,0.10.5,0.10.6,52,1,12,6,18,5,FALSE
react-modular-ui,0.10.4,0.10.5,51,1,6,6,12,5,FALSE
react-modular-ui,0.10.6,0.10.7,53,1,11,1,12,3,FALSE
react-modular-ui,0.3.2,0.3.3,16,2,152,2,154,3,FALSE
react-modular-ui,0.3.3,0.3.4,17,1,39,7,46,4,FALSE
react-modular-ui,0.3.0,0.3.1,14,1,16,6,22,4,FALSE
react-modular-ui,0.6.0,0.6.1,24,1,39,1,40,4,FALSE
react-modular-ui,0.6.7,0.6.8,31,2,139,2,141,5,FALSE
react-modular-ui,0.6.6,0.6.7,30,1,25,4,29,6,FALSE
react-modular-ui,0.3.4,0.3.5,18,1,75,23,98,5,FALSE
react-modular-ui,0.3.5,0.3.6,19,1,3,3,6,3,FALSE
react-modular-ui,0.4.1,0.5.0,22,1,252,10,262,14,FALSE
react-modular-ui,0.4.0,0.4.1,21,1,158,4,162,6,FALSE
react-modular-ui,0.7.2,0.8.0,37,6,27298,2123,29421,117,FALSE
react-modular-ui,0.5.0,0.6.0,23,1,294,1,295,21,FALSE
react-modular-ui,0.9.0,0.9.1,41,1,195,55,250,11,FALSE
react-modular-ui,0.9.1,0.9.2,42,1,19,35,54,7,FALSE
react-modular-ui,0.9.2,0.9.3,43,1,73,86,159,11,FALSE
react-modular-ui,0.9.3,0.9.4,44,1,11,11,22,7,FALSE
react-modular-ui,0.9.4,0.9.5,45,2,6,6,12,5,FALSE
react-modular-ui,0.9.5,0.10.0,46,4,1149,266,1415,51,FALSE
react-modular-ui,0.8.1,0.8.2,39,2,3,3,6,3,FALSE
react-modular-ui,0.10.3,0.10.4,50,1,9,6,15,5,FALSE
react-modular-ui,0.8.0,0.8.1,38,1,3,3,6,3,FALSE
react-modular-ui,0.6.5,0.6.6,29,1,20,20,40,10,FALSE
react-modular-ui,0.6.8,0.6.9,32,1,39,45,84,7,FALSE
react-modular-ui,0.8.2,0.9.0,40,1,493,18,511,19,FALSE
react-modular-ui,0.6.4,0.6.5,28,1,4,4,8,4,FALSE
react-modular-ui,0.7.0,0.7.1,35,1,25,11,36,5,FALSE
react-modular-ui,0.6.3,0.6.4,27,1,5,5,10,3,FALSE
react-modular-ui,0.6.2,0.6.3,26,1,43,85,128,7,FALSE
react-modular-ui,0.7.1,0.7.2,36,1,20,4,24,4,FALSE
react-modular-ui,0.6.10,0.7.0,34,7,2778,576,3354,95,FALSE
react-modular-ui,0.6.1,0.6.2,25,1,102,70,172,8,TRUE
react-modular-ui,0.9.5,0.10.0,46,4,1149,266,1415,51,TRUE
react-modular-ui,0.6.1,0.6.2,25,1,102,70,172,8,FALSE
react-modular-ui,0.9.3,0.9.4,44,1,11,11,22,7,TRUE
amelisa,0.1.8,0.1.9,10,6,1224,1430,2654,33,FALSE
amelisa,0.1.9,0.1.10,11,7,113,69,182,18,FALSE
amelisa,0.1.5,0.1.6,7,12,538,211,749,40,FALSE
amelisa,0.1.6,0.1.7,8,11,1227,1266,2493,145,FALSE
amelisa,0.1.7,0.1.8,9,9,72,94,166,22,FALSE
amelisa,0.1.28,0.1.33,29,10,52,16,68,12,FALSE
amelisa,0.1.23,0.1.24,25,4,272,184,456,25,FALSE
amelisa,0.1.22,0.1.23,24,4,79,2638,2717,61,FALSE
amelisa,0.1.21,0.1.22,23,8,1482,579,2061,132,FALSE
amelisa,0.1.20,0.1.21,22,9,178,79,257,14,FALSE
amelisa,0.1.27,0.1.28,28,3,116,5,121,6,TRUE
amelisa,0.1.25,0.1.27,27,9,685,230,915,40,FALSE
amelisa,0.1.24,0.1.25,26,3,11,7,18,3,FALSE
amelisa,0.1.12,0.1.13,14,16,2942,2032,4974,74,FALSE
amelisa,0.1.13,0.1.14,15,17,2126,720,2846,59,FALSE
amelisa,0.1.10,0.1.11,12,2,2,2,4,2,FALSE
amelisa,0.1.11,0.1.12,13,13,2138,499,2637,63,FALSE
amelisa,0.1.16,0.1.17,18,11,546,176,722,37,FALSE
amelisa,0.1.17,0.1.18,19,8,144,102,246,18,FALSE
amelisa,0.1.14,0.1.15,16,16,218,431,649,65,FALSE
amelisa,0.1.15,0.1.16,17,19,957,618,1575,115,FALSE
amelisa,0.1.34,0.1.35,31,3,12,4,16,4,FALSE
amelisa,0.1.18,0.1.19,20,7,412,241,653,30,FALSE
amelisa,0.1.19,0.1.20,21,8,266,159,425,28,FALSE
amelisa,0.1.33,0.1.34,30,2,5,1,6,2,FALSE
amelisa,0.1.0,0.1.1,2,2,3,1,4,2,FALSE
amelisa,0.1.1,0.1.2,3,7,313,223,536,33,FALSE
amelisa,0.1.2,0.1.3,4,10,430,365,795,36,FALSE
amelisa,0.1.3,0.1.4,5,14,648,381,1029,34,FALSE
amelisa,0.1.4,0.1.5,6,5,480,147,627,46,FALSE
amelisa,0.1.27,0.1.28,28,3,116,5,121,6,FALSE
amelisa,0.1.12,0.1.13,14,16,2942,2032,4974,74,TRUE
amelisa,0.1.17,0.1.18,19,8,144,102,246,18,TRUE
amelisa,0.1.14,0.1.15,16,16,218,431,649,65,TRUE
amelisa,0.1.13,0.1.14,15,17,2126,720,2846,59,TRUE
amelisa,0.1.5,0.1.6,7,12,538,211,749,40,TRUE
amelisa,0.1.6,0.1.7,8,11,1227,1266,2493,145,TRUE
amelisa,0.1.7,0.1.8,9,9,72,94,166,22,TRUE
amelisa,0.1.11,0.1.12,13,13,2138,499,2637,63,TRUE
amelisa,0.1.3,0.1.4,5,14,648,381,1029,34,TRUE
amelisa,0.1.1,0.1.2,3,7,313,223,536,33,TRUE
amelisa,0.1.4,0.1.5,6,5,480,147,627,46,TRUE
amelisa,0.1.2,0.1.3,4,10,430,365,795,36,TRUE
teasim-presets,1.0.2,1.0.3,1,1,72,83,155,9,FALSE
teasim-presets,1.1.1,1.1.2,4,1,72,83,155,9,FALSE
teasim-presets,1.1.2,1.1.4,5,1,72,83,155,9,FALSE
teasim-presets,1.1.5,2.0.0-alpha.0,7,8,55116,12112,67228,433,FALSE
teasim-presets,1.1.4,1.1.5,6,1,72,83,155,9,FALSE
teasim-presets,1.0.3,1.0.9,2,1,72,83,155,9,FALSE
teasim-presets,1.0.9,1.1.1,3,1,72,83,155,9,FALSE
teasim-presets,1.0.2,1.0.3,1,1,72,83,155,9,TRUE
teasim-presets,1.1.4,1.1.5,6,1,72,83,155,9,TRUE
ember-route-layers,1.0.4,2.0.0,5,3,5,5,10,5,FALSE
ember-route-layers,1.0.0,1.0.1,1,1,12,1,13,3,FALSE
ember-route-layers,1.0.1,1.0.2,2,1,2,2,4,2,FALSE
ember-route-layers,1.0.2,1.0.3,3,1,31,20,51,2,FALSE
ember-route-layers,2.0.0,2.2.0,6,3,8,8,16,4,FALSE
ember-route-layers,2.3.0,2.4.0,8,8,849,266,1115,91,FALSE
ember-route-layers,1.0.3,1.0.4,4,1,37,44,81,4,FALSE
ember-route-layers,2.2.0,2.3.0,7,1,6,2,8,3,FALSE
ember-route-layers,2.4.3,2.5.0,12,5,106,8,114,25,FALSE
ember-route-layers,2.4.2,2.4.3,11,2,2,2,4,2,FALSE
ember-route-layers,2.4.1,2.4.2,10,3,19,2,21,6,FALSE
ember-route-layers,2.4.0,2.4.1,9,17,263,47,310,47,FALSE
ember-route-layers,2.5.2,2.5.3,15,3,24,22,46,3,FALSE
ember-route-layers,2.5.0,2.5.1,13,1,1,1,2,1,FALSE
ember-route-layers,2.5.1,2.5.2,14,3,14,13,27,7,FALSE
ember-route-layers,2.4.2,2.4.3,11,2,2,2,4,2,TRUE
steam-inventory,1.0.4,1.0.5,5,1,10,11,21,2,FALSE
steam-inventory,1.0.0,1.0.1,1,1,10,11,21,2,FALSE
steam-inventory,1.0.1,1.0.2,2,1,10,11,21,2,FALSE
steam-inventory,1.0.2,1.0.3,3,3,25,11,36,4,FALSE
steam-inventory,1.0.3,1.0.4,4,1,2,1,3,1,TRUE
vue-framework7,0.0.5,0.0.6,5,1,9,9,18,4,FALSE
vue-framework7,0.0.4,0.0.5,4,1,9,9,18,4,FALSE
vue-framework7,0.0.7,0.0.8,7,1,9,9,18,4,FALSE
vue-framework7,0.0.6,0.0.7,6,1,9,9,18,4,FALSE
vue-framework7,0.0.9,0.0.10,9,1,9,9,18,4,FALSE
vue-framework7,0.0.8,0.0.9,8,1,9,9,18,4,FALSE
vue-framework7,0.0.14,0.0.15,14,1,9,9,18,4,FALSE
vue-framework7,0.0.11,0.0.12,11,1,9,9,18,4,FALSE
vue-framework7,0.0.10,0.0.11,10,1,9,9,18,4,FALSE
vue-framework7,0.0.13,0.0.14,13,1,9,9,18,4,FALSE
vue-framework7,0.0.12,0.0.13,12,1,9,9,18,4,FALSE
vue-framework7,0.0.1,0.0.2,1,1,9,9,18,4,FALSE
vue-framework7,0.0.3,0.0.4,3,1,9,9,18,4,FALSE
vue-framework7,0.0.2,0.0.3,2,1,9,9,18,4,FALSE
vue-framework7,0.0.15,0.1.0,15,1,9,9,18,4,FALSE
vue-framework7,0.2.1,0.2.2,19,1,9,9,18,4,FALSE
vue-framework7,0.2.0,0.2.1,18,1,9,9,18,4,FALSE
vue-framework7,0.1.0,0.1.1,16,1,9,9,18,4,FALSE
vue-framework7,0.1.1,0.2.0,17,1,9,9,18,4,FALSE
vue-framework7,0.3.0,0.4.0,21,1,9,9,18,4,FALSE
vue-framework7,0.2.2,0.3.0,20,1,9,9,18,4,FALSE
vue-framework7,0.5.0-alpha.1,0.5.0-alpha.2,23,4,63,50,113,5,FALSE
vue-framework7,0.5.0-alpha.3,0.5.0-alpha.4,25,1,2,2,4,2,FALSE
vue-framework7,0.5.0-alpha.2,0.5.0-alpha.3,24,8,5912,42,5954,51,FALSE
vue-framework7,0.5.0-alpha.4,0.5.0,26,9,612,302,914,22,FALSE
vue-framework7,0.4.0,0.5.0-alpha.1,22,3,3646,34,3680,36,FALSE
vue-framework7,0.5.0,0.5.1,27,1,4,4,8,2,FALSE
vue-framework7,0.0.3,0.0.4,3,1,9,9,18,4,TRUE
vue-framework7,0.0.6,0.0.7,6,1,9,9,18,4,TRUE
vue-framework7,0.0.11,0.0.12,11,1,9,9,18,4,TRUE
vue-framework7,0.1.0,0.1.1,16,1,9,9,18,4,TRUE
vue-framework7,0.5.0-alpha.1,0.5.0-alpha.2,23,4,63,50,113,5,TRUE
vue-framework7,0.5.0-alpha.2,0.5.0-alpha.3,24,8,5912,42,5954,51,TRUE
basic-streams,0.1.10,0.1.11,10,5,353,35,388,14,FALSE
basic-streams,0.1.11,0.2.0,11,4,200,408,608,5,FALSE
basic-streams,0.3.2,0.3.3,15,3,51,4,55,8,FALSE
basic-streams,0.3.3,0.4.0,16,5,45,28,73,9,FALSE
basic-streams,0.3.0,0.3.1,13,7,226,19,245,13,FALSE
basic-streams,0.3.1,0.3.2,14,3,54,35,89,5,FALSE
basic-streams,0.1.5,0.1.6,6,4,202,71,273,4,FALSE
basic-streams,0.1.9,0.1.10,9,5,68,55,123,6,FALSE
basic-streams,0.1.7,0.1.9,8,5,273,19,292,11,FALSE
basic-streams,0.1.3,0.1.4,4,5,272,41,313,19,FALSE
basic-streams,0.2.0,0.3.0,12,3,85,27,112,9,FALSE
basic-streams,0.1.0,0.1.1,1,2,15,3,18,3,FALSE
basic-streams,0.1.1,0.1.2,2,3,14,3,17,3,FALSE
basic-streams,0.1.2,0.1.3,3,9,184,42,226,11,FALSE
basic-streams,0.1.4,0.1.5,5,12,152,41,193,19,FALSE
basic-streams,0.4.0,0.4.1,17,4,106,5,111,5,FALSE
basic-streams,0.1.6,0.1.7,7,6,134,27,161,10,FALSE
basic-streams,0.4.1,0.4.2,18,13,249,119,368,29,FALSE
basic-streams,0.4.3,0.4.4,20,2,101,119,220,7,FALSE
basic-streams,0.4.2,0.4.3,19,16,1175,1375,2550,47,FALSE
basic-streams,0.1.9,0.1.10,9,5,68,55,123,6,TRUE
generator-buildpack,0.0.5,0.0.6,4,4,381,321,702,42,FALSE
generator-buildpack,0.0.4,0.0.5,3,3,279,223,502,34,FALSE
generator-buildpack,0.0.1,0.0.3,1,5,18,8,26,5,FALSE
generator-buildpack,0.0.3,0.0.4,2,4,32,29,61,8,FALSE
generator-buildpack,0.0.4,0.0.5,3,3,279,223,502,34,TRUE
ne-rc,0.2.0-rc,0.2.0-rc.1,14,1,12,16,28,4,FALSE
ne-rc,0.1.7,0.1.8,6,3,23,17,40,5,FALSE
ne-rc,0.6.1-beta.8,0.6.1-beta.9,28,1,2,1,3,2,FALSE
ne-rc,0.2.0-beta.2,0.2.0-beta.3,11,2,3,4,7,3,FALSE
ne-rc,0.2.0-beta.3,0.2.0-beta.4,12,9,227,215,442,139,FALSE
ne-rc,0.1.1,0.1.2,1,2,54,16,70,4,FALSE
ne-rc,0.2.0-beta.1,0.2.0-beta.2,10,1,1,52291,52292,4,FALSE
ne-rc,0.1.3,0.1.4,3,1,1,52291,52292,4,FALSE
ne-rc,0.6.1-beta.4,0.6.1-beta.5,24,1,15,17,32,4,FALSE
ne-rc,0.6.1-beta.2,0.6.1-beta.3,22,2,17,14,31,6,FALSE
ne-rc,0.1.2,0.1.3,2,1,19,8,27,3,FALSE
ne-rc,0.2.0-beta.4,0.2.0-rc,13,6,310,296,606,47,FALSE
ne-rc,0.6.1-beta.3,0.6.1-beta.4,23,4,713,371,1084,34,FALSE
ne-rc,0.2.0-rc.2,0.2.0-rc.3,16,1,3,5,8,2,FALSE
ne-rc,0.2.0-rc.3,0.2.0-rc.4,17,2,2,4,6,3,FALSE
ne-rc,0.6.1,0.7.0,30,24,1197,569,1766,109,FALSE
ne-rc,0.2.0-rc.1,0.2.0-rc.2,15,2,53,54,107,6,FALSE
ne-rc,0.2.0-rc.4,0.3.0-beta.1,18,2,566,463,1029,107,FALSE
ne-rc,0.6.1-beta.5,0.6.1-beta.6,25,2,2,2,4,2,FALSE
ne-rc,0.3.0-beta.1,0.4.0-beta.1,19,13,1637,893,2530,89,FALSE
ne-rc,0.6.1-beta.6,0.6.1-beta.7,26,2,12,10,22,2,FALSE
ne-rc,0.6.1-beta.7,0.6.1-beta.8,27,1,1,52291,52292,4,FALSE
ne-rc,0.6.1-beta.1,0.6.1-beta.2,21,2,5,3,8,3,FALSE
ne-rc,0.1.4,0.1.5,4,1,1,52291,52292,4,FALSE
ne-rc,0.1.8,0.1.9,7,124,14706,8856,23562,974,FALSE
ne-rc,0.2.0-beta,0.2.0-beta.1,9,5,27,32,59,8,FALSE
ne-rc,0.4.0-beta.1,0.6.1-beta.1,20,12,970,787,1757,66,FALSE
ne-rc,0.1.5,0.1.7,5,15,528,165,693,75,FALSE
ne-rc,0.1.5,0.1.7,5,15,528,165,693,75,TRUE
ne-rc,0.6.1-beta.8,0.6.1-beta.9,28,1,2,1,3,2,TRUE
ne-rc,0.6.1-beta.3,0.6.1-beta.4,23,4,713,371,1084,34,TRUE
ne-rc,0.2.0-rc.4,0.3.0-beta.1,18,2,566,463,1029,107,TRUE
ne-rc,0.2.0-beta.4,0.2.0-rc,13,6,310,296,606,47,TRUE
ne-rc,0.2.0-beta.3,0.2.0-beta.4,12,9,227,215,442,139,TRUE
ne-rc,0.2.0-beta,0.2.0-beta.1,9,5,27,32,59,8,TRUE
ne-rc,0.6.1-beta.2,0.6.1-beta.3,22,2,17,14,31,6,TRUE
bemact,0.0.1,0.0.2,1,9,83,20,103,11,FALSE
bemact,0.0.2,0.0.3,2,1,2,1,3,1,FALSE
bemact,0.0.2,0.0.3,2,1,2,1,3,1,TRUE
bemact,0.0.1,0.0.2,1,9,83,20,103,11,TRUE
mali-logger,0.1.0,0.1.1,1,2,1,3,4,2,FALSE
mali-logger,0.1.1,0.1.2,2,2,31,2,33,4,FALSE
mali-logger,0.1.2,0.2.0,3,4,136,109,245,9,FALSE
mali-logger,0.1.1,0.1.2,2,2,31,2,33,4,TRUE
bili,0.9.0,0.9.1,7,2,2,1,3,2,FALSE
bili,0.6.3,0.7.0,4,3,3539,463,4002,8,FALSE
bili,0.6.2,0.6.3,3,10,34,226,260,13,FALSE
bili,0.6.1,0.6.2,2,5,9,13,22,6,FALSE
bili,0.6.0,0.6.1,1,9,27,21,48,13,FALSE
bili,0.8.0,0.9.0,6,3,623,598,1221,4,FALSE
bili,0.7.0,0.8.0,5,7,69,64,133,14,FALSE
bili,0.9.1,0.10.0,8,6,1356,565,1921,34,FALSE
bili,0.15.2,0.15.3,19,2,5,4,9,3,FALSE
bili,0.15.3,0.15.4,20,2,11,2,13,3,FALSE
bili,0.14.1,0.14.2,14,7,75,11,86,8,FALSE
bili,0.14.0,0.14.1,13,14,2377,1176,3553,28,FALSE
bili,0.14.3,0.15.0,16,2,518,344,862,8,FALSE
bili,0.10.0,0.11.0,9,8,284,8,292,14,FALSE
bili,0.11.0,0.12.0,10,8,231,288,519,18,FALSE
bili,0.14.2,0.14.3,15,3,41,752,793,7,FALSE
bili,0.12.0,0.13.0,11,4,6,5,11,4,FALSE
bili,0.15.1,0.15.2,18,2,9,9,18,2,FALSE
bili,0.15.0,0.15.1,17,3,11,3,14,5,FALSE
bili,0.13.0,0.14.0,12,2,20,2,22,3,FALSE
bili,0.8.0,0.9.0,6,3,623,598,1221,4,TRUE
bili,0.14.0,0.14.1,13,14,2377,1176,3553,28,TRUE
bili,0.12.0,0.13.0,11,4,6,5,11,4,TRUE
bili,0.14.2,0.14.3,15,3,41,752,793,7,TRUE
bili,0.15.3,0.15.4,20,2,11,2,13,3,TRUE
styled-components,0.3.2,0.3.3,28,4,35,15,50,16,FALSE
styled-components,0.3.3,0.3.4,29,3,6,2,8,4,FALSE
styled-components,0.3.0,0.3.1,26,5,49,73,122,12,FALSE
styled-components,0.3.1,0.3.2,27,4,85,33,118,9,FALSE
styled-components,0.3.4,0.4.0,30,42,7189,729,7918,142,FALSE
styled-components,0.1.8,0.1.9,18,2,29,11,40,5,FALSE
styled-components,0.1.9,0.2.0,19,4,5873,1072,6945,73,FALSE
styled-components,0.2.5,0.3.0,25,5,233,34,267,22,FALSE
styled-components,0.2.4,0.2.5,24,6,557,20,577,9,FALSE
styled-components,0.2.3,0.2.4,23,12,827,192,1019,37,FALSE
styled-components,0.2.2,0.2.3,22,27,1186,350,1536,42,FALSE
styled-components,0.2.1,0.2.2,21,3,232,25,257,10,FALSE
styled-components,0.2.0,0.2.1,20,8,426,47,473,17,FALSE
styled-components,0.4.1,0.4.2,32,6,4270,529,4799,24,FALSE
styled-components,0.4.0,0.4.1,31,13,5000,1082,6082,60,FALSE
styled-components,0.4.2,1.0.0,33,6,995,206,1201,16,FALSE
styled-components,0.1.5,0.1.6,15,6,25,30,55,11,FALSE
styled-components,0.1.6,0.1.7,16,2,462,10,472,4,FALSE
styled-components,0.1.7,0.1.8,17,2,5,2,7,3,FALSE
styled-components,0.1.4,0.1.5,14,3,5,4,9,4,FALSE
styled-components,1.0.4,1.0.5,37,3,20,27,47,6,FALSE
styled-components,1.0.5,1.0.6,38,26,847,524,1371,60,FALSE
styled-components,1.0.6,1.0.7,39,28,3166,1364,4530,80,FALSE
styled-components,1.0.7,1.0.8,40,13,170,33,203,22,FALSE
styled-components,1.0.0,1.0.2,34,7,66,290,356,9,FALSE
styled-components,1.0.2,1.0.3,35,1,5055,44,5099,18,FALSE
styled-components,1.0.3,1.0.4,36,8,18,277,295,10,FALSE
styled-components,1.0.8,1.0.9,41,40,1534,161,1695,100,FALSE
styled-components,1.0.9,1.0.10,42,6,153,14,167,10,FALSE
styled-components,0.1.8,0.1.9,18,2,29,11,40,5,TRUE
styled-components,0.2.3,0.2.4,23,12,827,192,1019,37,TRUE
styled-components,0.1.0,0.1.1,10,5,48,46,94,17,FALSE
styled-components,0.1.1,0.1.2,11,4,62,32,94,7,FALSE
styled-components,0.1.2,0.1.3,12,13,208,74,282,28,FALSE
styled-components,0.1.3,0.1.4,13,2,2,1,3,2,FALSE
styled-components,1.0.10,1.0.11,43,51,23151,716,23867,256,TRUE
styled-components,1.0.11,1.0.12-0,44,26,1346,113,1459,86,FALSE
styled-components,1.1.1,1.1.2-0,47,3,34,11,45,6,FALSE
styled-components,1.0.12-0,1.1.0,45,22,743,80,823,44,FALSE
styled-components,1.1.2-0,1.1.2,48,39,1170,556,1726,134,FALSE
styled-components,1.1.0,1.1.1,46,4,161,10,171,7,FALSE
styled-components,2.0.0-8,2.0.0-9,70,11,1356,1070,2426,49,FALSE
styled-components,1.1.2,1.1.3,49,54,1850,886,2736,184,FALSE
styled-components,1.0.10,1.0.11,43,51,23151,716,23867,256,FALSE
styled-components,1.4.0,1.4.1,55,10,102,26,128,17,FALSE
styled-components,1.4.1,1.4.2,56,8,65,25,90,17,FALSE
styled-components,1.4.3,1.4.4,58,71,4103,2926,7029,166,FALSE
styled-components,1.4.4,1.4.5,59,195,10976,10582,21558,593,FALSE
styled-components,1.4.5,1.4.6,60,85,11575,6831,18406,348,FALSE
styled-components,1.3.1,1.4.0,54,69,8207,6613,14820,137,FALSE
styled-components,1.3.0,1.3.1,53,21,162,50,212,38,FALSE
styled-components,1.2.0,1.2.1,51,10,84,65,149,26,FALSE
styled-components,1.2.1,1.3.0,52,107,54205,10562,64767,766,FALSE
styled-components,1.4.2,1.4.3,57,24,1420,560,1980,63,FALSE
styled-components,2.0.0-19,2.0.0,81,20,922,1388,2310,62,FALSE
styled-components,2.0.0-18,2.0.0-19,80,20,5500,2429,7929,111,FALSE
styled-components,2.0.0-10,2.0.0-11,72,24,896,264,1160,35,FALSE
styled-components,2.0.0-11,2.0.0-12,73,2,6,15,21,4,FALSE
styled-components,2.0.0-12,2.0.0-13,74,10,225,76,301,20,FALSE
styled-components,2.0.0-13,2.0.0-14,75,3,8,4,12,4,FALSE
styled-components,2.0.0-14,2.0.0-15,76,59,5252,5373,10625,224,FALSE
styled-components,2.0.0-15,2.0.0-16,77,108,11720,9058,20778,421,FALSE
styled-components,2.0.0-16,2.0.0-17,78,7,1869,577,2446,48,FALSE
styled-components,2.0.0-17,2.0.0-18,79,27,80,38,118,32,FALSE
styled-components,2.0.0-6,2.0.0-7,68,7,459,346,805,23,FALSE
styled-components,2.0.0-7,2.0.0-8,69,34,637,272,909,85,FALSE
styled-components,2.0.0-4,2.0.0-5,66,26,467,311,778,62,FALSE
styled-components,2.0.0-5,2.0.0-6,67,15,212,347,559,31,FALSE
styled-components,2.0.0-2,2.0.0-3,64,2,105,567,672,3,FALSE
styled-components,2.0.0-3,2.0.0-4,65,25,1531,1365,2896,69,FALSE
styled-components,2.0.0-0,2.0.0-1,62,31,1955,728,2683,65,FALSE
styled-components,2.0.0-1,2.0.0-2,63,28,2840,1050,3890,64,FALSE
styled-components,1.1.3,1.2.0,50,31,2830,922,3752,155,FALSE
styled-components,2.0.0-9,2.0.0-10,71,3,60,21,81,9,FALSE
styled-components,1.0.3,1.0.4,36,8,18,277,295,10,TRUE
styled-components,0.2.2,0.2.3,22,27,1186,350,1536,42,TRUE
styled-components,0.0.5,0.0.6,8,5,360,87,447,18,FALSE
styled-components,0.0.4,0.0.5-0,4,9,329,10,339,14,FALSE
styled-components,0.0.6,0.1.0,9,38,6576,2929,9505,211,FALSE
styled-components,0.0.1,0.0.2,1,2,16,12,28,4,FALSE
styled-components,0.0.3,0.0.4,3,2,22,2,24,3,FALSE
styled-components,0.0.2,0.0.3,2,2,92,7,99,3,FALSE
styled-components,0.0.5-1,0.0.5-2,6,1,5055,44,5099,18,FALSE
styled-components,0.0.5-0,0.0.5-1,5,2,86,8,94,6,FALSE
styled-components,0.0.5-2,0.0.5,7,1,1,1,2,1,FALSE
styled-components,0.1.9,0.2.0,19,4,5873,1072,6945,73,TRUE
styled-components,0.3.2,0.3.3,28,4,35,15,50,16,TRUE
styled-components,0.2.4,0.2.5,24,6,557,20,577,9,TRUE
styled-components,2.0.0-3,2.0.0-4,65,25,1531,1365,2896,69,TRUE
styled-components,0.2.5,0.3.0,25,5,233,34,267,22,TRUE
styled-components,2.0.0-7,2.0.0-8,69,34,637,272,909,85,TRUE
styled-components,2.0.0-10,2.0.0-11,72,24,896,264,1160,35,TRUE
styled-components,1.0.6,1.0.7,39,28,3166,1364,4530,80,TRUE
styled-components,2.0.0-8,2.0.0-9,70,11,1356,1070,2426,49,TRUE
styled-components,1.4.4,1.4.5,59,195,10976,10582,21558,593,TRUE
styled-components,0.1.2,0.1.3,12,13,208,74,282,28,TRUE
styled-components,0.2.0,0.2.1,20,8,426,47,473,17,TRUE
styled-components,1.1.2,1.1.3,49,54,1850,886,2736,184,TRUE
styled-components,1.1.3,1.2.0,50,31,2830,922,3752,155,TRUE
styled-components,1.4.0,1.4.1,55,10,102,26,128,17,TRUE
styled-components,1.4.1,1.4.2,56,8,65,25,90,17,TRUE
styled-components,1.4.2,1.4.3,57,24,1420,560,1980,63,TRUE
styled-components,1.4.3,1.4.4,58,71,4103,2926,7029,166,TRUE
styled-components,1.4.5,1.4.6,60,85,11575,6831,18406,348,TRUE
styled-components,2.0.0-19,2.0.0,81,20,922,1388,2310,62,TRUE
styled-components,2.0.0-18,2.0.0-19,80,20,5500,2429,7929,111,TRUE
styled-components,2.0.0-6,2.0.0-7,68,7,459,346,805,23,TRUE
styled-components,1.0.4,1.0.5,37,3,20,27,47,6,TRUE
styled-components,2.0.0-13,2.0.0-14,75,3,8,4,12,4,TRUE
styled-components,1.0.7,1.0.8,40,13,170,33,203,22,TRUE
styled-components,1.0.0,1.0.2,34,7,66,290,356,9,TRUE
styled-components,1.3.1,1.4.0,54,69,8207,6613,14820,137,TRUE
styled-components,1.3.0,1.3.1,53,21,162,50,212,38,TRUE
styled-components,1.1.2-0,1.1.2,48,39,1170,556,1726,134,TRUE
lumenode-config,1.0.0,1.0.1,1,2,17,4,21,3,FALSE
lumenode-config,1.0.1,1.0.2,2,7,156,162,318,16,FALSE
lumenode-config,1.0.2,1.0.3,3,2,69,64,133,4,FALSE
lumenode-config,1.0.3,1.0.4,4,12,263,197,460,25,FALSE
lumenode-config,1.0.1,1.0.2,2,7,156,162,318,16,TRUE
safe-app,0.0.15,0.0.16,15,8,246,109,355,16,FALSE
safe-app,0.0.14,0.0.15,14,11,255,76,331,28,FALSE
safe-app,0.0.17,0.0.18,17,10,653,657,1310,35,FALSE
safe-app,0.0.16,0.0.17,16,12,213,138,351,25,FALSE
safe-app,0.0.11,0.0.12,11,3,46,42,88,8,FALSE
safe-app,0.0.10,0.0.11,10,18,1234,365,1599,75,FALSE
safe-app,0.0.13,0.0.14,13,5,56,43,99,10,FALSE
safe-app,0.0.12,0.0.13,12,6,192,708,900,16,FALSE
safe-app,0.0.19,0.0.20,19,2,504,404,908,14,FALSE
safe-app,0.0.18,0.0.19,18,6,134,76,210,17,FALSE
safe-app,0.0.5,0.0.6,5,23,6531,3738,10269,263,FALSE
safe-app,0.0.4,0.0.5,4,8,1115,288,1403,151,FALSE
safe-app,0.0.7,0.0.8,7,13,1111,306,1417,81,FALSE
safe-app,0.0.6,0.0.7,6,2,79,99,178,4,FALSE
safe-app,0.0.1,0.0.2,1,11,790,586,1376,69,FALSE
safe-app,0.0.3,0.0.4,3,7,218,142,360,19,FALSE
safe-app,0.0.2,0.0.3,2,2,278,9,287,11,FALSE
safe-app,0.0.9,0.0.10,9,10,221,107,328,22,FALSE
safe-app,0.0.8,0.0.9,8,11,384,442,826,35,FALSE
safe-app,0.0.20,0.0.21,20,5,267,60,327,20,FALSE
safe-app,0.0.21,0.0.22,21,9,953,328,1281,30,FALSE
safe-app,0.0.22,0.0.23,22,3,45,28,73,6,FALSE
safe-app,0.0.23,0.0.24,23,11,745,672,1417,38,FALSE
safe-app,0.0.24,0.0.25,24,3,36,18,54,8,FALSE
safe-app,0.0.25,0.0.26,25,7,1355,901,2256,41,FALSE
safe-app,0.0.11,0.0.12,11,3,46,42,88,8,TRUE
safe-app,0.0.4,0.0.5,4,8,1115,288,1403,151,TRUE
safe-app,0.0.9,0.0.10,9,10,221,107,328,22,TRUE
safe-app,0.0.10,0.0.11,10,18,1234,365,1599,75,TRUE
safe-app,0.0.13,0.0.14,13,5,56,43,99,10,TRUE
safe-app,0.0.3,0.0.4,3,7,218,142,360,19,TRUE
safe-app,0.0.5,0.0.6,5,23,6531,3738,10269,263,TRUE
safe-app,0.0.8,0.0.9,8,11,384,442,826,35,TRUE
safe-app,0.0.12,0.0.13,12,6,192,708,900,16,TRUE
safe-app,0.0.23,0.0.24,23,11,745,672,1417,38,TRUE
safe-app,0.0.16,0.0.17,16,12,213,138,351,25,TRUE
safe-app,0.0.14,0.0.15,14,11,255,76,331,28,TRUE
safe-app,0.0.22,0.0.23,22,3,45,28,73,6,TRUE
safe-app,0.0.25,0.0.26,25,7,1355,901,2256,41,TRUE
safe-app,0.0.20,0.0.21,20,5,267,60,327,20,TRUE
react-social,0.1.1,0.1.2,1,1,2,2,4,2,FALSE
react-social,0.1.2,0.1.3,2,1,24,10,34,2,FALSE
react-social,0.1.3,0.1.4,3,1,2,2,4,2,FALSE
react-social,0.1.4,0.1.5,4,3,31,7,38,5,FALSE
react-social,0.1.5,0.1.6,5,1,5,3,8,3,FALSE
react-social,1.1.1,1.2.0,17,1,124,50,174,6,FALSE
react-social,1.1.0,1.1.1,16,3,49,6,55,6,FALSE
react-social,1.4.2,1.4.3,22,2,13,7,20,8,FALSE
react-social,1.4.3,1.5.0,23,4,15,4,19,7,FALSE
react-social,1.4.0,1.4.1,20,2,11,3,14,5,FALSE
react-social,1.4.1,1.4.2,21,1,8,4,12,4,FALSE
react-social,1.5.0,1.6.0,24,1,11,7,18,4,FALSE
react-social,1.6.2,1.7.0,27,2,39,11,50,6,FALSE
react-social,1.6.0,1.6.1,25,4,19,7,26,8,FALSE
react-social,1.6.1,1.6.2,26,4,14,4,18,7,FALSE
react-social,1.2.0,1.3.0,18,4,65,7,72,10,FALSE
react-social,1.3.0,1.4.0,19,3,281,26,307,8,FALSE
react-social,1.8.0,1.9.0,30,2,16,5,21,6,FALSE
react-social,1.7.1,1.8.0,29,7,27,11,38,9,FALSE
react-social,1.7.0,1.7.1,28,2,13,4,17,6,FALSE
react-social,1.4.1,1.4.2,21,1,8,4,12,4,TRUE
react-social,1.0.4,1.0.6,13,3,22,6,28,7,FALSE
react-social,1.0.6,1.0.7,14,2,16,3,19,4,FALSE
react-social,1.0.7,1.1.0,15,6,233,25,258,14,FALSE
react-social,1.0.1,1.0.2,10,1,2,3,5,3,FALSE
react-social,1.0.2,1.0.3,11,3,19,2,21,4,FALSE
react-social,1.0.3,1.0.4,12,2,11,2,13,3,FALSE
react-social,0.1.8,0.1.9,8,2,7,2,9,4,FALSE
react-social,0.1.9,1.0.1,9,5,38,22,60,9,FALSE
react-social,0.1.6,0.1.7,6,1,52,21,73,4,FALSE
react-social,0.1.7,0.1.8,7,2,73,5,78,5,FALSE
broccoli-webpack-cached,0.3.0-beta,0.3.1-beta2,9,1,3,0,3,1,FALSE
broccoli-webpack-cached,0.2.0-beta,0.3.0-beta,8,1,3,0,3,1,FALSE
broccoli-webpack-cached,0.3.1-beta2,0.3.1-beta3,10,1,3,0,3,1,FALSE
broccoli-webpack-cached,0.3.1-beta3,0.3.1-beta4,11,1,3,0,3,1,FALSE
broccoli-webpack-cached,0.1.2,0.1.3,3,7,80,2,82,9,FALSE
broccoli-webpack-cached,0.1.3,0.1.4,4,3,70,64,134,4,FALSE
broccoli-webpack-cached,0.1.4,0.1.5,5,6,139,69,208,6,FALSE
broccoli-webpack-cached,0.1.5,0.1.6,6,2,44,22,66,2,FALSE
broccoli-webpack-cached,0.1.6,0.2.0-beta,7,2,16,2,18,2,FALSE
broccoli-webpack-cached,0.0.1,0.1.1,1,4,33,5,38,5,FALSE
broccoli-webpack-cached,0.1.4,0.1.5,5,6,139,69,208,6,TRUE
broccoli-webpack-cached,0.1.1,0.1.2,2,4,9,3,12,5,FALSE
atom-react,0.13.28,0.14.0,92,5,53,35,88,16,FALSE
atom-react,0.13.21,0.13.22,87,3,31,26,57,3,FALSE
atom-react,0.0.50,0.0.51,50,1,38,1,39,2,FALSE
atom-react,0.13.23,0.13.24,89,2,31,13,44,3,FALSE
atom-react,0.13.22,0.13.23,88,1,55,55,110,3,FALSE
atom-react,0.13.25,0.13.28,91,1,15,8,23,3,FALSE
atom-react,0.13.24,0.13.25,90,1,2,3,5,2,FALSE
atom-react,0.12.11,0.13.0,65,2,9,9,18,3,FALSE
atom-react,0.12.10,0.12.11,64,3,12,3,15,3,FALSE
atom-react,0.14.20,0.14.21,113,1,3,3,6,2,FALSE
atom-react,0.14.21,0.14.22,114,1,15,2,17,2,FALSE
atom-react,0.14.22,0.14.23,115,1,38,1,39,2,FALSE
atom-react,0.14.23,15.0.0,116,1,38,1,39,2,FALSE
atom-react,0.14.11,0.14.12,104,1,6,2,8,2,FALSE
atom-react,0.14.10,0.14.11,103,1,2,4,6,2,FALSE
atom-react,0.14.13,0.14.14,106,1,38,1,39,2,FALSE
atom-react,0.14.12,0.14.13,105,1,4,2,6,2,FALSE
atom-react,0.14.15,0.14.16,108,1,3,4,7,2,FALSE
atom-react,0.14.14,0.14.15,107,2,29,4,33,5,FALSE
atom-react,0.14.17,0.14.18,110,1,25,7,32,4,FALSE
atom-react,0.14.16,0.14.17,109,1,13,3,16,2,FALSE
atom-react,0.14.19,0.14.20,112,2,23,12,35,4,FALSE
atom-react,0.14.18,0.14.19,111,1,38,1,39,2,FALSE
atom-react,0.0.51,0.0.52,51,2,11,4,15,5,FALSE
atom-react,0.13.20,0.13.21,86,1,16,5,21,2,FALSE
atom-react,0.0.45,0.0.46,45,2,15,12,27,3,FALSE
atom-react,0.0.53,0.12.0,53,1,3,3,6,2,FALSE
atom-react,0.0.52,0.0.53,52,3,160,21,181,6,FALSE
atom-react,0.0.42,0.0.43,42,1,2,2,4,2,FALSE
atom-react,0.0.15,0.0.16,15,1,89,16,105,3,FALSE
atom-react,0.0.14,0.0.15,14,1,38,1,39,2,FALSE
atom-react,0.0.17,0.0.18,17,1,38,1,39,2,FALSE
atom-react,0.0.16,0.0.17,16,1,4,5,9,2,FALSE
atom-react,0.0.11,0.0.12,11,1,19,16,35,3,FALSE
atom-react,0.0.10,0.0.11,10,1,38,1,39,2,FALSE
atom-react,0.0.13,0.0.14,13,1,38,1,39,2,FALSE
atom-react,0.0.12,0.0.13,12,1,38,1,39,2,FALSE
atom-react,0.0.19,0.0.20,19,1,38,1,39,2,FALSE
atom-react,0.0.18,0.0.19,18,1,38,1,39,2,FALSE
atom-react,0.0.40,0.0.41,40,1,20,6,26,2,FALSE
atom-react,0.0.41,0.0.42,41,1,4,3,7,3,FALSE
atom-react,0.13.10,0.13.11,76,1,114,85,199,8,FALSE
atom-react,0.0.47,0.0.48,47,1,6,3,9,2,FALSE
atom-react,0.13.12,0.13.13,78,1,3,3,6,2,FALSE
atom-react,0.13.8,0.13.9,74,1,7,7,14,2,FALSE
atom-react,0.13.9,0.13.10,75,2,105,20,125,6,FALSE
atom-react,0.13.6,0.13.7,72,1,25,2,27,4,FALSE
atom-react,0.13.7,0.13.8,73,1,14,2,16,2,FALSE
atom-react,0.13.4,0.13.5,70,1,19,36,55,2,FALSE
atom-react,0.13.5,0.13.6,71,1,2,2,4,2,FALSE
atom-react,0.13.2,0.13.3,68,1,2,1,3,2,FALSE
atom-react,0.13.3,0.13.4,69,1,6,1,7,2,FALSE
atom-react,0.13.0,0.13.1,66,1,39,12,51,2,FALSE
atom-react,0.13.1,0.13.2,67,1,13,9,22,2,FALSE
atom-react,0.14.5,0.14.6,98,1,1,2,3,2,FALSE
atom-react,0.14.4,0.14.5,97,1,7,3,10,3,FALSE
atom-react,0.14.7,0.14.8,100,1,3,5,8,2,FALSE
atom-react,0.14.6,0.14.7,99,1,2,2,4,2,FALSE
atom-react,0.14.1,0.14.2,94,1,5,2,7,2,FALSE
atom-react,0.14.0,0.14.1,93,1,12,15,27,3,FALSE
atom-react,0.14.3,0.14.4,96,1,151,87,238,16,FALSE
atom-react,0.14.2,0.14.3,95,1,11,1,12,2,FALSE
atom-react,0.14.9,0.14.10,102,1,1,2,3,2,FALSE
atom-react,0.14.8,0.14.9,101,1,11,2,13,3,FALSE
atom-react,0.0.20,0.0.21,20,1,38,1,39,2,FALSE
atom-react,0.0.21,0.0.22,21,1,38,1,39,2,FALSE
atom-react,0.0.22,0.0.23,22,1,121,41,162,5,FALSE
atom-react,0.0.23,0.0.24,23,1,38,1,39,2,FALSE
atom-react,0.0.24,0.0.25,24,1,38,1,39,2,FALSE
atom-react,0.0.25,0.0.26,25,1,19,36,55,3,FALSE
atom-react,0.0.26,0.0.27,26,1,13,10,23,2,FALSE
atom-react,0.0.27,0.0.28,27,1,38,1,39,2,FALSE
atom-react,0.0.28,0.0.29,28,1,38,1,39,2,FALSE
atom-react,0.0.29,0.0.30,29,1,38,1,39,2,FALSE
atom-react,0.13.15,0.13.16,81,1,2,2,4,1,FALSE
atom-react,0.0.39,0.0.40,39,1,6,7,13,3,FALSE
atom-react,0.0.38,0.0.39,38,1,89,46,135,6,FALSE
atom-react,0.0.37,0.0.38,37,2,105,59,164,9,FALSE
atom-react,0.0.36,0.0.37,36,1,29,32,61,3,FALSE
atom-react,0.0.35,0.0.36,35,1,8,1,9,2,FALSE
atom-react,0.0.34,0.0.35,34,1,52,88,140,5,FALSE
atom-react,0.0.33,0.0.34,33,1,1,1,2,1,FALSE
atom-react,0.0.32,0.0.33,32,3,29,4,33,5,FALSE
atom-react,0.0.31,0.0.32,31,2,2,1,3,2,FALSE
atom-react,0.0.30,0.0.31,30,2,7,5,12,4,FALSE
atom-react,0.0.5,0.0.6,5,1,12,6,18,2,FALSE
atom-react,0.0.4,0.0.5,4,1,5,1,6,2,FALSE
atom-react,0.0.7,0.0.8,7,1,17,5,22,3,FALSE
atom-react,0.0.6,0.0.7,6,2,2,1,3,2,FALSE
atom-react,0.0.1,0.0.2,1,3,300,84,384,11,FALSE
atom-react,0.0.3,0.0.4,3,1,32,8,40,3,FALSE
atom-react,0.0.2,0.0.3,2,1,38,1,39,2,FALSE
atom-react,0.0.9,0.0.10,9,1,38,1,39,2,FALSE
atom-react,0.0.8,0.0.9,8,1,38,1,39,2,FALSE
atom-react,0.12.3,0.12.4,57,2,188,38,226,4,FALSE
atom-react,0.12.2,0.12.3,56,2,24,7,31,3,FALSE
atom-react,0.12.1,0.12.2,55,2,10,5,15,3,FALSE
atom-react,0.12.0,0.12.1,54,1,14,43,57,2,FALSE
atom-react,0.12.7,0.12.8,61,1,5,0,5,1,FALSE
atom-react,0.12.6,0.12.7,60,2,1224,20,1244,23,FALSE
atom-react,0.12.5,0.12.6,59,2,3,6,9,3,FALSE
atom-react,0.12.4,0.12.5,58,3,38,7,45,4,FALSE
atom-react,0.12.9,0.12.10,63,1,2,2,4,1,FALSE
atom-react,0.12.8,0.12.9,62,2,62,49,111,8,FALSE
atom-react,0.0.48,0.0.49,48,1,2,1,3,2,FALSE
atom-react,0.0.49,0.0.50,49,1,38,1,39,2,FALSE
atom-react,0.13.18,0.13.19,84,1,12,13,25,4,FALSE
atom-react,0.13.19,0.13.20,85,1,7,4,11,3,FALSE
atom-react,0.13.14,0.13.15,80,1,2,2,4,1,FALSE
atom-react,0.0.43,0.0.44,43,1,38,1,39,2,FALSE
atom-react,0.13.16,0.13.17,82,1,2,2,4,1,FALSE
atom-react,0.13.17,0.13.18,83,1,2,2,4,2,FALSE
atom-react,0.0.46,0.0.47,46,1,2,2,4,2,FALSE
atom-react,0.13.11,0.13.12,77,1,2,2,4,2,FALSE
atom-react,0.0.44,0.0.45,44,3,26,17,43,7,FALSE
atom-react,0.13.13,0.13.14,79,2,9,14,23,2,FALSE
atom-react,0.14.14,0.14.15,107,2,29,4,33,5,TRUE
atom-react,0.14.17,0.14.18,110,1,25,7,32,4,TRUE
atom-react,0.14.18,0.14.19,111,1,38,1,39,2,TRUE
atom-react,15.0.0,15.0.1,117,1,5,5,10,1,FALSE
atom-react,15.0.1,15.0.5,118,2,34,206,240,6,FALSE
atom-react,15.1.1,15.1.2,125,1,38,1,39,2,FALSE
atom-react,15.1.0,15.1.1,124,1,2,7,9,2,FALSE
atom-react,15.0.7,15.0.8,121,1,38,1,39,2,FALSE
atom-react,15.0.8,15.0.9,122,2,47,1399,1446,28,FALSE
atom-react,15.0.9,15.1.0,123,1,8,5,13,2,FALSE
atom-react,15.0.6,15.0.7,120,1,38,1,39,2,FALSE
atom-react,15.0.5,15.0.6,119,1,38,1,39,2,FALSE
sanntid,1.0.4,1.0.5,5,3,12,3,15,4,FALSE
sanntid,1.0.5,1.0.6,6,4,28,7,35,6,FALSE
sanntid,1.0.6,1.0.7,7,1,1,1,2,1,FALSE
sanntid,1.0.7,1.0.8,8,3,7,3,10,3,FALSE
sanntid,1.0.0,1.0.1,1,4,434224,245393,679617,11,FALSE
sanntid,1.0.1,1.0.2,2,6,28838,28836,57674,6,FALSE
sanntid,1.0.2,1.0.3,3,5,233,109,342,7,FALSE
sanntid,1.0.3,1.0.4,4,2,10,3,13,2,FALSE
sanntid,1.1.0,1.1.1,13,1,3,3,6,2,FALSE
sanntid,1.0.8,1.0.9,9,2,1,7,8,2,FALSE
sanntid,1.0.9,1.0.10,10,1,8,2,10,1,FALSE
sanntid,1.1.2,1.2.0,15,5,70,40,110,7,FALSE
sanntid,1.1.1,1.1.2,14,1,2,1,3,2,FALSE
sanntid,1.0.10,1.0.11,11,4,15,13,28,4,FALSE
sanntid,1.0.11,1.1.0,12,1,1,1,2,1,FALSE
sanntid,1.2.0,1.3.0,16,6,109,17,126,10,FALSE
sanntid,1.2.0,1.3.0,16,6,109,17,126,10,TRUE
laxar,1.0.0,1.0.1,8,2,6,2,8,4,FALSE
laxar,1.0.1,1.1.0-alpha.0,9,11,843,420,1263,67,FALSE
laxar,2.0.0-alpha.6,2.0.0-alpha.7,20,2,17,5,22,3,FALSE
laxar,2.0.0-alpha.7,2.0.0-alpha.8,21,2,1533,389,1922,37,FALSE
laxar,2.0.0-alpha.4,2.0.0-alpha.5,18,25,5792,4028,9820,206,FALSE
laxar,2.0.0-alpha.5,2.0.0-alpha.6,19,2,24,15,39,7,FALSE
laxar,2.0.0-alpha.2,2.0.0-alpha.3,16,3,56,73,129,13,FALSE
laxar,2.0.0-alpha.3,2.0.0-alpha.4,17,31,5084,4574,9658,339,FALSE
laxar,2.0.0-alpha.1,2.0.0-alpha.2,15,3,78,122,200,17,FALSE
laxar,2.0.0-alpha.8,2.0.0-alpha.9,22,4,289,177,466,14,FALSE
laxar,2.0.0-alpha.9,2.0.0-alpha.10,23,19,1969,911,2880,101,FALSE
laxar,1.0.0-alpha.11,1.0.0-alpha.12,1,6,173,114,287,20,FALSE
laxar,1.1.0-alpha.0,1.1.0-alpha.1,10,3,581,8,589,21,FALSE
laxar,1.1.0-alpha.1,1.1.0,11,72,5873,2034,7907,414,FALSE
laxar,1.0.0-beta.0,1.0.0-beta.1,6,9,253,178,431,37,FALSE
laxar,1.2.0,2.0.0-alpha.1,14,59,90628,104758,195386,979,FALSE
laxar,1.0.0-beta.1,1.0.0,7,1,7,4,11,3,FALSE
laxar,1.2.0-alpha.1,1.2.0,13,10,1563,436,1999,269,FALSE
laxar,1.0.0-alpha.13,1.0.0-alpha.14,3,3,11,2,13,7,FALSE
laxar,1.0.0-alpha.12,1.0.0-alpha.13,2,3,53,8,61,9,FALSE
laxar,1.0.0-alpha.15,1.0.0-beta.0,5,4,5076,443,5519,91,FALSE
laxar,1.0.0-alpha.14,1.0.0-alpha.15,4,3,13,4,17,7,FALSE
laxar,2.0.0-beta.0,2.0.0-rc.0,38,3,317,70,387,16,FALSE
laxar,2.0.0-alpha.24,2.0.0-beta.0,37,4,307,268,575,21,FALSE
laxar,2.0.0-alpha.21,2.0.0-alpha.22,34,5,189,33,222,14,FALSE
laxar,2.0.0-alpha.20,2.0.0-alpha.21,33,5,284,253,537,32,FALSE
laxar,2.0.0-alpha.23,2.0.0-alpha.24,36,3,14,6,20,6,FALSE
laxar,2.0.0-alpha.22,2.0.0-alpha.23,35,9,1347,448,1795,51,FALSE
laxar,2.0.0-alpha.10,2.0.0-alpha.12,24,28,10091,6643,16734,270,FALSE
laxar,2.0.0-alpha.12,2.0.0-alpha.13,25,3,374,56,430,22,FALSE
laxar,2.0.0-alpha.13,2.0.0-alpha.14,26,4,4255,325,4580,28,FALSE
laxar,2.0.0-alpha.14,2.0.0-alpha.15,27,3,58,9,67,8,FALSE
laxar,2.0.0-alpha.15,2.0.0-alpha.16,28,5,28,9,37,9,FALSE
laxar,2.0.0-alpha.16,2.0.0-alpha.17,29,9,268,70,338,34,FALSE
laxar,2.0.0-alpha.17,2.0.0-alpha.18,30,3,139,27,166,11,FALSE
laxar,2.0.0-alpha.18,2.0.0-alpha.19,31,13,4362,3011,7373,124,FALSE
laxar,2.0.0-alpha.19,2.0.0-alpha.20,32,2,43,6,49,9,FALSE
laxar,2.0.0-alpha.8,2.0.0-alpha.9,22,4,289,177,466,14,TRUE
laxar,2.0.0-rc.2,2.0.0-rc.3,41,3,20,14,34,7,FALSE
laxar,2.0.0-rc.0,2.0.0-rc.1,39,3,745,590,1335,20,FALSE
laxar,2.0.0-rc.1,2.0.0-rc.2,40,3,18,12,30,11,FALSE
laxar,2.0.0-alpha.14,2.0.0-alpha.15,27,3,58,9,67,8,TRUE
laxar,2.0.0-alpha.16,2.0.0-alpha.17,29,9,268,70,338,34,TRUE
laxar,2.0.0-alpha.5,2.0.0-alpha.6,19,2,24,15,39,7,TRUE
laxar,2.0.0-alpha.2,2.0.0-alpha.3,16,3,56,73,129,13,TRUE
laxar,2.0.0-alpha.20,2.0.0-alpha.21,33,5,284,253,537,32,TRUE
react-resumable-js,1.0.4,1.0.5,4,1,8,5,13,2,FALSE
react-resumable-js,1.0.5,1.0.6,5,3,11,7,18,4,FALSE
react-resumable-js,1.0.6,1.0.7,6,2,2,3,5,3,FALSE
react-resumable-js,1.0.7,1.0.8,7,1,3,3,6,2,FALSE
react-resumable-js,1.1.5,1.1.6,27,2,54,28,82,5,FALSE
react-resumable-js,1.0.1,1.0.2,1,1,1,1,2,1,FALSE
react-resumable-js,1.0.2,1.0.3,2,4,30,63,93,9,FALSE
react-resumable-js,1.0.3,1.0.4,3,2,12,4,16,2,FALSE
react-resumable-js,1.1.9,1.1.10,31,1,4,4,8,4,FALSE
react-resumable-js,1.1.8,1.1.9,30,1,35,28,63,5,FALSE
react-resumable-js,1.0.8,1.0.9,8,1,3,3,6,2,FALSE
react-resumable-js,1.0.9,1.0.10,9,3,347,5,352,5,FALSE
react-resumable-js,1.1.2,1.1.3,24,1,1,5,6,2,FALSE
react-resumable-js,1.1.4,1.1.5,26,7,24,10,34,10,FALSE
react-resumable-js,1.1.20,1.1.22,42,3,11,34,45,6,FALSE
react-resumable-js,1.1.7,1.1.8,29,2,59,11,70,5,FALSE
react-resumable-js,1.1.22,1.1.23,43,5,80,58,138,7,FALSE
react-resumable-js,1.1.6,1.1.7,28,2,6,6,12,2,FALSE
react-resumable-js,1.0.16,1.0.17,16,13,266,51,317,28,FALSE
react-resumable-js,1.0.17,1.0.18,17,5,42,268,310,12,FALSE
react-resumable-js,1.0.14,1.0.15,14,2,2,2,4,2,FALSE
react-resumable-js,1.0.15,1.0.16,15,4,1411,23,1434,21,FALSE
react-resumable-js,1.0.12,1.0.13,12,4,1839,437,2276,19,TRUE
react-resumable-js,1.0.13,1.0.14,13,8,174,40,214,17,FALSE
react-resumable-js,1.0.10,1.0.11,10,1,128,76,204,4,FALSE
react-resumable-js,1.0.11,1.0.12,11,2,1832,420,2252,17,FALSE
react-resumable-js,1.0.18,1.0.19,18,1,6,2,8,2,FALSE
react-resumable-js,1.0.19,1.0.20,19,5,85,91,176,11,FALSE
react-resumable-js,1.1.1,1.1.2,23,2,14,5,19,4,FALSE
react-resumable-js,1.1.17,1.1.18,39,2,28,11,39,4,FALSE
react-resumable-js,1.1.0,1.1.1,22,2,8,2,10,4,FALSE
react-resumable-js,1.1.19,1.1.20,41,5,18,11,29,9,FALSE
react-resumable-js,1.1.18,1.1.19,40,1,165,26,191,5,FALSE
react-resumable-js,1.0.21,1.1.0,21,7,370,419,789,24,FALSE
react-resumable-js,1.1.16,1.1.17,38,1,1,1,2,1,FALSE
react-resumable-js,1.1.11,1.1.12,33,1,6,2,8,4,FALSE
react-resumable-js,1.1.10,1.1.11,32,1,18,1,19,4,FALSE
react-resumable-js,1.1.13,1.1.14,35,1,7,4,11,4,TRUE
react-resumable-js,1.1.12,1.1.13,34,2,7,4,11,6,FALSE
react-resumable-js,1.1.15,1.1.16,37,2,15,5,20,6,FALSE
react-resumable-js,1.1.14,1.1.15,36,1,108,76,184,9,FALSE
react-resumable-js,1.1.3,1.1.4,25,8,120,92,212,20,FALSE
react-resumable-js,1.0.20,1.0.21,20,2,4,6,10,4,FALSE
react-resumable-js,1.0.12,1.0.13,12,4,1839,437,2276,19,FALSE
react-resumable-js,1.1.11,1.1.12,33,1,6,2,8,4,TRUE
react-resumable-js,1.1.13,1.1.14,35,1,7,4,11,4,FALSE
react-resumable-js,1.1.12,1.1.13,34,2,7,4,11,6,TRUE
react-resumable-js,1.1.10,1.1.11,32,1,18,1,19,4,TRUE
ml-matrix,1.0.4,1.1.0,11,8,65,12,77,15,FALSE
ml-matrix,1.1.1,1.1.2,13,2,21,3,24,4,FALSE
ml-matrix,1.1.3,1.1.4,15,2,7,3,10,3,FALSE
ml-matrix,1.1.2,1.1.3,14,4,60,2,62,6,FALSE
ml-matrix,1.1.5,1.2.0,17,4,82,15,97,6,FALSE
ml-matrix,1.0.1,1.0.2,8,2,102,96,198,11,FALSE
ml-matrix,1.0.2,1.0.3,9,5,16,7,23,6,FALSE
ml-matrix,1.1.0,1.1.1,12,3,8,3,11,3,FALSE
ml-matrix,1.0.3,1.0.4,10,4,11,5,16,5,FALSE
ml-matrix,1.2.0,1.2.1,18,2,23,9,32,3,FALSE
ml-matrix,1.2.1,1.3.0,19,3,70,6,76,6,FALSE
ml-matrix,1.0.0,1.0.1,7,3,9,3,12,4,FALSE
ml-matrix,1.1.4,1.1.5,16,3,25,8,33,3,FALSE
ml-matrix,2.2.0,2.3.0,24,4,2295,1225,3520,7,FALSE
ml-matrix,0.1.0,1.0.0-0,5,15,7097,3207,10304,73,FALSE
ml-matrix,2.1.0,2.2.0,23,20,2062,606,2668,65,FALSE
ml-matrix,0.0.4,0.1.0,4,5,72,52,124,7,FALSE
ml-matrix,0.0.1,0.0.2,1,4,118,85,203,12,FALSE
ml-matrix,0.0.3,0.0.4,3,6,1924,1666,3590,19,FALSE
ml-matrix,0.0.2,0.0.3,2,2,9,4,13,3,FALSE
ml-matrix,2.0.0,2.1.0,22,14,1590,463,2053,46,FALSE
ml-matrix,1.4.0,2.0.0,21,17,2938,1615,4553,74,TRUE
ml-matrix,1.3.0,1.4.0,20,14,8792,2339,11131,49,FALSE
ml-matrix,1.0.0-0,1.0.0,6,5,989,18,1007,14,FALSE
ml-matrix,3.0.0-0,3.0.0,28,15,2724,1015,3739,77,FALSE
ml-matrix,2.4.0-0,2.4.0-1,26,1,26,0,26,1,FALSE
ml-matrix,2.4.0-1,3.0.0-0,27,1,26,0,26,1,FALSE
ml-matrix,1.4.0,2.0.0,21,17,2938,1615,4553,74,FALSE
ml-matrix,2.3.0,2.4.0-0,25,1,538,356,894,1,FALSE
ml-matrix,2.3.0,2.4.0-0,25,1,538,356,894,1,TRUE
history,1.9.1,1.10.0,23,7,149,8,157,12,FALSE
history,1.6.0,1.7.0,14,4,494,217,711,15,FALSE
history,1.8.4,1.8.5,20,11,1030,997,2027,75,FALSE
history,1.8.5,1.9.0,21,9,64,2205,2269,17,FALSE
history,1.8.0,1.8.1,16,4,30,25,55,6,FALSE
history,1.8.1,1.8.2,17,3,149,10,159,10,FALSE
history,1.8.2,1.8.3,18,2,1,2,3,2,FALSE
history,1.7.0,1.8.0,15,2,243,145,388,13,FALSE
history,1.4.0,1.4.1,11,25,410,323,733,49,FALSE
history,1.4.1,1.5.0,12,4,38,47,85,7,FALSE
history,1.5.0,1.6.0,13,5,153,79,232,12,FALSE
history,1.13.0,1.13.1,36,47,1861,838,2699,131,FALSE
history,1.3.1,1.3.2,8,2,11,19,30,4,FALSE
history,1.3.0,1.3.1,7,3,8,5,13,5,FALSE
history,1.9.0,1.9.1,22,6,45,19,64,21,FALSE
history,1.12.4,1.12.5,33,8,206,146,352,17,FALSE
history,1.12.5,1.12.6,34,16,97,33,130,25,FALSE
history,1.12.6,1.13.0,35,16,91,59,150,20,FALSE
history,1.12.0,1.12.1,29,11,126,156,282,20,FALSE
history,1.12.1,1.12.2,30,6,174,112,286,10,FALSE
history,1.12.2,1.12.3,31,12,343,40,383,27,FALSE
history,1.12.3,1.12.4,32,8,50,19,69,14,FALSE
history,1.3.3,1.4.0,10,7,189,143,332,11,FALSE
history,1.11.1,1.12.0,28,8,190,56,246,26,FALSE
history,1.11.0,1.11.1,27,12,64,63,127,15,FALSE
history,1.3.2,1.3.3,9,2,7,1,8,2,FALSE
history,1.10.2,1.11.0,26,11,211,111,322,21,FALSE
history,1.10.0,1.10.1,24,2,2,1,3,2,FALSE
history,1.10.1,1.10.2,25,5,36,26,62,8,FALSE
history,1.8.3,1.8.4,19,2,9,9,18,7,FALSE
history,3.2.1,3.3.0,57,119,4711,5415,10126,365,FALSE
history,1.14.0,1.15.0,38,12,257,76,333,24,FALSE
history,3.1.0,3.2.0,55,3,6,3,9,3,FALSE
history,2.0.2,2.1.0,47,1,1237,1154,2391,50,FALSE
history,2.0.1,2.0.2,46,37,1744,2327,4071,174,FALSE
history,1.15.0,1.16.0,39,7,108,37,145,15,FALSE
history,2.0.0,2.0.1,45,17,311,318,629,43,FALSE
history,3.0.0,3.1.0,54,61,1049,674,1723,99,FALSE
history,1.16.0,1.17.0,40,10,97,59,156,19,FALSE
history,2.0.0-rc3,2.0.0,44,9,91,42,133,22,FALSE
history,1.17.0,2.0.0-rc1,41,5,38,8,46,6,FALSE
history,2.0.0-rc1,2.0.0-rc2,42,4,106,33,139,10,FALSE
history,3.0.0-2,3.0.0,53,31,364,161,525,55,TRUE
history,2.1.0,2.1.1,48,14,247,152,399,26,FALSE
history,3.0.0-0,3.0.0-1,51,19,124,179,303,28,FALSE
history,2.1.1,2.1.2,49,20,120,91,211,31,FALSE
history,3.0.0-1,3.0.0-2,52,3,11,3,14,3,FALSE
history,3.2.0,3.2.1,56,3,71,57,128,3,FALSE
history,2.0.0-rc2,2.0.0-rc3,43,21,332,71,403,35,FALSE
history,1.1.0,1.2.0,3,18,747,458,1205,48,FALSE
history,1.0.0,1.1.0,2,16,69,60,129,22,FALSE
history,1.13.1,1.14.0,37,34,1714,518,2232,136,FALSE
history,1.2.2,1.3.0,6,3,919,151,1070,14,FALSE
history,1.2.0,1.2.1,4,4,23,25,48,8,FALSE
history,1.2.1,1.2.2,5,3,20,32,52,7,FALSE
history,4.4.1,4.5.0,69,5,138,12,150,9,FALSE
history,3.0.0-2,3.0.0,53,31,364,161,525,55,FALSE
history,4.0.1,4.1.0,63,5,68,4,72,12,FALSE
history,4.0.0,4.0.1,62,4,4,4,8,4,FALSE
history,4.1.0,4.2.0,64,4,38,17,55,8,FALSE
history,4.0.0-0,4.0.0-1,59,13,393,151,544,42,FALSE
history,4.0.0-1,4.0.0-2,60,16,437,349,786,51,FALSE
history,4.0.0-2,4.0.0,61,12,272,67,339,26,FALSE
history,4.6.0,4.6.1,72,3,86,28,114,8,FALSE
history,4.5.1,4.6.0,71,24,4548,184,4732,60,FALSE
history,4.5.0,4.5.1,70,4,19,9,28,5,FALSE
history,1.11.1,1.12.0,28,8,190,56,246,26,TRUE
history,4.4.0,4.4.1,68,4,25,7,32,6,FALSE
history,4.2.1,4.3.0,66,6,106,24,130,21,FALSE
history,4.2.0,4.2.1,65,6,145,17,162,8,FALSE
history,4.3.0,4.4.0,67,6,16,36,52,7,FALSE
history,1.12.6,1.13.0,35,16,91,59,150,20,TRUE
history,4.2.0,4.2.1,65,6,145,17,162,8,TRUE
history,4.6.0,4.6.1,72,3,86,28,114,8,TRUE
history,1.8.3,1.8.4,19,2,9,9,18,7,TRUE
history,1.1.0,1.2.0,3,18,747,458,1205,48,TRUE
history,2.0.2,2.1.0,47,1,1237,1154,2391,50,TRUE
history,3.0.0-0,3.0.0-1,51,19,124,179,303,28,TRUE
history,1.15.0,1.16.0,39,7,108,37,145,15,TRUE
history,1.8.5,1.9.0,21,9,64,2205,2269,17,TRUE
history,1.12.0,1.12.1,29,11,126,156,282,20,TRUE
history,1.12.5,1.12.6,34,16,97,33,130,25,TRUE
history,2.0.0-rc3,2.0.0,44,9,91,42,133,22,TRUE
history,1.13.0,1.13.1,36,47,1861,838,2699,131,TRUE
history,4.4.1,4.5.0,69,5,138,12,150,9,TRUE
history,4.0.0-1,4.0.0-2,60,16,437,349,786,51,TRUE
history,1.5.0,1.6.0,13,5,153,79,232,12,TRUE
history,4.5.0,4.5.1,70,4,19,9,28,5,TRUE
history,4.3.0,4.4.0,67,6,16,36,52,7,TRUE
history,1.0.0,1.1.0,2,16,69,60,129,22,TRUE
history,1.8.4,1.8.5,20,11,1030,997,2027,75,TRUE
history,1.8.0,1.8.1,16,4,30,25,55,6,TRUE
history,1.12.2,1.12.3,31,12,343,40,383,27,TRUE
angular-autogrowjs,1.0.0,1.0.1,1,7,32,23,55,7,TRUE
eslint-config-brightspace,0.0.1,0.0.2,1,2,8,4,12,2,FALSE
eslint-config-brightspace,0.0.3,0.1.0,3,6,70,20,90,12,FALSE
eslint-config-brightspace,0.0.2,0.0.3,2,3,5,3,8,3,FALSE
eslint-config-brightspace,0.2.3,0.2.4,8,3,3,3,6,3,FALSE
eslint-config-brightspace,0.2.2,0.2.3,7,1,1,1,2,1,FALSE
eslint-config-brightspace,0.2.1,0.2.2,6,4,43,1,44,5,FALSE
eslint-config-brightspace,0.2.0,0.2.1,5,2,48,6,54,6,TRUE
eslint-config-brightspace,0.1.0,0.2.0,4,4,8,16,24,6,FALSE
eslint-config-brightspace,0.2.0,0.2.1,5,2,48,6,54,6,FALSE
fis-msprd-vue_2_0_4,2.0.5,2.0.6,2,1,1,1,2,1,FALSE
fis-msprd-vue_2_0_4,2.0.4,2.0.5,1,1,1,1,2,1,FALSE
fis-msprd-vue_2_0_4,2.0.4,2.0.5,1,1,1,1,2,1,TRUE
react-component-grid,0.1.0,0.1.1,11,11,1879,614,2493,85,FALSE
react-component-grid,0.1.1,0.2.0,12,13,2146,598,2744,70,FALSE
react-component-grid,0.2.0,0.2.2,13,8,2034,597,2631,39,FALSE
react-component-grid,0.0.5,0.0.6,4,1,66,102,168,5,FALSE
react-component-grid,0.0.4,0.0.5,3,1,66,102,168,5,FALSE
react-component-grid,0.0.7,0.0.8,6,1,66,102,168,5,FALSE
react-component-grid,0.0.6,0.0.7,5,1,66,102,168,5,FALSE
react-component-grid,0.0.1,0.0.2,1,1,66,102,168,5,FALSE
react-component-grid,0.0.2,0.0.4,2,1,66,102,168,5,FALSE
react-component-grid,0.0.9,0.0.10,8,1,66,102,168,5,FALSE
react-component-grid,0.0.8,0.0.9,7,1,66,102,168,5,FALSE
react-component-grid,0.0.10,0.0.11,9,1,66,102,168,5,FALSE
react-component-grid,0.1.0,0.1.1,11,11,1879,614,2493,85,TRUE
react-component-grid,0.0.11,0.1.0,10,6,987,5,992,41,FALSE
cursor-position-notifier,0.0.5,0.0.6,5,1,2,2,4,2,FALSE
cursor-position-notifier,0.0.4,0.0.5,4,1,11881,6,11887,7,FALSE
cursor-position-notifier,0.0.7,0.0.8,7,1,76,85,161,3,FALSE
cursor-position-notifier,0.0.6,0.0.7,6,1,2,2,4,2,FALSE
cursor-position-notifier,0.0.1,0.0.2,1,1,6,6,12,2,FALSE
cursor-position-notifier,0.0.3,0.0.4,3,1,119,9,128,2,FALSE
cursor-position-notifier,0.0.2,0.0.3,2,1,16,10,26,2,FALSE
cursor-position-notifier,0.0.9,0.1.0,9,2,176,18,194,5,FALSE
cursor-position-notifier,0.0.8,0.0.9,8,1,33,19,52,3,FALSE
cursor-position-notifier,0.1.0,0.1.1,10,1,1,1,2,1,FALSE
cursor-position-notifier,0.1.1,0.1.2,11,4,20,103,123,6,FALSE
cursor-position-notifier,0.0.3,0.0.4,3,1,119,9,128,2,TRUE
prelude-es6,0.3.1,0.3.2,34,7,103,24,127,14,FALSE
prelude-es6,0.2.7,0.3.0,32,5,2070,18,2088,252,FALSE
prelude-es6,0.2.6,0.2.7,31,4,13,2,15,4,FALSE
prelude-es6,0.2.5,0.2.6,30,4,23,2,25,5,FALSE
prelude-es6,0.2.4,0.2.5,29,12,15,11,26,12,FALSE
prelude-es6,0.2.3,0.2.4,28,4,12,2,14,4,FALSE
prelude-es6,0.2.2,0.2.3,27,4,10,2,12,4,FALSE
prelude-es6,0.2.1,0.2.2,26,4,10,2,12,4,FALSE
prelude-es6,0.2.0,0.2.1,25,4,33,4,37,6,FALSE
prelude-es6,0.1.24,0.1.25,23,5,6,4,10,5,FALSE
prelude-es6,0.3.8,0.3.9,41,4,130,252,382,196,FALSE
prelude-es6,0.3.9,0.3.10,42,5,37,13,50,7,FALSE
prelude-es6,0.3.2,0.3.3,35,10,48,11,59,11,FALSE
prelude-es6,0.1.22,0.1.23,21,3,4,3,7,3,FALSE
prelude-es6,0.3.0,0.3.1,33,4,99,54,153,47,FALSE
prelude-es6,0.1.20,0.1.21,19,7,32,24,56,12,FALSE
prelude-es6,0.3.6,0.3.7,39,7,52,15,67,11,FALSE
prelude-es6,0.3.7,0.3.8,40,4,57,3,60,10,FALSE
prelude-es6,0.3.4,0.3.5,37,2,2,2,4,2,FALSE
prelude-es6,0.3.5,0.3.6,38,5,47,3,50,5,FALSE
prelude-es6,0.3.18,0.3.19,51,5,39,3,42,5,FALSE
prelude-es6,0.3.19,0.3.20,52,8,62,123,185,17,FALSE
prelude-es6,0.3.14,0.3.15,47,3,127,16,143,4,FALSE
prelude-es6,0.3.15,0.3.16,48,5,78,6,84,12,FALSE
prelude-es6,0.3.16,0.3.17,49,8,224,8,232,17,FALSE
prelude-es6,0.3.17,0.3.18,50,10,129,30,159,15,FALSE
prelude-es6,0.3.10,0.3.11,43,6,67,5,72,7,FALSE
prelude-es6,0.3.11,0.3.12,44,4,53,29,82,8,FALSE
prelude-es6,0.3.12,0.3.13,45,17,253,56,309,25,FALSE
prelude-es6,0.1.25,0.2.0,24,3,9,9,18,128,FALSE
prelude-es6,0.1.23,0.1.24,22,5,70,11,81,29,FALSE
prelude-es6,0.3.3,0.3.4,36,2,4,3,7,3,FALSE
prelude-es6,0.3.13,0.3.14,46,14,166,124,290,19,FALSE
prelude-es6,0.1.21,0.1.22,20,4,331,165,496,112,FALSE
prelude-es6,0.1.8,0.1.9,8,21,79,37,116,22,FALSE
prelude-es6,0.1.9,0.1.10,9,49,3299,3129,6428,90,FALSE
prelude-es6,0.2.5,0.2.6,30,4,23,2,25,5,TRUE
prelude-es6,0.1.1,0.1.2,1,3,13,5,18,3,FALSE
prelude-es6,0.1.2,0.1.3,2,14,111,50,161,17,FALSE
prelude-es6,0.1.3,0.1.4,3,17,135,32,167,17,FALSE
prelude-es6,0.1.4,0.1.5,4,4,6,1,7,4,FALSE
prelude-es6,0.1.5,0.1.6,5,2,2,2,4,2,FALSE
prelude-es6,0.1.6,0.1.7,6,7,105,6,111,11,FALSE
prelude-es6,0.1.7,0.1.8,7,13,120,145,265,17,FALSE
prelude-es6,0.1.15,0.1.16,14,3,4,2,6,3,FALSE
prelude-es6,0.1.12,0.1.14,12,11,16,9,25,11,FALSE
prelude-es6,0.1.10,0.1.11,10,5,33,9,42,6,FALSE
prelude-es6,0.1.11,0.1.12,11,2,26,1,27,2,FALSE
prelude-es6,0.1.16,0.1.17,15,5,37,4,41,5,FALSE
prelude-es6,0.1.17,0.1.18,16,6,77,55,132,18,FALSE
prelude-es6,0.1.14,0.1.15,13,4,5,2,7,4,FALSE
prelude-es6,0.1.18,0.1.19,17,12,164,98,262,41,FALSE
prelude-es6,0.1.19,0.1.20,18,9,74,42,116,17,FALSE
prelude-es6,0.3.10,0.3.11,43,6,67,5,72,7,TRUE
prelude-es6,0.3.2,0.3.3,35,10,48,11,59,11,TRUE
prelude-es6,0.2.4,0.2.5,29,12,15,11,26,12,TRUE
prelude-es6,0.1.25,0.2.0,24,3,9,9,18,128,TRUE
suitup-ui,0.3.10,0.3.11,24,9,704,176,880,31,FALSE
suitup-ui,0.1.8,0.1.9,9,2,23,15,38,7,FALSE
suitup-ui,0.1.9,0.2.0,10,3,67,100,167,22,FALSE
suitup-ui,0.2.4,0.3.0,15,9,551,75,626,48,FALSE
suitup-ui,0.2.3,0.2.4,14,7,1788,2155,3943,112,FALSE
suitup-ui,0.2.2,0.2.3,13,5,265,153,418,11,FALSE
suitup-ui,0.2.1,0.2.2,12,3,713,475,1188,61,FALSE
suitup-ui,0.2.0,0.2.1,11,3,298,44,342,13,FALSE
suitup-ui,0.1.0,0.1.1,2,2,41,11,52,2,FALSE
suitup-ui,0.1.1,0.1.2,3,6,1124,490,1614,110,FALSE
suitup-ui,0.1.2,0.1.3,4,3,76,20,96,6,FALSE
suitup-ui,0.1.3,0.1.5,5,5,3742,1810,5552,93,FALSE
suitup-ui,0.1.5,0.1.6,6,2,343,252,595,44,FALSE
suitup-ui,0.1.6,0.1.7,7,2,107,40,147,11,FALSE
suitup-ui,0.1.7,0.1.8,8,6,68,23,91,14,FALSE
suitup-ui,0.3.8,0.3.10,23,4,452,139,591,23,FALSE
suitup-ui,0.0.1,0.1.0,1,16,7902,6560,14462,317,FALSE
suitup-ui,0.3.3,0.3.4,18,2,134,114,248,9,FALSE
suitup-ui,0.3.0,0.3.1,16,5,152,220,372,37,FALSE
suitup-ui,0.3.1,0.3.3,17,6,5538,368,5906,87,FALSE
suitup-ui,0.3.6,0.3.7,21,1,3,3,6,1,FALSE
suitup-ui,0.3.7,0.3.8,22,1,3,3,6,1,FALSE
suitup-ui,0.3.4,0.3.5,19,4,175,66,241,19,FALSE
suitup-ui,0.5.1,0.5.2,34,2,4,4,8,5,FALSE
suitup-ui,0.5.4,0.5.5,37,2,67,75,142,9,FALSE
suitup-ui,0.5.5,0.5.6,38,2,20,9,29,7,FALSE
suitup-ui,0.5.6,0.5.7,39,2,71,64,135,6,FALSE
suitup-ui,0.4.5,0.5.0,32,2,293,383,676,17,FALSE
suitup-ui,0.3.11,0.3.12,25,3,61,56,117,7,FALSE
suitup-ui,0.5.2,0.5.3,35,2,165,92,257,24,FALSE
suitup-ui,0.5.3,0.5.4,36,2,10,6,16,7,FALSE
suitup-ui,0.4.1,0.4.2,28,2,26,8,34,10,FALSE
suitup-ui,0.4.0,0.4.1,27,3,93,69,162,47,FALSE
suitup-ui,0.4.3,0.4.4,30,2,7,9,16,7,FALSE
suitup-ui,0.4.2,0.4.3,29,2,5,5,10,5,FALSE
suitup-ui,0.5.0,0.5.1,33,6,262,141,403,34,FALSE
suitup-ui,0.4.4,0.4.5,31,2,127,80,207,12,FALSE
suitup-ui,0.3.12,0.4.0,26,3,1012,5305,6317,138,FALSE
suitup-ui,0.4.5,0.5.0,32,2,293,383,676,17,TRUE
suitup-ui,0.4.4,0.4.5,31,2,127,80,207,12,TRUE
suitup-ui,0.2.2,0.2.3,13,5,265,153,418,11,TRUE
suitup-ui,0.1.3,0.1.5,5,5,3742,1810,5552,93,TRUE
suitup-ui,0.5.0,0.5.1,33,6,262,141,403,34,TRUE
suitup-ui,0.5.1,0.5.2,34,2,4,4,8,5,TRUE
suitup-ui,0.1.5,0.1.6,6,2,343,252,595,44,TRUE
suitup-ui,0.1.6,0.1.7,7,2,107,40,147,11,TRUE
suitup-ui,0.4.1,0.4.2,28,2,26,8,34,10,TRUE
suitup-ui,0.1.2,0.1.3,4,3,76,20,96,6,TRUE
suitup-ui,0.3.0,0.3.1,16,5,152,220,372,37,TRUE
suitup-ui,0.3.12,0.4.0,26,3,1012,5305,6317,138,TRUE
suitup-ui,0.0.1,0.1.0,1,16,7902,6560,14462,317,TRUE
suitup-ui,0.3.1,0.3.3,17,6,5538,368,5906,87,TRUE
appirio-tech-client-app-layer,0.0.5,0.0.6,2,3,31,43,74,9,TRUE
appirio-tech-client-app-layer,0.0.4,0.0.5,1,2,12,0,12,2,FALSE
appirio-tech-client-app-layer,0.0.7,0.0.8,4,1,76,23,99,5,FALSE
appirio-tech-client-app-layer,0.0.6,0.0.7,3,1,4,3,7,1,FALSE
appirio-tech-client-app-layer,0.0.9,0.1.0,6,32,2523,1024,3547,144,FALSE
appirio-tech-client-app-layer,0.0.8,0.0.9,5,1,1,1,2,1,FALSE
appirio-tech-client-app-layer,0.1.0,0.1.1,7,1,1,1,2,1,FALSE
appirio-tech-client-app-layer,0.1.1,0.1.2,8,1,23,25,48,3,FALSE
appirio-tech-client-app-layer,0.1.2,0.1.3,9,1,0,1,1,1,FALSE
appirio-tech-client-app-layer,0.0.5,0.0.6,2,3,31,43,74,9,FALSE
appirio-tech-client-app-layer,0.0.9,0.1.0,6,32,2523,1024,3547,144,TRUE
appirio-tech-client-app-layer,0.1.1,0.1.2,8,1,23,25,48,3,TRUE
appirio-tech-client-app-layer,0.1.0,0.1.1,7,1,1,1,2,1,TRUE
pxt-core,1.3.14,1.3.15,730,2,2,1,3,2,FALSE
pxt-core,1.0.4,1.0.5,625,1,1,1,2,1,FALSE
pxt-core,0.10.6,0.10.7,460,4,7,39,46,5,FALSE
pxt-core,1.0.5,1.0.6,626,2,3,3,6,2,FALSE
pxt-core,1.0.6,1.0.7,627,2,159,90,249,8,FALSE
pxt-core,1.0.7,1.0.8,628,3,128,18,146,7,FALSE
pxt-core,1.0.1,1.0.2,622,2,49,21,70,6,FALSE
pxt-core,0.12.19,0.12.20,568,2,413,6,419,7,FALSE
pxt-core,0.12.18,0.12.19,567,7,166,25,191,23,FALSE
pxt-core,1.0.2,1.0.3,623,3,58,28,86,7,FALSE
pxt-core,0.12.13,0.12.14,562,3,35,18,53,3,FALSE
pxt-core,0.12.12,0.12.13,561,5,101567,114,101681,71,FALSE
pxt-core,0.12.11,0.12.12,560,4,250,70,320,14,FALSE
pxt-core,0.12.10,0.12.11,559,8,99,61,160,16,FALSE
pxt-core,0.12.17,0.12.18,566,16,7184,6318,13502,64,FALSE
pxt-core,0.12.16,0.12.17,565,4,208,155,363,13,FALSE
pxt-core,0.12.15,0.12.16,564,9,90,62,152,15,FALSE
pxt-core,0.12.14,0.12.15,563,2,12,12,24,2,FALSE
pxt-core,0.10.15,0.10.16,469,41,4767,62894,67661,241,FALSE
pxt-core,0.10.14,0.10.15,468,2,224,111,335,14,FALSE
pxt-core,0.10.11,0.10.12,465,3,62,4,66,6,FALSE
pxt-core,0.10.10,0.10.11,464,9,64,129,193,21,FALSE
pxt-core,0.10.13,0.10.14,467,4,109,49,158,17,FALSE
pxt-core,0.3.79,0.3.80,219,2,20,3,23,2,FALSE
pxt-core,0.3.76,0.3.77,217,6,84,38,122,10,FALSE
pxt-core,0.3.77,0.3.79,218,8,155,43,198,17,FALSE
pxt-core,0.3.74,0.3.75,215,8,259,209,468,10,FALSE
pxt-core,0.3.75,0.3.76,216,5,261,211,472,10,FALSE
pxt-core,0.3.72,0.3.74,214,13,1201,198,1399,42,FALSE
pxt-core,0.3.70,0.3.71,212,2,1,1,2,2,FALSE
pxt-core,0.3.71,0.3.72,213,4,5,5,10,4,FALSE
pxt-core,0.2.139,0.2.140,89,2,9,6,15,2,FALSE
pxt-core,0.2.138,0.2.139,88,7,36,125,161,9,FALSE
pxt-core,0.2.131,0.2.132,82,8,71,65,136,13,FALSE
pxt-core,0.2.130,0.2.131,81,4,73,38,111,5,FALSE
pxt-core,0.2.133,0.2.134,84,2,45,7,52,7,FALSE
pxt-core,0.2.132,0.2.133,83,3,21,14,35,4,FALSE
pxt-core,0.2.135,0.2.137,86,5,14,9,23,5,FALSE
pxt-core,0.2.134,0.2.135,85,4,35,24,59,16,FALSE
pxt-core,0.2.137,0.2.138,87,3,14,3,17,5,FALSE
pxt-core,0.5.78,0.5.79,391,2,2,2,4,3,FALSE
pxt-core,0.5.79,0.5.80,392,2,15,12,27,2,FALSE
pxt-core,0.5.74,0.5.75,387,16,32721,4501,37222,92,FALSE
pxt-core,0.5.75,0.5.76,388,6,27,4489,4516,13,FALSE
pxt-core,0.5.76,0.5.77,389,35,9359,61637,70996,240,FALSE
pxt-core,0.5.77,0.5.78,390,2,2,1,3,2,FALSE
pxt-core,0.5.70,0.5.71,383,3,201,1657,1858,39,FALSE
pxt-core,0.5.71,0.5.72,384,5,11,10,21,6,FALSE
pxt-core,0.5.72,0.5.73,385,5,726,373,1099,16,FALSE
pxt-core,0.5.73,0.5.74,386,5,64,18,82,5,FALSE
pxt-core,0.5.68,0.5.69,381,4,69,44,113,5,FALSE
pxt-core,0.2.125,0.2.126,76,8,80,36,116,17,FALSE
pxt-core,1.0.30,1.0.31,651,2,22,2,24,3,FALSE
pxt-core,0.11.62,0.11.63,532,4,13,15,28,6,FALSE
pxt-core,0.11.61,0.11.62,531,34,644,275,919,61,FALSE
pxt-core,1.0.33,1.1.1,654,4,175,18,193,12,FALSE
pxt-core,0.11.67,0.11.68,537,24,1398,224,1622,62,FALSE
pxt-core,0.11.66,0.11.67,536,2,52,29,81,4,FALSE
pxt-core,0.11.65,0.11.66,535,8,275,58,333,14,FALSE
pxt-core,0.11.64,0.11.65,534,13,65,26,91,18,FALSE
pxt-core,0.11.69,0.11.70,539,1,6,2,8,1,FALSE
pxt-core,0.11.68,0.11.69,538,1,3,3,6,2,FALSE
pxt-core,0.5.61,0.5.62,374,2,2,2,4,2,FALSE
pxt-core,0.4.11,0.4.12,252,2,2,2,4,2,FALSE
pxt-core,0.4.10,0.4.11,251,2,20,16,36,3,FALSE
pxt-core,0.4.13,0.4.15,254,10,199,51,250,24,FALSE
pxt-core,0.4.12,0.4.13,253,3,84,81,165,3,FALSE
pxt-core,0.4.15,0.4.16,255,3,3,3,6,3,FALSE
pxt-core,0.5.101,0.5.102,414,2,2,2,4,2,FALSE
pxt-core,0.4.17,0.4.18,257,4,8,8,16,4,FALSE
pxt-core,0.4.16,0.4.17,256,20,555,162,717,25,FALSE
pxt-core,0.4.19,0.4.20,259,9,53,13,66,12,FALSE
pxt-core,0.4.18,0.4.19,258,2,5,2,7,2,FALSE
pxt-core,1.3.27,1.3.28,743,6,400,99,499,12,FALSE
pxt-core,0.5.65,0.5.66,378,3,18,16,34,3,FALSE
pxt-core,0.5.64,0.5.65,377,5,19,46,65,8,FALSE
pxt-core,1.1.55,1.1.56,709,2,77,7,84,4,FALSE
pxt-core,1.1.54,1.1.55,708,2,1,2,3,2,FALSE
pxt-core,1.1.57,1.1.58,711,4,15,6,21,5,FALSE
pxt-core,1.1.56,1.1.57,710,7,85,112,197,20,FALSE
pxt-core,1.1.51,1.1.52,705,5,21,15,36,10,FALSE
pxt-core,1.1.50,1.1.51,704,4,97,51,148,12,FALSE
pxt-core,1.1.53,1.1.54,707,4,30,14,44,6,FALSE
pxt-core,1.1.52,1.1.53,706,4,5,3,8,6,FALSE
pxt-core,1.1.58,1.2.1,712,7,37152,37043,74195,11,FALSE
pxt-core,1.1.28,1.1.29,682,21,1437,1506,2943,123,FALSE
pxt-core,1.1.29,1.1.30,683,2,3,12,15,4,FALSE
pxt-core,0.5.96,0.5.97,409,3,273,181,454,13,FALSE
pxt-core,0.5.97,0.5.98,410,3,43,12,55,5,FALSE
pxt-core,0.5.94,0.5.95,407,4,73,45,118,7,FALSE
pxt-core,0.5.95,0.5.96,408,3,6,3,9,4,FALSE
pxt-core,0.5.92,0.5.93,405,6,264,64,328,18,FALSE
pxt-core,0.5.93,0.5.94,406,5,129,108,237,8,FALSE
pxt-core,0.5.90,0.5.91,403,5,97,25,122,10,FALSE
pxt-core,0.2.185,0.2.186,132,2,28,30,58,5,FALSE
pxt-core,1.0.14,1.0.15,635,5,18,7,25,5,FALSE
pxt-core,0.5.98,0.5.99,411,2,15,2,17,2,FALSE
pxt-core,0.5.99,0.5.100,412,11,1283,217,1500,57,FALSE
pxt-core,1.0.15,1.0.16,636,2,9,3,12,3,FALSE
pxt-core,1.0.12,1.0.13,633,2,13,3,16,2,FALSE
pxt-core,1.0.13,1.0.14,634,2,14,11,25,5,FALSE
pxt-core,1.0.10,1.0.11,631,7,197,106,303,21,FALSE
pxt-core,1.0.11,1.0.12,632,4,13,15,28,6,FALSE
pxt-core,0.2.179,0.2.180,127,3,59,5,64,5,FALSE
pxt-core,0.2.178,0.2.179,126,5,3793,1630,5423,94,FALSE
pxt-core,0.2.175,0.2.176,123,4,63,17,80,11,FALSE
pxt-core,0.2.174,0.2.175,122,2,34,11,45,3,FALSE
pxt-core,0.2.177,0.2.178,125,3,4,3,7,3,FALSE
pxt-core,0.2.176,0.2.177,124,2,3,3,6,2,FALSE
pxt-core,0.2.171,0.2.172,119,2,5,5,10,4,FALSE
pxt-core,0.2.170,0.2.171,118,5,77,33,110,7,FALSE
pxt-core,0.2.173,0.2.174,121,7,71,46,117,11,FALSE
pxt-core,0.2.172,0.2.173,120,9,32,33,65,10,FALSE
pxt-core,0.12.44,0.12.45,584,10,108,64,172,17,FALSE
pxt-core,0.12.45,0.12.46,585,9,169,70,239,25,FALSE
pxt-core,0.12.46,0.12.47,586,10,330,129,459,31,FALSE
pxt-core,0.12.47,0.12.48,587,11,270,252,522,24,FALSE
pxt-core,0.12.40,0.12.41,580,4,1099,839,1938,50,FALSE
pxt-core,0.12.41,0.12.42,581,1,135,21,156,13,FALSE
pxt-core,0.12.42,0.12.43,582,1,1,1,2,1,FALSE
pxt-core,0.12.43,0.12.44,583,3,18,9,27,5,FALSE
pxt-core,0.12.48,0.12.49,588,5,118,21,139,11,FALSE
pxt-core,0.12.49,0.12.50,589,5,7,7,14,6,FALSE
pxt-core,0.11.38,0.11.39,508,2,8,9,17,3,FALSE
pxt-core,0.11.39,0.11.40,509,3,731,147,878,14,FALSE
pxt-core,0.11.34,0.11.35,504,2,6,9,15,3,FALSE
pxt-core,0.11.35,0.11.36,505,2,23,31,54,2,FALSE
pxt-core,0.11.36,0.11.37,506,2,46,93,139,5,FALSE
pxt-core,0.11.37,0.11.38,507,3,6,4,10,3,FALSE
pxt-core,0.11.30,0.11.31,500,6,345,92,437,23,FALSE
pxt-core,0.11.31,0.11.32,501,4,13,10,23,6,FALSE
pxt-core,0.11.32,0.11.33,502,7,115,153,268,22,FALSE
pxt-core,0.11.33,0.11.34,503,2,8,11,19,2,FALSE
pxt-core,0.7.8,0.7.9,430,3,5,5,10,3,FALSE
pxt-core,0.7.9,0.7.10,431,8,378,25,403,18,FALSE
pxt-core,0.7.6,0.7.7,428,3,80,19,99,8,FALSE
pxt-core,0.7.7,0.7.8,429,2,46,64,110,3,FALSE
pxt-core,0.7.4,0.7.5,426,4,67,8,75,6,FALSE
pxt-core,0.7.5,0.7.6,427,10,481,237,718,34,FALSE
pxt-core,0.7.2,0.7.3,424,6,745,239,984,35,FALSE
pxt-core,0.7.3,0.7.4,425,4,83,24,107,15,FALSE
pxt-core,0.7.1,0.7.2,423,3,35,27,62,5,FALSE
pxt-core,0.3.32,0.3.33,178,12,389,179,568,31,FALSE
pxt-core,0.3.33,0.3.34,179,4,75,21,96,7,FALSE
pxt-core,0.3.30,0.3.31,176,2,4,2,6,3,FALSE
pxt-core,0.3.31,0.3.32,177,2,5,3,8,2,FALSE
pxt-core,0.5.8,0.5.9,322,2,2,2,4,2,FALSE
pxt-core,0.3.37,0.3.38,183,2,19,9,28,2,FALSE
pxt-core,0.3.34,0.3.35,180,9,148,51,199,22,FALSE
pxt-core,0.3.35,0.3.36,181,4,64,42,106,10,FALSE
pxt-core,0.5.4,0.5.5,318,3,104,43,147,5,FALSE
pxt-core,0.5.5,0.5.6,319,1,3,3,6,2,FALSE
pxt-core,0.5.6,0.5.7,320,4,228,144,372,11,FALSE
pxt-core,0.3.39,0.3.40,185,8,186134,798,186932,124,FALSE
pxt-core,0.5.1,0.5.2,315,3,17,13,30,4,FALSE
pxt-core,0.5.2,0.5.3,316,13,1636,319,1955,418,FALSE
pxt-core,0.5.3,0.5.4,317,2,42,42,84,2,FALSE
pxt-core,0.5.27,0.5.28,341,2,4,2,6,2,FALSE
pxt-core,0.5.26,0.5.27,340,2,2,3,5,2,FALSE
pxt-core,0.5.25,0.5.26,339,2,131,131,262,4,FALSE
pxt-core,0.5.24,0.5.25,338,5,205,118,323,10,FALSE
pxt-core,0.5.23,0.5.24,337,3,4,5,9,3,FALSE
pxt-core,0.5.22,0.5.23,336,5,19926,19288,39214,147,FALSE
pxt-core,0.5.21,0.5.22,335,3,6,4,10,4,FALSE
pxt-core,0.5.20,0.5.21,334,7,215,104,319,17,FALSE
pxt-core,0.11.77,0.11.78,547,2,24,22,46,2,FALSE
pxt-core,0.5.29,0.5.30,343,4,25,21,46,9,FALSE
pxt-core,0.5.28,0.5.29,342,4,855,626,1481,12,TRUE
pxt-core,0.11.78,0.11.79,548,3,13,3,16,3,FALSE
pxt-core,1.0.26,1.0.27,647,6,2244,107,2351,67,FALSE
pxt-core,0.2.197,0.2.199,143,4,7,4,11,4,FALSE
pxt-core,1.3.12,1.3.14,729,6,105,45,150,13,FALSE
pxt-core,0.2.195,0.2.196,141,55,3780,2249,6029,146,FALSE
pxt-core,0.2.194,0.2.195,140,6,193,21,214,7,FALSE
pxt-core,0.2.193,0.2.194,139,27,1241,383,1624,81,FALSE
pxt-core,1.3.16,1.3.17,732,2,2,1,3,2,FALSE
pxt-core,1.3.15,1.3.16,731,2,13,21,34,3,FALSE
pxt-core,0.2.190,0.2.191,137,8,164,113,277,13,FALSE
pxt-core,1.1.11,1.1.12,665,2,67,73,140,3,FALSE
pxt-core,1.1.10,1.1.11,664,12,349,131,480,30,FALSE
pxt-core,1.1.13,1.1.14,667,2,12,12,24,2,FALSE
pxt-core,1.1.12,1.1.13,666,6,101535,59,101594,71,FALSE
pxt-core,1.1.15,1.1.16,669,3,162,128,290,9,FALSE
pxt-core,1.1.14,1.1.15,668,9,90,62,152,15,FALSE
pxt-core,1.1.17,1.1.18,671,11,7173,6311,13484,58,FALSE
pxt-core,1.1.16,1.1.17,670,6,57,34,91,10,FALSE
pxt-core,0.4.68,0.4.69,306,2,11,8,19,2,FALSE
pxt-core,0.4.69,0.4.70,307,3,7,7,14,3,FALSE
pxt-core,0.4.60,0.4.61,298,2,2,1,3,2,FALSE
pxt-core,0.4.61,0.4.62,299,2,27,17,44,6,FALSE
pxt-core,0.4.62,0.4.63,300,5,183,60,243,11,FALSE
pxt-core,0.4.63,0.4.64,301,3,9566,9460,19026,36,FALSE
pxt-core,0.4.64,0.4.65,302,2,69,2,71,5,FALSE
pxt-core,0.4.65,0.4.66,303,8,157,99,256,15,FALSE
pxt-core,0.4.66,0.4.67,304,4,14,10,24,4,FALSE
pxt-core,0.4.67,0.4.68,305,3,557,56,613,9,FALSE
pxt-core,0.3.8,0.3.9,155,20,2577,174,2751,53,FALSE
pxt-core,0.3.9,0.3.10,156,7,19,6,25,7,FALSE
pxt-core,1.5.19,1.5.20,770,4,496,337,833,12,FALSE
pxt-core,1.5.18,1.5.19,769,2,1,6,7,2,FALSE
pxt-core,1.5.15,1.5.17,767,7,529,413,942,32,FALSE
pxt-core,1.5.14,1.5.15,766,7,3146,2390,5536,176,FALSE
pxt-core,1.5.17,1.5.18,768,10,146,35,181,19,FALSE
pxt-core,1.5.11,1.5.12,763,3,4,5,9,5,FALSE
pxt-core,1.5.10,1.5.11,762,13,6635,54,6689,30,FALSE
pxt-core,1.5.13,1.5.14,765,4,17,9,26,4,FALSE
pxt-core,0.3.5,0.3.7,153,31,2811,778,3589,115,FALSE
pxt-core,0.3.36,0.3.37,182,3,30,13,43,5,FALSE
pxt-core,0.5.9,0.5.10,323,3,29,10,39,5,FALSE
pxt-core,0.3.38,0.3.39,184,3,19,16,35,5,FALSE
pxt-core,0.5.7,0.5.8,321,2,4,3,7,2,FALSE
pxt-core,0.5.69,0.5.70,382,4,326,367,693,34,FALSE
pxt-core,0.2.44,0.2.45,2,2,4,4,8,3,FALSE
pxt-core,0.2.45,0.2.46,3,2,6,4,10,2,FALSE
pxt-core,0.2.46,0.2.47,4,2,25,5,30,4,FALSE
pxt-core,0.2.47,0.2.48,5,4,158,61,219,14,FALSE
pxt-core,0.2.43,0.2.44,1,2,92,92,184,20,FALSE
pxt-core,0.2.48,0.2.49,6,13,531,152,683,47,FALSE
pxt-core,0.2.49,0.2.50,7,5,144,77,221,16,TRUE
pxt-core,0.5.67,0.5.68,380,4,14,45,59,8,TRUE
pxt-core,0.3.68,0.3.70,211,10,71,64,135,26,FALSE
pxt-core,0.9.1,0.9.2,450,4,367,252,619,10,FALSE
pxt-core,0.3.65,0.3.66,208,2,1,10,11,4,FALSE
pxt-core,0.3.64,0.3.65,207,7,136,49,185,12,FALSE
pxt-core,0.3.67,0.3.68,210,2,7,2,9,3,FALSE
pxt-core,0.3.66,0.3.67,209,3,27,18,45,8,FALSE
pxt-core,0.3.61,0.3.62,204,23,1336,742,2078,156,FALSE
pxt-core,0.9.2,0.9.3,451,4,8,2,10,4,FALSE
pxt-core,0.3.63,0.3.64,206,2,2,1,3,2,FALSE
pxt-core,0.3.62,0.3.63,205,2,8,3,11,4,FALSE
pxt-core,0.2.126,0.2.127,77,4,70,15,85,5,FALSE
pxt-core,0.2.127,0.2.128,78,3,3,2,5,3,FALSE
pxt-core,0.2.124,0.2.125,75,10,151,169,320,17,FALSE
pxt-core,0.9.3,0.9.4,452,6,169,127,296,12,FALSE
pxt-core,0.2.122,0.2.123,73,11,706,24,730,25,FALSE
pxt-core,0.2.123,0.2.124,74,3,51,20,71,5,FALSE
pxt-core,0.2.120,0.2.121,71,9,294,78,372,17,FALSE
pxt-core,0.2.121,0.2.122,72,4,39,11,50,9,FALSE
pxt-core,0.9.4,0.9.5,453,3,18,7,25,3,FALSE
pxt-core,0.2.128,0.2.129,79,2,4,4,8,3,FALSE
pxt-core,0.2.129,0.2.130,80,9,186,68,254,15,FALSE
pxt-core,1.0.3,1.0.4,624,3,12,2,14,3,FALSE
pxt-core,1.3.28,1.3.29,744,2,56,23,79,3,FALSE
pxt-core,1.3.29,1.3.30,745,2,2,2,4,2,FALSE
pxt-core,0.5.63,0.5.64,376,1,1,1,2,1,FALSE
pxt-core,1.3.23,1.3.24,739,4,13,8,21,4,FALSE
pxt-core,1.3.20,1.3.21,736,2,2,2,4,2,FALSE
pxt-core,0.5.60,0.5.61,373,6,2976,658,3634,21,FALSE
pxt-core,1.3.26,1.3.27,742,2,12,6,18,2,FALSE
pxt-core,0.5.66,0.5.67,379,3,40,11,51,5,FALSE
pxt-core,1.3.24,1.3.25,740,1,3,3,6,2,FALSE
pxt-core,1.3.25,1.3.26,741,2,2,2,4,2,FALSE
pxt-core,0.11.8,0.11.9,478,4,4,4,8,4,FALSE
pxt-core,0.11.9,0.11.10,479,11,623,573,1196,25,FALSE
pxt-core,0.11.70,0.11.71,540,2,15,8,23,6,FALSE
pxt-core,0.11.71,0.11.72,541,4,83,59,142,11,FALSE
pxt-core,0.11.72,0.11.73,542,3,33,71,104,10,FALSE
pxt-core,0.11.73,0.11.74,543,1,2,2,4,1,FALSE
pxt-core,0.11.74,0.11.75,544,3,464,27,491,14,FALSE
pxt-core,0.11.75,0.11.76,545,4,3,6,9,4,FALSE
pxt-core,0.11.76,0.11.77,546,6,2244,107,2351,67,FALSE
pxt-core,1.0.28,1.0.29,649,6,19,43,62,7,FALSE
pxt-core,1.0.27,1.0.28,648,2,24,22,46,2,FALSE
pxt-core,0.11.79,0.12.1,549,26,1014,640,1654,59,FALSE
pxt-core,1.0.25,1.0.26,646,4,3,6,9,4,FALSE
pxt-core,1.0.24,1.0.25,645,16,605,171,776,45,FALSE
pxt-core,1.0.23,1.0.24,644,1,1,1,2,1,FALSE
pxt-core,1.0.22,1.0.23,643,4,17,10,27,6,FALSE
pxt-core,1.0.21,1.0.22,642,11,418,136,554,33,FALSE
pxt-core,1.0.20,1.0.21,641,8,1012,104,1116,24,FALSE
pxt-core,0.4.28,0.4.30,268,7,214,112,326,15,FALSE
pxt-core,0.4.24,0.4.25,264,2,4,4,8,3,FALSE
pxt-core,0.4.25,0.4.26,265,41,29571,144878,174449,292,FALSE
pxt-core,0.4.26,0.4.27,266,8,108,67,175,31,FALSE
pxt-core,0.4.27,0.4.28,267,8,769,47,816,27,FALSE
pxt-core,0.4.20,0.4.21,260,1,3,3,6,2,FALSE
pxt-core,0.4.21,0.4.22,261,10,11366,72428,83794,76,FALSE
pxt-core,0.4.22,0.4.23,262,1,3,3,6,2,FALSE
pxt-core,0.4.23,0.4.24,263,1,3,3,6,2,FALSE
pxt-core,0.12.59,0.12.60,599,22,40521,37307,77828,54,FALSE
pxt-core,0.5.18,0.5.19,332,5,38,27,65,9,FALSE
pxt-core,0.5.19,0.5.20,333,3,23,18,41,5,FALSE
pxt-core,0.5.16,0.5.17,330,2,69,30,99,7,FALSE
pxt-core,0.5.17,0.5.18,331,3,39,6,45,5,FALSE
pxt-core,0.5.14,0.5.15,328,4,1234,809,2043,24,FALSE
pxt-core,0.5.15,0.5.16,329,5,72,14,86,8,FALSE
pxt-core,0.5.12,0.5.13,326,2,47,44,91,11,FALSE
pxt-core,0.5.13,0.5.14,327,2,6,3,9,2,FALSE
pxt-core,0.5.10,0.5.11,324,7,20,104,124,12,FALSE
pxt-core,0.5.11,0.5.12,325,5,101,13,114,10,FALSE
pxt-core,1.1.19,1.1.20,673,11,566,34,600,28,FALSE
pxt-core,0.7.10,0.7.11,432,2,1,2,3,2,FALSE
pxt-core,0.7.11,0.7.12,433,4,21,5,26,6,FALSE
pxt-core,0.7.12,0.7.13,434,5,196,100,296,15,FALSE
pxt-core,0.7.13,0.8.1,435,4,79,110,189,41,FALSE
pxt-core,1.1.18,1.1.19,672,7,166,25,191,23,FALSE
pxt-core,0.9.5,0.10.1,454,6,197,73,270,16,FALSE
pxt-core,0.5.85,0.5.86,398,8,623,267,890,29,FALSE
pxt-core,0.5.84,0.5.85,397,11,100,24,124,14,FALSE
pxt-core,0.5.87,0.5.88,400,3,4,3,7,3,FALSE
pxt-core,0.5.86,0.5.87,399,5,74,68,142,7,FALSE
pxt-core,0.5.81,0.5.82,394,9,112,50,162,19,FALSE
pxt-core,0.5.80,0.5.81,393,5,69,7,76,12,FALSE
pxt-core,0.5.83,0.5.84,396,3,6,10,16,3,FALSE
pxt-core,0.5.82,0.5.83,395,6,506,644,1150,68,FALSE
pxt-core,0.5.89,0.5.90,402,2,21,22,43,4,FALSE
pxt-core,0.5.88,0.5.89,401,5,33,13,46,6,FALSE
pxt-core,0.2.88,0.2.89,43,4,42,10,52,6,FALSE
pxt-core,0.2.89,0.2.90,44,17,1250,597,1847,66,FALSE
pxt-core,0.2.80,0.2.81,37,1,3,3,6,2,FALSE
pxt-core,0.2.81,0.2.82,38,10,365,229,594,30,FALSE
pxt-core,0.2.82,0.2.83,39,3,72,110,182,7,FALSE
pxt-core,0.2.83,0.2.84,40,5,70,58,128,5,FALSE
pxt-core,0.2.84,0.2.85,41,4,8,4,12,4,FALSE
pxt-core,0.2.85,0.2.88,42,11,122,37,159,20,FALSE
pxt-core,1.5.4,1.5.5,756,2,6,2,8,3,FALSE
pxt-core,0.2.168,0.2.169,116,5,10,13,23,7,FALSE
pxt-core,0.2.169,0.2.170,117,1,3,3,6,2,FALSE
pxt-core,0.2.162,0.2.163,110,3,3,3,6,3,FALSE
pxt-core,0.2.163,0.2.164,111,2,4,6,10,2,FALSE
pxt-core,0.2.160,0.2.161,108,3,7,6,13,5,FALSE
pxt-core,0.2.161,0.2.162,109,2,2,2,4,2,FALSE
pxt-core,0.2.166,0.2.167,114,1,1,1,2,1,FALSE
pxt-core,0.2.167,0.2.168,115,8,176,64,240,17,FALSE
pxt-core,0.2.164,0.2.165,112,8,104,22,126,15,FALSE
pxt-core,0.2.165,0.2.166,113,2,2,2,4,2,FALSE
pxt-core,0.12.71,0.12.72,611,3,18,10,28,3,FALSE
pxt-core,0.12.70,0.12.71,610,3,1967,10,1977,45,FALSE
pxt-core,0.12.73,0.12.74,613,1,3,3,6,2,FALSE
pxt-core,0.12.72,0.12.73,612,3,15,4,19,6,FALSE
pxt-core,0.12.75,0.12.76,615,1,3,3,6,2,FALSE
pxt-core,0.10.4,0.10.5,458,5,60,12,72,11,FALSE
pxt-core,0.12.77,0.12.78,617,14,573,231,804,28,FALSE
pxt-core,0.12.76,0.12.77,616,15,6701,50,6751,38,FALSE
pxt-core,0.12.79,0.12.80,619,4,2639,2182,4821,167,FALSE
pxt-core,0.12.78,0.12.79,618,1,1,4,5,1,FALSE
pxt-core,1.3.11,1.3.12,728,2,2302,395,2697,9,FALSE
pxt-core,0.12.3,0.12.4,552,8,157,24,181,14,FALSE
pxt-core,0.12.2,0.12.3,551,8,175,18,193,17,FALSE
pxt-core,0.12.1,0.12.2,550,14,492,535,1027,40,FALSE
pxt-core,1.3.10,1.3.11,727,2,39,22,61,6,FALSE
pxt-core,0.12.7,0.12.8,556,3,98,55,153,8,FALSE
pxt-core,0.12.6,0.12.7,555,7,134,42,176,14,FALSE
pxt-core,0.12.5,0.12.6,554,8,704,183,887,28,FALSE
pxt-core,0.12.4,0.12.5,553,12,695,419,1114,43,FALSE
pxt-core,1.3.17,1.3.18,733,3,3,4,7,4,FALSE
pxt-core,0.12.9,0.12.10,558,1,3,3,6,2,FALSE
pxt-core,0.12.8,0.12.9,557,10,296,196,492,27,FALSE
pxt-core,1.5.7,1.5.8,759,3,1229,107,1336,39,FALSE
pxt-core,0.3.94,0.3.95,233,13,760,440,1200,50,FALSE
pxt-core,1.4.1,1.4.2,749,4,44,12,56,4,FALSE
pxt-core,1.4.2,1.4.3,750,2,4,5,9,2,FALSE
pxt-core,1.4.3,1.4.4,751,2,2,1,3,2,FALSE
pxt-core,1.4.4,1.5.1,752,3,27,8,35,4,FALSE
pxt-core,0.3.91,0.3.92,230,2,2,1,3,2,FALSE
pxt-core,0.3.92,0.3.93,231,16,548,164,712,36,FALSE
pxt-core,0.3.93,0.3.94,232,8,524,240,764,33,FALSE
pxt-core,1.5.1,1.5.2,753,2,9,9,18,2,FALSE
pxt-core,1.5.6,1.5.7,758,6,28,13,41,7,FALSE
pxt-core,0.3.98,0.3.100,237,7,53,69,122,14,FALSE
pxt-core,1.2.4,1.2.5,716,2,2,2,4,2,FALSE
pxt-core,1.2.5,1.3.1,717,15,3012,1030,4042,72,FALSE
pxt-core,1.2.2,1.2.3,714,7,1960,251,2211,31,FALSE
pxt-core,1.2.3,1.2.4,715,2,175,9,184,7,FALSE
pxt-core,1.2.1,1.2.2,713,10,3341,248,3589,33,FALSE
pxt-core,0.11.20,0.11.21,490,2,65,11,76,4,FALSE
pxt-core,1.3.19,1.3.20,735,2,5,4,9,3,FALSE
pxt-core,1.3.18,1.3.19,734,1,3,3,6,2,FALSE
pxt-core,0.2.119,0.2.120,70,4,273,33,306,18,FALSE
pxt-core,1.3.2,1.3.3,719,4,13,5,18,4,FALSE
pxt-core,0.2.117,0.2.119,69,10,190,46,236,20,FALSE
pxt-core,0.2.114,0.2.117,68,23,8193,1687,9880,189,FALSE
pxt-core,0.2.113,0.2.114,67,17,2079,1845,3924,108,FALSE
pxt-core,0.2.112,0.2.113,66,6,221,40,261,15,FALSE
pxt-core,0.2.111,0.2.112,65,4,23,6,29,6,FALSE
pxt-core,0.2.110,0.2.111,64,2,3,2,5,2,FALSE
pxt-core,0.3.21,0.3.22,167,3,20,3,23,4,FALSE
pxt-core,0.5.0-rc1,0.5.1,314,18,635,52,687,29,FALSE
pxt-core,0.3.23,0.3.24,169,2,21,3,24,5,FALSE
pxt-core,0.3.22,0.3.23,168,25,4559,1344,5903,268,FALSE
pxt-core,0.3.25,0.3.26,171,4,20,15,35,7,FALSE
pxt-core,0.2.199,0.2.200,144,2,2,2,4,2,FALSE
pxt-core,0.3.27,0.3.28,173,2,10,10,20,2,FALSE
pxt-core,0.3.26,0.3.27,172,2,31,1150,1181,12,FALSE
pxt-core,0.3.29,0.3.30,175,3,29,146,175,12,FALSE
pxt-core,0.3.28,0.3.29,174,2,2,2,4,2,FALSE
pxt-core,0.5.52,0.5.53,365,3,107,698,805,8,FALSE
pxt-core,0.5.53,0.5.54,366,4,40,27,67,5,FALSE
pxt-core,0.5.50,0.5.51,363,2,5,12,17,2,FALSE
pxt-core,0.5.51,0.5.52,364,1,2,2,4,1,FALSE
pxt-core,0.5.56,0.5.57,369,2,18,1,19,2,FALSE
pxt-core,0.5.57,0.5.58,370,2,22,12,34,4,FALSE
pxt-core,0.5.54,0.5.55,367,3,18,5,23,4,FALSE
pxt-core,0.5.55,0.5.56,368,2,2,2,4,2,FALSE
pxt-core,0.5.58,0.5.59,371,3,139,87,226,9,FALSE
pxt-core,0.5.59,0.5.60,372,5,20,19,39,6,FALSE
pxt-core,1.0.8,1.0.9,629,2,39,18,57,3,FALSE
pxt-core,1.0.9,1.0.10,630,12,87,29,116,13,FALSE
pxt-core,1.1.24,1.1.25,678,2,7,7,14,2,FALSE
pxt-core,0.11.63,0.11.64,533,4,27,14,41,7,FALSE
pxt-core,1.1.26,1.1.27,680,15,430,229,659,57,FALSE
pxt-core,1.1.27,1.1.28,681,10,252,132,384,19,FALSE
pxt-core,1.1.20,1.1.21,674,9,739,106,845,25,FALSE
pxt-core,1.1.21,1.1.22,675,2,75,69,144,3,FALSE
pxt-core,1.1.22,1.1.23,676,4,13,11,24,4,FALSE
pxt-core,1.1.23,1.1.24,677,3,2,3,5,2,FALSE
pxt-core,0.8.14,0.9.1,449,9,1412,53,1465,28,FALSE
pxt-core,0.8.11,0.8.12,446,5,165,54,219,11,FALSE
pxt-core,0.8.10,0.8.11,445,4,768,352,1120,21,FALSE
pxt-core,0.8.13,0.8.14,448,5,51,33,84,9,FALSE
pxt-core,0.8.12,0.8.13,447,4,28,30,58,5,FALSE
pxt-core,1.0.16,1.0.17,637,2,17,9,26,3,FALSE
pxt-core,1.0.17,1.0.18,638,3,5,5,10,3,FALSE
pxt-core,0.2.186,0.2.187,133,8,25,13,38,10,FALSE
pxt-core,0.2.187,0.2.188,134,8,157,106,263,35,FALSE
pxt-core,0.2.180,0.2.181,128,2,278,38,316,64,FALSE
pxt-core,0.2.181,0.2.182,129,3,37,9,46,5,FALSE
pxt-core,0.2.182,0.2.183,130,11,141,44,185,15,FALSE
pxt-core,0.2.183,0.2.185,131,7,78,30,108,11,FALSE
pxt-core,0.2.188,0.2.189,135,2,2,2,4,2,FALSE
pxt-core,0.2.189,0.2.190,136,3,10,4,14,3,FALSE
pxt-core,1.0.18,1.0.19,639,3,17,9,26,8,FALSE
pxt-core,1.0.19,1.0.20,640,6,274,51,325,10,FALSE
pxt-core,0.12.80,0.12.81,620,11,619,428,1047,40,FALSE
pxt-core,0.4.73,0.4.74,311,2,3,3,6,2,FALSE
pxt-core,0.4.72,0.4.73,310,7,46,9,55,8,FALSE
pxt-core,0.4.71,0.4.72,309,4,47,13,60,7,FALSE
pxt-core,0.5.62,0.5.63,375,12,4816,3577,8393,111,FALSE
pxt-core,0.3.60,0.3.61,203,10,465,228,693,40,FALSE
pxt-core,1.5.20,1.5.21,771,7,186,39,225,20,FALSE
pxt-core,1.5.21,1.5.22,772,4,27,9,36,4,FALSE
pxt-core,1.5.5,1.5.6,757,3,4,5,9,3,FALSE
pxt-core,0.12.39,0.12.40,579,3,11,5,16,6,FALSE
pxt-core,0.12.38,0.12.39,578,4,41,22,63,11,FALSE
pxt-core,0.11.58,0.11.59,528,5,57,18,75,6,FALSE
pxt-core,0.2.53,0.2.54,11,3,4,10,14,5,FALSE
pxt-core,0.2.52,0.2.53,10,2,2,2,4,2,FALSE
pxt-core,0.2.51,0.2.52,9,4,14,3,17,6,FALSE
pxt-core,0.2.50,0.2.51,8,4,680,213,893,53,FALSE
pxt-core,0.2.57,0.2.58,15,2,8,8,16,2,FALSE
pxt-core,0.2.56,0.2.57,14,3,162,97,259,12,TRUE
pxt-core,0.2.55,0.2.56,13,2,95,8,103,7,FALSE
pxt-core,0.2.54,0.2.55,12,2,42,5,47,4,FALSE
pxt-core,0.2.59,0.2.60,17,4,7,8,15,4,FALSE
pxt-core,0.2.58,0.2.59,16,7,92,102,194,20,FALSE
pxt-core,0.3.59,0.3.60,202,6,108,38,146,11,FALSE
pxt-core,0.3.50,0.3.51,195,1,7,6,13,1,FALSE
pxt-core,0.3.51,0.3.52,196,7,278,165,443,25,FALSE
pxt-core,0.3.52,0.3.53,197,3,118,23,141,7,FALSE
pxt-core,0.3.53,0.3.55,198,10,258,226,484,59,FALSE
pxt-core,0.3.55,0.3.56,199,11,182,79,261,17,FALSE
pxt-core,0.3.56,0.3.57,200,6,1096,589,1685,75,FALSE
pxt-core,0.3.57,0.3.59,201,20,788,201,989,70,FALSE
pxt-core,0.2.153,0.2.154,101,4,37,32,69,8,FALSE
pxt-core,0.2.152,0.2.153,100,3,4,3,7,4,FALSE
pxt-core,0.2.151,0.2.152,99,1,3,3,6,2,FALSE
pxt-core,0.2.157,0.2.158,105,2,23,7,30,3,FALSE
pxt-core,0.2.156,0.2.157,104,3,66,37,103,9,FALSE
pxt-core,0.2.155,0.2.156,103,2,22,16,38,2,FALSE
pxt-core,0.2.154,0.2.155,102,6,85,43,128,10,FALSE
pxt-core,0.10.12,0.10.13,466,3,6,6,12,3,FALSE
pxt-core,0.2.158,0.2.159,106,3,3,2,5,3,FALSE
pxt-core,0.11.51,0.11.52,521,4,45,8,53,7,FALSE
pxt-core,0.11.57,0.11.58,527,1,3,3,6,2,FALSE
pxt-core,0.3.2,0.3.3,150,23,529,90,619,46,FALSE
pxt-core,0.11.54,0.11.55,524,1,1,1,2,1,FALSE
pxt-core,0.3.3,0.3.4,151,5,76,22,98,7,FALSE
pxt-core,0.5.100,0.5.101,413,2,2,1,3,2,FALSE
pxt-core,0.12.58,0.12.59,598,1,3,3,6,2,FALSE
pxt-core,1.3.31,1.3.32,747,7,952,664,1616,38,FALSE
pxt-core,1.3.30,1.3.31,746,3,18,7,25,3,FALSE
pxt-core,1.3.32,1.4.1,748,2,3,2,5,2,FALSE
pxt-core,0.3.7,0.3.8,154,3,11,7,18,3,FALSE
pxt-core,0.3.4,0.3.5,152,13,679,194,873,46,FALSE
pxt-core,0.3.101,0.3.102,239,1,1,1,2,1,FALSE
pxt-core,0.3.100,0.3.101,238,2,2373,1,2374,7,FALSE
pxt-core,0.3.103,0.4.1,241,6,574,210,784,25,FALSE
pxt-core,1.5.12,1.5.13,764,2,33,5,38,7,FALSE
pxt-core,0.2.159,0.2.160,107,3,67,21,88,4,FALSE
pxt-core,0.6.3,0.6.4,418,4,150,2,152,6,FALSE
pxt-core,0.6.2,0.6.3,417,5,2611,91,2702,23,FALSE
pxt-core,0.6.1,0.6.2,416,15,4142,433,4575,87,FALSE
pxt-core,0.6.7,0.7.1,422,4,615,170,785,53,FALSE
pxt-core,0.6.6,0.6.7,421,6,24,31,55,9,FALSE
pxt-core,0.6.5,0.6.6,420,2,6,3,9,3,FALSE
pxt-core,0.6.4,0.6.5,419,2,6,6,12,2,FALSE
pxt-core,0.4.9,0.4.10,250,2,35,31,66,3,FALSE
pxt-core,0.4.8,0.4.9,249,7,26,12,38,10,FALSE
pxt-core,0.11.49,0.11.50,519,3,4,3,7,3,FALSE
pxt-core,0.11.48,0.11.49,518,4,44,13,57,6,FALSE
pxt-core,0.11.45,0.11.46,515,2,64,4,68,3,FALSE
pxt-core,0.11.44,0.11.45,514,5,263,59,322,9,FALSE
pxt-core,0.4.3,0.4.4,244,4,159,19,178,7,FALSE
pxt-core,0.4.2,0.4.3,243,3,172,27,199,6,FALSE
pxt-core,0.11.41,0.11.42,511,9,30,18,48,11,FALSE
pxt-core,0.4.4,0.4.5,245,8,508,58,566,14,FALSE
pxt-core,0.11.43,0.11.44,513,10,2828,1500,4328,90,FALSE
pxt-core,0.11.42,0.11.43,512,4,686,218,904,20,FALSE
pxt-core,0.4.39,0.4.40,277,8,517,177,694,31,FALSE
pxt-core,0.4.38,0.4.39,276,1,1,1,2,1,FALSE
pxt-core,0.8.9,0.8.10,444,2,3,3,6,2,FALSE
pxt-core,0.8.8,0.8.9,443,5,370,77,447,17,FALSE
pxt-core,0.4.33,0.4.34,271,6,1368,804,2172,43,FALSE
pxt-core,0.4.32,0.4.33,270,11,2618,287,2905,109,FALSE
pxt-core,0.8.7,0.8.8,442,3,5,43,48,10,FALSE
pxt-core,0.4.30,0.4.32,269,7,93,50,143,9,FALSE
pxt-core,0.4.37,0.4.38,275,3,20,11,31,4,FALSE
pxt-core,0.4.36,0.4.37,274,5,207,181,388,17,FALSE
pxt-core,0.4.35,0.4.36,273,3,8,9,17,4,FALSE
pxt-core,0.4.34,0.4.35,272,2,1,11,12,2,FALSE
pxt-core,0.2.68,0.2.69,25,4,40,13,53,5,FALSE
pxt-core,0.2.69,0.2.70,26,8,106414,99,106513,20,FALSE
pxt-core,0.2.62,0.2.63,20,6,186,171,357,24,FALSE
pxt-core,0.2.63,0.2.64,21,5,84,19,103,7,FALSE
pxt-core,0.2.60,0.2.61,18,3,3,3,6,3,FALSE
pxt-core,0.2.61,0.2.62,19,2,41,60,101,4,FALSE
pxt-core,0.2.67,0.2.68,24,2,3,3,6,2,FALSE
pxt-core,0.2.64,0.2.65,22,3,101,43,144,9,FALSE
pxt-core,0.2.65,0.2.67,23,7,44,26,70,11,FALSE
pxt-core,0.4.48,0.4.49,286,5,87,17,104,8,FALSE
pxt-core,0.4.49,0.4.50,287,3,19,21,40,3,FALSE
pxt-core,0.4.46,0.4.47,284,2,21,20,41,5,FALSE
pxt-core,0.4.47,0.4.48,285,6,630,512,1142,31,FALSE
pxt-core,0.4.44,0.4.45,282,7,108,45,153,15,FALSE
pxt-core,0.4.45,0.4.46,283,12,1644,133,1777,39,FALSE
pxt-core,0.4.42,0.4.43,280,12,2772,2012,4784,60,TRUE
pxt-core,0.4.43,0.4.44,281,2,9,1,10,3,FALSE
pxt-core,0.4.40,0.4.41,278,7,2424,1482,3906,24,FALSE
pxt-core,0.4.41,0.4.42,279,4,4,4,8,4,FALSE
pxt-core,0.2.97,0.2.98,52,2,52,9,61,2,FALSE
pxt-core,0.2.96,0.2.97,51,11,957,602,1559,45,TRUE
pxt-core,0.2.95,0.2.96,50,6,56,55,111,11,FALSE
pxt-core,0.2.94,0.2.95,49,2,2,2,4,2,FALSE
pxt-core,0.2.93,0.2.94,48,2,10,7,17,2,FALSE
pxt-core,0.2.92,0.2.93,47,16,459,287,746,26,FALSE
pxt-core,0.2.91,0.2.92,46,2,14,6,20,3,FALSE
pxt-core,0.2.90,0.2.91,45,6,288,97,385,13,FALSE
pxt-core,0.2.99,0.2.100,54,11,1161,472,1633,49,FALSE
pxt-core,0.2.98,0.2.99,53,3,8,6,14,3,FALSE
pxt-core,0.11.55,0.11.56,525,7,90,61,151,10,FALSE
pxt-core,0.2.204,0.3.2,149,12,182,46,228,16,FALSE
pxt-core,0.2.203,0.2.204,148,9,854,327,1181,30,FALSE
pxt-core,0.2.202,0.2.203,147,32,5954,5461,11415,268,FALSE
pxt-core,0.2.201,0.2.202,146,6,216,78,294,16,FALSE
pxt-core,0.2.200,0.2.201,145,4,32,31,63,4,FALSE
pxt-core,0.10.1,0.10.2,455,8,200,48,248,16,FALSE
pxt-core,0.10.3,0.10.4,457,7,28,21,49,8,FALSE
pxt-core,0.10.2,0.10.3,456,3,6,4,10,3,FALSE
pxt-core,0.10.5,0.10.6,459,3,14,5,19,3,FALSE
pxt-core,0.12.74,0.12.75,614,2,38,16,54,3,FALSE
pxt-core,0.10.7,0.10.8,461,7,130,92,222,13,FALSE
pxt-core,0.12.68,0.12.69,608,15,166,62,228,26,FALSE
pxt-core,0.12.69,0.12.70,609,10,1362,148,1510,53,FALSE
pxt-core,0.12.66,0.12.67,606,2,1,11,12,2,FALSE
pxt-core,0.12.67,0.12.68,607,70,4022,1347,5369,130,FALSE
pxt-core,0.12.64,0.12.65,604,5,222,33,255,11,FALSE
pxt-core,0.12.65,0.12.66,605,19,146,168,314,28,FALSE
pxt-core,0.12.62,0.12.63,602,2,2,2,4,2,FALSE
pxt-core,0.12.63,0.12.64,603,36,3382,1195,4577,112,FALSE
pxt-core,0.12.60,0.12.61,600,1,1931,234,2165,20,FALSE
pxt-core,0.12.61,0.12.62,601,3,176,10,186,8,FALSE
pxt-core,0.10.9,0.10.10,463,12,298,189,487,20,FALSE
pxt-core,0.10.8,0.10.9,462,14,172,90,262,21,FALSE
pxt-core,0.3.83,0.3.84,223,7,106,28,134,12,FALSE
pxt-core,0.3.82,0.3.83,222,8,288,56,344,21,FALSE
pxt-core,0.3.81,0.3.82,221,2,4,1,5,2,FALSE
pxt-core,0.3.80,0.3.81,220,2,5,3,8,2,FALSE
pxt-core,0.3.87,0.3.89,227,33,1700,250106,251806,80,FALSE
pxt-core,0.3.86,0.3.87,226,18,741,266,1007,28,FALSE
pxt-core,0.3.85,0.3.86,225,4,28,20,48,6,FALSE
pxt-core,0.3.84,0.3.85,224,2,48,2,50,6,FALSE
pxt-core,0.3.89,0.3.90,228,6,525,41315,41840,130,FALSE
pxt-core,0.2.109,0.2.110,63,3,22,14,36,8,FALSE
pxt-core,0.2.104,0.2.105,59,5,76,50,126,9,FALSE
pxt-core,0.2.105,0.2.106,60,4,46,23,69,10,FALSE
pxt-core,0.2.106,0.2.107,61,5,68,26,94,7,FALSE
pxt-core,0.2.107,0.2.109,62,13,132,14,146,14,FALSE
pxt-core,0.2.100,0.2.101,55,3,18,8,26,5,FALSE
pxt-core,0.2.101,0.2.102,56,3,4,1,5,4,FALSE
pxt-core,0.2.102,0.2.103,57,7,105,15,120,15,FALSE
pxt-core,0.2.103,0.2.104,58,9,357,96,453,13,FALSE
pxt-core,0.2.191,0.2.193,138,8,90,20,110,18,FALSE
pxt-core,0.3.18,0.3.19,165,12,104,47,151,16,FALSE
pxt-core,0.3.19,0.3.21,166,17,175,73,248,24,FALSE
pxt-core,0.3.14,0.3.15,161,5,92,12,104,8,FALSE
pxt-core,0.3.15,0.3.16,162,4,106,16,122,8,FALSE
pxt-core,0.3.16,0.3.17,163,4,84,16,100,4,FALSE
pxt-core,0.3.17,0.3.18,164,17,2646,2142,4788,35,FALSE
pxt-core,0.3.10,0.3.11,157,5,9,6,15,6,FALSE
pxt-core,0.3.11,0.3.12,158,3,42,9,51,6,FALSE
pxt-core,0.3.12,0.3.13,159,3,19,9,28,3,FALSE
pxt-core,0.3.13,0.3.14,160,9,95,19,114,12,FALSE
pxt-core,0.5.41,0.5.42,354,3,310,294,604,4,FALSE
pxt-core,0.5.43,0.5.44,356,2,5,6,11,5,FALSE
pxt-core,0.5.42,0.5.43,355,2,1,2,3,2,FALSE
pxt-core,0.5.45,0.5.46,358,2,19,7,26,2,FALSE
pxt-core,0.5.44,0.5.45,357,8,3572,3892,7464,122,FALSE
pxt-core,0.5.47,0.5.48,360,5,24,11,35,6,TRUE
pxt-core,0.5.46,0.5.47,359,2,2,2,4,2,FALSE
pxt-core,0.5.49,0.5.50,362,8,593,491,1084,29,FALSE
pxt-core,0.5.48,0.5.49,361,3,46,15,61,6,FALSE
pxt-core,1.1.33,1.1.34,687,1,1,1,2,1,FALSE
pxt-core,1.1.32,1.1.33,686,7,201,192,393,31,FALSE
pxt-core,1.1.31,1.1.32,685,5,165,97,262,14,FALSE
pxt-core,1.1.30,1.1.31,684,2,107,6,113,11,FALSE
pxt-core,1.1.37,1.1.38,691,4,41,22,63,11,FALSE
pxt-core,1.1.36,1.1.37,690,2,27,21,48,6,FALSE
pxt-core,1.1.35,1.1.36,689,7,163,190,353,28,FALSE
pxt-core,1.1.34,1.1.35,688,2,57,53,110,6,FALSE
pxt-core,1.1.39,1.1.40,693,4,1099,839,1938,50,FALSE
pxt-core,1.1.38,1.1.39,692,3,11,5,16,6,FALSE
pxt-core,0.11.16,0.11.17,486,4,22,16,38,6,FALSE
pxt-core,0.11.17,0.11.18,487,3,71,31,102,6,FALSE
pxt-core,0.11.14,0.11.15,484,7,194,149,343,21,FALSE
pxt-core,0.11.15,0.11.16,485,4,35,27,62,7,FALSE
pxt-core,0.11.12,0.11.13,482,2,2,2,4,2,FALSE
pxt-core,0.11.13,0.11.14,483,6,186,342,528,24,FALSE
pxt-core,0.11.10,0.11.11,480,2,4,4,8,2,FALSE
pxt-core,0.11.11,0.11.12,481,8,2648,1367,4015,54,FALSE
pxt-core,0.11.18,0.11.19,488,4,648,131,779,24,FALSE
pxt-core,0.11.19,0.11.20,489,2,3,3,6,2,FALSE
pxt-core,0.3.95,0.3.96,234,2,81,46,127,3,FALSE
pxt-core,1.0.31,1.0.32,652,2,2,2,4,2,FALSE
pxt-core,0.3.96,0.3.97,235,5,378,379,757,41,FALSE
pxt-core,0.3.97,0.3.98,236,10,758,297,1055,35,FALSE
pxt-core,1.0.29,1.0.30,650,13,807,577,1384,36,FALSE
pxt-core,0.3.90,0.3.91,229,9,96,59,155,9,FALSE
pxt-core,0.3.102,0.3.103,240,3,381,2,383,7,FALSE
pxt-core,1.0.32,1.0.33,653,2,2,1,3,2,FALSE
pxt-core,1.1.46,1.1.47,700,11,270,252,522,24,FALSE
pxt-core,1.1.47,1.1.48,701,2,9,3,12,2,FALSE
pxt-core,1.1.44,1.1.45,698,5,192,88,280,15,FALSE
pxt-core,1.1.45,1.1.46,699,5,138,41,179,16,FALSE
pxt-core,1.1.42,1.1.43,696,7,89,59,148,20,FALSE
pxt-core,1.1.43,1.1.44,697,2,80,11,91,5,FALSE
pxt-core,1.1.40,1.1.41,694,5,154,31,185,19,FALSE
pxt-core,1.1.41,1.1.42,695,10,108,64,172,17,FALSE
pxt-core,1.1.48,1.1.49,702,4,110,19,129,10,FALSE
pxt-core,1.1.49,1.1.50,703,4,6,6,12,5,FALSE
pxt-core,0.12.22,0.12.23,571,2,45,20,65,3,FALSE
pxt-core,0.12.23,0.12.24,572,1,7,5,12,1,FALSE
pxt-core,0.12.20,0.12.21,569,2,11,3,14,3,FALSE
pxt-core,0.2.196,0.2.197,142,2,32,25,57,2,FALSE
pxt-core,0.12.26,0.12.27,575,40,1971,1867,3838,190,FALSE
pxt-core,0.12.27,0.12.28,576,7,163,190,353,28,FALSE
pxt-core,0.12.24,0.12.25,573,13,775,161,936,28,FALSE
pxt-core,0.12.25,0.12.26,574,34,715,395,1110,86,FALSE
pxt-core,0.12.28,0.12.38,577,2,27,21,48,6,FALSE
pxt-core,1.3.22,1.3.23,738,2,3,3,6,2,FALSE
pxt-core,0.5.91,0.5.92,404,8,108,45,153,18,FALSE
pxt-core,1.1.25,1.1.26,679,5,24,24,48,6,FALSE
pxt-core,0.2.140,0.2.141,90,4,15,13,28,6,FALSE
pxt-core,0.2.141,0.2.143,91,6,27,18,45,12,FALSE
pxt-core,0.2.143,0.2.144,92,2,1,2,3,2,FALSE
pxt-core,0.2.144,0.2.145,93,2,11,8,19,2,FALSE
pxt-core,0.2.145,0.2.146,94,8,200,116,316,24,FALSE
pxt-core,0.2.146,0.2.147,95,20,900,443,1343,73,FALSE
pxt-core,0.2.147,0.2.148,96,3,9,6,15,6,FALSE
pxt-core,0.2.148,0.2.149,97,2,3,3,6,2,FALSE
pxt-core,0.2.149,0.2.151,98,7,191,28,219,8,FALSE
pxt-core,0.12.57,0.12.58,597,10,80,116,196,22,FALSE
pxt-core,0.12.56,0.12.57,596,1,20,2,22,3,FALSE
pxt-core,0.12.55,0.12.56,595,4,78,9,87,6,FALSE
pxt-core,0.12.54,0.12.55,594,4,30,14,44,6,FALSE
pxt-core,0.12.53,0.12.54,593,3,4,2,6,5,FALSE
pxt-core,0.12.52,0.12.53,592,1,1,1,2,1,FALSE
pxt-core,0.12.51,0.12.52,591,8,89,53,142,15,FALSE
pxt-core,0.12.50,0.12.51,590,1,29,13,42,7,FALSE
pxt-core,0.11.4,0.11.5,474,3,13,19,32,3,FALSE
pxt-core,0.11.5,0.11.6,475,2,600,303,903,5,FALSE
pxt-core,0.11.6,0.11.7,476,4,359,182,541,21,FALSE
pxt-core,0.11.7,0.11.8,477,3,7,3,10,3,FALSE
pxt-core,0.11.1,0.11.2,471,2,2,2,4,2,FALSE
pxt-core,0.11.2,0.11.3,472,2,2,2,4,2,FALSE
pxt-core,0.11.3,0.11.4,473,3,9,9,18,3,FALSE
pxt-core,1.5.9,1.5.10,761,8,125,20,145,18,FALSE
pxt-core,1.5.8,1.5.9,760,10,2093,51,2144,58,FALSE
pxt-core,0.11.29,0.11.30,499,2,5,2,7,2,FALSE
pxt-core,0.11.28,0.11.29,498,4,338,185,523,16,FALSE
pxt-core,0.11.27,0.11.28,497,4,368,230,598,24,FALSE
pxt-core,0.11.26,0.11.27,496,3,76,79,155,5,FALSE
pxt-core,0.11.25,0.11.26,495,2,170,97,267,3,FALSE
pxt-core,0.11.24,0.11.25,494,2,99,102,201,6,FALSE
pxt-core,0.11.23,0.11.24,493,3,17,9,26,6,FALSE
pxt-core,0.11.22,0.11.23,492,4,18,11,29,4,FALSE
pxt-core,0.11.21,0.11.22,491,2,2,1,3,2,FALSE
pxt-core,1.5.2,1.5.3,754,4,87,10,97,9,FALSE
pxt-core,1.3.3,1.3.4,720,2,4,3,7,2,FALSE
pxt-core,0.4.1,0.4.2,242,3,13,14,27,12,FALSE
pxt-core,1.3.1,1.3.2,718,11,340,144,484,27,FALSE
pxt-core,1.3.7,1.3.8,724,6,32,124,156,7,FALSE
pxt-core,1.3.6,1.3.7,723,10,99,33,132,17,FALSE
pxt-core,1.3.5,1.3.6,722,6,228,33,261,12,FALSE
pxt-core,1.3.4,1.3.5,721,3,7,13,20,6,FALSE
pxt-core,0.8.1,0.8.2,436,5,209,47,256,9,FALSE
pxt-core,1.3.9,1.3.10,726,2,1,11,12,2,FALSE
pxt-core,1.3.8,1.3.9,725,3,15,11,26,4,FALSE
pxt-core,0.11.47,0.11.48,517,2,11,2,13,2,FALSE
pxt-core,0.11.46,0.11.47,516,13,287,225,512,31,FALSE
pxt-core,0.4.5,0.4.6,246,4,5542,1054,6596,101,FALSE
pxt-core,0.11.40,0.11.41,510,4,5,6,11,4,FALSE
pxt-core,0.3.47,0.3.48,192,2,2,1,3,2,FALSE
pxt-core,0.3.46,0.3.47,191,33,799,259,1058,63,FALSE
pxt-core,0.3.45,0.3.46,190,9,130,88,218,15,FALSE
pxt-core,0.3.44,0.3.45,189,2,3,1,4,2,FALSE
pxt-core,0.3.43,0.3.44,188,2,2,1,3,2,FALSE
pxt-core,0.3.42,0.3.43,187,2,2,1,3,2,FALSE
pxt-core,0.12.21,0.12.22,570,7,142,25,167,18,FALSE
pxt-core,0.3.40,0.3.42,186,8,186152,793,186945,129,FALSE
pxt-core,0.11.52,0.11.53,522,2,3,3,6,2,FALSE
pxt-core,0.11.53,0.11.54,523,2,6,4,10,2,FALSE
pxt-core,0.11.50,0.11.51,520,2,14,10,24,3,FALSE
pxt-core,0.4.6,0.4.7,247,1,43,4,47,1,FALSE
pxt-core,0.11.56,0.11.57,526,12,493,578,1071,27,FALSE
pxt-core,0.5.102,0.6.1,415,4,118,87,205,19,FALSE
pxt-core,0.3.49,0.3.50,194,22,866,392,1258,53,FALSE
pxt-core,0.3.48,0.3.49,193,2,5,1,6,2,FALSE
pxt-core,1.1.1,1.1.2,655,12,490,533,1023,38,FALSE
pxt-core,1.1.3,1.1.4,657,6,169,16,185,15,FALSE
pxt-core,1.1.2,1.1.3,656,2,2,2,4,2,FALSE
pxt-core,1.1.5,1.1.6,659,2,6,2,8,2,FALSE
pxt-core,1.1.4,1.1.5,658,2,6,2,8,2,FALSE
pxt-core,1.1.7,1.1.8,661,8,704,183,887,28,FALSE
pxt-core,1.1.6,1.1.7,660,18,846,441,1287,55,FALSE
pxt-core,1.1.9,1.1.10,663,13,394,251,645,35,FALSE
pxt-core,1.1.8,1.1.9,662,7,134,42,176,14,FALSE
pxt-core,0.5.38,0.5.39,352,2,11,6,17,3,FALSE
pxt-core,0.5.39,0.5.41,353,4,23,17,40,5,FALSE
pxt-core,0.8.3,0.8.4,438,4,111,17,128,9,FALSE
pxt-core,0.5.30,0.5.31,344,4,304,199,503,14,FALSE
pxt-core,0.5.31,0.5.32,345,7,164,241,405,20,FALSE
pxt-core,0.5.32,0.5.33,346,2,13,2,15,4,FALSE
pxt-core,0.5.33,0.5.34,347,7,1333,812,2145,50,FALSE
pxt-core,0.5.34,0.5.35,348,3,10,3,13,4,FALSE
pxt-core,0.5.35,0.5.36,349,4,458,352,810,13,FALSE
pxt-core,0.5.36,0.5.37,350,3,10,4,14,3,FALSE
pxt-core,0.5.37,0.5.38,351,3,77,202,279,11,FALSE
pxt-core,0.5.0-rc0,0.5.0-rc1,313,1,3,3,6,2,FALSE
pxt-core,0.11.60,0.11.61,530,7,95,46,141,14,FALSE
pxt-core,1.3.21,1.3.22,737,2,2,1,3,2,FALSE
pxt-core,0.8.5,0.8.6,440,5,794,181,975,21,FALSE
pxt-core,0.8.2,0.8.3,437,5,425,230,655,22,FALSE
pxt-core,0.4.7,0.4.8,248,1,1,1,2,1,FALSE
pxt-core,0.8.4,0.8.5,439,4,26,4,30,5,FALSE
pxt-core,0.4.70,0.4.71,308,3,97,38,135,108,FALSE
pxt-core,0.11.59,0.11.60,529,1,3,3,6,2,FALSE
pxt-core,0.3.24,0.3.25,170,2,2,2,4,2,FALSE
pxt-core,0.2.79,0.2.80,36,13,202,105,307,20,FALSE
pxt-core,0.2.78,0.2.79,35,3,23,17,40,6,FALSE
pxt-core,0.8.6,0.8.7,441,5,546,299,845,33,FALSE
pxt-core,0.2.71,0.2.72,28,3,6,2,8,3,FALSE
pxt-core,0.2.70,0.2.71,27,7,55,31,86,10,FALSE
pxt-core,0.2.73,0.2.74,30,2,3,4,7,2,FALSE
pxt-core,0.2.72,0.2.73,29,2,9,1,10,2,FALSE
pxt-core,0.2.75,0.2.76,32,6,41,7,48,7,FALSE
pxt-core,0.2.74,0.2.75,31,7,106630,176,106806,30,FALSE
pxt-core,0.2.77,0.2.78,34,2,10,2,12,2,FALSE
pxt-core,0.2.76,0.2.77,33,2,3,3,6,2,FALSE
pxt-core,0.4.59,0.4.60,297,5,343,14,357,16,FALSE
pxt-core,0.4.58,0.4.59,296,6,29,21,50,8,FALSE
pxt-core,0.4.55,0.4.56,293,5,6618,1441,8059,69,FALSE
pxt-core,0.4.54,0.4.55,292,5,112,32,144,10,FALSE
pxt-core,0.4.57,0.4.58,295,2,85,116,201,11,FALSE
pxt-core,0.4.56,0.4.57,294,3,3,3,6,3,FALSE
pxt-core,0.4.51,0.4.52,289,3,296,133,429,8,FALSE
pxt-core,0.4.50,0.4.51,288,2,3,3,6,2,FALSE
pxt-core,0.4.53,0.4.54,291,2,4,4,8,2,FALSE
pxt-core,0.4.52,0.4.53,290,4,18,15,33,4,FALSE
pxt-core,1.5.3,1.5.4,755,4,67,43,110,9,FALSE
pxt-core,1.0.12,1.0.13,633,2,13,3,16,2,TRUE
pxt-core,0.11.63,0.11.64,533,4,27,14,41,7,TRUE
pxt-core,0.11.70,0.11.71,540,2,15,8,23,6,TRUE
pxt-core,0.5.28,0.5.29,342,4,855,626,1481,12,FALSE
pxt-core,0.2.49,0.2.50,7,5,144,77,221,16,FALSE
pxt-core,0.5.67,0.5.68,380,4,14,45,59,8,FALSE
pxt-core,0.2.56,0.2.57,14,3,162,97,259,12,FALSE
pxt-core,0.4.42,0.4.43,280,12,2772,2012,4784,60,FALSE
pxt-core,0.2.96,0.2.97,51,11,957,602,1559,45,FALSE
pxt-core,0.5.47,0.5.48,360,5,24,11,35,6,FALSE
pxt-core,0.11.65,0.11.66,535,8,275,58,333,14,TRUE
pxt-core,0.4.17,0.4.18,257,4,8,8,16,4,TRUE
pxt-core,0.12.48,0.12.49,588,5,118,21,139,11,TRUE
pxt-core,1.0.19,1.0.20,640,6,274,51,325,10,TRUE
pxt-core,1.5.20,1.5.21,771,7,186,39,225,20,TRUE
pxt-core,0.6.1,0.6.2,416,15,4142,433,4575,87,TRUE
pxt-core,1.1.48,1.1.49,702,4,110,19,129,10,TRUE
pxt-core,0.5.37,0.5.38,351,3,77,202,279,11,TRUE
pxt-core,0.3.77,0.3.79,218,8,155,43,198,17,TRUE
pxt-core,0.11.61,0.11.62,531,34,644,275,919,61,TRUE
pxt-core,1.0.10,1.0.11,631,7,197,106,303,21,TRUE
pxt-core,0.7.5,0.7.6,427,10,481,237,718,34,TRUE
pxt-core,0.3.61,0.3.62,204,23,1336,742,2078,156,TRUE
pxt-core,0.2.60,0.2.61,18,3,3,3,6,3,TRUE
pxt-core,0.3.49,0.3.50,194,22,866,392,1258,53,TRUE
pxt-core,0.2.120,0.2.121,71,9,294,78,372,17,TRUE
pxt-core,0.8.2,0.8.3,437,5,425,230,655,22,TRUE
pxt-core,1.5.14,1.5.15,766,7,3146,2390,5536,176,TRUE
pxt-core,0.12.78,0.12.79,618,1,1,4,5,1,TRUE
pxt-core,0.4.50,0.4.51,288,2,3,3,6,2,TRUE
pxt-core,0.3.86,0.3.87,226,18,741,266,1007,28,TRUE
pxt-core,0.2.179,0.2.180,127,3,59,5,64,5,TRUE
pxt-core,0.2.170,0.2.171,118,5,77,33,110,7,TRUE
pxt-core,0.2.89,0.2.90,44,17,1250,597,1847,66,TRUE
pxt-core,0.2.167,0.2.168,115,8,176,64,240,17,TRUE
pxt-core,0.2.164,0.2.165,112,8,104,22,126,15,TRUE
pxt-core,0.12.40,0.12.41,580,4,1099,839,1938,50,TRUE
pxt-core,1.1.39,1.1.40,693,4,1099,839,1938,50,TRUE
pxt-core,0.2.114,0.2.117,68,23,8193,1687,9880,189,TRUE
pxt-core,0.4.72,0.4.73,310,7,46,9,55,8,TRUE
pxt-core,0.2.202,0.2.203,147,32,5954,5461,11415,268,TRUE
pxt-core,0.8.1,0.8.2,436,5,209,47,256,9,TRUE
pxt-core,0.2.191,0.2.193,138,8,90,20,110,18,TRUE
pxt-core,0.3.5,0.3.7,153,31,2811,778,3589,115,TRUE
pxt-core,0.2.121,0.2.122,72,4,39,11,50,9,TRUE
everest,0.4.1,0.4.2,9,4,34,26,60,8,FALSE
everest,0.4.0,0.4.1,8,2,7,13,20,2,FALSE
everest,0.4.10,0.4.11,18,1,1,1,2,1,FALSE
everest,0.4.9,0.4.10,17,2,3,3,6,2,FALSE
everest,0.4.7,0.4.8,15,1,1,1,2,1,FALSE
everest,0.4.8,0.4.9,16,2,61,4,65,6,FALSE
everest,0.3.0,0.3.1,6,2,3,3,6,2,FALSE
everest,0.3.1,0.4.0,7,9,456,310,766,24,FALSE
everest,0.4.4,0.4.5,12,2,3,2,5,2,FALSE
everest,0.2.2,0.3.0,5,3,80,29,109,11,FALSE
everest,0.2.1,0.2.2,4,3,13,8,21,3,FALSE
everest,0.2.0,0.2.1,3,4,58,47,105,9,FALSE
everest,0.4.3,0.4.4,11,2,4,1,5,2,FALSE
everest,0.4.2,0.4.3,10,19,477,235,712,51,FALSE
everest,0.4.5,0.4.6,13,2,13,3,16,3,FALSE
everest,0.1.2,0.2.0,2,9,82,67,149,15,FALSE
everest,0.4.6,0.4.7,14,6,137,102,239,24,FALSE
everest,0.2.2,0.3.0,5,3,80,29,109,11,TRUE
everest,0.2.1,0.2.2,4,3,13,8,21,3,TRUE
everest,0.1.2,0.2.0,2,9,82,67,149,15,TRUE
everest,0.3.0,0.3.1,6,2,3,3,6,2,TRUE
everest,0.4.2,0.4.3,10,19,477,235,712,51,TRUE
everest,0.3.1,0.4.0,7,9,456,310,766,24,TRUE
generator-lmf,0.0.5,0.0.6,5,1,1,1,2,1,FALSE
generator-lmf,0.0.4,0.0.5,4,1,6,13,19,3,FALSE
generator-lmf,0.0.7,0.0.8,7,4,467,675,1142,21,FALSE
generator-lmf,0.0.6,0.0.7,6,1,1,1,2,1,FALSE
generator-lmf,0.0.1,0.0.2,2,1,19,6,25,3,FALSE
generator-lmf,0.0.0,0.0.1,1,1,1,1,2,1,FALSE
generator-lmf,0.0.2,0.0.4,3,2,4,6,10,2,FALSE
generator-lmf,0.0.9,0.1.0,9,1,0,341,341,15,FALSE
generator-lmf,0.0.8,0.0.9,8,1,71,195,266,4,FALSE
generator-lmf,0.1.0,0.1.1,10,1,1,1,2,1,FALSE
generator-lmf,0.0.0,0.0.1,1,1,1,1,2,1,TRUE
block-sequence-compliance-tests,1.1.0,1.2.0,3,2,17,1,18,2,FALSE
block-sequence-compliance-tests,1.0.0,1.1.0,2,2,5,10,15,2,FALSE
block-sequence-compliance-tests,2.0.0,2.0.1,5,2,3,3,6,2,FALSE
block-sequence-compliance-tests,1.2.0,2.0.0,4,2,27,1,28,3,FALSE
block-sequence-compliance-tests,0.1.0,1.0.0,1,2,38,37,75,2,FALSE
block-sequence-compliance-tests,1.0.0,1.1.0,2,2,5,10,15,2,TRUE
scraper.js,0.1.1,0.1.2,3,1,24,117,141,3,FALSE
scraper.js,0.1.0,0.1.1,2,1,24,117,141,3,FALSE
scraper.js,0.0.1,0.1.0,1,1,24,117,141,3,FALSE
scraper.js,0.1.2,0.1.3,4,1,24,117,141,3,FALSE
scraper.js,0.1.3,0.1.4,5,1,24,117,141,3,FALSE
scraper.js,0.12.3,0.12.4,98,1,24,117,141,3,FALSE
scraper.js,0.12.2,0.12.3,97,1,24,117,141,3,FALSE
scraper.js,0.12.1,0.12.2,96,1,24,117,141,3,FALSE
scraper.js,0.12.0,0.12.1,95,1,24,117,141,3,FALSE
scraper.js,0.12.4,0.12.5,99,1,24,117,141,3,FALSE
scraper.js,0.10.0-beta.1,0.10.0-beta.2,88,1,24,117,141,3,FALSE
scraper.js,0.12.7,0.13.0-alpha.1,102,1,24,117,141,3,FALSE
scraper.js,0.12.6,0.12.7,101,1,24,117,141,3,FALSE
scraper.js,0.5.41,0.5.42,47,1,24,117,141,3,FALSE
scraper.js,0.5.40,0.5.41,46,1,24,117,141,3,FALSE
scraper.js,0.5.43,0.5.44,49,1,24,117,141,3,FALSE
scraper.js,0.5.42,0.5.43,48,1,24,117,141,3,FALSE
scraper.js,0.5.45,0.5.46,51,1,24,117,141,3,FALSE
scraper.js,0.5.44,0.5.45,50,1,24,117,141,3,FALSE
scraper.js,0.5.47,0.6.0,53,1,24,117,141,3,FALSE
scraper.js,0.5.46,0.5.47,52,1,24,117,141,3,FALSE
scraper.js,0.5.27,0.5.28,33,1,24,117,141,3,FALSE
scraper.js,0.8.0-rc5,0.8.0-rc6,81,1,24,117,141,3,FALSE
scraper.js,0.8.0-rc4,0.8.0-rc5,80,1,24,117,141,3,FALSE
scraper.js,0.8.0-rc7,0.8.0-rc8,83,1,24,117,141,3,FALSE
scraper.js,0.8.0-rc6,0.8.0-rc7,82,1,24,117,141,3,FALSE
scraper.js,0.8.0-rc1,0.8.0-rc10,60,1,24,117,141,3,FALSE
scraper.js,0.8.0-rc3,0.8.0-rc4,79,1,24,117,141,3,FALSE
scraper.js,0.8.0-rc2,0.8.0-rc20,71,1,24,117,141,3,FALSE
scraper.js,0.8.0-rc9,0.8.0,85,1,24,117,141,3,FALSE
scraper.js,0.8.0-rc8,0.8.0-rc9,84,1,24,117,141,3,FALSE
scraper.js,0.8.0-rc17,0.8.0-rc18,68,1,24,117,141,3,FALSE
scraper.js,0.6.0,0.6.1,54,1,24,117,141,3,FALSE
scraper.js,0.5.18,0.5.19,24,1,24,117,141,3,FALSE
scraper.js,0.5.19,0.5.20,25,1,24,117,141,3,FALSE
scraper.js,0.5.16,0.5.17,22,1,24,117,141,3,FALSE
scraper.js,0.5.17,0.5.18,23,1,24,117,141,3,FALSE
scraper.js,0.5.14,0.5.15,20,1,24,117,141,3,FALSE
scraper.js,0.5.15,0.5.16,21,1,24,117,141,3,FALSE
scraper.js,0.5.13,0.5.14,19,1,24,117,141,3,FALSE
scraper.js,0.5.10,0.5.11,17,1,24,117,141,3,FALSE
scraper.js,0.5.11,0.5.13,18,1,24,117,141,3,FALSE
scraper.js,0.8.0-rc18,0.8.0-rc19,69,1,24,117,141,3,FALSE
scraper.js,0.8.0-rc15,0.8.0-rc16,66,1,24,117,141,3,FALSE
scraper.js,0.8.0-rc14,0.8.0-rc15,65,1,24,117,141,3,FALSE
scraper.js,0.6.1,0.7.0,55,1,24,117,141,3,FALSE
scraper.js,0.8.0-rc16,0.8.0-rc17,67,1,24,117,141,3,FALSE
scraper.js,0.8.0-rc11,0.8.0-rc12,62,1,24,117,141,3,FALSE
scraper.js,0.8.0-rc10,0.8.0-rc11,61,1,24,117,141,3,FALSE
scraper.js,0.8.0-rc13,0.8.0-rc14,64,1,24,117,141,3,FALSE
scraper.js,0.8.0-rc12,0.8.0-rc13,63,1,24,117,141,3,FALSE
scraper.js,0.13.4,0.13.5,110,1,1,1,2,1,FALSE
scraper.js,0.13.5,0.14.0,111,1,11,13,24,2,FALSE
scraper.js,0.13.2,0.13.3,108,3,11,3,14,5,FALSE
scraper.js,0.13.3,0.13.4,109,1,3722,17,3739,5,FALSE
scraper.js,0.13.0,0.13.1,106,1,70,69,139,7,FALSE
scraper.js,0.13.1,0.13.2,107,2,2,2,4,3,FALSE
scraper.js,0.14.5,0.14.6,117,1,24,117,141,3,FALSE
scraper.js,0.14.4,0.14.5,116,1,24,117,141,3,FALSE
scraper.js,0.14.6,0.15.0,118,6,642,514,1156,29,FALSE
scraper.js,0.14.1,0.14.2,113,1,4,3,7,2,FALSE
scraper.js,0.14.0,0.14.1,112,2,5,2,7,2,FALSE
scraper.js,0.14.3,0.14.4,115,1,6,14,20,1,FALSE
scraper.js,0.14.2,0.14.3,114,1,6,5,11,2,FALSE
scraper.js,0.8.0,0.9.0,86,1,24,117,141,3,FALSE
scraper.js,0.8.0-rc20,0.8.0-rc21,72,1,24,117,141,3,FALSE
scraper.js,0.8.0-rc21,0.8.0-rc22,73,1,24,117,141,3,FALSE
scraper.js,0.8.0-rc22,0.8.0-rc23,74,1,24,117,141,3,FALSE
scraper.js,0.8.0-rc23,0.8.0-rc24,75,1,24,117,141,3,FALSE
scraper.js,0.8.0-rc24,0.8.0-rc25,76,1,24,117,141,3,FALSE
scraper.js,0.8.0-rc25,0.8.0-rc26,77,1,24,117,141,3,FALSE
scraper.js,0.13.0-alpha.3,0.13.0,105,3,1077,236,1313,51,FALSE
scraper.js,0.13.0-alpha.2,0.13.0-alpha.3,104,1,24,117,141,3,FALSE
scraper.js,0.13.0-alpha.1,0.13.0-alpha.2,103,1,24,117,141,3,FALSE
scraper.js,0.5.38,0.5.39,44,1,24,117,141,3,FALSE
scraper.js,0.5.39,0.5.40,45,1,24,117,141,3,FALSE
scraper.js,0.5.30,0.5.31,36,1,24,117,141,3,FALSE
scraper.js,0.5.31,0.5.32,37,1,24,117,141,3,FALSE
scraper.js,0.5.32,0.5.33,38,1,24,117,141,3,FALSE
scraper.js,0.5.33,0.5.34,39,1,24,117,141,3,FALSE
scraper.js,0.5.34,0.5.35,40,1,24,117,141,3,FALSE
scraper.js,0.5.35,0.5.36,41,1,24,117,141,3,FALSE
scraper.js,0.5.36,0.5.37,42,1,24,117,141,3,FALSE
scraper.js,0.5.37,0.5.38,43,1,24,117,141,3,FALSE
scraper.js,0.7.2,0.7.3,58,1,24,117,141,3,FALSE
scraper.js,0.7.3,0.8.0-rc1,59,1,24,117,141,3,FALSE
scraper.js,0.7.0,0.7.1,56,1,24,117,141,3,FALSE
scraper.js,0.7.1,0.7.2,57,1,24,117,141,3,FALSE
scraper.js,0.10.0-beta.3,0.11.0-rc1,90,1,24,117,141,3,FALSE
scraper.js,0.10.0-beta.2,0.10.0-beta.3,89,1,24,117,141,3,FALSE
scraper.js,0.5.8,0.5.9,15,1,24,117,141,3,FALSE
scraper.js,0.5.9,0.5.10,16,1,24,117,141,3,FALSE
scraper.js,0.12.5,0.12.6,100,1,24,117,141,3,FALSE
scraper.js,0.5.4,0.5.5,11,1,24,117,141,3,FALSE
scraper.js,0.5.5,0.5.6,12,1,24,117,141,3,FALSE
scraper.js,0.5.6,0.5.7,13,1,24,117,141,3,FALSE
scraper.js,0.5.7,0.5.8,14,1,24,117,141,3,FALSE
scraper.js,0.5.0,0.5.1,7,1,24,117,141,3,FALSE
scraper.js,0.5.1,0.5.2,8,1,24,117,141,3,FALSE
scraper.js,0.5.2,0.5.3,9,1,24,117,141,3,FALSE
scraper.js,0.5.3,0.5.4,10,1,24,117,141,3,FALSE
scraper.js,0.9.0,0.10.0-beta.1,87,1,24,117,141,3,FALSE
scraper.js,0.5.26,0.5.27,32,1,24,117,141,3,FALSE
scraper.js,0.5.25,0.5.26,31,1,24,117,141,3,FALSE
scraper.js,0.5.24,0.5.25,30,1,24,117,141,3,FALSE
scraper.js,0.5.23,0.5.24,29,1,24,117,141,3,FALSE
scraper.js,0.5.22,0.5.23,28,1,24,117,141,3,FALSE
scraper.js,0.5.21,0.5.22,27,1,24,117,141,3,FALSE
scraper.js,0.5.20,0.5.21,26,1,24,117,141,3,FALSE
scraper.js,0.5.29,0.5.30,35,1,24,117,141,3,FALSE
scraper.js,0.5.28,0.5.29,34,1,24,117,141,3,FALSE
scraper.js,0.11.0-rc4,0.12.0,94,1,24,117,141,3,FALSE
scraper.js,0.11.0-rc1,0.11.0-rc2,91,1,24,117,141,3,FALSE
scraper.js,0.11.0-rc2,0.11.0-rc3,92,1,24,117,141,3,FALSE
scraper.js,0.11.0-rc3,0.11.0-rc4,93,1,24,117,141,3,FALSE
scraper.js,0.0.1,0.1.0,1,1,24,117,141,3,TRUE
scraper.js,0.8.0-rc5,0.8.0-rc6,81,1,24,117,141,3,TRUE
scraper.js,0.13.2,0.13.3,108,3,11,3,14,5,TRUE
scraper.js,0.8.0-rc2,0.8.0-rc20,71,1,24,117,141,3,TRUE
scraper.js,0.8.0-rc17,0.8.0-rc18,68,1,24,117,141,3,TRUE
scraper.js,0.8.0-rc16,0.8.0-rc17,67,1,24,117,141,3,TRUE
scraper.js,0.13.0-alpha.3,0.13.0,105,3,1077,236,1313,51,TRUE
scraper.js,0.13.3,0.13.4,109,1,3722,17,3739,5,TRUE
scraper.js,0.1.4,0.5.0,6,1,244,0,244,12,FALSE
scraper.js,0.6.1,0.7.0,55,1,24,117,141,3,TRUE
scraper.js,0.5.47,0.6.0,53,1,24,117,141,3,TRUE
scraper.js,0.6.0,0.6.1,54,1,24,117,141,3,TRUE
scraper.js,0.14.4,0.14.5,116,1,24,117,141,3,TRUE
scraper.js,0.9.0,0.10.0-beta.1,87,1,24,117,141,3,TRUE
scraper.js,0.14.1,0.14.2,113,1,4,3,7,2,TRUE
scraper.js,0.8.0-rc9,0.8.0,85,1,24,117,141,3,TRUE
scraper.js,0.8.0-rc25,0.8.0-rc26,77,1,24,117,141,3,TRUE
scraper.js,0.12.6,0.12.7,101,1,24,117,141,3,TRUE
scraper.js,0.11.0-rc4,0.12.0,94,1,24,117,141,3,TRUE
scraper.js,0.11.0-rc3,0.11.0-rc4,93,1,24,117,141,3,TRUE
api-actions-js,1.6.0,1.7.6,14,7,1842,1126,2968,201,FALSE
api-actions-js,1.7.9,1.7.10,17,1,20,16,36,15,FALSE
api-actions-js,1.7.8,1.7.9,16,5,1009,265,1274,64,FALSE
api-actions-js,1.7.6,1.7.8,15,3,62,42,104,19,FALSE
api-actions-js,1.8.0,1.8.3,20,6,200,236,436,38,FALSE
api-actions-js,1.8.3,1.8.4,21,1,24,24,48,6,TRUE
api-actions-js,1.4.1,1.4.2,10,1,17,17,34,8,FALSE
api-actions-js,1.4.2,1.4.3,11,1,37,85,122,8,FALSE
api-actions-js,1.4.3,1.5.0,12,1,605,99,704,32,FALSE
api-actions-js,1.7.11,1.8.0,19,4,779,691,1470,36,FALSE
api-actions-js,1.7.10,1.7.11,18,2,19,30,49,6,FALSE
api-actions-js,1.5.0,1.6.0,13,1,339,121,460,38,FALSE
api-actions-js,1.2.6,1.2.7,1,1,27,26,53,13,FALSE
api-actions-js,1.2.7,1.2.9,2,4,519,119,638,33,TRUE
api-actions-js,1.2.9,1.3.10,3,2,185,38,223,25,FALSE
api-actions-js,1.3.13,1.3.15,6,2,73,22,95,8,FALSE
api-actions-js,1.3.11,1.3.13,5,4,52,27,79,17,FALSE
api-actions-js,1.3.10,1.3.11,4,2,82,17,99,13,FALSE
api-actions-js,1.3.17,1.4.1,9,3,434,194,628,51,FALSE
api-actions-js,1.3.16,1.3.17,8,2,91,77,168,6,FALSE
api-actions-js,1.3.15,1.3.16,7,1,4,2,6,4,FALSE
api-actions-js,1.8.3,1.8.4,21,1,24,24,48,6,FALSE
api-actions-js,1.2.7,1.2.9,2,4,519,119,638,33,FALSE
api-actions-js,1.5.0,1.6.0,13,1,339,121,460,38,TRUE
api-actions-js,1.7.6,1.7.8,15,3,62,42,104,19,TRUE
api-actions-js,1.8.0,1.8.3,20,6,200,236,436,38,TRUE
gulp-pug,3.0.4,3.1.0,25,3,40,4,44,5,FALSE
gulp-pug,3.1.0,3.2.0,26,2,51,16,67,5,FALSE
gulp-pug,3.2.0,3.3.0,27,4,2581,3,2584,5,FALSE
gulp-pug,3.0.3,3.0.4,24,2,2,2,4,2,FALSE
gulp-pug,1.3.1,2.0.0,19,1,1,1,2,1,FALSE
gulp-pug,1.3.0,1.3.1,18,1,1,1,2,1,FALSE
gulp-pug,1.1.1,1.1.2,15,1,1,1,2,1,FALSE
gulp-pug,1.1.0,1.1.1,14,1,1,1,2,1,FALSE
gulp-pug,1.1.2,1.2.0,16,1,1,1,2,1,FALSE
gulp-pug,1.0.0,1.1.0,13,1,1,1,2,1,FALSE
gulp-pug,3.0.0,3.0.1,21,2,31,130,161,3,FALSE
gulp-pug,2.0.0,3.0.0,20,4,160,177,337,27,FALSE
gulp-pug,0.1.1,0.1.2,2,1,1,1,2,1,FALSE
gulp-pug,0.2.2,0.3.0,6,1,1,1,2,1,FALSE
gulp-pug,0.2.1,0.2.2,5,1,1,1,2,1,FALSE
gulp-pug,0.2.0,0.2.1,4,1,1,1,2,1,FALSE
gulp-pug,3.0.2,3.0.3,23,4,8,19,27,5,FALSE
gulp-pug,0.1.2,0.2.0,3,1,1,1,2,1,FALSE
gulp-pug,0.3.2,0.4.0,9,1,1,1,2,1,FALSE
gulp-pug,0.3.0,0.3.1,7,1,1,1,2,1,FALSE
gulp-pug,3.0.1,3.0.2,22,2,2,2,4,2,FALSE
gulp-pug,0.4.1,0.4.2,11,1,1,1,2,1,FALSE
gulp-pug,0.4.0,0.4.1,10,1,1,1,2,1,FALSE
gulp-pug,0.4.2,1.0.0,12,1,1,1,2,1,FALSE
gulp-pug,1.2.0,1.3.0,17,1,1,1,2,1,FALSE
gulp-pug,0.3.1,0.3.2,8,1,1,1,2,1,FALSE
gulp-pug,2.0.0,3.0.0,20,4,160,177,337,27,TRUE
gulp-pug,1.0.0,1.1.0,13,1,1,1,2,1,TRUE
react-jobs,0.0.5,0.1.0,4,2,380,264,644,25,FALSE
react-jobs,0.4.0,0.4.1,9,2,20,26,46,3,FALSE
react-jobs,0.0.3,0.0.5,3,5,30,19,49,8,FALSE
react-jobs,0.0.2,0.0.3,2,2,1,4,5,2,FALSE
react-jobs,0.3.0,0.4.0,8,23,488,294,782,58,FALSE
react-jobs,0.6.0,0.6.1,14,1,41,69,110,2,FALSE
react-jobs,0.4.1,0.4.2,10,2,2,2,4,2,FALSE
react-jobs,0.2.0,0.3.0,7,6,188,178,366,15,FALSE
react-jobs,0.1.0,0.1.1,5,14,125,75,200,15,FALSE
react-jobs,0.1.1,0.2.0,6,11,529,195,724,34,FALSE
react-jobs,0.4.3,0.5.0,12,5,129,52,181,10,FALSE
react-jobs,0.4.2,0.4.3,11,5,60,3,63,6,FALSE
react-jobs,0.5.0,0.6.0,13,16,489,540,1029,66,FALSE
react-jobs,0.6.1,0.6.2,15,1,5,5,10,2,FALSE
react-jobs,1.0.0-alpha.2,1.0.0-alpha.3,18,2,5,13,18,5,FALSE
react-jobs,1.0.0-alpha.1,1.0.0-alpha.2,17,5,193,166,359,12,FALSE
react-jobs,0.6.2,1.0.0-alpha.1,16,16,5353,7018,12371,145,FALSE
react-jobs,1.0.0-beta.2,1.0.0-beta.3,21,5,868,501,1369,13,FALSE
react-jobs,1.0.0-beta.1,1.0.0-beta.2,20,6,1042,917,1959,27,FALSE
react-jobs,1.0.0-alpha.3,1.0.0-beta.1,19,5,28,18,46,9,FALSE
react-jobs,0.3.0,0.4.0,8,23,488,294,782,58,TRUE
react-jobs,0.4.0,0.4.1,9,2,20,26,46,3,TRUE
discord-react-forms,1.0.4,1.0.5,5,2,13,12,25,8,FALSE
discord-react-forms,1.0.5,1.0.6,6,1,9,7,16,3,FALSE
discord-react-forms,1.0.6,1.0.7,7,1,4,4,8,2,FALSE
discord-react-forms,1.0.7,1.0.8,8,1,2,2,4,2,FALSE
discord-react-forms,1.0.0,1.0.1,1,3,6,5,11,3,FALSE
discord-react-forms,1.0.1,1.0.2,2,2,7,6,13,2,FALSE
discord-react-forms,1.0.2,1.0.3,3,2,14,11,25,2,FALSE
discord-react-forms,1.0.3,1.0.4,4,2,3,3,6,2,FALSE
discord-react-forms,1.0.8,1.0.9,9,1,10,8,18,3,FALSE
discord-react-forms,1.0.9,1.0.10,10,1,13,27,40,6,FALSE
discord-react-forms,2.1.3,2.1.4,22,2,2,3,5,2,FALSE
discord-react-forms,2.0.3,2.1.3,21,2,130,106,236,37,FALSE
discord-react-forms,2.1.4,2.1.5,23,2,2,3,5,2,FALSE
discord-react-forms,2.0.2,2.0.3,20,2,1,2,3,2,FALSE
discord-react-forms,2.0.1,2.0.2,19,1,1,1,2,1,FALSE
discord-react-forms,2.0.0,2.0.1,18,1,1,11,12,2,FALSE
discord-react-forms,1.0.16,2.0.0,17,2,17,3,20,15,FALSE
discord-react-forms,1.0.14,1.0.15,15,1,57,2,59,8,FALSE
discord-react-forms,1.0.15,1.0.16,16,4,25,5,30,5,FALSE
discord-react-forms,1.0.12,1.0.13,13,1,6,6,12,3,FALSE
discord-react-forms,1.0.13,1.0.14,14,1,62,22,84,16,FALSE
discord-react-forms,1.0.10,1.0.11,11,1,8,8,16,4,FALSE
discord-react-forms,1.0.11,1.0.12,12,2,10,5,15,5,FALSE
discord-react-forms,1.0.1,1.0.2,2,2,7,6,13,2,TRUE
discord-react-forms,1.0.14,1.0.15,15,1,57,2,59,8,TRUE
discord-react-forms,1.0.9,1.0.10,10,1,13,27,40,6,TRUE
discord-react-forms,1.0.0,1.0.1,1,3,6,5,11,3,TRUE
discord-react-forms,1.0.15,1.0.16,16,4,25,5,30,5,TRUE
emock,0.0.5,0.0.6,5,1,2,2,4,2,FALSE
emock,0.0.4,0.0.5,4,1,2,2,4,2,FALSE
emock,0.0.7,0.0.8,7,1,6,8,14,3,FALSE
emock,0.0.6,0.0.7,6,1,1,5,6,2,FALSE
emock,0.0.1,0.0.2,1,1,8,1,9,1,FALSE
emock,0.0.3,0.0.4,3,2,8,4,12,4,FALSE
emock,0.0.2,0.0.3,2,3,17,2,19,3,FALSE
emock,0.0.9,0.0.10,9,4,35,24,59,8,FALSE
emock,0.0.8,0.0.9,8,4,6,6,12,4,FALSE
emock,0.0.11,0.0.12,11,1,1,1,2,1,FALSE
emock,0.0.10,0.0.11,10,2,1,2,3,2,FALSE
emock,0.0.13,0.1.0,13,2,1,3908,3909,2,FALSE
emock,0.0.12,0.0.13,12,5,3916,5,3921,8,FALSE
emock,0.1.0,0.1.1,14,1,1,1,2,1,FALSE
emock,0.1.1,1.0.0,15,8,5806,410,6216,32,FALSE
emock,0.0.9,0.0.10,9,4,35,24,59,8,TRUE
emock,0.1.0,0.1.1,14,1,1,1,2,1,TRUE
heroku-apps,1.0.0,1.1.0,28,5,295,13,308,11,FALSE
heroku-apps,2.1.21,2.1.22,85,5,79,21,100,10,FALSE
heroku-apps,2.1.20,2.1.21,84,2,42,1,43,3,FALSE
heroku-apps,2.1.23,2.1.24,87,2,2,1,3,2,FALSE
heroku-apps,2.1.22,2.1.23,86,4,2986,33,3019,5,FALSE
heroku-apps,2.1.25,2.1.26,89,3,4,2,6,3,FALSE
heroku-apps,2.1.24,2.1.25,88,2,1,3,4,2,FALSE
heroku-apps,2.1.27,2.2.0,91,4,277,135,412,12,FALSE
heroku-apps,2.1.26,2.1.27,90,5,65,57,122,6,FALSE
heroku-apps,0.3.2,0.4.0,20,12,1497,32,1529,45,FALSE
heroku-apps,1.7.2,1.7.3,53,2,11,6,17,5,FALSE
heroku-apps,0.3.0,0.3.1,18,4,15,9,24,5,FALSE
heroku-apps,0.3.1,0.3.2,19,3,18,12,30,7,FALSE
heroku-apps,1.6.0,1.7.0,50,1,1,1,2,1,FALSE
heroku-apps,1.7.1,1.7.2,52,7,164,19,183,11,FALSE
heroku-apps,1.1.0,1.1.1,29,1,1,1,2,1,FALSE
heroku-apps,2.2.20,2.2.21,111,2,152,72,224,10,FALSE
heroku-apps,2.1.18,2.1.19,82,3,67,58,125,7,FALSE
heroku-apps,2.1.19,2.1.20,83,3,65,2,67,7,FALSE
heroku-apps,2.1.14,2.1.15,78,4,44,20,64,5,FALSE
heroku-apps,2.1.15,2.1.16,79,2,7,7,14,3,FALSE
heroku-apps,2.1.16,2.1.17,80,5,101,40,141,12,FALSE
heroku-apps,2.1.17,2.1.18,81,3,3,3,6,3,FALSE
heroku-apps,2.1.10,2.1.11,74,1,37,55,92,11,FALSE
heroku-apps,2.1.11,2.1.12,75,8,51,51,102,11,FALSE
heroku-apps,2.1.12,2.1.13,76,2,45,5,50,3,FALSE
heroku-apps,2.1.13,2.1.14,77,5,131,153,284,24,FALSE
heroku-apps,0.5.2,0.5.3,25,9,122,43,165,14,FALSE
heroku-apps,1.7.0,1.7.1,51,1,2,2,4,1,FALSE
heroku-apps,1.1.2,1.1.3,31,2,2,2,4,2,FALSE
heroku-apps,2.0.7,2.1.0,63,7,80,72,152,16,FALSE
heroku-apps,2.0.6,2.0.7,62,8,250,149,399,41,FALSE
heroku-apps,2.0.5,2.0.6,61,2,276,5,281,8,FALSE
heroku-apps,2.0.4,2.0.5,60,6,542,78,620,17,FALSE
heroku-apps,2.0.3,2.0.4,59,12,154,151,305,24,FALSE
heroku-apps,2.0.2,2.0.3,58,9,3756,3436,7192,139,FALSE
heroku-apps,2.0.1,2.0.2,57,2,66,17,83,4,FALSE
heroku-apps,2.0.0,2.0.1,56,6,73,2,75,6,FALSE
heroku-apps,2.2.22,2.2.23,113,2,20,19,39,7,FALSE
heroku-apps,2.2.5,2.2.6,97,3,90,32,122,5,FALSE
heroku-apps,2.2.4,2.2.5,96,2,5,5,10,3,FALSE
heroku-apps,2.2.7,2.2.8,99,2,2,2,4,2,FALSE
heroku-apps,2.2.6,2.2.7,98,3,47,47,94,4,FALSE
heroku-apps,2.2.1,2.2.2,93,2,39,1,40,4,FALSE
heroku-apps,2.2.0,2.2.1,92,2,12,29,41,3,FALSE
heroku-apps,2.2.3,2.2.4,95,3,89,31,120,5,FALSE
heroku-apps,2.2.2,2.2.3,94,3,82,12,94,7,FALSE
heroku-apps,2.2.24,2.2.25,115,2,52,1,53,5,FALSE
heroku-apps,0.5.0,0.5.1,23,1,2,2,4,1,FALSE
heroku-apps,2.2.9,2.2.10,101,2,5,5,10,3,FALSE
heroku-apps,2.2.8,2.2.9,100,2,6,6,12,3,FALSE
heroku-apps,2.2.25,2.3.0,116,3,179,30,209,8,FALSE
heroku-apps,0.4.1,0.5.0,22,13,2020,48,2068,59,FALSE
heroku-apps,0.4.0,0.4.1,21,10,217,53,270,19,FALSE
heroku-apps,2.2.15,2.2.16,106,2,229,1,230,10,FALSE
heroku-apps,2.2.17,2.2.18,108,2,5,5,10,3,FALSE
heroku-apps,2.2.16,2.2.17,107,2,27,8,35,3,FALSE
heroku-apps,2.2.11,2.2.12,103,2,40,2,42,3,FALSE
heroku-apps,2.2.10,2.2.11,102,3,6,6,12,4,FALSE
heroku-apps,2.2.13,2.2.15,105,2,33,7,40,3,FALSE
heroku-apps,2.2.12,2.2.13,104,3,96,7,103,5,FALSE
heroku-apps,1.5.1,1.5.2,48,5,10,9,19,7,FALSE
heroku-apps,1.5.0,1.5.1,47,3,92,2,94,5,FALSE
heroku-apps,1.5.2,1.6.0,49,2,78,2,80,4,FALSE
heroku-apps,1.3.0,1.4.0,45,1,301,0,301,9,FALSE
heroku-apps,0.1.9,0.1.10,11,3,3,3,6,3,FALSE
heroku-apps,1.1.1,1.1.2,30,2,6,3,9,2,FALSE
heroku-apps,2.2.21,2.2.22,112,2,50,9,59,5,FALSE
heroku-apps,1.1.3,1.1.4,32,3,9,8,17,4,FALSE
heroku-apps,2.2.23,2.2.24,114,3,44,17,61,5,FALSE
heroku-apps,1.1.5,1.1.6,34,1,2,2,4,1,FALSE
heroku-apps,1.1.4,1.1.5,33,6,24,8,32,8,FALSE
heroku-apps,1.1.7,1.2.0,36,8,82,22,104,15,FALSE
heroku-apps,1.1.6,1.1.7,35,15,750,68,818,50,FALSE
heroku-apps,0.1.8,0.1.9,10,1,9,1,10,1,FALSE
heroku-apps,2.1.2,2.1.3,66,2,15,2,17,3,FALSE
heroku-apps,2.1.8,2.1.9,72,2,34,89,123,3,FALSE
heroku-apps,2.1.9,2.1.10,73,2,6,6,12,4,FALSE
heroku-apps,0.2.2,0.3.0,17,2,3,3,6,3,FALSE
heroku-apps,0.2.1,0.2.2,16,8,20,18,38,13,FALSE
heroku-apps,0.2.0,0.2.1,15,3,3,3,6,3,FALSE
heroku-apps,0.1.0,0.1.1,2,2,4,4,8,4,FALSE
heroku-apps,0.1.1,0.1.2,3,2,2,1,3,2,FALSE
heroku-apps,0.1.2,0.1.3,4,2,3,3,6,2,FALSE
heroku-apps,0.1.3,0.1.4,5,2,6,11,17,4,FALSE
heroku-apps,0.1.4,0.1.5,6,3,3,3,6,3,FALSE
heroku-apps,2.1.7,2.1.8,71,2,89,34,123,3,FALSE
heroku-apps,0.1.6,0.1.7,8,9,124,57,181,15,FALSE
heroku-apps,0.1.7,0.1.8,9,2,2,2,4,2,FALSE
heroku-apps,2.1.3,2.1.4,67,2,15,2,17,3,FALSE
heroku-apps,2.1.1,2.1.2,65,5,154,49,203,7,FALSE
heroku-apps,0.0.0,0.1.0,1,3,73,8,81,8,FALSE
heroku-apps,2.1.6,2.1.7,70,3,62,92,154,6,FALSE
heroku-apps,1.8.0,2.0.0,55,31,2963,520,3483,105,FALSE
heroku-apps,0.1.5,0.1.6,7,2,2,2,4,2,FALSE
heroku-apps,2.1.4,2.1.5,68,2,25,4,29,3,FALSE
heroku-apps,0.5.4,1.0.0,27,13,499,57,556,41,FALSE
heroku-apps,2.1.5,2.1.6,69,2,40,6,46,3,FALSE
heroku-apps,1.7.3,1.8.0,54,12,369,78,447,39,FALSE
heroku-apps,0.5.1,0.5.2,24,2,2,2,4,2,FALSE
heroku-apps,2.1.0,2.1.1,64,2,2,2,4,2,FALSE
heroku-apps,0.5.3,0.5.4,26,2,80,16,96,6,FALSE
heroku-apps,1.4.0,1.5.0,46,4,415,1,416,20,FALSE
heroku-apps,2.3.0,2.3.1,117,3,10,7,17,5,FALSE
heroku-apps,2.2.19,2.2.20,110,2,16,4,20,4,FALSE
heroku-apps,2.2.18,2.2.19,109,2,154,10,164,7,FALSE
heroku-apps,1.2.6,1.2.7,43,4,126,4,130,6,FALSE
heroku-apps,1.2.7,1.3.0,44,13,403,42,445,26,FALSE
heroku-apps,1.2.4,1.2.5,41,5,35,6,41,7,FALSE
heroku-apps,1.2.5,1.2.6,42,6,41,34,75,8,FALSE
heroku-apps,1.2.2,1.2.3,39,1,2,1,3,1,FALSE
heroku-apps,1.2.3,1.2.4,40,10,46,34,80,16,FALSE
heroku-apps,1.2.0,1.2.1,37,2,7,6,13,3,FALSE
heroku-apps,1.2.1,1.2.2,38,2,2,2,4,2,FALSE
heroku-apps,0.1.12,0.2.0,14,2,16,12,28,2,FALSE
heroku-apps,0.1.10,0.1.11,12,3,181,99,280,5,FALSE
heroku-apps,0.1.11,0.1.12,13,2,1,2,3,2,FALSE
heroku-apps,2.1.13,2.1.14,77,5,131,153,284,24,TRUE
heroku-apps,1.1.7,1.2.0,36,8,82,22,104,15,TRUE
heroku-apps,2.0.3,2.0.4,59,12,154,151,305,24,TRUE
heroku-apps,2.1.21,2.1.22,85,5,79,21,100,10,TRUE
heroku-apps,2.1.1,2.1.2,65,5,154,49,203,7,TRUE
heroku-apps,1.2.2,1.2.3,39,1,2,1,3,1,TRUE
heroku-apps,2.0.7,2.1.0,63,7,80,72,152,16,TRUE
heroku-apps,1.0.0,1.1.0,28,5,295,13,308,11,TRUE
heroku-apps,2.2.3,2.2.4,95,3,89,31,120,5,TRUE
react-native-image-carousel,0.0.1,0.1.0,1,8,109,41126,41235,2109,FALSE
react-native-image-carousel,0.3.0,0.3.1,10,1,2,1,3,1,FALSE
react-native-image-carousel,0.3.1,0.3.2,11,1,4,5,9,1,FALSE
react-native-image-carousel,0.2.4,0.3.0,9,20,1801,2718,4519,41,FALSE
react-native-image-carousel,0.2.3,0.2.4,8,14,5486,52,5538,14,FALSE
react-native-image-carousel,0.2.2,0.2.3,7,2,15,5,20,2,FALSE
react-native-image-carousel,0.2.1,0.2.2,6,3,22,15,37,3,FALSE
react-native-image-carousel,0.2.0,0.2.1,5,5,165,65,230,5,FALSE
react-native-image-carousel,0.1.0,0.1.2,2,4,409,410,819,5,TRUE
react-native-image-carousel,0.1.2,0.1.3,3,4,147,237,384,5,FALSE
react-native-image-carousel,0.1.3,0.2.0,4,3,107,66,173,3,FALSE
react-native-image-carousel,0.1.0,0.1.2,2,4,409,410,819,5,FALSE
react-native-image-carousel,0.2.3,0.2.4,8,14,5486,52,5538,14,TRUE
stf-input-list-filter,0.5.11,0.5.12,11,1,1,1,2,1,FALSE
stf-input-list-filter,0.5.10,0.5.11,10,1,3,3,6,2,FALSE
stf-input-list-filter,0.5.15,0.5.16,15,1,7,5,12,2,TRUE
stf-input-list-filter,0.5.14,0.5.15,14,2,4,4,8,4,FALSE
stf-input-list-filter,0.5.13,0.5.14,13,1,1,1,2,1,FALSE
stf-input-list-filter,0.5.4,0.5.5,4,1,1,1,2,1,FALSE
stf-input-list-filter,0.5.8,0.5.9,8,1,1,1,2,1,FALSE
stf-input-list-filter,0.5.9,0.5.10,9,3,1015,2,1017,36,FALSE
stf-input-list-filter,0.5.5,0.5.6,5,1,1,1,2,1,FALSE
stf-input-list-filter,0.5.6,0.5.7,6,1,1,1,2,1,FALSE
stf-input-list-filter,0.5.7,0.5.8,7,1,1,1,2,1,FALSE
stf-input-list-filter,0.5.12,0.5.13,12,1,11,28,39,6,FALSE
stf-input-list-filter,0.5.1,0.5.2,1,1,1,1,2,1,FALSE
stf-input-list-filter,0.5.2,0.5.3,2,1,1,1,2,1,FALSE
stf-input-list-filter,0.5.3,0.5.4,3,1,1,1,2,1,FALSE
stf-input-list-filter,0.5.15,0.5.16,15,1,7,5,12,2,FALSE
hasbin,1.1.1,1.1.2,6,4,8,7,15,5,FALSE
hasbin,1.1.0,1.1.1,5,3,55,13,68,11,FALSE
hasbin,1.1.3,1.2.0,8,4,279,16,295,10,FALSE
hasbin,1.1.2,1.1.3,7,5,23,12,35,10,FALSE
hasbin,1.0.0,1.1.0,4,5,46,8,54,8,FALSE
hasbin,1.2.0,1.2.1,9,5,28,22,50,8,FALSE
hasbin,1.2.1,1.2.2,10,3,10,5,15,6,FALSE
hasbin,1.2.2,1.2.3,11,2,34,2,36,4,FALSE
hasbin,0.2.1,1.0.0,3,5,102,16,118,13,FALSE
hasbin,0.2.0,0.2.1,2,2,20,11,31,5,TRUE
hasbin,0.1.0,0.2.0,1,2,39,8,47,4,FALSE
hasbin,1.1.0,1.1.1,5,3,55,13,68,11,TRUE
hasbin,0.2.0,0.2.1,2,2,20,11,31,5,FALSE
hasbin,1.1.2,1.1.3,7,5,23,12,35,10,TRUE
react-icheck,0.3.2,0.3.3,10,5,16,11,27,7,FALSE
react-icheck,0.3.3,0.3.4,11,4,92,58,150,18,FALSE
react-icheck,0.3.0,0.3.1,8,15,516,80335,80851,82,FALSE
react-icheck,0.3.1,0.3.2,9,3,5,7,12,4,FALSE
react-icheck,0.3.6,0.3.7,14,11,15,13,28,11,FALSE
react-icheck,0.3.7,0.3.8,15,2,104,98,202,6,FALSE
react-icheck,0.3.4,0.3.5,12,4,11,13,24,13,FALSE
react-icheck,0.3.5,0.3.6,13,5,89,46,135,7,FALSE
react-icheck,0.2.2,0.3.0,7,5,92,54,146,10,FALSE
react-icheck,0.2.1,0.2.2,6,2,6,22,28,4,FALSE
react-icheck,0.2.0,0.2.1,5,8,101,55,156,10,FALSE
react-icheck,0.1.0,0.1.1,3,4,486,452,938,7,FALSE
react-icheck,0.1.1,0.2.0,4,30,161741,868,162609,162,FALSE
react-icheck,0.0.3,0.1.0,2,5,1199,117,1316,23,FALSE
react-icheck,0.0.2,0.0.3,1,6,526,72,598,20,FALSE
react-icheck,0.0.3,0.1.0,2,5,1199,117,1316,23,TRUE
react-icheck,0.2.2,0.3.0,7,5,92,54,146,10,TRUE
giveme,1.1.0,1.1.1,2,2,37,29,66,9,FALSE
giveme,1.0.0,1.1.0,1,1,214,5,219,7,FALSE
giveme,1.0.0,1.1.0,1,1,214,5,219,7,TRUE
selenium-assistant,0.2.0,0.3.0,9,6,16,8,24,6,FALSE
selenium-assistant,0.1.0,0.1.1,3,3,27,4,31,3,FALSE
selenium-assistant,0.1.1,0.1.2,4,2,39,13,52,3,FALSE
selenium-assistant,0.1.2,0.1.4,5,9,153,185,338,28,FALSE
selenium-assistant,0.1.4,0.1.5,6,3,219,109,328,11,FALSE
selenium-assistant,0.1.5,0.1.6,7,10,374,120,494,26,FALSE
selenium-assistant,0.1.6,0.2.0,8,10,136,110,246,17,FALSE
selenium-assistant,4.0.1,5.0.0,27,1,400,270,670,27,FALSE
selenium-assistant,0.0.4,0.1.0,2,10,1695,595,2290,47,FALSE
selenium-assistant,3.0.0,3.0.1,23,3,5,5,10,4,FALSE
selenium-assistant,0.0.3,0.0.4,1,2,39,3,42,2,FALSE
selenium-assistant,3.0.1,3.0.2,24,1,2,2,4,1,FALSE
selenium-assistant,4.0.0,4.0.1,26,7,2534,1246,3780,55,FALSE
selenium-assistant,5.0.0,5.0.1,28,1,2,2,4,1,FALSE
selenium-assistant,5.0.1,5.0.2,29,3,5,8,13,4,FALSE
selenium-assistant,5.0.2,5.0.3,30,6,151,68,219,10,FALSE
selenium-assistant,5.0.3,5.0.4,31,2,43,27,70,9,FALSE
selenium-assistant,5.0.4,5.0.5,32,4,28,30,58,8,FALSE
selenium-assistant,3.0.2,4.0.0,25,3,2138,1056,3194,38,FALSE
selenium-assistant,2.0.5,3.0.0,22,12,459,182,641,40,FALSE
selenium-assistant,2.0.4,2.0.5,21,5,75,92,167,10,FALSE
selenium-assistant,1.0.0,2.0.0,16,30,34617,1415,36032,162,FALSE
selenium-assistant,2.0.2,2.0.3,19,5,17,221787,221804,516,FALSE
selenium-assistant,2.0.1,2.0.2,18,4,8,5,13,5,FALSE
selenium-assistant,2.0.0,2.0.1,17,5,16431,205339,221770,515,FALSE
selenium-assistant,0.3.0,0.4.0,10,3,253,289,542,21,FALSE
selenium-assistant,0.4.0,0.5.0,11,34,173144,17543,190687,505,FALSE
selenium-assistant,2.0.3,2.0.4,20,2,2,2,4,2,FALSE
selenium-assistant,0.5.0,0.5.1,12,4,17251,17251,34502,78,FALSE
selenium-assistant,0.5.1,0.5.2,13,4,17248,4,17252,41,FALSE
selenium-assistant,0.5.2,0.5.3,14,4,17265,31,17296,45,FALSE
selenium-assistant,0.5.3,1.0.0,15,13,16896,17936,34832,111,TRUE
selenium-assistant,0.5.3,1.0.0,15,13,16896,17936,34832,111,FALSE
selenium-assistant,4.0.1,5.0.0,27,1,400,270,670,27,TRUE
selenium-assistant,0.1.0,0.1.1,3,3,27,4,31,3,TRUE
selenium-assistant,0.4.0,0.5.0,11,34,173144,17543,190687,505,TRUE
selenium-assistant,0.0.4,0.1.0,2,10,1695,595,2290,47,TRUE
selenium-assistant,1.0.0,2.0.0,16,30,34617,1415,36032,162,TRUE
selenium-assistant,0.2.0,0.3.0,9,6,16,8,24,6,TRUE
selenium-assistant,5.0.2,5.0.3,30,6,151,68,219,10,TRUE
selenium-assistant,3.0.0,3.0.1,23,3,5,5,10,4,TRUE
selenium-assistant,2.0.0,2.0.1,17,5,16431,205339,221770,515,TRUE
selenium-assistant,4.0.0,4.0.1,26,7,2534,1246,3780,55,TRUE
droppable.js,2.0.7,2.0.8,10,3,3,3,6,3,FALSE
droppable.js,2.0.6,2.0.7,9,4,77,21,98,8,FALSE
droppable.js,2.0.5,2.0.6,8,3,13,11,24,3,FALSE
droppable.js,2.0.4,2.0.5,7,3,23,67,90,7,FALSE
droppable.js,2.0.3,2.0.4,6,3,5,3,8,3,FALSE
droppable.js,2.0.2,2.0.3,5,4,30,2,32,6,FALSE
droppable.js,2.0.1,2.0.2,4,1,1,1,2,1,FALSE
droppable.js,2.0.0,2.0.1,3,3,4,6,10,6,FALSE
droppable.js,2.0.9,2.0.10,12,3,3,3,6,3,FALSE
droppable.js,2.0.8,2.0.9,11,3,5,3,8,3,FALSE
droppable.js,2.0.10,2.0.11,13,3,5,3,8,3,FALSE
droppable.js,2.0.2,2.0.3,5,4,30,2,32,6,TRUE
droppable.js,1.0.3,2.0.0,2,15,2121,581,2702,88,FALSE
droppable.js,1.0.2,1.0.3,1,2,19,13,32,2,FALSE
enclave,0.10.1,0.10.2,29,1,4,4,8,1,FALSE
enclave,0.10.0,0.10.1,28,6,27,11,38,6,FALSE
enclave,0.10.3,0.10.4,31,6,48,58,106,8,FALSE
enclave,0.10.2,0.10.3,30,4,6,4,10,4,FALSE
enclave,0.10.5,0.10.6,33,4,2,6,8,4,FALSE
enclave,0.10.4,0.10.5,32,3,3,1,4,3,FALSE
enclave,0.10.7,0.10.8,35,6,20,2,22,8,FALSE
enclave,0.10.6,0.10.7,34,3,9,3,12,3,FALSE
enclave,0.8.21,0.8.22,21,2,8,12,20,4,FALSE
enclave,0.8.22,0.8.23,22,2,2,36,38,6,FALSE
enclave,0.8.23,0.9.0,23,6,454,53,507,26,FALSE
enclave,0.11.0,0.11.1,37,2,2,1,3,2,FALSE
enclave,0.11.1,0.11.2,38,3,4489,4,4493,4,FALSE
enclave,0.9.2,0.9.3,26,3,11,13,24,3,FALSE
enclave,0.9.1,0.9.2,25,4,46,46,92,10,FALSE
enclave,0.9.3,0.10.0,27,10,224,38,262,18,FALSE
enclave,0.9.0,0.9.1,24,10,84,15,99,14,FALSE
enclave,0.10.8,0.11.0,36,3,5,5,10,3,FALSE
enclave,0.8.15,0.8.16,16,9,12,10,22,9,FALSE
enclave,0.8.14,0.8.15,15,4,111,30,141,12,FALSE
enclave,0.8.16,0.8.18,17,8,45,5,50,13,FALSE
enclave,0.8.11,0.8.12,12,5,251,37,288,20,FALSE
enclave,0.8.10,0.8.11,11,12,59,45,104,19,FALSE
enclave,0.8.13,0.8.14,14,2,3,3,6,2,FALSE
enclave,0.8.12,0.8.13,13,12,233,70,303,28,FALSE
enclave,0.8.9,0.8.10,10,3,12,2,14,6,FALSE
enclave,0.8.8,0.8.9,9,16,221,84,305,28,FALSE
enclave,0.8.5,0.8.6,6,2,2,2,4,2,FALSE
enclave,0.8.4,0.8.5,5,2,2,2,4,2,FALSE
enclave,0.8.7,0.8.8,8,2,2,2,4,2,FALSE
enclave,0.8.6,0.8.7,7,2,2,2,4,2,FALSE
enclave,0.8.1,0.8.2,2,2,2,2,4,2,FALSE
enclave,0.8.0,0.8.1,1,6,210,100,310,26,FALSE
enclave,0.8.3,0.8.4,4,2,2,2,4,2,FALSE
enclave,0.8.2,0.8.3,3,2,3,3,6,2,FALSE
enclave,0.8.19,0.8.20,19,8,24,2,26,8,FALSE
enclave,0.8.18,0.8.19,18,4,93,57,150,9,FALSE
enclave,0.8.20,0.8.21,20,12,260,18,278,35,FALSE
enclave,0.8.20,0.8.21,20,12,260,18,278,35,TRUE
enclave,0.8.15,0.8.16,16,9,12,10,22,9,TRUE
enclave,0.10.0,0.10.1,28,6,27,11,38,6,TRUE
enclave,0.10.4,0.10.5,32,3,3,1,4,3,TRUE
enclave,0.9.1,0.9.2,25,4,46,46,92,10,TRUE
waldojs,0.1.8,0.1.9,9,8,28,27,55,8,TRUE
waldojs,0.1.9,0.1.10,10,1,5,33,38,2,FALSE
waldojs,0.1.4,0.1.5,5,6,33,13,46,8,FALSE
waldojs,0.1.5,0.1.6,6,5,52,48,100,8,FALSE
waldojs,0.1.6,0.1.7,7,3,12,4,16,3,FALSE
waldojs,0.1.7,0.1.8,8,3,4,4,8,3,FALSE
waldojs,0.1.0,0.1.1,1,4,17,19,36,4,FALSE
waldojs,0.1.1,0.1.2,2,2,2,2,4,2,FALSE
waldojs,0.1.2,0.1.3,3,2,6,1,7,4,FALSE
waldojs,0.1.8,0.1.9,9,8,28,27,55,8,FALSE
waldojs,0.1.3,0.1.4,4,2,14,7,21,3,FALSE
lc-form-validation,0.1.6,0.1.7,6,17,170,212,382,67,FALSE
lc-form-validation,0.1.1,0.1.2,1,5,148,69,217,28,FALSE
lc-form-validation,0.1.2,0.1.3,2,14,1085,1011,2096,30,FALSE
lc-form-validation,0.1.3,0.1.4,3,2,11,57,68,4,FALSE
lc-form-validation,0.1.4,0.1.5,4,1,2,0,2,1,FALSE
lc-form-validation,1.0.0-beta.0,1.0.0,8,5,10,26,36,9,FALSE
lc-form-validation,0.1.5,0.1.6,5,20,451,741,1192,117,FALSE
lc-form-validation,0.1.7,1.0.0-beta.0,7,114,24132,15056,39188,1182,FALSE
lc-form-validation,0.1.1,0.1.2,1,5,148,69,217,28,TRUE
lc-form-validation,0.1.5,0.1.6,5,20,451,741,1192,117,TRUE
lc-form-validation,0.1.6,0.1.7,6,17,170,212,382,67,TRUE
ahab,0.1.0,0.1.2,1,2,2,2,4,2,TRUE
ahab,0.1.0,0.1.2,1,2,2,2,4,2,FALSE
organism-react-scroll-nav,0.0.5,0.0.6,6,1,75,32,107,5,FALSE
organism-react-scroll-nav,0.0.4,0.0.5,5,1,21,17,38,5,FALSE
organism-react-scroll-nav,0.0.7,0.0.8,8,2,42,40,82,9,FALSE
organism-react-scroll-nav,0.0.6,0.0.7,7,1,60,21,81,7,FALSE
organism-react-scroll-nav,0.0.1,0.0.2,2,1,1477,31722,33199,14,FALSE
organism-react-scroll-nav,0.0.0,0.0.1,1,1,1477,31722,33199,14,FALSE
organism-react-scroll-nav,0.0.3,0.0.4,4,1,1,1,2,1,FALSE
organism-react-scroll-nav,0.0.2,0.0.3,3,3,1078,814,1892,15,FALSE
organism-react-scroll-nav,0.0.9,0.0.10,10,1,1477,31722,33199,14,FALSE
organism-react-scroll-nav,0.0.8,0.0.9,9,1,1477,31722,33199,14,FALSE
organism-react-scroll-nav,0.0.15,0.0.16,16,1,1477,31722,33199,14,FALSE
organism-react-scroll-nav,0.0.14,0.0.15,15,1,1,2,3,2,FALSE
organism-react-scroll-nav,0.0.17,0.0.18,18,1,14,8,22,5,FALSE
organism-react-scroll-nav,0.0.16,0.0.17,17,1,39,100,139,5,FALSE
organism-react-scroll-nav,0.0.11,0.0.12,12,1,1477,31722,33199,14,FALSE
organism-react-scroll-nav,0.0.10,0.0.11,11,1,1477,31722,33199,14,FALSE
organism-react-scroll-nav,0.0.13,0.0.14,14,1,4,4,8,2,FALSE
organism-react-scroll-nav,0.0.12,0.0.13,13,1,1477,31722,33199,14,FALSE
organism-react-scroll-nav,0.0.18,0.0.19,19,1,1477,31722,33199,14,FALSE
organism-react-scroll-nav,0.2.1,0.2.2,32,1,1477,31722,33199,14,FALSE
organism-react-scroll-nav,0.2.0,0.2.1,31,1,8,2,10,4,FALSE
organism-react-scroll-nav,0.2.5,0.2.6,35,1,5,4,9,4,FALSE
organism-react-scroll-nav,0.1.0,0.1.1,21,1,2683,17,2700,5,FALSE
organism-react-scroll-nav,0.1.1,0.1.2,22,1,2,2,4,2,FALSE
organism-react-scroll-nav,0.1.2,0.1.3,23,2,1390,1707,3097,8,FALSE
organism-react-scroll-nav,0.1.3,0.1.4,24,1,1477,31722,33199,14,FALSE
organism-react-scroll-nav,0.0.19,0.1.0,20,1,96,34,130,4,FALSE
organism-react-scroll-nav,0.1.6,0.1.7,27,1,2335,4071,6406,5,FALSE
organism-react-scroll-nav,0.1.7,0.1.8,28,1,15,7,22,5,FALSE
organism-react-scroll-nav,0.1.4,0.1.5,25,1,893,1344,2237,4,FALSE
organism-react-scroll-nav,0.1.5,0.1.6,26,1,15,13,28,5,FALSE
organism-react-scroll-nav,0.2.6,0.2.7,36,1,5836,1201,7037,5,FALSE
organism-react-scroll-nav,0.1.9,0.2.0,30,1,374,871,1245,7,FALSE
organism-react-scroll-nav,0.1.8,0.1.9,29,1,29,27,56,5,FALSE
organism-react-scroll-nav,0.2.3,0.2.5,34,1,2889,2762,5651,6,FALSE
organism-react-scroll-nav,0.2.2,0.2.3,33,1,33,24,57,5,FALSE
organism-react-scroll-nav,0.0.8,0.0.9,9,1,1477,31722,33199,14,TRUE
organism-react-scroll-nav,0.1.3,0.1.4,24,1,1477,31722,33199,14,TRUE
organism-react-scroll-nav,0.0.13,0.0.14,14,1,4,4,8,2,TRUE
zenypass-vault-service,0.1.0,0.2.0,1,1,37,25,62,5,FALSE
zenypass-vault-service,0.1.0,0.2.0,1,1,37,25,62,5,TRUE
zp-mobile,1.0.4,1.0.5,5,1,16,13,29,12,FALSE
zp-mobile,1.0.5,1.0.6,6,1,24,10,34,6,FALSE
zp-mobile,1.0.6,1.0.7,7,2,3,3,6,2,FALSE
zp-mobile,1.0.7,1.0.8,8,2,189,154,343,9,FALSE
zp-mobile,1.0.0,1.0.1,1,1,24,10,34,6,FALSE
zp-mobile,1.0.1,1.0.2,2,1,199,35,234,7,FALSE
zp-mobile,1.0.2,1.0.3,3,1,2,2,4,2,FALSE
zp-mobile,1.0.3,1.0.4,4,2,102,3,105,4,FALSE
zp-mobile,1.0.8,1.0.9,9,1,24,10,34,6,FALSE
zp-mobile,1.0.9,1.1.0,10,1,303,1,304,8,FALSE
zp-mobile,1.1.2,1.2.0,12,1,484,60,544,19,FALSE
zp-mobile,1.6.0,1.7.0,21,7,838,345,1183,21,FALSE
zp-mobile,1.7.5,1.8.0,25,3,313,207,520,38,FALSE
zp-mobile,1.7.2,1.7.5,24,1,129,606,735,14,FALSE
zp-mobile,1.7.1,1.7.2,23,1,24,10,34,6,FALSE
zp-mobile,1.7.0,1.7.1,22,1,24,10,34,6,FALSE
zp-mobile,1.4.0,1.4.2,17,1,24,10,34,6,FALSE
zp-mobile,1.4.2,1.5.0,18,1,501,69,570,16,FALSE
zp-mobile,1.5.1,1.6.0,20,1,24,10,34,6,FALSE
zp-mobile,1.5.0,1.5.1,19,1,12,10,22,3,FALSE
zp-mobile,1.3.1,1.4.0,16,1,567,52,619,16,FALSE
zp-mobile,1.3.0,1.3.1,15,1,24,10,34,6,FALSE
zp-mobile,1.2.0,1.2.1,13,1,24,10,34,6,FALSE
zp-mobile,1.2.1,1.3.0,14,1,12,8,20,4,FALSE
zp-mobile,1.1.0,1.1.2,11,2,424,228,652,23,FALSE
zp-mobile,1.1.0,1.1.2,11,2,424,228,652,23,TRUE
balm,0.4.28,0.4.29,40,6,441,339,780,59,FALSE
balm,0.4.29,0.4.30,41,1,56,12,68,9,FALSE
balm,0.4.24,0.4.25,36,2,32,16,48,7,FALSE
balm,0.4.25,0.4.26,37,1,11,3,14,3,FALSE
balm,0.4.26,0.4.27,38,3,55,4,59,10,FALSE
balm,0.4.27,0.4.28,39,1,57,22,79,8,FALSE
balm,0.4.20,0.4.21,32,2,809,246,1055,11,FALSE
balm,0.4.21,0.4.22,33,12,221,158,379,53,FALSE
balm,0.4.22,0.4.23,34,3,134,42,176,21,FALSE
balm,0.4.23,0.4.24,35,4,19,21,40,8,FALSE
balm,0.5.0-beta.6,0.5.0,52,3,145,90,235,16,FALSE
balm,0.6.0-beta.6,0.6.0-beta.7,66,2,28,112,140,6,FALSE
balm,0.6.0-beta.5,0.6.0-beta.6,65,3,436,333,769,8,FALSE
balm,0.6.0-beta.4,0.6.0-beta.5,64,6,216,104,320,17,FALSE
balm,0.6.0-beta.3,0.6.0-beta.4,63,3,333,440,773,38,FALSE
balm,0.6.0-beta.2,0.6.0-beta.3,62,2,218,93,311,3,FALSE
balm,0.6.0-beta.9,0.6.0-beta.10,69,1,6,3,9,2,FALSE
balm,0.6.0-beta.8,0.6.0-beta.9,68,1,27,14,41,6,FALSE
balm,0.5.4,0.5.5,57,2,36,17,53,5,FALSE
balm,0.5.5,0.5.6,58,2,8462,8364,16826,10,FALSE
balm,0.5.6,0.5.7,59,2,8397,22,8419,22,FALSE
balm,0.5.7,0.6.0-beta,60,4,1095,704,1799,56,FALSE
balm,0.5.0,0.5.1,53,2,193,117,310,9,FALSE
balm,0.5.1,0.5.2,54,4,360,327,687,44,FALSE
balm,0.5.2,0.5.3,55,1,19,13,32,9,FALSE
balm,0.5.3,0.5.4,56,1,162,94,256,24,FALSE
balm,0.4.33,0.4.34,45,1,6,2,8,3,FALSE
balm,0.4.32,0.4.33,44,5,106,77,183,20,FALSE
balm,0.4.31,0.4.32,43,2,88,103,191,14,FALSE
balm,0.4.30,0.4.31,42,2,25,9,34,6,FALSE
balm,0.4.37,0.5.0-beta,49,3,723,539,1262,57,FALSE
balm,0.4.36,0.4.37,48,2,267,215,482,8,FALSE
balm,0.4.35,0.4.36,47,1,13,7,20,3,FALSE
balm,0.4.34,0.4.35,46,2,15,4,19,5,FALSE
balm,0.6.0-beta,0.6.0-beta.2,61,3,1927,2114,4041,8,FALSE
balm,0.6.0-beta.7,0.6.0-beta.8,67,1,100,56,156,2,FALSE
balm,0.5.0-beta,0.5.0-beta.3,50,8,456,319,775,54,FALSE
balm,0.6.0-beta.12,0.6.0-rc,72,6,102,55,157,26,FALSE
balm,0.6.0-beta.11,0.6.0-beta.12,71,3,1788,1657,3445,14,FALSE
balm,0.6.0-beta.10,0.6.0-beta.11,70,2,220,114,334,17,FALSE
balm,0.6.0-rc,0.6.0-rc.2,73,16,9029,8846,17875,54,FALSE
balm,0.5.0-beta.3,0.5.0-beta.6,51,8,438,339,777,67,FALSE
balm,0.2.4,0.3.0-beta,8,11,235,226,461,67,FALSE
balm,0.2.3,0.2.4,7,2,111,46,157,15,FALSE
balm,0.2.2,0.2.3,6,5,23,19,42,8,FALSE
balm,0.2.0,0.2.2,5,3,113,35,148,17,FALSE
balm,0.1.0,0.1.1,1,1,19,9,28,2,FALSE
balm,0.1.1,0.1.2,2,1,138,27,165,6,FALSE
balm,0.1.2,0.1.3,3,1,126,46,172,11,FALSE
balm,0.3.0-beta2,0.3.0-beta3,10,3,215,163,378,20,FALSE
balm,0.3.0-beta3,0.4.0,11,10,373,141,514,54,FALSE
balm,0.1.3,0.2.0,4,1,30,14,44,6,FALSE
balm,0.4.9,0.4.10,21,6,133,48,181,19,FALSE
balm,0.4.8,0.4.9,20,1,5,5,10,2,FALSE
balm,0.4.1,0.4.2,13,15,254,130,384,44,FALSE
balm,0.4.0,0.4.1,12,2,14,7,21,4,FALSE
balm,0.4.3,0.4.4,15,1,47,53,100,6,FALSE
balm,0.4.2,0.4.3,14,9,46,33,79,16,FALSE
balm,0.3.0-beta,0.3.0-beta2,9,1,16,19,35,6,FALSE
balm,0.4.4,0.4.5,16,1,12,25,37,6,FALSE
balm,0.4.7,0.4.8,19,1,3,3,6,3,FALSE
balm,0.4.6,0.4.7,18,5,125,118,243,27,FALSE
balm,0.4.11,0.4.12,23,2,10,5,15,3,FALSE
balm,0.4.10,0.4.11,22,10,288,288,576,52,FALSE
balm,0.4.13,0.4.14,25,2,33,15,48,4,FALSE
balm,0.4.12,0.4.13,24,5,80,81,161,25,FALSE
balm,0.4.15,0.4.16,27,4,23,12,35,9,FALSE
balm,0.4.14,0.4.15,26,3,16,8,24,4,FALSE
balm,0.4.17,0.4.18,29,1,11,8,19,4,FALSE
balm,0.4.16,0.4.17,28,1,29,19,48,5,FALSE
balm,0.4.18,0.4.19,30,2,36,14,50,5,FALSE
balm,0.4.5,0.4.6,17,7,118,79,197,13,FALSE
balm,0.4.19,0.4.20,31,4,49,23,72,9,FALSE
balm,0.4.13,0.4.14,25,2,33,15,48,4,TRUE
balm,0.5.2,0.5.3,55,1,19,13,32,9,TRUE
balm,0.5.7,0.6.0-beta,60,4,1095,704,1799,56,TRUE
balm,0.6.0-beta.4,0.6.0-beta.5,64,6,216,104,320,17,TRUE
balm,0.4.31,0.4.32,43,2,88,103,191,14,TRUE
balm,0.5.1,0.5.2,54,4,360,327,687,44,TRUE
balm,0.5.0,0.5.1,53,2,193,117,310,9,TRUE
balm,0.4.28,0.4.29,40,6,441,339,780,59,TRUE
balm,0.6.0-beta.8,0.6.0-beta.9,68,1,27,14,41,6,TRUE
balm,0.5.4,0.5.5,57,2,36,17,53,5,TRUE
balm,0.6.0-beta.7,0.6.0-beta.8,67,1,100,56,156,2,TRUE
balm,0.4.6,0.4.7,18,5,125,118,243,27,TRUE
balm,0.6.0-beta.2,0.6.0-beta.3,62,2,218,93,311,3,TRUE
balm,0.2.2,0.2.3,6,5,23,19,42,8,TRUE
balm,0.5.6,0.5.7,59,2,8397,22,8419,22,TRUE
balm,0.4.19,0.4.20,31,4,49,23,72,9,TRUE
balm,0.4.1,0.4.2,13,15,254,130,384,44,TRUE
balm,0.6.0-beta.10,0.6.0-beta.11,70,2,220,114,334,17,TRUE
balm,0.6.0-beta.3,0.6.0-beta.4,63,3,333,440,773,38,TRUE
balm,0.6.0-rc,0.6.0-rc.2,73,16,9029,8846,17875,54,TRUE
balm,0.4.2,0.4.3,14,9,46,33,79,16,TRUE
balm,0.4.4,0.4.5,16,1,12,25,37,6,TRUE
balm,0.4.12,0.4.13,24,5,80,81,161,25,TRUE
balm,0.5.0-beta.6,0.5.0,52,3,145,90,235,16,TRUE
balm,0.4.20,0.4.21,32,2,809,246,1055,11,TRUE
balm,0.3.0-beta2,0.3.0-beta3,10,3,215,163,378,20,TRUE
balm,0.6.0-beta,0.6.0-beta.2,61,3,1927,2114,4041,8,TRUE
balm,0.4.8,0.4.9,20,1,5,5,10,2,TRUE
balm,0.4.10,0.4.11,22,10,288,288,576,52,TRUE
balm,0.4.16,0.4.17,28,1,29,19,48,5,TRUE
balm,0.4.30,0.4.31,42,2,25,9,34,6,TRUE
balm,0.5.3,0.5.4,56,1,162,94,256,24,TRUE
gateblu,6.0.2,7.0.0,73,1,1,2,3,2,FALSE
gateblu,6.0.1,6.0.2,72,1,2,1,3,2,FALSE
gateblu,6.0.0,6.0.1,71,2,5,1,6,3,FALSE
gateblu,5.1.0,5.2.0,58,6,23,13,36,8,FALSE
gateblu,4.0.1,4.0.2,44,1,2,1,3,2,FALSE
gateblu,4.0.0,4.0.1,43,3,4,7,11,3,FALSE
gateblu,5.5.3,5.5.4,66,1,3,3,6,2,FALSE
gateblu,5.5.2,5.5.3,65,1,3,3,6,2,FALSE
gateblu,4.1.0,4.2.0,49,1,70,25,95,3,FALSE
gateblu,5.5.4,5.5.6,67,7,227,42,269,16,FALSE
gateblu,4.0.7,4.1.0,48,1,2,1,3,2,FALSE
gateblu,4.0.6,4.0.7,47,1,7,5,12,1,FALSE
gateblu,5.5.9,6.0.0,70,1,38,148,186,3,FALSE
gateblu,5.5.8,5.5.9,69,1,5,6,11,2,FALSE
gateblu,5.5.1,5.5.2,64,1,24,27,51,3,FALSE
gateblu,5.0.0,5.0.1,56,2,13,8,21,3,FALSE
gateblu,5.5.0,5.5.1,63,1,3,3,6,2,FALSE
gateblu,4.0.3,4.0.6,46,1,4,1,5,1,FALSE
gateblu,5.2.0,5.3.0,59,1,15,9,24,2,FALSE
gateblu,4.0.2,4.0.3,45,1,2,2,4,2,FALSE
gateblu,5.4.0,5.5.0,62,1,7,6,13,2,FALSE
gateblu,5.3.1,5.4.0,61,3,12,5,17,4,FALSE
gateblu,5.3.0,5.3.1,60,1,3,2,5,2,FALSE
gateblu,4.5.0,5.0.0,55,1,115,41,156,5,FALSE
gateblu,5.0.1,5.1.0,57,2,31,46,77,5,FALSE
gateblu,7.0.0,7.0.1,74,1,2,2,4,2,FALSE
gateblu,5.5.6,5.5.8,68,2,23,13,36,5,FALSE
gateblu,4.4.0,4.5.0,54,1,43,16,59,3,FALSE
gateblu,4.2.1,4.3.0,51,2,92,6,98,5,FALSE
gateblu,4.2.0,4.2.1,50,2,10,8,18,5,FALSE
gateblu,4.3.0,4.3.1,52,2,145,8,153,6,FALSE
gateblu,4.3.1,4.4.0,53,1,2,2,4,2,FALSE
gateblu,3.1.3,3.1.4,32,4,19,11,30,7,FALSE
gateblu,3.1.0,3.1.3,31,5,39,39,78,7,FALSE
gateblu,3.0.2,3.0.3,29,1,2,2,4,1,FALSE
gateblu,2.0.2,2.1.0,13,1,16,5,21,3,FALSE
gateblu,2.0.1,2.0.2,12,1,10,3,13,2,FALSE
gateblu,2.0.0,2.0.1,11,2,35,9,44,6,FALSE
gateblu,3.0.3,3.1.0,30,4,464,344,808,15,FALSE
gateblu,2.2.4,2.3.0,23,2,26,17,43,5,FALSE
gateblu,2.2.1,2.2.3,21,2,34,10,44,5,FALSE
gateblu,2.2.0,2.2.1,20,2,35,7,42,4,FALSE
gateblu,2.2.3,2.2.4,22,1,2,2,4,1,FALSE
gateblu,2.1.2,2.1.3,16,1,8,8,16,3,FALSE
gateblu,2.1.3,2.1.4,17,2,47,16,63,4,FALSE
gateblu,2.1.0,2.1.1,14,1,1,1,2,1,FALSE
gateblu,2.1.1,2.1.2,15,1,2,4,6,1,FALSE
gateblu,2.1.4,2.1.5,18,1,5,2,7,2,FALSE
gateblu,2.1.5,2.2.0,19,3,38,5,43,3,FALSE
gateblu,3.1.5,3.2.0,34,1,3,12,15,2,FALSE
gateblu,3.1.4,3.1.5,33,1,8,2,10,2,FALSE
gateblu,3.0.1,3.0.2,28,1,1,10,11,2,FALSE
gateblu,3.0.0,3.0.1,27,3,52,315,367,9,FALSE
gateblu,1.6.0,1.6.1,2,3,84,64,148,6,FALSE
gateblu,1.6.1,1.7.0,3,1,30,2,32,2,FALSE
gateblu,1.9.0,1.10.0,8,1,24,7,31,3,FALSE
gateblu,1.8.0,1.9.0,7,7,63,24,87,13,TRUE
gateblu,1.7.2,1.8.0,6,4,136,67,203,7,FALSE
gateblu,1.7.1,1.7.2,5,3,6,2,8,3,FALSE
gateblu,1.7.0,1.7.1,4,1,2,2,4,2,FALSE
gateblu,2.3.0,2.3.1,24,2,4,1,5,2,FALSE
gateblu,2.3.1,2.3.2,25,1,3,1,4,2,FALSE
gateblu,2.3.2,3.0.0,26,2,27,319,346,5,FALSE
gateblu,1.11.0,2.0.0,10,3,73,69,142,7,FALSE
gateblu,1.10.0,1.11.0,9,1,23,20,43,2,FALSE
gateblu,3.3.1,3.3.2,40,2,5,3,8,2,FALSE
gateblu,3.3.0,3.3.1,39,2,10,4,14,3,FALSE
gateblu,3.3.2,3.3.3,41,1,5,4,9,2,FALSE
gateblu,3.2.0,3.2.1,35,1,2,2,4,1,FALSE
gateblu,3.2.1,3.2.2,36,2,81,23,104,5,FALSE
gateblu,3.2.2,3.2.3,37,1,5,3,8,2,FALSE
gateblu,3.2.3,3.3.0,38,5,82,51,133,6,TRUE
gateblu,6.0.2,7.0.0,73,1,1,2,3,2,TRUE
gateblu,1.8.0,1.9.0,7,7,63,24,87,13,FALSE
gateblu,0.1.0,1.6.0,1,30,562,307,869,56,FALSE
gateblu,3.3.3,4.0.0,42,8,559,392,951,17,FALSE
gateblu,3.2.3,3.3.0,38,5,82,51,133,6,FALSE
gateblu,2.1.3,2.1.4,17,2,47,16,63,4,TRUE
gateblu,1.11.0,2.0.0,10,3,73,69,142,7,TRUE
gateblu,2.2.3,2.2.4,22,1,2,2,4,1,TRUE
gateblu,5.0.1,5.1.0,57,2,31,46,77,5,TRUE
gateblu,4.0.1,4.0.2,44,1,2,1,3,2,TRUE
gateblu,4.2.0,4.2.1,50,2,10,8,18,5,TRUE
gateblu,4.0.0,4.0.1,43,3,4,7,11,3,TRUE
gateblu,4.2.1,4.3.0,51,2,92,6,98,5,TRUE
warren,1.0.0,1.0.1,2,2,24,10,34,2,FALSE
warren,1.0.1,1.0.2,3,17,76,30,106,19,FALSE
warren,1.0.2,1.1.0,4,2,25,25,50,2,FALSE
warren,0.0.1,1.0.0,1,3,1228,2,1230,30,FALSE
warren,1.0.1,1.0.2,3,17,76,30,106,19,TRUE
securemark,0.9.0,0.10.0,14,7,150,76,226,32,FALSE
securemark,0.6.0,0.7.0,11,18,476,388,864,148,FALSE
securemark,0.2.0,0.3.0,4,8,109,42,151,24,FALSE
securemark,0.1.0,0.2.0,3,2,38,13,51,7,FALSE
securemark,0.10.0,0.11.0,15,5,34,30,64,11,FALSE
securemark,0.0.1,0.1.0,2,3,12,17,29,6,FALSE
securemark,0.0.0,0.0.1,1,5,9,2,11,5,FALSE
securemark,0.3.0,0.3.1,5,5,24,3,27,11,FALSE
securemark,0.3.1,0.4.0,6,8,315,165,480,85,FALSE
securemark,0.11.0,0.12.0,16,2,34,26,60,5,FALSE
securemark,0.17.0,0.17.1,23,4,70,79,149,8,FALSE
securemark,0.7.0,0.8.0,12,7,397,19,416,13,FALSE
securemark,0.12.1,0.13.0,18,6,67,76,143,31,FALSE
securemark,0.12.0,0.12.1,17,2,6,1,7,3,FALSE
securemark,0.16.0,0.17.0,22,13,164,102,266,31,FALSE
securemark,0.4.1,0.4.2,8,4,63,44,107,12,FALSE
securemark,0.4.0,0.4.1,7,5,51,44,95,10,FALSE
securemark,0.4.2,0.5.0,9,4,183,57,240,13,FALSE
securemark,0.5.0,0.6.0,10,11,159,119,278,29,FALSE
securemark,0.13.0,0.14.0,19,8,91,70,161,35,FALSE
securemark,0.15.0,0.16.0,21,9,609,300,909,70,FALSE
securemark,0.17.1,0.18.0,24,8,183,68,251,27,FALSE
securemark,0.14.0,0.15.0,20,4,117,20,137,15,FALSE
securemark,0.8.0,0.9.0,13,11,65,47,112,28,FALSE
securemark,0.13.0,0.14.0,19,8,91,70,161,35,TRUE
securemark,0.2.0,0.3.0,4,8,109,42,151,24,TRUE
securemark,0.6.0,0.7.0,11,18,476,388,864,148,TRUE
angular-lazy-for,1.1.1,1.1.2,5,1,24,16,40,4,FALSE
angular-lazy-for,1.1.0,1.1.1,4,1,4,1,5,2,FALSE
angular-lazy-for,1.1.2,1.1.3,6,2,181,102,283,7,FALSE
angular-lazy-for,1.0.0,1.1.0,3,2,96,39,135,6,TRUE
angular-lazy-for,0.0.2,1.0.0,2,1,11,12,23,7,FALSE
angular-lazy-for,0.0.1,0.0.2,1,1,4,1,5,2,FALSE
angular-lazy-for,1.0.0,1.1.0,3,2,96,39,135,6,FALSE
angular-lazy-for,1.1.1,1.1.2,5,1,24,16,40,4,TRUE
babel-plugin-react-native-layout,0.1.0,0.1.1,1,2,232,141,373,4,FALSE
babel-plugin-react-native-layout,0.1.1,0.1.2,2,1,6,5,11,2,FALSE
babel-plugin-react-native-layout,0.1.2,0.1.3,3,1,9,1,10,2,FALSE
babel-plugin-react-native-layout,0.1.3,0.1.4,4,1,63,40,103,4,FALSE
babel-plugin-react-native-layout,0.1.4,0.1.5,5,1,52,5,57,4,FALSE
babel-plugin-react-native-layout,0.1.5,0.1.6,6,1,79,32,111,5,FALSE
babel-plugin-react-native-layout,0.1.6,0.1.7,7,1,49,36,85,2,FALSE
babel-plugin-react-native-layout,0.1.3,0.1.4,4,1,63,40,103,4,TRUE
react-jsonschema-form,0.42.0,0.43.0,69,10,270,179,449,24,FALSE
react-jsonschema-form,0.31.0,0.32.0,49,13,980,88,1068,41,FALSE
react-jsonschema-form,0.37.0,0.38.0,61,5,145,46,191,8,FALSE
react-jsonschema-form,0.32.0,0.33.0,50,8,451,153,604,19,FALSE
react-jsonschema-form,0.36.1,0.37.0,60,2,54,58,112,16,FALSE
react-jsonschema-form,0.36.0,0.36.1,59,2,27,9,36,7,FALSE
react-jsonschema-form,0.40.0,0.41.0,65,28,2055,671,2726,155,FALSE
react-jsonschema-form,0.43.0,0.44.0,70,20,6041,4852,10893,176,FALSE
react-jsonschema-form,0.35.0,0.35.1,57,6,29,18,47,6,FALSE
react-jsonschema-form,0.35.1,0.36.0,58,10,337,109,446,28,FALSE
react-jsonschema-form,0.34.1,0.35.0,56,2,292,31,323,15,FALSE
react-jsonschema-form,0.34.0,0.34.1,55,2,22,1,23,3,FALSE
react-jsonschema-form,0.38.1,0.39.0,63,2,204,71,275,7,FALSE
react-jsonschema-form,0.38.0,0.38.1,62,6,69,10,79,9,FALSE
react-jsonschema-form,0.39.0,0.40.0,64,2,138,14,152,13,FALSE
react-jsonschema-form,0.41.2,0.42.0,68,14,969,257,1226,66,FALSE
react-jsonschema-form,0.41.1,0.41.2,67,10,168,124,292,18,FALSE
react-jsonschema-form,0.41.0,0.41.1,66,3,7,7,14,3,FALSE
react-jsonschema-form,0.46.0,0.47.0,73,6,246,191,437,43,FALSE
react-jsonschema-form,0.47.0,0.48.0,74,5,64,18,82,15,FALSE
react-jsonschema-form,0.44.0,0.45.0,71,3,117,18,135,12,FALSE
react-jsonschema-form,0.45.0,0.46.0,72,6,137,18,155,15,FALSE
react-jsonschema-form,0.33.0,0.33.1,51,5,131,10,141,9,FALSE
react-jsonschema-form,0.33.1,0.33.2,52,4,98,10,108,7,FALSE
react-jsonschema-form,0.33.2,0.33.3,53,2,14,1,15,3,FALSE
react-jsonschema-form,0.33.3,0.34.0,54,2,55,14,69,4,FALSE
react-jsonschema-form,0.30.2,0.31.0,48,2,160,8,168,11,FALSE
react-jsonschema-form,0.30.1,0.30.2,47,5,37,4,41,8,FALSE
react-jsonschema-form,0.30.0,0.30.1,46,2,74,15,89,3,FALSE
react-jsonschema-form,0.48.0,0.48.1,75,3,49,42,91,13,FALSE
react-jsonschema-form,0.48.1,0.48.2,76,2,2,7,9,6,FALSE
react-jsonschema-form,0.15.0,0.16.0,19,5,3727,3065,6792,45,FALSE
react-jsonschema-form,0.9.1,0.9.2,12,2,7,7,14,5,FALSE
react-jsonschema-form,0.7.0,0.7.1,8,3,136,38,174,21,FALSE
react-jsonschema-form,0.2.0,0.3.0,2,13,1467,553,2020,152,FALSE
react-jsonschema-form,0.1.0,0.2.0,1,4,1276,773,2049,56,FALSE
react-jsonschema-form,0.19.1,0.19.2,27,2,2,2,4,2,FALSE
react-jsonschema-form,0.10.0,0.11.0,14,5,139,27,166,17,FALSE
react-jsonschema-form,0.22.0,0.23.0,33,5,244,83,327,10,FALSE
react-jsonschema-form,0.3.0,0.4.0,3,6,1457,323,1780,104,FALSE
react-jsonschema-form,0.6.0,0.7.0,7,3,557,822,1379,65,FALSE
react-jsonschema-form,0.11.0,0.12.0,15,7,442,136,578,26,FALSE
react-jsonschema-form,0.7.1,0.8.0,9,10,394,168,562,43,FALSE
react-jsonschema-form,0.24.0,0.25.0,37,4,490,54,544,14,FALSE
react-jsonschema-form,0.17.0,0.17.1,23,3,14,9,23,5,FALSE
react-jsonschema-form,0.12.0,0.13.0,16,13,527,41,568,27,FALSE
react-jsonschema-form,0.20.0,0.21.0,30,6,323,273,596,16,FALSE
react-jsonschema-form,0.16.2,0.17.0,22,5,605,128,733,23,FALSE
react-jsonschema-form,0.16.1,0.16.2,21,5,880,399,1279,51,FALSE
react-jsonschema-form,0.16.0,0.16.1,20,3,35,1,36,7,FALSE
react-jsonschema-form,0.4.1,0.5.0,5,6,700,39,739,38,FALSE
react-jsonschema-form,0.4.0,0.4.1,4,3,551,75,626,24,FALSE
react-jsonschema-form,0.23.1,0.23.2,35,4,85,58,143,6,FALSE
react-jsonschema-form,0.23.0,0.23.1,34,4,224,142,366,35,FALSE
react-jsonschema-form,0.5.0,0.6.0,6,5,701,76,777,33,FALSE
react-jsonschema-form,0.13.0,0.14.0,17,3,77,29,106,15,FALSE
react-jsonschema-form,0.9.0,0.9.1,11,1,8,8,16,4,FALSE
react-jsonschema-form,0.17.1,0.18.0,24,3,67,3,70,7,FALSE
react-jsonschema-form,0.9.2,0.10.0,13,6,106,14,120,13,FALSE
react-jsonschema-form,0.19.0,0.19.1,26,12,216,64,280,23,FALSE
react-jsonschema-form,0.14.0,0.15.0,18,6,230,38,268,26,FALSE
react-jsonschema-form,0.19.2,0.19.3,28,5,31,6,37,5,FALSE
react-jsonschema-form,0.19.3,0.20.0,29,21,1424,590,2014,105,FALSE
react-jsonschema-form,0.21.1,0.22.0,32,8,808,94,902,39,FALSE
react-jsonschema-form,0.21.0,0.21.1,31,10,168,24,192,16,FALSE
react-jsonschema-form,0.8.0,0.9.0,10,5,219,73,292,32,TRUE
react-jsonschema-form,0.25.0,0.26.0,38,4,728,409,1137,26,FALSE
react-jsonschema-form,0.29.1,0.30.0,45,6,647,217,864,24,FALSE
react-jsonschema-form,0.29.0,0.29.1,44,2,51,17,68,3,FALSE
react-jsonschema-form,0.23.2,0.24.0,36,2,152,46,198,21,FALSE
react-jsonschema-form,0.18.0,0.19.0,25,3,767,33,800,19,FALSE
react-jsonschema-form,0.26.0,0.26.1,39,2,33,13,46,4,FALSE
react-jsonschema-form,0.26.1,0.27.0,40,2,469,165,634,12,FALSE
react-jsonschema-form,0.28.0,0.28.1,42,4,112,44,156,6,FALSE
react-jsonschema-form,0.28.1,0.29.0,43,5,716,283,999,37,FALSE
react-jsonschema-form,0.27.0,0.28.0,41,5,564,331,895,25,FALSE
react-jsonschema-form,0.45.0,0.46.0,72,6,137,18,155,15,TRUE
react-jsonschema-form,0.21.0,0.21.1,31,10,168,24,192,16,TRUE
react-jsonschema-form,0.8.0,0.9.0,10,5,219,73,292,32,FALSE
react-jsonschema-form,0.9.2,0.10.0,13,6,106,14,120,13,TRUE
react-jsonschema-form,0.30.2,0.31.0,48,2,160,8,168,11,TRUE
react-jsonschema-form,0.30.1,0.30.2,47,5,37,4,41,8,TRUE
react-jsonschema-form,0.19.2,0.19.3,28,5,31,6,37,5,TRUE
react-jsonschema-form,0.4.1,0.5.0,5,6,700,39,739,38,TRUE
react-jsonschema-form,0.40.0,0.41.0,65,28,2055,671,2726,155,TRUE
react-jsonschema-form,0.18.0,0.19.0,25,3,767,33,800,19,TRUE
react-jsonschema-form,0.34.0,0.34.1,55,2,22,1,23,3,TRUE
react-jsonschema-form,0.25.0,0.26.0,38,4,728,409,1137,26,TRUE
react-jsonschema-form,0.31.0,0.32.0,49,13,980,88,1068,41,TRUE
react-jsonschema-form,0.19.3,0.20.0,29,21,1424,590,2014,105,TRUE
react-jsonschema-form,0.41.2,0.42.0,68,14,969,257,1226,66,TRUE
react-jsonschema-form,0.38.0,0.38.1,62,6,69,10,79,9,TRUE
react-jsonschema-form,0.6.0,0.7.0,7,3,557,822,1379,65,TRUE
react-jsonschema-form,0.20.0,0.21.0,30,6,323,273,596,16,TRUE
react-jsonschema-form,0.29.1,0.30.0,45,6,647,217,864,24,TRUE
react-jsonschema-form,0.26.0,0.26.1,39,2,33,13,46,4,TRUE
react-jsonschema-form,0.28.1,0.29.0,43,5,716,283,999,37,TRUE
react-jsonschema-form,0.35.0,0.35.1,57,6,29,18,47,6,TRUE
react-jsonschema-form,0.4.0,0.4.1,4,3,551,75,626,24,TRUE
react-jsonschema-form,0.21.1,0.22.0,32,8,808,94,902,39,TRUE
react-jsonschema-form,0.42.0,0.43.0,69,10,270,179,449,24,TRUE
react-jsonschema-form,0.33.2,0.33.3,53,2,14,1,15,3,TRUE
react-jsonschema-form,0.43.0,0.44.0,70,20,6041,4852,10893,176,TRUE
react-jsonschema-form,0.16.2,0.17.0,22,5,605,128,733,23,TRUE
react-jsonschema-form,0.47.0,0.48.0,74,5,64,18,82,15,TRUE
react-jsonschema-form,0.35.1,0.36.0,58,10,337,109,446,28,TRUE
react-jsonschema-form,0.11.0,0.12.0,15,7,442,136,578,26,TRUE
react-player-fork,0.12.104,0.12.105,4,2,10,8,18,6,FALSE
react-player-fork,0.12.101,0.12.102,1,2,25,16,41,8,FALSE
react-player-fork,0.12.102,0.12.103,2,5,45,31,76,15,FALSE
react-player-fork,0.12.103,0.12.104,3,3,22,8,30,6,FALSE
react-player-fork,0.12.104,0.12.105,4,2,10,8,18,6,TRUE
react-player-fork,0.12.101,0.12.102,1,2,25,16,41,8,TRUE
syntax-cli,0.0.59,0.0.60,59,3,128,29,157,11,FALSE
syntax-cli,0.0.58,0.0.59,58,3,3,3,6,3,FALSE
syntax-cli,0.0.51,0.0.52,51,21,1639,240,1879,53,FALSE
syntax-cli,0.0.50,0.0.51,50,10,1285,83,1368,29,FALSE
syntax-cli,0.0.53,0.0.54,53,2,155,7,162,5,FALSE
syntax-cli,0.0.52,0.0.53,52,6,640,104,744,19,FALSE
syntax-cli,0.0.55,0.0.56,55,4,297,75,372,7,FALSE
syntax-cli,0.0.54,0.0.55,54,2,174,10,184,5,FALSE
syntax-cli,0.0.57,0.0.58,57,2,254,13,267,14,FALSE
syntax-cli,0.0.56,0.0.57,56,2,29,2,31,3,FALSE
syntax-cli,0.0.64,0.0.65,64,5,186,63,249,24,FALSE
syntax-cli,0.0.65,0.0.66,65,2,185,1,186,3,FALSE
syntax-cli,0.0.66,0.0.67,66,2,261,61,322,7,FALSE
syntax-cli,0.0.67,0.0.68,67,5,283,41,324,13,FALSE
syntax-cli,0.0.60,0.0.61,60,2,56,27,83,7,FALSE
syntax-cli,0.0.61,0.0.62,61,3,265,68,333,10,FALSE
syntax-cli,0.0.62,0.0.63,62,6,477,128,605,27,FALSE
syntax-cli,0.0.63,0.0.64,63,2,167,3,170,6,FALSE
syntax-cli,0.0.68,0.0.69,68,2,7,3,10,2,FALSE
syntax-cli,0.0.69,0.0.70,69,2,26,15,41,4,FALSE
syntax-cli,0.0.73,0.0.74,73,6,181,63,244,19,FALSE
syntax-cli,0.0.72,0.0.73,72,2,67,28,95,6,FALSE
syntax-cli,0.0.71,0.0.72,71,2,2,2,4,2,FALSE
syntax-cli,0.0.70,0.0.71,70,3,105,105,210,7,FALSE
syntax-cli,0.0.77,0.0.78,77,3,66,32,98,9,FALSE
syntax-cli,0.0.76,0.0.77,76,2,121,87,208,6,FALSE
syntax-cli,0.0.75,0.0.76,75,4,535,246,781,29,FALSE
syntax-cli,0.0.74,0.0.75,74,4,46,13,59,4,FALSE
syntax-cli,0.0.79,0.0.80,79,3,58,44,102,10,FALSE
syntax-cli,0.0.78,0.0.79,78,7,97,38,135,11,FALSE
syntax-cli,0.0.88,0.0.89,88,2,5,2,7,2,FALSE
syntax-cli,0.0.89,0.0.90,89,2,4,4,8,2,FALSE
syntax-cli,0.0.86,0.0.87,86,4,494,145,639,17,FALSE
syntax-cli,0.0.87,0.0.88,87,3,5,2,7,3,FALSE
syntax-cli,0.0.84,0.0.85,84,2,32,1,33,3,FALSE
syntax-cli,0.0.85,0.0.86,85,2,15,7,22,2,FALSE
syntax-cli,0.0.82,0.0.83,82,2,214,143,357,27,FALSE
syntax-cli,0.0.83,0.0.84,83,5,82,43,125,8,FALSE
syntax-cli,0.0.80,0.0.81,80,3,207,67,274,12,FALSE
syntax-cli,0.0.81,0.0.82,81,2,998,18,1016,8,FALSE
syntax-cli,0.0.91,0.0.92,91,3,3,3,6,3,FALSE
syntax-cli,0.0.90,0.0.91,90,2,108,107,215,5,FALSE
syntax-cli,0.0.15,0.0.16,15,6,888,150,1038,31,FALSE
syntax-cli,0.0.14,0.0.15,14,4,71,6,77,7,FALSE
syntax-cli,0.0.17,0.0.18,17,3,65,46,111,17,FALSE
syntax-cli,0.0.16,0.0.17,16,2,31,11,42,2,FALSE
syntax-cli,0.0.11,0.0.12,11,3,38,6,44,4,FALSE
syntax-cli,0.0.10,0.0.11,10,2,163,8,171,5,FALSE
syntax-cli,0.0.13,0.0.14,13,3,157,7,164,5,FALSE
syntax-cli,0.0.12,0.0.13,12,2,576,238,814,12,FALSE
syntax-cli,0.0.19,0.0.20,19,2,5,2,7,2,FALSE
syntax-cli,0.0.18,0.0.19,18,6,709,32,741,16,FALSE
syntax-cli,0.0.20,0.0.21,20,2,204,17,221,10,FALSE
syntax-cli,0.0.21,0.0.22,21,2,635,8,643,15,FALSE
syntax-cli,0.0.22,0.0.23,22,3,217,9,226,9,FALSE
syntax-cli,0.0.23,0.0.24,23,5,635,200,835,22,FALSE
syntax-cli,0.0.24,0.0.25,24,3,46,35,81,5,FALSE
syntax-cli,0.0.25,0.0.26,25,2,6,8,14,3,FALSE
syntax-cli,0.0.26,0.0.27,26,2,148,7,155,4,FALSE
syntax-cli,0.0.27,0.0.28,27,3,10,13,23,3,FALSE
syntax-cli,0.0.28,0.0.29,28,2,3,1,4,2,FALSE
syntax-cli,0.0.29,0.0.30,29,2,28,12,40,4,FALSE
syntax-cli,0.0.39,0.0.40,39,3,1207,4,1211,12,FALSE
syntax-cli,0.0.38,0.0.39,38,2,2,2,4,2,FALSE
syntax-cli,0.0.37,0.0.38,37,3,1154,9,1163,13,FALSE
syntax-cli,0.0.36,0.0.37,36,2,2,3,5,3,FALSE
syntax-cli,0.0.35,0.0.36,35,4,213,51,264,17,FALSE
syntax-cli,0.0.34,0.0.35,34,2,38,3,41,3,FALSE
syntax-cli,0.0.33,0.0.34,33,4,11,9,20,5,FALSE
syntax-cli,0.0.32,0.0.33,32,2,2,2,4,2,FALSE
syntax-cli,0.0.31,0.0.32,31,4,73,4,77,4,FALSE
syntax-cli,0.0.30,0.0.31,30,5,119,31,150,11,FALSE
syntax-cli,0.0.5,0.0.6,5,2,12,2,14,2,FALSE
syntax-cli,0.0.4,0.0.5,4,4,124,18,142,9,TRUE
syntax-cli,0.0.7,0.0.8,7,2,5,14,19,4,FALSE
syntax-cli,0.0.6,0.0.7,6,3,68,20,88,6,FALSE
syntax-cli,0.0.1,0.0.2,1,3,4,4,8,3,TRUE
syntax-cli,0.0.3,0.0.4,3,2,9,3,12,3,FALSE
syntax-cli,0.0.2,0.0.3,2,2,10,4,14,2,FALSE
syntax-cli,0.0.9,0.0.10,9,8,487,222,709,20,FALSE
syntax-cli,0.0.8,0.0.9,8,2,78,129,207,7,FALSE
syntax-cli,0.0.48,0.0.49,48,6,449,63,512,15,FALSE
syntax-cli,0.0.49,0.0.50,49,3,263,80,343,10,FALSE
syntax-cli,0.0.42,0.0.43,42,3,616,69,685,18,FALSE
syntax-cli,0.0.43,0.0.44,43,3,74,47,121,5,FALSE
syntax-cli,0.0.40,0.0.41,40,6,378,20,398,11,FALSE
syntax-cli,0.0.41,0.0.42,41,22,1241,174,1415,50,FALSE
syntax-cli,0.0.46,0.0.47,46,6,787,280,1067,18,FALSE
syntax-cli,0.0.47,0.0.48,47,2,4,5,9,3,FALSE
syntax-cli,0.0.44,0.0.45,44,2,4,6,10,4,FALSE
syntax-cli,0.0.45,0.0.46,45,6,679,360,1039,25,FALSE
syntax-cli,0.0.4,0.0.5,4,4,124,18,142,9,FALSE
syntax-cli,0.0.62,0.0.63,62,6,477,128,605,27,TRUE
syntax-cli,0.0.1,0.0.2,1,3,4,4,8,3,FALSE
syntax-cli,0.0.44,0.0.45,44,2,4,6,10,4,TRUE
react-emojione,1.1.1,1.2.2,10,6,93,13,106,10,FALSE
react-emojione,1.1.0,1.1.1,9,4,26,24,50,5,FALSE
react-emojione,1.0.0,1.0.1,5,2,2,2,4,2,FALSE
react-emojione,1.0.1,1.0.2,6,4,76,33,109,10,FALSE
react-emojione,1.0.2,1.0.3,7,1,6,5,11,2,FALSE
react-emojione,1.0.3,1.1.0,8,7,523,132,655,30,FALSE
react-emojione,3.1.1,3.1.2,15,3,104,16,120,5,FALSE
react-emojione,3.1.0,3.1.1,14,4,81,26,107,5,FALSE
react-emojione,3.1.7,3.1.8,21,13,2511,4131,6642,7309,FALSE
react-emojione,3.1.6,3.1.7,20,2,9,10,19,5,FALSE
react-emojione,3.1.5,3.1.6,19,2,23,4,27,4,FALSE
react-emojione,3.1.4,3.1.5,18,2,2,2,4,2,FALSE
react-emojione,3.1.9,3.1.10,23,2,19,7,26,4,FALSE
react-emojione,3.1.8,3.1.9,22,2,17,46,63,3,FALSE
react-emojione,3.0.0,3.1.0,13,5,190,112,302,14,FALSE
react-emojione,1.2.2,2.0.0,11,2,19,4,23,3,FALSE
react-emojione,3.1.3,3.1.4,17,6,108,78,186,9,FALSE
react-emojione,2.0.0,3.0.0,12,4,10143,2861,13004,34,FALSE
react-emojione,3.1.2,3.1.3,16,2,5,1,6,2,FALSE
react-emojione,1.0.3,1.1.0,8,7,523,132,655,30,TRUE
react-emojione,2.0.0,3.0.0,12,4,10143,2861,13004,34,TRUE
react-emojione,0.1.0,0.1.1,1,1,1,4,5,1,FALSE
react-emojione,0.1.1,0.1.2,2,2,25,8,33,3,FALSE
react-emojione,0.1.2,0.1.3,3,3,1323,1307,2630,7,FALSE
react-emojione,0.1.3,1.0.0,4,1,165,54,219,6,FALSE
reify,0.10.0,0.11.0,95,29,686,482,1168,103,FALSE
reify,0.11.8,0.11.9,104,3,10,5,15,3,FALSE
reify,0.11.9,0.11.10,105,2,3,3,6,3,FALSE
reify,0.11.4,0.11.5,100,7,448,405,853,22,FALSE
reify,0.11.5,0.11.6,101,16,483,396,879,38,FALSE
reify,0.11.6,0.11.7,102,12,108,125,233,18,FALSE
reify,0.11.7,0.11.8,103,9,160,32,192,22,FALSE
reify,0.11.0,0.11.1,96,15,447,294,741,49,FALSE
reify,0.11.1,0.11.2,97,3,84,8,92,4,FALSE
reify,0.11.2,0.11.3,98,3,79,34,113,13,FALSE
reify,0.11.3,0.11.4,99,2,10,11,21,3,FALSE
reify,0.11.20,0.11.21,116,2,21,2,23,4,FALSE
reify,0.11.16,0.11.17,112,3,49,7,56,7,FALSE
reify,0.11.17,0.11.18,113,3,27,57,84,15,FALSE
reify,0.11.14,0.11.15,110,2,69,25,94,4,FALSE
reify,0.11.15,0.11.16,111,3,66,64,130,8,FALSE
reify,0.11.12,0.11.13,108,1,2,2,4,2,FALSE
reify,0.11.13,0.11.14,109,2,35,7,42,3,FALSE
reify,0.11.10,0.11.11,106,2,30,24,54,4,FALSE
reify,0.11.11,0.11.12,107,4,44,27,71,4,FALSE
reify,0.11.18,0.11.19,114,4,14,4,18,6,FALSE
reify,0.11.19,0.11.20,115,2,3,10,13,2,FALSE
reify,0.0.8,0.0.10,9,8,187,51,238,13,FALSE
reify,0.3.8,0.4.0,43,17,324,113,437,22,FALSE
reify,0.3.2,0.3.3,37,2,9,2,11,3,FALSE
reify,0.3.3,0.3.4,38,2,42,4,46,3,FALSE
reify,0.3.0,0.3.1,35,3,91,51,142,3,FALSE
reify,0.3.1,0.3.2,36,2,84,44,128,2,FALSE
reify,0.3.6,0.3.7,41,26,627,286,913,27,FALSE
reify,0.3.7,0.3.8,42,1,1,1,2,1,FALSE
reify,0.3.4,0.3.5,39,14,194,43,237,16,FALSE
reify,0.3.5,0.3.6,40,3,38,2,40,5,FALSE
reify,0.4.11,0.4.12,55,8,83,18,101,9,FALSE
reify,0.4.10,0.4.11,54,12,279,36,315,18,FALSE
reify,0.4.13,0.4.14,57,4,17,17,34,5,FALSE
reify,0.4.12,0.4.13,56,4,15,5,20,4,FALSE
reify,0.4.15,0.4.16,59,2,2,3,5,2,FALSE
reify,0.4.14,0.4.15,58,2,2,1,3,2,FALSE
reify,0.4.16,0.5.0,60,10,220,74,294,15,FALSE
reify,0.6.5,0.6.6,74,2,4,2,6,2,FALSE
reify,0.6.2,0.6.3,71,8,45,54,99,11,FALSE
reify,0.6.1,0.6.2,70,14,1379,1017,2396,28,FALSE
reify,0.6.0,0.6.1,69,11,98,129,227,11,FALSE
reify,0.0.15,0.0.16,14,7,114,29,143,10,FALSE
reify,0.0.14,0.0.15,13,2,30,14,44,2,FALSE
reify,0.0.16,0.0.18,15,11,262,119,381,21,FALSE
reify,0.0.11,0.0.12,11,5,100,3,103,9,FALSE
reify,0.0.10,0.0.11,10,4,108,99,207,5,FALSE
reify,0.0.12,0.0.14,12,7,65,25,90,10,FALSE
reify,0.6.4,0.6.5,73,4,57,47,104,5,FALSE
reify,0.0.19,0.1.0,17,4,223,25,248,24,FALSE
reify,0.0.18,0.0.19,16,4,22,14,36,9,FALSE
reify,0.6.9,0.6.10,78,2,6,35,41,4,FALSE
reify,0.6.8,0.6.9,77,12,175,170,345,22,FALSE
reify,0.6.3,0.6.4,72,2,2,4,6,2,FALSE
reify,0.6.7,0.6.8,76,5,294,168,462,18,FALSE
reify,0.6.6,0.6.7,75,5,91,70,161,10,TRUE
reify,0.4.9,0.4.10,53,4,787,667,1454,12,FALSE
reify,0.4.8,0.4.9,52,3,28,12,40,3,FALSE
reify,0.4.1,0.4.2,45,8,133,41,174,14,FALSE
reify,0.4.0,0.4.1,44,2,93,16,109,6,FALSE
reify,0.4.3,0.4.4,47,7,112,25,137,14,FALSE
reify,0.4.2,0.4.3,46,2,4,1,5,2,FALSE
reify,0.4.5,0.4.6,49,3,14,8,22,4,TRUE
reify,0.4.4,0.4.5,48,9,28,29,57,10,TRUE
reify,0.4.7,0.4.8,51,2,53,1,54,3,FALSE
reify,0.4.6,0.4.7,50,2,2,2,4,2,FALSE
reify,0.8.4,0.9.0,91,11,278,202,480,23,FALSE
reify,0.8.1,0.8.2,88,2,20,1,21,4,FALSE
reify,0.8.0,0.8.1,87,3,4,4,8,4,FALSE
reify,0.8.3,0.8.4,90,10,441,299,740,23,FALSE
reify,0.8.2,0.8.3,89,6,50,26,76,13,FALSE
reify,0.6.11,0.7.0,80,9,321,115,436,44,FALSE
reify,0.6.10,0.6.11,79,8,1169,796,1965,50,FALSE
reify,0.1.8,0.1.9,26,2,5,10,15,2,FALSE
reify,0.1.9,0.1.10,27,2,2,2,4,2,FALSE
reify,0.2.3,0.3.0,34,14,610,394,1004,30,FALSE
reify,0.2.1,0.2.3,33,16,444,205,649,26,FALSE
reify,0.2.0,0.2.1,32,4,216,19,235,4,FALSE
reify,0.1.0,0.1.1,18,2,20,5,25,2,FALSE
reify,0.1.1,0.1.2,19,2,1,3,4,2,FALSE
reify,0.1.2,0.1.3,20,4,44,40,84,6,FALSE
reify,0.1.3,0.1.4,21,3,4,6,10,3,FALSE
reify,0.1.4,0.1.5,22,1,9,9,18,1,FALSE
reify,0.1.5,0.1.6,23,1,1,1,2,1,FALSE
reify,0.1.6,0.1.7,24,10,317,147,464,13,FALSE
reify,0.1.7,0.1.8,25,3,103,93,196,4,FALSE
reify,0.0.5,0.0.6,6,4,70,18,88,7,FALSE
reify,0.0.7,0.0.8,8,2,25,5,30,4,FALSE
reify,0.0.6,0.0.7,7,2,3,1,4,3,FALSE
reify,0.0.3,0.0.4,4,2,2,2,4,2,FALSE
reify,0.7.4,0.7.5,85,3,54,65,119,3,FALSE
reify,0.7.5,0.8.0,86,29,1467,1127,2594,56,FALSE
reify,0.7.2,0.7.3,83,2,11,6,17,2,FALSE
reify,0.7.3,0.7.4,84,2,3,3,6,2,FALSE
reify,0.7.0,0.7.1,81,7,278,272,550,58,FALSE
reify,0.7.1,0.7.2,82,7,428,432,860,8,FALSE
reify,0.5.4,0.5.5,65,5,66,59,125,19,FALSE
reify,0.5.5,0.5.6,66,3,21,5,26,4,FALSE
reify,0.5.6,0.5.7,67,8,57,61,118,17,FALSE
reify,0.5.0,0.5.1,61,2,3,5,8,2,FALSE
reify,0.5.1,0.5.2,62,11,166,15,181,18,FALSE
reify,0.5.2,0.5.3,63,6,74,9,83,8,FALSE
reify,0.5.3,0.5.4,64,5,8,7,15,5,FALSE
reify,0.9.0,0.9.1,92,3,5,5,10,4,FALSE
reify,0.9.1,0.9.2,93,2,5,4,9,2,FALSE
reify,0.9.2,0.10.0,94,37,753,692,1445,82,FALSE
reify,0.0.4,0.0.5,5,2,4,2,6,2,FALSE
reify,0.1.12,0.1.13,30,2,21,4,25,4,FALSE
reify,0.1.13,0.2.0,31,19,662,148,810,30,FALSE
reify,0.1.10,0.1.11,28,2,19,25,44,3,FALSE
reify,0.1.11,0.1.12,29,3,25,33,58,7,FALSE
reify,0.6.6,0.6.7,75,5,91,70,161,10,FALSE
reify,0.5.4,0.5.5,65,5,66,59,125,19,TRUE
reify,0.6.9,0.6.10,78,2,6,35,41,4,TRUE
reify,0.4.5,0.4.6,49,3,14,8,22,4,FALSE
reify,0.4.4,0.4.5,48,9,28,29,57,10,FALSE
livetoken,0.1.0,0.1.1,1,3,39,18,57,5,FALSE
livetoken,0.1.1,0.1.2,2,2,4,4,8,3,FALSE
livetoken,0.1.2,0.1.3,3,4,35,15,50,5,FALSE
livetoken,0.1.3,0.1.4,4,2,4,4,8,3,FALSE
livetoken,0.1.4,0.1.5,5,1,9,9,18,2,TRUE
teasim-helpers,1.1.1,1.1.2,40,1,308,789,1097,5,FALSE
teasim-helpers,3.0.6,3.0.7,60,1,1446,396,1842,11,FALSE
teasim-helpers,2.0.5,3.0.0-alpha.1,52,6,266,228,494,45,FALSE
teasim-helpers,1.1.2,1.1.4,41,1,308,789,1097,5,FALSE
teasim-helpers,1.1.5,2.0.0-alpha.0,43,1,308,789,1097,5,FALSE
teasim-helpers,1.0.1,1.0.2,36,1,308,789,1097,5,FALSE
teasim-helpers,1.0.2,1.0.3,37,1,308,789,1097,5,FALSE
teasim-helpers,1.0.3,1.0.9,38,1,308,789,1097,5,FALSE
teasim-helpers,1.0.9,1.1.1,39,1,308,789,1097,5,FALSE
teasim-helpers,2.0.4,2.0.5,51,1,308,789,1097,5,FALSE
teasim-helpers,2.0.0-alpha.0,2.0.0-alpha.1,44,1,31,0,31,2,FALSE
teasim-helpers,2.0.0-alpha.1,2.0.0-alpha.2,45,6,34512,217,34729,497,FALSE
teasim-helpers,3.0.7,3.0.8-alpha.1,61,1,409,14,423,10,FALSE
teasim-helpers,2.0.3,2.0.4,50,1,308,789,1097,5,FALSE
teasim-helpers,3.0.3,3.0.4,57,1,42,5,47,7,FALSE
teasim-helpers,2.0.2,2.0.3,49,1,308,789,1097,5,FALSE
teasim-helpers,2.0.1,2.0.2,48,1,308,789,1097,5,FALSE
teasim-helpers,2.0.0,2.0.1,47,2,34288,0,34288,458,FALSE
teasim-helpers,0.7.2,0.8.0,31,1,308,789,1097,5,FALSE
teasim-helpers,3.0.0,3.0.1,54,1,148,163,311,13,FALSE
teasim-helpers,0.7.1,0.7.2,30,1,308,789,1097,5,FALSE
teasim-helpers,3.0.1,3.0.2,55,1,4,8,12,4,FALSE
teasim-helpers,3.0.4,3.0.5,58,1,39,4,43,6,FALSE
teasim-helpers,0.8.4,1.0.1,35,1,308,789,1097,5,FALSE
teasim-helpers,0.8.1,0.8.3,33,1,308,789,1097,5,FALSE
teasim-helpers,0.8.0,0.8.1,32,1,308,789,1097,5,FALSE
teasim-helpers,0.8.3,0.8.4,34,1,308,789,1097,5,FALSE
teasim-helpers,3.0.5,3.0.6,59,1,11,11,22,4,FALSE
teasim-helpers,1.1.4,1.1.5,42,1,308,789,1097,5,FALSE
teasim-helpers,3.0.8-alpha.1,3.0.8,62,1,308,789,1097,5,FALSE
teasim-helpers,3.0.2,3.0.3,56,1,22,37,59,11,FALSE
teasim-helpers,0.0.9,0.1.0,9,1,308,789,1097,5,FALSE
teasim-helpers,0.2.2,0.4.0,13,1,308,789,1097,5,FALSE
teasim-helpers,0.1.0,0.1.1,10,1,308,789,1097,5,FALSE
teasim-helpers,0.1.1,0.2.1,11,1,308,789,1097,5,FALSE
teasim-helpers,0.0.5,0.0.6,5,1,308,789,1097,5,FALSE
teasim-helpers,0.0.4,0.0.5,4,1,308,789,1097,5,FALSE
teasim-helpers,0.0.7,0.0.8,7,1,308,789,1097,5,FALSE
teasim-helpers,0.0.6,0.0.7,6,1,308,789,1097,5,FALSE
teasim-helpers,0.0.1,0.0.2,1,1,308,789,1097,5,FALSE
teasim-helpers,0.0.3,0.0.4,3,1,308,789,1097,5,FALSE
teasim-helpers,0.0.2,0.0.3,2,1,308,789,1097,5,FALSE
teasim-helpers,0.6.3,0.6.10,22,1,308,789,1097,5,FALSE
teasim-helpers,0.6.0,0.6.3,21,1,308,789,1097,5,FALSE
teasim-helpers,0.0.8,0.0.9,8,1,308,789,1097,5,FALSE
teasim-helpers,0.7.0,0.7.1,29,1,308,789,1097,5,FALSE
teasim-helpers,0.4.1,0.5.0,15,1,308,789,1097,5,FALSE
teasim-helpers,0.4.0,0.4.1,14,1,308,789,1097,5,FALSE
teasim-helpers,0.5.0,0.5.1,16,1,308,789,1097,5,FALSE
teasim-helpers,0.5.1,0.5.2,17,1,308,789,1097,5,FALSE
teasim-helpers,0.5.2,0.5.3,18,1,308,789,1097,5,FALSE
teasim-helpers,0.5.3,0.5.4,19,1,308,789,1097,5,FALSE
teasim-helpers,0.2.1,0.2.2,12,1,308,789,1097,5,FALSE
teasim-helpers,0.5.4,0.6.0,20,1,308,789,1097,5,FALSE
teasim-helpers,0.6.13,0.6.15,26,1,308,789,1097,5,FALSE
teasim-helpers,0.6.12,0.6.13,25,1,308,789,1097,5,FALSE
teasim-helpers,0.6.11,0.6.12,24,1,308,789,1097,5,FALSE
teasim-helpers,0.6.10,0.6.11,23,1,308,789,1097,5,FALSE
teasim-helpers,0.6.16,0.7.0,28,1,308,789,1097,5,FALSE
teasim-helpers,0.6.15,0.6.16,27,1,308,789,1097,5,FALSE
teasim-helpers,0.0.9,0.1.0,9,1,308,789,1097,5,TRUE
teasim-helpers,0.2.1,0.2.2,12,1,308,789,1097,5,TRUE
teasim-helpers,0.1.0,0.1.1,10,1,308,789,1097,5,TRUE
teasim-helpers,0.0.1,0.0.2,1,1,308,789,1097,5,TRUE
teasim-helpers,1.0.2,1.0.3,37,1,308,789,1097,5,TRUE
teasim-helpers,0.7.1,0.7.2,30,1,308,789,1097,5,TRUE
teasim-helpers,0.8.4,1.0.1,35,1,308,789,1097,5,TRUE
teasim-helpers,1.1.4,1.1.5,42,1,308,789,1097,5,TRUE
teasim-helpers,2.0.0-alpha.1,2.0.0-alpha.2,45,6,34512,217,34729,497,TRUE
teasim-helpers,0.8.0,0.8.1,32,1,308,789,1097,5,TRUE
teasim-helpers,1.0.1,1.0.2,36,1,308,789,1097,5,TRUE
teasim-helpers,0.0.2,0.0.3,2,1,308,789,1097,5,TRUE
teasim-helpers,0.0.6,0.0.7,6,1,308,789,1097,5,TRUE
teasim-helpers,0.6.3,0.6.10,22,1,308,789,1097,5,TRUE
teasim-helpers,2.0.0-alpha.0,2.0.0-alpha.1,44,1,31,0,31,2,TRUE
teasim-helpers,0.4.1,0.5.0,15,1,308,789,1097,5,TRUE
teasim-helpers,0.5.0,0.5.1,16,1,308,789,1097,5,TRUE
generator-yact,0.1.1,0.2.0,2,4,820,549,1369,28,FALSE
generator-yact,0.3.0,0.3.1,4,1,116,84,200,7,FALSE
generator-yact,0.2.0,0.3.0,3,1,208,51,259,16,FALSE
generator-yact,0.1.0,0.1.1,1,2,102,94,196,7,FALSE
generator-yact,0.2.0,0.3.0,3,1,208,51,259,16,TRUE
generator-yact,0.1.1,0.2.0,2,4,820,549,1369,28,TRUE
generator-yact,0.3.0,0.3.1,4,1,116,84,200,7,TRUE
gitftw,0.1.0,0.1.1,1,15,421,477,898,47,FALSE
gitftw,0.1.1,0.1.2,2,5,187,49,236,9,FALSE
gitftw,0.1.2,0.1.3,3,3,169,4,173,7,FALSE
gitftw,0.1.3,0.1.4,4,2,6,6,12,3,FALSE
gitftw,0.1.4,0.1.5,5,2,410,12,422,8,FALSE
gitftw,0.1.5,0.1.6,6,2,44,5,49,4,FALSE
gitftw,0.1.6,1.0.0,7,7,55,44,99,11,FALSE
gitftw,0.1.1,0.1.2,2,5,187,49,236,9,TRUE
gitftw,0.1.2,0.1.3,3,3,169,4,173,7,TRUE
gitftw,0.1.4,0.1.5,5,2,410,12,422,8,TRUE
gitftw,0.1.6,1.0.0,7,7,55,44,99,11,TRUE
react-d3-svg,0.0.7,0.0.8,7,6,194,71,265,18,FALSE
react-d3-svg,0.0.6,0.0.7,6,2,4,4,8,2,FALSE
react-d3-svg,0.0.9,0.0.10,9,5,64,12,76,11,FALSE
react-d3-svg,0.0.8,0.0.9,8,4,93,136,229,12,FALSE
react-d3-svg,0.0.10,0.0.11,10,3,253,227,480,27,FALSE
react-d3-svg,0.0.5,0.0.6,5,5,112,13,125,10,FALSE
react-d3-svg,0.0.4,0.0.5,4,4,97,36,133,12,FALSE
react-d3-svg,0.0.3,0.0.4,3,2,61,47,108,5,FALSE
react-d3-svg,0.0.2,0.0.3,2,5,132,26,158,18,FALSE
react-d3-svg,0.0.7,0.0.8,7,6,194,71,265,18,TRUE
react-d3-svg,0.0.1,0.0.2,1,2,622,8,630,13,FALSE
react-d3-svg,0.0.9,0.0.10,9,5,64,12,76,11,TRUE
react-d3-svg,0.0.8,0.0.9,8,4,93,136,229,12,TRUE
react-d3-svg,0.0.5,0.0.6,5,5,112,13,125,10,TRUE
react-d3-svg,0.0.10,0.0.11,10,3,253,227,480,27,TRUE
zanata-ui,1.0.0,1.0.1,1,3,9,2,11,3,FALSE
zanata-ui,1.0.4,1.0.5,4,2,2,3,5,2,FALSE
zanata-ui,1.0.5,1.0.7,5,8,442,422,864,98,FALSE
zanata-ui,1.0.7,1.0.8,6,3,242,141,383,11,FALSE
zanata-ui,1.0.1,1.0.3,2,4,34,18,52,6,FALSE
zanata-ui,1.0.3,1.0.4,3,4,386,42,428,13,FALSE
zanata-ui,1.0.11,2.0.0-0,10,5,1556,1071,2627,77,FALSE
zanata-ui,1.0.8,1.0.9,7,4,80,22,102,6,FALSE
zanata-ui,1.0.9,1.0.10,8,3,20,12,32,4,FALSE
zanata-ui,2.0.0-6,2.0.0-7,17,2,4,1,5,2,FALSE
zanata-ui,2.0.0-7,2.0.0-8,18,4,100,79,179,70,FALSE
zanata-ui,2.0.0-4,2.0.0-5,15,3,41,39,80,10,FALSE
zanata-ui,2.0.0-5,2.0.0-6,16,2,1,2,3,2,FALSE
zanata-ui,2.0.0-2,2.0.0-3,13,2,623,1370,1993,20,FALSE
zanata-ui,2.0.0-3,2.0.0-4,14,4,32,22,54,7,FALSE
zanata-ui,1.0.10,1.0.11,9,2,8,7,15,4,FALSE
zanata-ui,2.0.0-1,2.0.0-2,12,2,3,3,6,2,FALSE
zanata-ui,2.0.0-0,2.0.0-1,11,2,11,7,18,7,FALSE
zanata-ui,2.0.0-8,2.0.0-9,19,2,3,3,6,3,FALSE
zanata-ui,3.0.6,3.0.7,27,1,1,10734,10735,160,FALSE
zanata-ui,3.0.4,3.0.5,25,1,1,2,3,2,FALSE
zanata-ui,3.0.5,3.0.6,26,1,2,1,3,2,FALSE
zanata-ui,3.0.2,3.0.3,23,1,24,5,29,3,FALSE
zanata-ui,3.0.3,3.0.4,24,2,34,11,45,5,FALSE
zanata-ui,3.0.0,3.0.1,21,2,9562,7389,16951,197,FALSE
zanata-ui,3.0.1,3.0.2,22,1,494,739,1233,6,FALSE
zanata-ui,2.0.0-9,3.0.0,20,1,1,10734,10735,160,FALSE
zanata-ui,1.0.11,2.0.0-0,10,5,1556,1071,2627,77,TRUE
zanata-ui,2.0.0-7,2.0.0-8,18,4,100,79,179,70,TRUE
zanata-ui,2.0.0-4,2.0.0-5,15,3,41,39,80,10,TRUE
zanata-ui,2.0.0-2,2.0.0-3,13,2,623,1370,1993,20,TRUE
zanata-ui,1.0.9,1.0.10,8,3,20,12,32,4,TRUE
zanata-ui,1.0.7,1.0.8,6,3,242,141,383,11,TRUE
zanata-ui,2.0.0-3,2.0.0-4,14,4,32,22,54,7,TRUE
toosimple,0.3.0,0.3.1,4,1,517,369,886,12,FALSE
toosimple,0.1.5,0.1.6,1,3,17,4,21,3,FALSE
toosimple,0.1.6,0.2.0,2,11,465,70,535,23,FALSE
toosimple,0.2.0,0.3.0,3,25,2731,854,3585,160,FALSE
toosimple,0.3.0,0.3.1,4,1,517,369,886,12,TRUE
toosimple,0.1.6,0.2.0,2,11,465,70,535,23,TRUE
toosimple,0.2.0,0.3.0,3,25,2731,854,3585,160,TRUE
ion-js,1.0.0,1.1.0,1,13,21874,23890,45764,267,FALSE
ion-js,1.0.0,1.1.0,1,13,21874,23890,45764,267,TRUE
carauction-network,0.0.7-20170406083440,0.0.7-20170411104824,29,1,11,0,11,2,FALSE
carauction-network,0.0.3-20170315101526,0.0.3-20170315120041,7,4,211,149,360,44,FALSE
carauction-network,0.0.3-20170315120041,0.0.3,8,1,61,61,122,11,FALSE
carauction-network,0.0.6-20170316170625,0.0.6-20170316180304,22,4,6,2,8,4,FALSE
carauction-network,0.0.7-20170418105406,0.0.7-20170418110054,31,1,1,1,2,1,FALSE
carauction-network,0.0.7-20170427195125,0.0.7-20170428002629,37,1,61,61,122,11,FALSE
carauction-network,0.0.7-20170418110054,0.0.7-20170418135447,32,2,238,7,245,4,FALSE
carauction-network,0.0.4-20170315181444,0.0.4-20170316133210,12,3,244,135,379,31,FALSE
carauction-network,0.0.7-20170418144438,0.0.7-20170426105640,34,2,429,596,1025,12,FALSE
carauction-network,0.0.4-20170316134459,0.0.4-20170316134742,15,1,1,1,2,1,FALSE
carauction-network,0.0.8-20170504220927,0.0.8-20170508134753,49,1,55,32,87,5,FALSE
carauction-network,0.0.2-20170315093736,0.0.2-20170315095015,4,2,4,2,6,2,FALSE
carauction-network,0.0.8-20170509053914,0.0.8-20170509223715,51,1,61,61,122,11,FALSE
carauction-network,0.0.4-20170316133210,0.0.4-20170316133757,13,1,61,61,122,11,FALSE
carauction-network,0.0.5,0.0.6-20170316150937,20,1,9,9,18,9,FALSE
carauction-network,0.0.7-20170428015850,0.0.7-20170428052145,40,1,61,61,122,11,FALSE
carauction-network,0.0.6-20170316150937,0.0.6-20170316170625,21,4,543,133,676,19,FALSE
carauction-network,0.0.6,0.0.7-20170317110609,25,2,18,18,36,20,FALSE
carauction-network,0.0.7-20170503110301,0.0.7-20170503123741,46,1,89,562,651,49,FALSE
carauction-network,0.0.3,0.0.4-20170315133744,9,1,9,9,18,9,FALSE
carauction-network,0.0.2,0.0.3-20170315101526,6,1,10,10,20,9,FALSE
carauction-network,0.0.7-20170317110609,0.0.7-20170327164432,26,1,3,3,6,2,FALSE
carauction-network,0.0.7-20170502135321,0.0.7-20170503110301,45,1,19,20,39,2,FALSE
carauction-network,0.0.5-20170316135253,0.0.5-20170316140648,18,2,22,22,44,10,FALSE
carauction-network,0.0.7-20170428052145,0.0.7-20170428054303,41,1,61,61,122,11,FALSE
carauction-network,0.0.7-20170411104824,0.0.7-20170418105406,30,1,1,1,2,2,FALSE
carauction-network,0.0.7-20170418135447,0.0.7-20170418144438,33,1,103,14,117,2,FALSE
carauction-network,0.0.9-20170524200542,0.0.9-20170531221646,58,1,1,1,2,1,FALSE
carauction-network,0.0.4,0.0.5-20170316135253,17,1,9,9,18,9,FALSE
carauction-network,0.0.7-20170327164432,0.0.7-20170329131338,27,1,13,13,26,22,FALSE
carauction-network,0.0.7,0.0.8-20170504220927,48,1,63,57,120,10,FALSE
carauction-network,0.0.7-20170428002629,0.0.7-20170428012139,38,1,61,61,122,11,FALSE
carauction-network,0.0.7-20170428054303,0.0.7-20170428054902,42,1,61,61,122,11,FALSE
carauction-network,0.0.8-20170508134753,0.0.8-20170509053914,50,1,8,8,16,1,FALSE
carauction-network,0.0.6-20170316183007,0.0.6,24,1,61,61,122,11,FALSE
carauction-network,0.0.4-20170315133744,0.0.4-20170315164450,10,1,16,2,18,1,FALSE
carauction-network,0.0.4-20170316134742,0.0.4,16,1,61,61,122,11,FALSE
carauction-network,0.0.7-20170426175550,0.0.7-20170427195125,36,1,10,0,10,1,FALSE
carauction-network,0.0.2-20170315095015,0.0.2,5,1,61,61,122,11,FALSE
carauction-network,0.0.7-20170503123741,0.0.7,47,1,61,61,122,11,FALSE
carauction-network,0.0.7-20170329131338,0.0.7-20170406083440,28,4,628,254,882,19,FALSE
carauction-network,0.0.2-20170314215144,0.0.2-20170315093736,3,4,150,128,278,42,FALSE
carauction-network,0.0.8-20170512113024,0.0.8-20170513160434,53,1,12,0,12,2,FALSE
carauction-network,0.0.7-20170428054902,0.0.7-20170428055920,43,1,61,61,122,11,FALSE
carauction-network,0.0.4-20170316133757,0.0.4-20170316134459,14,1,20,9,29,2,FALSE
carauction-network,0.0.7-20170428012139,0.0.7-20170428015850,39,1,61,61,122,11,FALSE
carauction-network,0.0.4-20170315164450,0.0.4-20170315181444,11,1,1,1,2,1,FALSE
carauction-network,0.0.7-20170426105640,0.0.7-20170426175550,35,1,255,74,329,3,FALSE
carauction-network,0.0.2-20170314174933,0.0.2-20170314215144,2,2,40,40,80,10,FALSE
carauction-network,0.0.2-20170314174623,0.0.2-20170314174933,1,1,61,61,122,11,FALSE
carauction-network,0.0.7-20170428055920,0.0.7-20170502135321,44,1,315,15,330,8,FALSE
carauction-network,0.0.8-20170509223715,0.0.8-20170512113024,52,1,33,0,33,4,FALSE
carauction-network,0.0.8-20170513160434,0.0.8-20170524193658,54,2,20,20,40,20,FALSE
carauction-network,0.0.8-20170524193658,0.0.8,55,1,61,61,122,11,FALSE
carauction-network,0.0.5-20170316140648,0.0.5,19,1,61,61,122,11,FALSE
carauction-network,0.0.9-20170524184640,0.0.9-20170524200542,57,2,20,20,40,20,FALSE
carauction-network,0.0.6-20170316180304,0.0.6-20170316183007,23,2,0,6,6,2,FALSE
carauction-network,0.0.8-20170513160434,0.0.8-20170524193658,54,2,20,20,40,20,TRUE
mos,1.3.0,1.3.1,51,35,405066,4149,409215,1436,FALSE
mos,2.0.0-alpha.2,2.0.0-alpha.3,54,31,36315,1277,37592,327,FALSE
mos,1.2.0,1.3.0-alpha.c9768757,49,39,405080,4138,409218,1425,FALSE
mos,2.0.0-alpha.1,2.0.0-alpha.2,53,2,52,53,105,16,FALSE
mos,0.9.0,0.9.1,22,1,48,0,48,5,FALSE
mos,0.11.0,0.11.1,31,1,16,12,28,6,FALSE
mos,0.11.1,0.12.0,32,9,160,550,710,24,FALSE
mos,0.9.4,0.9.5,26,1,21,0,21,2,FALSE
mos,0.9.5,0.9.6,27,2,121,79,200,7,FALSE
mos,0.10.0,0.11.0,30,3,268,190,458,24,FALSE
mos,0.6.1,0.7.0,12,5,558,18,576,29,FALSE
mos,0.6.0,0.6.1,11,1,5,2,7,3,FALSE
mos,0.7.2,0.7.3,15,2,21,7,28,4,FALSE
mos,0.7.3,0.8.0-beta.1,16,1,63,18,81,5,FALSE
mos,0.7.0,0.7.1,13,2,122,52,174,18,FALSE
mos,0.7.1,0.7.2,14,3,251,9,260,8,FALSE
mos,0.12.0,0.13.0,33,1,202,153,355,12,FALSE
mos,0.5.0,0.6.0,10,5,136,22,158,17,FALSE
mos,0.13.0,0.13.1,34,2,25,25,50,3,FALSE
mos,0.13.1,0.14.0,35,13,103,1285,1388,75,FALSE
mos,0.9.1,0.9.2,23,7,133,80,213,19,FALSE
mos,0.9.2,0.9.3,24,1,2,2,4,1,FALSE
mos,0.9.3,0.9.4,25,4,35,26,61,7,FALSE
mos,0.14.1,0.14.2,37,1,6,6,12,2,FALSE
mos,0.14.0,0.14.1,36,6,45,48,93,9,FALSE
mos,0.9.6,0.9.7,28,1,15,1,16,2,FALSE
mos,0.9.7,0.10.0,29,11,273,185,458,43,FALSE
mos,0.8.1,0.8.2,20,1,1,1,2,1,FALSE
mos,0.8.0,0.8.1,19,3,19,5,24,5,FALSE
mos,0.8.2,0.9.0,21,2,130,58,188,9,FALSE
mos,0.8.0-beta.1,0.8.0-beta.2,17,1,21,1,22,2,FALSE
mos,0.8.0-beta.2,0.8.0,18,1,217,47,264,16,FALSE
mos,0.14.2,0.15.0,38,6,271,88,359,16,FALSE
mos,1.1.1,1.2.0,48,5,249,218,467,35,FALSE
mos,1.1.0,1.1.1,47,1,44,44,88,4,FALSE
mos,1.0.0,1.1.0,46,3,62,10,72,8,FALSE
mos,0.19.0,0.20.0,44,1,30,31,61,6,FALSE
mos,0.17.0,0.18.0,42,1,45,2,47,3,FALSE
mos,0.20.0,1.0.0,45,2,190,438,628,28,FALSE
mos,0.16.1,0.17.0,41,8,68,324,392,38,FALSE
mos,0.16.0,0.16.1,40,1,5,5,10,5,FALSE
mos,0.18.0,0.19.0,43,3,25,5,30,6,FALSE
mos,0.15.0,0.16.0,39,5,22,42,64,11,FALSE
mos,0.2.3,0.3.0,6,1,119,0,119,6,FALSE
mos,0.2.2,0.2.3,5,2,15,5,20,4,FALSE
mos,0.2.1,0.2.2,4,2,24,20,44,4,FALSE
mos,0.2.0,0.2.1,3,3,179,84,263,13,FALSE
mos,0.1.0,0.2.0,2,11,541,115,656,60,FALSE
mos,0.3.0,0.3.1,7,1,4,2,6,2,FALSE
mos,0.3.1,0.4.0,8,2,140,175,315,12,FALSE
mos,0.4.0,0.5.0,9,10,325,258,583,54,FALSE
mos,0.9.3,0.9.4,25,4,35,26,61,7,TRUE
mos,0.0.0,0.1.0,1,22,1277,387,1664,90,FALSE
mos,0.13.1,0.14.0,35,13,103,1285,1388,75,TRUE
mos,0.14.2,0.15.0,38,6,271,88,359,16,TRUE
mos,0.15.0,0.16.0,39,5,22,42,64,11,TRUE
mos,1.1.1,1.2.0,48,5,249,218,467,35,TRUE
mos,0.9.5,0.9.6,27,2,121,79,200,7,TRUE
mos,0.9.1,0.9.2,23,7,133,80,213,19,TRUE
mos,0.12.0,0.13.0,33,1,202,153,355,12,TRUE
mos,0.20.0,1.0.0,45,2,190,438,628,28,TRUE
mos,0.9.7,0.10.0,29,11,273,185,458,43,TRUE
mos,0.6.1,0.7.0,12,5,558,18,576,29,TRUE
tsd,0.6.0-beta.4,0.6.0-beta.5,17,5,12,11,23,5,FALSE
tsd,0.6.0-beta.1,0.6.0-beta.2,14,4,47,19,66,8,FALSE
tsd,0.6.3,0.6.4-beta,21,22,35917,151,36068,166,FALSE
tsd,0.6.1,0.6.3,20,21,37579,453,38032,146,FALSE
tsd,0.6.0,0.6.1,19,8,20,24,44,16,FALSE
tsd,0.6.4,0.6.5-beta,23,5,35322,21,35343,67,FALSE
tsd,0.6.0-beta.5,0.6.0,18,8,217,25,242,18,FALSE
tsd,0.6.4-beta,0.6.4,22,12,51380,49,51429,180,FALSE
tsd,0.6.0-beta.3,0.6.0-beta.4,16,6,58,27,85,16,FALSE
tsd,0.6.0-beta.2,0.6.0-beta.3,15,2,14,16,30,4,FALSE
tsd,0.6.5-beta.2,0.6.5,25,11,245,171,416,53,FALSE
tsd,0.6.5-beta,0.6.5-beta.2,24,6,18610,450,19060,54,FALSE
tsd,0.5.5,0.5.6,11,26,2083,1022,3105,77,FALSE
tsd,0.5.6,0.5.7,12,31,22909,31706,54615,674,FALSE
tsd,0.5.7,0.6.0-beta.1,13,111,17343,16103,33446,1154,FALSE
tsd,0.5.2,0.5.3,9,7,485,438,923,35,FALSE
tsd,0.5.3,0.5.5,10,8,69,39,108,22,FALSE
tsd,0.3.1,0.5.2,8,320,297542,192593,490135,5314,FALSE
tsd,0.2.2,0.3.0,6,13,1196,592,1788,55,FALSE
tsd,0.2.1,0.2.2,5,4,229,35,264,14,FALSE
tsd,0.2.0,0.2.1,4,4,51,51,102,10,FALSE
tsd,0.1.0,0.1.1,1,7,80,45,125,14,FALSE
tsd,0.1.1,0.1.2,2,5,147,41,188,17,FALSE
tsd,0.1.2,0.2.0,3,10,2826,1012,3838,85,FALSE
tsd,0.3.0,0.3.1,7,7,16349,1267,17616,158,FALSE
tsd,0.6.3,0.6.4-beta,21,22,35917,151,36068,166,TRUE
tsd,0.6.4,0.6.5-beta,23,5,35322,21,35343,67,TRUE
tsd,0.6.4-beta,0.6.4,22,12,51380,49,51429,180,TRUE
tsd,0.5.7,0.6.0-beta.1,13,111,17343,16103,33446,1154,TRUE
generator-webpack-versatile,3.1.1,3.2.0,3,16,685,717,1402,95,FALSE
generator-webpack-versatile,3.1.0,3.1.1,2,2,2,1,3,2,FALSE
generator-webpack-versatile,3.0.0,3.1.0,1,5,833,723,1556,37,FALSE
generator-webpack-versatile,3.2.0,3.2.1,4,3,14,10,24,6,FALSE
generator-webpack-versatile,3.2.1,4.0.0,5,13,725,789,1514,217,FALSE
generator-webpack-versatile,3.2.0,3.2.1,4,3,14,10,24,6,TRUE
multithread-it,0.0.5,0.0.6,5,4,44,39,83,12,FALSE
multithread-it,0.0.4,0.0.5,4,5,631,89,720,40,TRUE
multithread-it,0.0.7,0.0.8,7,3,715,27,742,39,FALSE
multithread-it,0.0.6,0.0.7,6,1,38,4,42,4,FALSE
multithread-it,0.0.1,0.0.2,1,1,5,5,10,3,FALSE
multithread-it,0.0.3,0.0.4,3,1,794,49,843,45,FALSE
multithread-it,0.0.2,0.0.3,2,1,5,5,10,3,FALSE
multithread-it,0.0.9,0.1.0,9,1,4,5,9,4,FALSE
multithread-it,0.0.8,0.0.9,8,1,6,6,12,8,FALSE
multithread-it,0.1.0,0.1.1,10,1,5,5,10,3,FALSE
multithread-it,0.1.1,0.1.2,11,1,125,16,141,6,FALSE
multithread-it,0.1.2,0.1.3,12,1,5,5,10,3,FALSE
multithread-it,0.0.4,0.0.5,4,5,631,89,720,40,FALSE
multithread-it,0.0.6,0.0.7,6,1,38,4,42,4,TRUE
multithread-it,0.0.3,0.0.4,3,1,794,49,843,45,TRUE
meetup-web-components,0.1.66-beta,0.1.67-beta,27,4,93,28,121,7,FALSE
meetup-web-components,0.1.160-beta,0.1.161-beta,100,1,16,18,34,1,FALSE
meetup-web-components,0.1.116-beta,0.1.117-beta,58,2,724,2,726,12,FALSE
meetup-web-components,0.1.157-beta,0.1.158,97,1,67,4,71,3,FALSE
meetup-web-components,0.1.21-beta,0.1.22,11,1,58,149,207,7,FALSE
meetup-web-components,0.1.79-beta,0.1.80-beta,40,1,7,4,11,1,FALSE
meetup-web-components,0.1.169,0.1.170-beta,107,1,74,147,221,4,FALSE
meetup-web-components,0.1.76-beta,0.1.77-beta,37,2,8,7,15,2,FALSE
meetup-web-components,0.1.132-beta,0.1.133-beta,73,1,7,4,11,1,FALSE
meetup-web-components,0.1.166-beta,0.1.167-beta,104,1,8,2,10,1,FALSE
meetup-web-components,0.1.126-beta,0.1.127-beta,67,1,7,4,11,1,FALSE
meetup-web-components,0.1.127-beta,0.1.128,68,1,19,19,38,1,FALSE
meetup-web-components,0.1.134-beta,0.1.135-beta,75,1,13,5,18,1,FALSE
meetup-web-components,0.1.155-beta,0.1.156,95,1,2,0,2,1,FALSE
meetup-web-components,0.1.125-beta,0.1.126-beta,66,1,40,1,41,2,FALSE
meetup-web-components,0.1.144-beta,0.1.145-beta,84,1,7,4,11,1,FALSE
meetup-web-components,0.1.135-beta,0.1.136-beta,76,2,25,6,31,2,FALSE
meetup-web-components,0.1.152-beta,0.1.153,92,4,42,611,653,60,FALSE
meetup-web-components,0.1.172,0.1.173-beta,110,1,7,4,11,1,FALSE
meetup-web-components,0.1.120-beta,0.1.121-beta,61,1,7,4,11,1,FALSE
meetup-web-components,0.1.74-beta,0.1.75-beta,35,2,24,13,37,3,FALSE
meetup-web-components,0.1.56-beta,0.1.61,21,1,256,0,256,5,FALSE
meetup-web-components,0.1.34,0.1.37-beta,16,6,126,164,290,16,FALSE
meetup-web-components,0.1.55-beta,0.1.56-beta,20,1,7,4,11,1,FALSE
meetup-web-components,0.1.154-beta,0.1.155-beta,94,1,7,4,11,1,FALSE
meetup-web-components,0.1.133-beta,0.1.134-beta,74,1,7,4,11,1,FALSE
meetup-web-components,0.1.102-beta,0.1.103-beta,48,1,1,2,3,1,FALSE
meetup-web-components,0.1.123-beta,0.1.124-beta,64,1,0,1,1,1,FALSE
meetup-web-components,0.1.75-beta,0.1.76-beta,36,2,211,5,216,4,FALSE
meetup-web-components,0.1.170-beta,0.1.171-beta,108,1,1,1,2,1,FALSE
meetup-web-components,0.1.145-beta,0.1.146-beta,85,1,7,4,11,1,FALSE
meetup-web-components,0.1.122-beta,0.1.123-beta,63,2,2,3,5,2,FALSE
meetup-web-components,0.1.141-beta,0.1.142,81,1,1,1,2,1,FALSE
meetup-web-components,0.1.20-beta,0.1.21-beta,10,1,7,4,11,1,FALSE
meetup-web-components,0.1.72-beta,0.1.73,33,1,1,1,2,1,FALSE
meetup-web-components,0.1.90-beta,0.1.94-beta,44,4,11,10,21,4,FALSE
meetup-web-components,0.1.140-beta,0.1.141-beta,80,1,1,1,2,1,FALSE
meetup-web-components,0.1.11-beta,0.1.13-beta,3,2,5,2,7,3,FALSE
meetup-web-components,0.1.22,0.1.23-beta,12,1,7,4,11,1,FALSE
meetup-web-components,0.1.24,0.1.33-beta,14,10,531,176,707,15,FALSE
meetup-web-components,0.1.124-beta,0.1.125-beta,65,1,7,4,11,1,FALSE
meetup-web-components,0.1.39-beta,0.1.55-beta,19,15,715,775,1490,30,FALSE
meetup-web-components,0.1.115-beta,0.1.116-beta,57,1,57,33,90,3,FALSE
meetup-web-components,0.1.114,0.1.115-beta,56,1,6,6,12,2,FALSE
meetup-web-components,0.1.37-beta,0.1.38-beta,17,1,3,3,6,1,FALSE
meetup-web-components,0.1.73,0.1.74-beta,34,3,4,10,14,5,FALSE
meetup-web-components,0.1.121-beta,0.1.122-beta,62,1,4,1,5,1,FALSE
meetup-web-components,0.1.110-beta,0.1.111-beta,53,1,37,0,37,1,FALSE
meetup-web-components,0.1.17,0.1.19-beta,8,1,7,4,11,1,FALSE
meetup-web-components,0.1.129,0.1.130,70,1,7,4,11,1,FALSE
meetup-web-components,0.1.128,0.1.129,69,3,523,2,525,13,FALSE
meetup-web-components,0.1.137-beta,0.1.138,78,1,21,20,41,4,FALSE
meetup-web-components,0.1.103-beta,0.1.104-beta,49,1,14,13,27,3,FALSE
meetup-web-components,0.1.94-beta,0.1.95,45,1,9,8,17,2,FALSE
meetup-web-components,0.1.107-beta,0.1.108-beta,51,1,19,20,39,1,FALSE
meetup-web-components,0.1.159,0.1.160-beta,99,2,218,635,853,71,FALSE
meetup-web-components,0.1.161-beta,0.1.162,101,1,173,0,173,5,FALSE
meetup-web-components,0.1.146-beta,0.1.147,86,2,2,2,4,2,FALSE
meetup-web-components,0.1.38-beta,0.1.39-beta,18,1,5,9,14,1,FALSE
meetup-web-components,0.1.111-beta,0.1.112-beta,54,1,65,28,93,3,FALSE
meetup-web-components,0.1.130,0.1.131,71,1,7,4,11,1,FALSE
meetup-web-components,0.1.131,0.1.132-beta,72,1,475,23,498,14,FALSE
meetup-web-components,0.1.173-beta,0.1.174-beta,111,1,1,1,2,1,FALSE
meetup-web-components,0.1.100-beta,0.1.102-beta,47,3,433,15,448,8,FALSE
meetup-web-components,0.1.112-beta,0.1.114,55,4,801,27,828,20,FALSE
meetup-web-components,0.1.138,0.1.140-beta,79,3,4,12,16,3,FALSE
meetup-web-components,0.1.69-beta,0.1.70-beta,30,1,9,0,9,1,FALSE
meetup-web-components,0.0.8-beta,0.1.10,1,2,5,5,10,5,FALSE
meetup-web-components,0.1.108-beta,0.1.110-beta,52,4,63,52,115,6,FALSE
meetup-web-components,0.1.15-beta,0.1.16,6,1,19,2,21,7,FALSE
meetup-web-components,0.1.23-beta,0.1.24,13,1,8,11,19,7,FALSE
meetup-web-components,0.1.67-beta,0.1.68-beta,28,1,7,4,11,1,FALSE
meetup-web-components,0.1.19-beta,0.1.20-beta,9,1,7,4,11,1,FALSE
meetup-web-components,0.1.14,0.1.15-beta,5,1,7,4,11,1,FALSE
meetup-web-components,0.1.78,0.1.79-beta,39,5,276,25,301,18,FALSE
meetup-web-components,0.1.118-beta,0.1.120-beta,60,4,255,3,258,9,FALSE
meetup-web-components,0.1.117-beta,0.1.118-beta,59,1,7,4,11,1,FALSE
meetup-web-components,0.1.71-beta,0.1.72-beta,32,1,3,3,6,1,FALSE
meetup-web-components,0.1.95,0.1.100-beta,46,13,858,533,1391,27,FALSE
meetup-web-components,0.1.143,0.1.144-beta,83,1,2,5,7,1,FALSE
meetup-web-components,0.1.142,0.1.143,82,1,24,5,29,2,FALSE
meetup-web-components,0.1.68-beta,0.1.69-beta,29,1,16,8,24,1,FALSE
meetup-web-components,0.1.148,0.1.149-beta,88,1,7,4,11,1,FALSE
meetup-web-components,0.1.65,0.1.66-beta,26,1,3,2,5,2,FALSE
meetup-web-components,0.1.62,0.1.63-beta,23,4,96,36,132,8,FALSE
meetup-web-components,0.1.61,0.1.62,22,9,547,128,675,23,FALSE
meetup-web-components,0.1.77-beta,0.1.78,38,1,207,0,207,3,FALSE
meetup-web-components,0.1.104-beta,0.1.107-beta,50,3,61,51,112,5,FALSE
meetup-web-components,0.1.82-beta,0.1.89-beta,42,8,129,69,198,18,FALSE
meetup-web-components,0.1.13-beta,0.1.14,4,1,4,1,5,2,FALSE
meetup-web-components,0.1.174-beta,0.1.175,112,1,1,1,2,1,FALSE
meetup-web-components,0.1.149-beta,0.1.150-beta,89,1,584,43,627,19,FALSE
meetup-web-components,0.1.156,0.1.157-beta,96,1,7,4,11,1,FALSE
meetup-web-components,0.1.151,0.1.152-beta,91,1,7,4,11,1,FALSE
meetup-web-components,0.1.153,0.1.154-beta,93,1,7,4,11,1,FALSE
meetup-web-components,0.1.33-beta,0.1.34,15,1,22,22,44,2,FALSE
meetup-web-components,0.1.158,0.1.159,98,1,97,1,98,6,FALSE
meetup-web-components,0.1.80-beta,0.1.82-beta,41,2,111,71,182,4,FALSE
meetup-web-components,0.1.10,0.1.11-beta,2,1,7,4,11,1,FALSE
meetup-web-components,0.1.16,0.1.17,7,1,1,1,2,1,FALSE
meetup-web-components,0.1.136-beta,0.1.137-beta,77,1,7,4,11,1,FALSE
meetup-web-components,0.1.70-beta,0.1.71-beta,31,1,6,0,6,1,FALSE
meetup-web-components,0.1.64-beta,0.1.65,25,1,2,1,3,1,FALSE
meetup-web-components,0.1.150-beta,0.1.151,90,1,1,1,2,1,FALSE
meetup-web-components,0.1.63-beta,0.1.64-beta,24,1,2,1,3,1,FALSE
meetup-web-components,0.1.171-beta,0.1.172,109,1,1,1,2,1,FALSE
meetup-web-components,0.1.89-beta,0.1.90-beta,43,2,42,34,76,2,FALSE
meetup-web-components,0.1.144-beta,0.1.145-beta,84,1,7,4,11,1,TRUE
meetup-web-components,0.1.173-beta,0.1.174-beta,111,1,1,1,2,1,TRUE
meetup-web-components,0.1.172,0.1.173-beta,110,1,7,4,11,1,TRUE
meetup-web-components,0.1.170-beta,0.1.171-beta,108,1,1,1,2,1,TRUE
meetup-web-components,0.1.138,0.1.140-beta,79,3,4,12,16,3,TRUE
meetup-web-components,0.1.136-beta,0.1.137-beta,77,1,7,4,11,1,TRUE
meetup-web-components,1.1.964,1.1.965-beta,527,2,24,16,40,5,FALSE
meetup-web-components,1.1.966-beta,1.1.967-beta,529,2,990,564,1554,44,FALSE
meetup-web-components,1.1.974,1.1.975-beta,537,1,9,13,22,2,FALSE
meetup-web-components,1.1.960,1.1.961-beta,523,2,800,611,1411,47,FALSE
meetup-web-components,1.1.973-beta,1.1.974,536,2,124,163,287,10,FALSE
meetup-web-components,1.1.971,1.1.972-beta,534,1,7,4,11,1,FALSE
meetup-web-components,1.1.956,1.1.957-beta,519,3,821,572,1393,51,FALSE
meetup-web-components,1.1.963-beta,1.1.964,526,1,4,3,7,1,FALSE
meetup-web-components,1.1.972-beta,1.1.973-beta,535,1,3,4,7,2,FALSE
meetup-web-components,1.1.958-beta,1.1.959-beta,521,2,274,52,326,11,FALSE
meetup-web-components,1.1.970-beta,1.1.971,533,2,19,11,30,3,FALSE
meetup-web-components,1.1.969-beta,1.1.970-beta,532,1,2,2,4,1,FALSE
meetup-web-components,1.1.962-beta,1.1.963-beta,525,1,7,4,11,1,FALSE
meetup-web-components,1.1.965-beta,1.1.966-beta,528,1,0,1,1,1,FALSE
meetup-web-components,1.1.957-beta,1.1.958-beta,520,2,736,555,1291,43,FALSE
meetup-web-components,1.1.959-beta,1.1.960,522,1,7,4,11,1,FALSE
meetup-web-components,1.1.961-beta,1.1.962-beta,524,1,10,8,18,1,FALSE
meetup-web-components,1.1.968-beta,1.1.969-beta,531,1,2,2,4,1,FALSE
meetup-web-components,1.1.967-beta,1.1.968-beta,530,1,16,4,20,2,FALSE
meetup-web-components,0.1.281-beta,0.1.283,197,1,0,1,1,1,FALSE
meetup-web-components,0.1.261-beta,0.1.262-beta,179,1,7,4,11,1,FALSE
meetup-web-components,0.1.295-beta,0.1.296,206,3,395,56,451,9,FALSE
meetup-web-components,1.0.673-beta,1.0.676-beta,356,1,19,5,24,3,FALSE
meetup-web-components,1.0.779,1.0.780,382,4,122,88,210,92,FALSE
meetup-web-components,1.0.914-beta,1.0.915-beta,480,2,61,5,66,4,FALSE
meetup-web-components,0.1.321-beta,0.1.324,225,3,96,106,202,5,FALSE
meetup-web-components,1.0.810-beta,1.0.812-beta,396,1,7,4,11,1,FALSE
meetup-web-components,1.0.807-beta,1.0.810-beta,395,1,7,4,11,1,FALSE
meetup-web-components,1.0.815-beta,1.0.816,399,1,98,15,113,3,FALSE
meetup-web-components,0.1.254-beta,0.1.255-beta,174,1,1,1,2,1,FALSE
meetup-web-components,1.0.421-beta,1.0.422-beta,264,2,128,78,206,9,FALSE
meetup-web-components,1.0.338-beta,1.0.339-beta,242,1,10,1,11,1,FALSE
meetup-web-components,0.1.247,0.1.248-beta,169,1,0,14,14,1,FALSE
meetup-web-components,1.0.884-beta,1.0.885,450,1,29,30,59,3,FALSE
meetup-web-components,1.0.457-beta,1.0.458-beta,283,1,7,4,11,1,FALSE
meetup-web-components,1.0.868-beta,1.0.869-beta,435,1,7,4,11,1,FALSE
meetup-web-components,1.0.769-beta,1.0.772-beta,378,1,7,4,11,1,FALSE
meetup-web-components,1.0.333-beta,1.0.334-beta,237,2,6,6,12,2,FALSE
meetup-web-components,1.0.845-beta,1.0.846,415,1,42,4,46,3,FALSE
meetup-web-components,0.1.276-beta,0.1.278-beta,194,1,7,4,11,1,FALSE
meetup-web-components,0.1.202-beta,0.1.203-beta,134,1,7,4,11,1,FALSE
meetup-web-components,1.0.410-beta,1.0.411-beta,257,1,7,4,11,1,FALSE
meetup-web-components,1.0.432-beta,1.0.437-beta,271,3,40,29,69,4,FALSE
meetup-web-components,1.0.893-beta,1.0.894,459,1,29,29,58,4,FALSE
meetup-web-components,1.0.897-beta,1.0.898,463,3,170,53,223,6,FALSE
meetup-web-components,1.0.792-beta,1.0.793,385,1,5,5,10,3,FALSE
meetup-web-components,0.1.244-beta,0.1.245,166,3,651,31,682,8,FALSE
meetup-web-components,1.0.337,1.0.338-beta,241,1,1,1,2,1,FALSE
meetup-web-components,1.0.585-beta,1.0.589-beta,331,3,1380,288,1668,29,FALSE
meetup-web-components,0.1.234-beta,0.1.235-beta,158,2,118,4,122,6,FALSE
meetup-web-components,1.0.949-beta,1.0.950-beta,511,1,15,46,61,2,FALSE
meetup-web-components,1.0.901-beta,1.0.902-beta,467,1,3,1,4,1,FALSE
meetup-web-components,1.0.923-beta,1.0.924-beta,487,2,612,18,630,12,FALSE
meetup-web-components,1.0.349-beta,1.0.350-beta,253,2,6,5,11,2,FALSE
meetup-web-components,1.0.924-beta,1.0.925-beta,488,1,2,2,4,2,FALSE
meetup-web-components,1.0.513,1.0.516-beta,309,1,105,105,210,2,FALSE
meetup-web-components,1.0.518,1.0.521-beta,311,1,66,19,85,3,FALSE
meetup-web-components,1.0.812-beta,1.0.813,397,1,1,1,2,1,FALSE
meetup-web-components,1.0.737-beta,1.0.739,366,1,328,325,653,2,FALSE
meetup-web-components,1.0.593-beta,1.0.595,334,1,7,4,11,1,FALSE
meetup-web-components,0.1.296,0.1.297-beta,207,2,38,45,83,2,FALSE
meetup-web-components,1.0.937-beta,1.0.938,501,2,66,6,72,6,FALSE
meetup-web-components,1.0.682,1.0.686-beta,359,1,7,4,11,1,FALSE
meetup-web-components,1.0.731-beta,1.0.734,364,1,59,12,71,5,FALSE
meetup-web-components,1.0.940-beta,1.0.941-beta,504,2,144,16,160,8,FALSE
meetup-web-components,1.0.533-beta,1.0.536,316,1,5,5,10,1,FALSE
meetup-web-components,1.0.758-beta,1.0.760,374,1,86,80,166,84,FALSE
meetup-web-components,1.0.854,1.0.855-beta,424,2,63,6,69,4,FALSE
meetup-web-components,1.0.857,1.0.858-beta,426,1,4,0,4,1,FALSE
meetup-web-components,1.0.344-beta,1.0.345-beta,248,2,192,165,357,3,FALSE
meetup-web-components,1.0.853,1.0.854,423,1,0,829,829,11,FALSE
meetup-web-components,0.1.269,0.1.270-beta,187,1,1039,141,1180,22,FALSE
meetup-web-components,1.0.635,1.0.638-beta,344,1,1,1,2,1,FALSE
meetup-web-components,1.1.953-beta,1.1.954,517,1,129,19,148,9,FALSE
meetup-web-components,1.0.505-beta,1.0.508-beta,306,1,2,1,3,1,FALSE
meetup-web-components,1.0.616-beta,1.0.619-beta,339,1,6,2,8,1,FALSE
meetup-web-components,1.0.724-beta,1.0.730,362,4,366,332,698,9,FALSE
meetup-web-components,0.1.190,0.1.191-beta,123,1,7,4,11,1,FALSE
meetup-web-components,1.0.569-beta,1.0.572-beta,326,1,294,2,296,5,FALSE
meetup-web-components,0.1.195,0.1.197-beta,128,1,7,4,11,1,FALSE
meetup-web-components,1.0.688,1.0.724-beta,361,13,256,118,374,39,FALSE
meetup-web-components,0.1.199,0.1.200-beta,131,1,32,39,71,9,FALSE
meetup-web-components,1.0.927-beta,1.0.928-beta,491,1,7,4,11,1,FALSE
meetup-web-components,0.1.299-beta,0.1.300-beta,210,1,6,7,13,1,FALSE
meetup-web-components,1.0.818-beta,1.0.819,401,1,4,5,9,1,FALSE
meetup-web-components,1.0.350-beta,1.0.351-beta,254,1,14,7,21,1,FALSE
meetup-web-components,0.1.249-beta,0.1.251,171,2,37,37,74,3,FALSE
meetup-web-components,0.1.223-beta,0.1.224-beta,150,1,7,4,11,1,FALSE
meetup-web-components,0.1.267-beta,0.1.268-beta,185,1,55,11,66,3,FALSE
meetup-web-components,1.0.335,1.0.336-beta,239,1,88,99,187,1,FALSE
meetup-web-components,1.0.849-beta,1.0.850-beta,419,1,7,4,11,1,FALSE
meetup-web-components,0.1.206-beta,0.1.208-beta,138,1,7,4,11,1,FALSE
meetup-web-components,1.0.859-beta,1.0.860,428,1,18,10,28,2,FALSE
meetup-web-components,1.0.950-beta,1.0.951-beta,512,1,89,29,118,12,FALSE
meetup-web-components,1.0.353-beta,1.0.410-beta,256,62,5062,1970,7032,186,FALSE
meetup-web-components,0.1.262-beta,0.1.263-beta,180,1,7,4,11,1,FALSE
meetup-web-components,1.0.561-beta,1.0.563,323,1,30,9,39,5,FALSE
meetup-web-components,0.1.320-beta,0.1.321-beta,224,2,628,613,1241,3,FALSE
meetup-web-components,1.0.911-beta,1.0.912,477,4,158,132,290,10,FALSE
meetup-web-components,1.0.463-beta,1.0.464-beta,289,1,7,4,11,1,FALSE
meetup-web-components,0.1.177-beta,0.1.178,115,1,20,14,34,1,FALSE
meetup-web-components,0.1.197-beta,0.1.198-beta,129,2,396,246,642,27,FALSE
meetup-web-components,1.0.419,1.0.420,262,1,7,4,11,1,FALSE
meetup-web-components,1.0.418,1.0.419,261,1,66,25,91,10,FALSE
meetup-web-components,1.0.413,1.0.417-beta,259,4,194,162,356,17,FALSE
meetup-web-components,1.0.947-beta,1.0.949-beta,510,5,818,762,1580,53,FALSE
meetup-web-components,1.0.928-beta,1.0.929-beta,492,1,10,11,21,1,FALSE
meetup-web-components,1.0.437-beta,1.0.439,272,1,41,13,54,2,FALSE
meetup-web-components,1.0.763-beta,1.0.766-beta,376,1,1,0,1,1,FALSE
meetup-web-components,0.1.226,0.1.228,152,1,7,4,11,1,FALSE
meetup-web-components,1.0.430-beta,1.0.432-beta,270,1,15,6,21,1,FALSE
meetup-web-components,0.1.184-beta,0.1.185-beta,120,1,0,1,1,1,FALSE
meetup-web-components,1.0.670-beta,1.0.673-beta,355,1,12,6,18,2,FALSE
meetup-web-components,1.0.855-beta,1.0.857,425,3,300,59,359,12,FALSE
meetup-web-components,0.1.238-beta,0.1.239-beta,161,1,78,15,93,3,FALSE
meetup-web-components,1.0.482,1.0.486-beta,299,1,1,1,2,1,FALSE
meetup-web-components,0.1.200-beta,0.1.201,132,1,382,239,621,23,FALSE
meetup-web-components,1.0.488,1.0.491-beta,301,1,430,224,654,28,FALSE
meetup-web-components,1.0.622-beta,1.0.624-beta,341,1,7,4,11,1,FALSE
meetup-web-components,1.0.806,1.0.807-beta,394,1,7,4,11,1,FALSE
meetup-web-components,0.1.317,0.1.319-beta,222,5,423,451,874,8,FALSE
meetup-web-components,1.0.805,1.0.806,393,1,10,1,11,2,FALSE
meetup-web-components,0.1.241-beta,0.1.242-beta,163,1,7,4,11,1,FALSE
meetup-web-components,1.0.800,1.0.802-beta,390,2,50,25,75,11,FALSE
meetup-web-components,1.0.836,1.0.842-beta,411,5,453,392,845,8,FALSE
meetup-web-components,1.0.445-beta,1.0.448-beta,276,1,0,5,5,1,FALSE
meetup-web-components,1.0.744,1.0.747-beta,369,2,399,341,740,10,FALSE
meetup-web-components,1.0.867-beta,1.0.868-beta,434,1,7,4,11,1,FALSE
meetup-web-components,1.0.494-beta,1.0.497-beta,303,1,11,28,39,2,FALSE
meetup-web-components,1.0.749,1.0.752-beta,371,1,399,341,740,9,FALSE
meetup-web-components,1.0.851-beta,1.0.852-beta,421,1,127,10,137,4,FALSE
meetup-web-components,0.1.217-beta,0.1.218-beta,145,1,1,1,2,1,FALSE
meetup-web-components,0.1.179,0.1.182-beta,117,1,7,4,11,1,FALSE
meetup-web-components,1.0.667,1.0.670-beta,354,1,32,3,35,2,FALSE
meetup-web-components,1.0.662,1.0.665-beta,352,1,28,11,39,2,FALSE
meetup-web-components,1.0.910-beta,1.0.911-beta,476,1,27,19,46,2,FALSE
meetup-web-components,1.0.900-beta,1.0.901-beta,466,1,8,55,63,3,FALSE
meetup-web-components,1.0.934-beta,1.0.935-beta,498,1,399,214,613,17,FALSE
meetup-web-components,1.0.508-beta,1.0.511-beta,307,1,1,1,2,1,FALSE
meetup-web-components,1.0.881-beta,1.0.882-beta,447,2,240,0,240,3,FALSE
meetup-web-components,1.0.465-beta,1.0.466-beta,291,1,7,4,11,1,FALSE
meetup-web-components,1.0.874-beta,1.0.875-beta,441,1,7,4,11,1,FALSE
meetup-web-components,1.0.890-beta,1.0.891,456,1,1,7,8,2,FALSE
meetup-web-components,1.0.655-beta,1.0.657,349,2,4,2,6,2,FALSE
meetup-web-components,1.0.632-beta,1.0.635,343,1,118,28,146,6,FALSE
meetup-web-components,1.0.428-beta,1.0.429,268,1,23,14,37,2,FALSE
meetup-web-components,1.0.766-beta,1.0.769-beta,377,2,486,421,907,90,FALSE
meetup-web-components,1.0.340,1.0.341-beta,244,3,2082,840,2922,39,FALSE
meetup-web-components,1.0.343,1.0.344-beta,247,1,7,4,11,1,FALSE
meetup-web-components,1.0.572-beta,1.0.575-beta,327,1,0,4,4,1,FALSE
meetup-web-components,1.0.872,1.0.873-beta,439,3,118,55,173,10,FALSE
meetup-web-components,0.1.284-beta,0.1.285,199,1,120,36,156,2,FALSE
meetup-web-components,0.1.285,0.1.287-beta,200,1,209,47,256,5,FALSE
meetup-web-components,1.0.804-beta,1.0.805,392,1,13,7,20,1,FALSE
meetup-web-components,0.1.300-beta,0.1.301-beta,211,1,7,4,11,1,FALSE
meetup-web-components,1.0.486-beta,1.0.488,300,1,1,1,2,1,FALSE
meetup-web-components,0.1.252-beta,0.1.254-beta,173,7,1451,11,1462,21,FALSE
meetup-web-components,1.0.454-beta,1.0.455-beta,280,1,7,4,11,1,FALSE
meetup-web-components,0.1.263-beta,0.1.264-beta,181,1,1,1,2,1,FALSE
meetup-web-components,0.1.251,0.1.252-beta,172,8,765,625,1390,31,FALSE
meetup-web-components,1.0.752-beta,1.0.755-beta,372,1,7,4,11,1,FALSE
meetup-web-components,1.0.442-beta,1.0.445-beta,275,1,12,2,14,2,FALSE
meetup-web-components,1.0.451-beta,1.0.453-beta,278,1,11,29,40,1,FALSE
meetup-web-components,1.0.646,1.0.655-beta,348,4,373,6,379,9,FALSE
meetup-web-components,0.1.264-beta,0.1.265-beta,182,1,7,4,11,1,FALSE
meetup-web-components,1.0.821-beta,1.0.823-beta,403,1,3,6,9,1,FALSE
meetup-web-components,1.0.511-beta,1.0.513,308,1,1,1,2,1,FALSE
meetup-web-components,0.1.289-beta,0.1.290-beta,203,1,7,4,11,1,FALSE
meetup-web-components,0.1.324,0.1.325-beta,226,1,25,27,52,3,FALSE
meetup-web-components,1.0.832,1.0.836,410,3,50,45,95,4,FALSE
meetup-web-components,1.0.831,1.0.832,409,1,3,1,4,1,FALSE
meetup-web-components,0.1.301-beta,0.1.302-beta,212,1,2,1,3,1,FALSE
meetup-web-components,0.1.283,0.1.284-beta,198,6,120,36,156,6,FALSE
meetup-web-components,1.0.829-beta,1.0.831,408,1,1,1,2,1,FALSE
meetup-web-components,0.1.232-beta,0.1.233-beta,156,1,7,4,11,1,FALSE
meetup-web-components,0.1.212-beta,0.1.214-beta,142,1,7,4,11,1,FALSE
meetup-web-components,1.0.798-beta,1.0.799-beta,388,1,7,4,11,1,FALSE
meetup-web-components,1.0.778-beta,1.0.779,381,1,9,7,16,6,FALSE
meetup-web-components,1.0.848,1.0.849-beta,418,1,1,0,1,1,FALSE
meetup-web-components,1.0.346-beta,1.0.347-beta,250,1,7,4,11,1,FALSE
meetup-web-components,0.1.215,0.1.217-beta,144,2,5,1,6,2,FALSE
meetup-web-components,1.0.843,1.0.844-beta,413,1,7,4,11,1,FALSE
meetup-web-components,0.1.219,0.1.220-beta,147,1,1,1,2,1,FALSE
meetup-web-components,1.0.846,1.0.847-beta,416,2,678,443,1121,18,FALSE
meetup-web-components,1.0.453-beta,1.0.454-beta,279,1,266,224,490,2,FALSE
meetup-web-components,1.0.780,1.0.787-beta,383,14,633,469,1102,119,FALSE
meetup-web-components,0.1.235-beta,0.1.237-beta,159,1,7,4,11,1,FALSE
meetup-web-components,0.1.231-beta,0.1.232-beta,155,1,7,4,11,1,FALSE
meetup-web-components,1.0.908-beta,1.0.909-beta,474,1,1,2,3,1,FALSE
meetup-web-components,1.0.643-beta,1.0.644,346,1,24,2,26,1,FALSE
meetup-web-components,0.1.182-beta,0.1.183-beta,118,1,7,4,11,1,FALSE
meetup-web-components,0.1.193-beta,0.1.194-beta,126,1,463,233,696,25,FALSE
meetup-web-components,1.0.930-beta,1.0.931-beta,494,4,387,102,489,17,FALSE
meetup-web-components,1.0.933,1.0.934-beta,497,1,0,25,25,1,FALSE
meetup-web-components,0.1.278-beta,0.1.279,195,1,245,0,245,3,FALSE
meetup-web-components,1.0.938,1.0.939,502,1,7,4,11,1,FALSE
meetup-web-components,1.0.939,1.0.940-beta,503,1,21,20,41,2,FALSE
meetup-web-components,1.0.775-beta,1.0.778-beta,380,1,11,11,22,2,FALSE
meetup-web-components,1.0.665-beta,1.0.667,353,1,28,11,39,2,FALSE
meetup-web-components,1.0.657,1.0.660-beta,350,1,1,1,2,1,FALSE
meetup-web-components,1.0.944-beta,1.0.945,507,2,237,229,466,18,FALSE
meetup-web-components,1.0.852-beta,1.0.853,422,1,1,0,1,1,FALSE
meetup-web-components,1.0.679-beta,1.0.682,358,3,60,14,74,5,FALSE
meetup-web-components,0.1.291-beta,0.1.295-beta,205,5,1882,277,2159,40,FALSE
meetup-web-components,1.0.417-beta,1.0.418,260,2,50,13,63,5,FALSE
meetup-web-components,1.0.578-beta,1.0.580,329,1,80,7,87,3,FALSE
meetup-web-components,1.0.793,1.0.795-beta,386,1,1,1,2,1,FALSE
meetup-web-components,1.0.422-beta,1.0.425-beta,265,1,7,4,11,1,FALSE
meetup-web-components,1.1.954,1.1.956,518,2,720,550,1270,42,FALSE
meetup-web-components,1.1.919-beta,1.1.920-beta,515,4,415,119,534,19,FALSE
meetup-web-components,0.1.258-beta,0.1.259-beta,177,3,1139,135,1274,24,FALSE
meetup-web-components,1.0.332-beta,1.0.333-beta,236,4,4,4,8,4,FALSE
meetup-web-components,1.0.425-beta,1.0.427-beta,266,1,7,4,11,1,FALSE
meetup-web-components,1.0.342-beta,1.0.343,246,1,180,160,340,2,FALSE
meetup-web-components,0.1.209-beta,0.1.211-beta,140,1,7,4,11,1,FALSE
meetup-web-components,1.0.448-beta,1.0.451-beta,277,1,1,1,2,1,FALSE
meetup-web-components,1.0.863-beta,1.0.864-beta,430,1,6,4,10,1,FALSE
meetup-web-components,0.1.270-beta,0.1.271,188,1,169,0,169,3,FALSE
meetup-web-components,1.0.491-beta,1.0.494-beta,302,5,45,36,81,8,FALSE
meetup-web-components,1.0.580,1.0.585-beta,330,2,33,37,70,5,FALSE
meetup-web-components,1.0.557-beta,1.0.561-beta,322,1,4,4,8,1,FALSE
meetup-web-components,1.0.772-beta,1.0.775-beta,379,4,617,374,991,18,FALSE
meetup-web-components,0.1.245,0.1.246-beta,167,1,0,1,1,1,FALSE
meetup-web-components,1.0.351-beta,1.0.353-beta,255,1,3,0,3,1,FALSE
meetup-web-components,1.0.946-beta,1.0.947-beta,509,2,157,487,644,12,FALSE
meetup-web-components,1.0.936-beta,1.0.937-beta,500,1,3,3,6,2,FALSE
meetup-web-components,1.1.920-beta,1.1.953-beta,516,49,4276,3043,7319,251,FALSE
meetup-web-components,1.0.925-beta,1.0.926-beta,489,1,32,33,65,2,FALSE
meetup-web-components,1.0.899-beta,1.0.900-beta,465,1,52,15,67,2,FALSE
meetup-web-components,1.0.913-beta,1.0.914-beta,479,1,13,26,39,4,FALSE
meetup-web-components,0.1.268-beta,0.1.269,186,1,10,8,18,3,FALSE
meetup-web-components,0.1.203-beta,0.1.204,135,2,2,2,4,2,FALSE
meetup-web-components,0.1.288-beta,0.1.289-beta,202,1,7,4,11,1,FALSE
meetup-web-components,1.0.624-beta,1.0.632-beta,342,4,1197,129,1326,26,FALSE
meetup-web-components,1.0.907,1.0.908-beta,473,3,69,6,75,7,FALSE
meetup-web-components,1.0.905,1.0.906-beta,471,1,8,0,8,1,FALSE
meetup-web-components,1.0.903,1.0.904-beta,469,1,12,22,34,1,FALSE
meetup-web-components,1.0.892-beta,1.0.893-beta,458,1,29,29,58,4,FALSE
meetup-web-components,1.0.888-beta,1.0.889,454,1,8,6,14,2,FALSE
meetup-web-components,0.1.194-beta,0.1.195,127,1,1,1,2,1,FALSE
meetup-web-components,1.0.472,1.0.475-beta,295,1,8,6,14,4,FALSE
meetup-web-components,1.0.871,1.0.872,438,1,4,0,4,1,FALSE
meetup-web-components,1.0.870,1.0.871,437,1,1,0,1,1,FALSE
meetup-web-components,1.0.877,1.0.878,444,2,42,34,76,2,FALSE
meetup-web-components,1.0.876,1.0.877,443,1,30,41,71,1,FALSE
meetup-web-components,1.0.878,1.0.880-beta,445,2,13,13,26,3,FALSE
meetup-web-components,1.0.345-beta,1.0.346-beta,249,1,14,13,27,2,FALSE
meetup-web-components,1.0.545-beta,1.0.548,319,1,1,1,2,1,FALSE
meetup-web-components,1.0.660-beta,1.0.662,351,1,5,2,7,1,FALSE
meetup-web-components,0.1.266-beta,0.1.267-beta,184,1,5,12,17,1,FALSE
meetup-web-components,1.0.563,1.0.565-beta,324,2,59,17,76,7,FALSE
meetup-web-components,0.1.243-beta,0.1.244-beta,165,2,238,21,259,4,FALSE
meetup-web-components,1.0.686-beta,1.0.688,360,1,3,1,4,2,FALSE
meetup-web-components,1.0.500-beta,1.0.505-beta,305,2,9,11,20,3,FALSE
meetup-web-components,0.1.311-beta,0.1.315-beta,219,6,1088,477,1565,22,FALSE
meetup-web-components,1.0.516-beta,1.0.518,310,1,105,105,210,2,FALSE
meetup-web-components,1.0.864-beta,1.0.865,431,1,6,4,10,1,FALSE
meetup-web-components,1.0.882-beta,1.0.883-beta,448,1,3,3,6,1,FALSE
meetup-web-components,0.1.242-beta,0.1.243-beta,164,2,6179,4,6183,5,FALSE
meetup-web-components,1.0.747-beta,1.0.749,370,1,1,1,2,1,FALSE
meetup-web-components,1.0.819,1.0.821-beta,402,1,46,5,51,3,FALSE
meetup-web-components,1.0.880-beta,1.0.881-beta,446,1,7,4,11,1,FALSE
meetup-web-components,0.1.298-beta,0.1.299-beta,209,1,7,4,11,1,FALSE
meetup-web-components,1.0.755-beta,1.0.758-beta,373,1,33,21,54,4,FALSE
meetup-web-components,0.1.316,0.1.317,221,1,7,4,11,1,FALSE
meetup-web-components,0.1.191-beta,0.1.192-beta,124,1,7,4,11,1,FALSE
meetup-web-components,1.0.460-beta,1.0.461-beta,286,1,7,4,11,1,FALSE
meetup-web-components,1.0.941-beta,1.0.943-beta,505,2,8,8,16,2,FALSE
meetup-web-components,1.0.524-beta,1.0.526-beta,313,1,719,415,1134,37,FALSE
meetup-web-components,0.2.322-beta,1.0.323-beta,228,1,1,1,2,1,FALSE
meetup-web-components,1.0.895-beta,1.0.896-beta,461,1,7,4,11,1,FALSE
meetup-web-components,1.0.922-beta,1.0.923-beta,486,1,5,5,10,3,FALSE
meetup-web-components,1.0.813,1.0.815-beta,398,1,25,10,35,5,FALSE
meetup-web-components,1.0.458-beta,1.0.459-beta,284,1,7,4,11,1,FALSE
meetup-web-components,1.0.826,1.0.828-beta,406,1,1,1,2,1,FALSE
meetup-web-components,1.0.536,1.0.543,317,3,2263,5,2268,30,FALSE
meetup-web-components,1.0.348-beta,1.0.349-beta,252,2,3,5,8,2,FALSE
meetup-web-components,1.0.742-beta,1.0.744,368,1,4,4,8,2,FALSE
meetup-web-components,0.1.319-beta,0.1.320-beta,223,1,1,1,2,1,FALSE
meetup-web-components,1.0.439,1.0.440,273,3,184,296,480,28,FALSE
meetup-web-components,0.1.305-beta,0.1.306-beta,214,1,7,4,11,1,FALSE
meetup-web-components,1.0.918-beta,1.0.921-beta,484,8,1110,149,1259,37,FALSE
meetup-web-components,1.0.823-beta,1.0.825-beta,404,1,3,1,4,1,FALSE
meetup-web-components,0.1.233-beta,0.1.234-beta,157,1,7,4,11,1,FALSE
meetup-web-components,0.1.201,0.1.202-beta,133,1,7,4,11,1,FALSE
meetup-web-components,1.0.459-beta,1.0.460-beta,285,1,7,4,11,1,FALSE
meetup-web-components,0.1.205,0.1.206-beta,137,1,7,4,11,1,FALSE
meetup-web-components,0.1.302-beta,0.1.305-beta,213,3,1699,227,1926,33,FALSE
meetup-web-components,1.0.456-beta,1.0.457-beta,282,1,7,4,11,1,FALSE
meetup-web-components,1.0.555-beta,1.0.557-beta,321,2,1250,122,1372,19,FALSE
meetup-web-components,1.0.891,1.0.892-beta,457,3,401,103,504,13,FALSE
meetup-web-components,1.0.331-beta,1.0.332-beta,235,1,1,1,2,1,FALSE
meetup-web-components,1.0.894,1.0.895-beta,460,1,7,4,11,1,FALSE
meetup-web-components,1.0.548,1.0.555-beta,320,6,2500,220,2720,41,FALSE
meetup-web-components,1.0.898,1.0.899-beta,464,1,226,137,363,3,FALSE
meetup-web-components,1.0.543,1.0.545-beta,318,1,7,4,11,1,FALSE
meetup-web-components,1.0.869-beta,1.0.870,436,1,75,17,92,2,FALSE
meetup-web-components,1.0.847-beta,1.0.848,417,1,283,0,283,3,FALSE
meetup-web-components,1.0.828-beta,1.0.829-beta,407,1,189,34,223,16,FALSE
meetup-web-components,1.0.825-beta,1.0.826,405,1,32,0,32,3,FALSE
meetup-web-components,1.0.795-beta,1.0.798-beta,387,1,442,407,849,88,FALSE
meetup-web-components,0.1.211-beta,0.1.212-beta,141,1,7,4,11,1,FALSE
meetup-web-components,1.0.945,1.0.946-beta,508,2,237,230,467,17,FALSE
meetup-web-components,0.1.272-beta,0.1.273,190,1,18,0,18,2,FALSE
meetup-web-components,1.0.475-beta,1.0.478-beta,296,1,361,84,445,19,FALSE
meetup-web-components,1.0.842-beta,1.0.843,412,1,474,408,882,5,FALSE
meetup-web-components,1.0.858-beta,1.0.859-beta,427,1,7,4,11,1,FALSE
meetup-web-components,1.0.644,1.0.646,347,1,7,4,11,1,FALSE
meetup-web-components,1.0.619-beta,1.0.622-beta,340,2,5,3,8,5,FALSE
meetup-web-components,1.0.760,1.0.763-beta,375,1,10,1,11,2,FALSE
meetup-web-components,0.1.248-beta,0.1.249-beta,170,1,0,1,1,1,FALSE
meetup-web-components,0.1.218-beta,0.1.219,146,1,1,1,2,1,FALSE
meetup-web-components,1.0.906-beta,1.0.907,472,1,8,0,8,1,FALSE
meetup-web-components,0.1.185-beta,0.1.189,121,1,0,1,1,1,FALSE
meetup-web-components,0.1.274-beta,0.1.275-beta,192,2,204,9,213,8,FALSE
meetup-web-components,0.1.178,0.1.179,116,1,74,147,221,4,FALSE
meetup-web-components,1.0.480-beta,1.0.482,298,1,4,4,8,2,FALSE
meetup-web-components,1.0.427-beta,1.0.428-beta,267,2,118,148,266,20,FALSE
meetup-web-components,1.0.676-beta,1.0.679-beta,357,1,2,2,4,1,FALSE
meetup-web-components,1.0.347-beta,1.0.348-beta,251,1,14,16,30,2,FALSE
meetup-web-components,0.1.221-beta,0.1.223-beta,149,1,7,4,11,1,FALSE
meetup-web-components,1.0.330-beta,1.0.331-beta,234,1,1,1,2,1,FALSE
meetup-web-components,1.0.935-beta,1.0.936-beta,499,1,0,0,0,0,FALSE
meetup-web-components,1.0.530-beta,1.0.533-beta,315,1,4,3,7,1,FALSE
meetup-web-components,1.0.323-beta,1.0.326,229,3,1712,559,2271,30,FALSE
meetup-web-components,0.1.279,0.1.281-beta,196,6,2025,222,2247,42,FALSE
meetup-web-components,0.1.271,0.1.272-beta,189,1,18,0,18,2,FALSE
meetup-web-components,0.1.273,0.1.274-beta,191,1,50,35,85,2,FALSE
meetup-web-components,1.0.462-beta,1.0.463-beta,288,1,7,4,11,1,FALSE
meetup-web-components,1.0.497-beta,1.0.500-beta,304,1,6,51,57,3,FALSE
meetup-web-components,0.1.255-beta,0.1.256-beta,175,1,1,1,2,1,FALSE
meetup-web-components,1.0.951-beta,1.0.952-beta,513,2,2,2,4,2,FALSE
meetup-web-components,0.1.315-beta,0.1.316,220,3,367,437,804,4,FALSE
meetup-web-components,0.1.256-beta,0.1.258-beta,176,1,1,1,2,1,FALSE
meetup-web-components,1.0.875-beta,1.0.876,442,1,8,12,20,1,FALSE
meetup-web-components,1.0.912,1.0.913-beta,478,2,402,145,547,2,FALSE
meetup-web-components,0.1.183-beta,0.1.184-beta,119,1,7,4,11,1,FALSE
meetup-web-components,1.0.468,1.0.469,293,1,6,14,20,2,FALSE
meetup-web-components,1.0.469,1.0.472,294,6,936,69,1005,29,FALSE
meetup-web-components,1.0.896-beta,1.0.897-beta,462,2,184,1,185,4,FALSE
meetup-web-components,0.1.237-beta,0.1.238-beta,160,1,7,4,11,1,FALSE
meetup-web-components,0.1.265-beta,0.1.266-beta,183,2,1093,231,1324,25,FALSE
meetup-web-components,1.0.860,1.0.863-beta,429,4,413,1711,2124,39,FALSE
meetup-web-components,1.0.865,1.0.866-beta,432,1,1,0,1,1,FALSE
meetup-web-components,1.0.917-beta,1.0.918-beta,483,1,28,346,374,5,FALSE
meetup-web-components,1.0.921-beta,1.0.922-beta,485,3,328,100,428,18,FALSE
meetup-web-components,1.0.336-beta,1.0.337,240,1,88,99,187,1,FALSE
meetup-web-components,1.0.605,1.0.606,337,1,7,4,11,1,FALSE
meetup-web-components,1.0.606,1.0.616-beta,338,5,1106,11,1117,18,FALSE
meetup-web-components,1.0.589-beta,1.0.590,332,1,7,4,11,1,FALSE
meetup-web-components,1.0.478-beta,1.0.480-beta,297,1,4,4,8,2,FALSE
meetup-web-components,1.0.850-beta,1.0.851-beta,420,1,7,4,11,1,FALSE
meetup-web-components,1.0.590,1.0.593-beta,333,2,27,26,53,4,FALSE
meetup-web-components,1.0.595,1.0.601-beta,335,5,165,83,248,19,FALSE
meetup-web-components,1.0.916-beta,1.0.917-beta,482,1,2,2,4,1,FALSE
meetup-web-components,0.1.189,0.1.190,122,1,22,62,84,8,FALSE
meetup-web-components,1.0.575-beta,1.0.578-beta,328,2,32,16,48,3,FALSE
meetup-web-components,1.0.341-beta,1.0.342-beta,245,1,7,4,11,1,FALSE
meetup-web-components,1.0.461-beta,1.0.462-beta,287,1,7,4,11,1,FALSE
meetup-web-components,0.1.290-beta,0.1.291-beta,204,1,7,4,11,1,FALSE
meetup-web-components,1.0.734,1.0.737-beta,365,2,101,19,120,13,FALSE
meetup-web-components,1.0.873-beta,1.0.874-beta,440,1,4,4,8,2,FALSE
meetup-web-components,1.0.730,1.0.731-beta,363,1,7,4,11,1,FALSE
meetup-web-components,1.0.739,1.0.742-beta,367,1,4,4,8,2,FALSE
meetup-web-components,1.0.411-beta,1.0.413,258,1,2,5,7,2,FALSE
meetup-web-components,1.0.328,1.0.329-beta,232,3,324,130,454,6,FALSE
meetup-web-components,1.0.464-beta,1.0.465-beta,290,1,3,1,4,1,FALSE
meetup-web-components,0.1.306-beta,0.1.307-beta,215,1,2,1,3,1,FALSE
meetup-web-components,0.1.224-beta,0.1.226,151,9,24281,37,24318,14,FALSE
meetup-web-components,1.0.326,1.0.327-beta,230,5,238,169,407,12,FALSE
meetup-web-components,1.0.866-beta,1.0.867-beta,433,1,7,4,11,1,FALSE
meetup-web-components,0.1.287-beta,0.1.288-beta,201,1,7,4,11,1,FALSE
meetup-web-components,1.0.638-beta,1.0.643-beta,345,3,1405,117,1522,34,FALSE
meetup-web-components,1.0.601-beta,1.0.605,336,3,1108,51,1159,14,FALSE
meetup-web-components,1.0.909-beta,1.0.910-beta,475,1,23,0,23,2,FALSE
meetup-web-components,1.0.802-beta,1.0.804-beta,391,1,7,7,14,4,FALSE
meetup-web-components,0.1.220-beta,0.1.221-beta,148,1,1,1,2,1,FALSE
meetup-web-components,0.1.176-beta,0.1.177-beta,114,1,2,1,3,1,FALSE
meetup-web-components,0.1.246-beta,0.1.247,168,1,694,92,786,18,FALSE
meetup-web-components,0.1.307-beta,0.1.308,216,1,207,0,207,3,FALSE
meetup-web-components,1.0.327-beta,1.0.328,231,1,5,0,5,1,FALSE
meetup-web-components,1.0.420,1.0.421-beta,263,1,7,4,11,1,FALSE
meetup-web-components,0.1.308,0.1.310-beta,217,4,120,225,345,13,FALSE
meetup-web-components,1.0.931-beta,1.0.932-beta,495,1,146,203,349,6,FALSE
meetup-web-components,1.0.466-beta,1.0.468,292,2,282,248,530,36,FALSE
meetup-web-components,1.0.429,1.0.430-beta,269,1,74,109,183,3,FALSE
meetup-web-components,0.1.208-beta,0.1.209-beta,139,1,7,4,11,1,FALSE
meetup-web-components,1.0.816,1.0.818-beta,400,1,4,5,9,1,FALSE
meetup-web-components,1.0.455-beta,1.0.456-beta,281,1,7,4,11,1,FALSE
meetup-web-components,1.0.339-beta,1.0.340,243,1,11,2,13,2,FALSE
meetup-web-components,1.0.799-beta,1.0.800,389,1,1,1,2,1,FALSE
meetup-web-components,1.0.565-beta,1.0.569-beta,325,1,2,6,8,1,FALSE
meetup-web-components,0.1.192-beta,0.1.193-beta,125,1,1,1,2,1,FALSE
meetup-web-components,1.0.915-beta,1.0.916-beta,481,1,7,4,11,1,FALSE
meetup-web-components,0.1.310-beta,0.1.311-beta,218,1,230,0,230,3,FALSE
meetup-web-components,1.0.904-beta,1.0.905,470,1,567,8,575,5,FALSE
meetup-web-components,0.1.230,0.1.231-beta,154,1,7,4,11,1,FALSE
meetup-web-components,0.1.214-beta,0.1.215,143,1,1,1,2,1,FALSE
meetup-web-components,0.1.259-beta,0.1.261-beta,178,2,25,27,52,3,FALSE
meetup-web-components,1.0.883-beta,1.0.884-beta,449,2,7,7,14,3,FALSE
meetup-web-components,0.1.198-beta,0.1.199,130,1,878,0,878,8,FALSE
meetup-web-components,1.0.929-beta,1.0.930-beta,493,2,155,212,367,9,FALSE
meetup-web-components,1.0.943-beta,1.0.944-beta,506,1,4,4,8,2,FALSE
meetup-web-components,0.1.239-beta,0.1.241-beta,162,1,7,4,11,1,FALSE
meetup-web-components,1.0.889,1.0.890-beta,455,1,1,7,8,2,FALSE
meetup-web-components,1.0.887,1.0.888-beta,453,1,8,6,14,2,FALSE
meetup-web-components,1.0.885,1.0.886-beta,451,1,34,34,68,4,FALSE
meetup-web-components,1.0.521-beta,1.0.524-beta,312,1,3,2,5,1,FALSE
meetup-web-components,1.0.886-beta,1.0.887,452,1,118,55,173,7,FALSE
meetup-web-components,1.0.926-beta,1.0.927-beta,490,2,12,11,23,3,FALSE
meetup-web-components,1.0.844-beta,1.0.845-beta,414,1,7,4,11,1,FALSE
meetup-web-components,0.1.297-beta,0.1.298-beta,208,1,1,1,2,1,FALSE
meetup-web-components,1.0.902-beta,1.0.903,468,2,38,51,89,5,FALSE
meetup-web-components,1.0.526-beta,1.0.530-beta,314,2,722,416,1138,38,FALSE
meetup-web-components,0.1.163-beta,0.1.166-beta,103,1,7,4,11,1,FALSE
meetup-web-components,0.1.162,0.1.163-beta,102,1,7,4,11,1,FALSE
meetup-web-components,0.1.167-beta,0.1.168-beta,105,1,7,4,11,1,FALSE
meetup-web-components,1.0.337,1.0.338-beta,241,1,1,1,2,1,TRUE
meetup-web-components,0.1.175,0.1.176-beta,113,1,19,14,33,1,FALSE
meetup-web-components,0.1.256-beta,0.1.258-beta,176,1,1,1,2,1,TRUE
meetup-web-components,0.1.168-beta,0.1.169,106,1,8,2,10,1,FALSE
meetup-web-components,0.1.300-beta,0.1.301-beta,211,1,7,4,11,1,TRUE
meetup-web-components,1.0.432-beta,1.0.437-beta,271,3,40,29,69,4,TRUE
meetup-web-components,1.0.456-beta,1.0.457-beta,282,1,7,4,11,1,TRUE
meetup-web-components,0.1.288-beta,0.1.289-beta,202,1,7,4,11,1,TRUE
meetup-web-components,0.1.311-beta,0.1.315-beta,219,6,1088,477,1565,22,TRUE
meetup-web-components,1.0.326,1.0.327-beta,230,5,238,169,407,12,TRUE
meetup-web-components,0.1.255-beta,0.1.256-beta,175,1,1,1,2,1,TRUE
meetup-web-components,0.1.251,0.1.252-beta,172,8,765,625,1390,31,TRUE
meetup-web-components,0.1.231-beta,0.1.232-beta,155,1,7,4,11,1,TRUE
meetup-web-components,1.0.351-beta,1.0.353-beta,255,1,3,0,3,1,TRUE
meetup-web-components,0.1.301-beta,0.1.302-beta,212,1,2,1,3,1,TRUE
meetup-web-components,0.1.254-beta,0.1.255-beta,174,1,1,1,2,1,TRUE
meetup-web-components,0.1.287-beta,0.1.288-beta,201,1,7,4,11,1,TRUE
meetup-web-components,1.0.772-beta,1.0.775-beta,379,4,617,374,991,18,TRUE
meetup-web-components,1.0.331-beta,1.0.332-beta,235,1,1,1,2,1,TRUE
meetup-web-components,0.1.220-beta,0.1.221-beta,148,1,1,1,2,1,TRUE
meetup-web-components,0.1.215,0.1.217-beta,144,2,5,1,6,2,TRUE
meetup-web-components,0.1.211-beta,0.1.212-beta,141,1,7,4,11,1,TRUE
meetup-web-components,0.1.285,0.1.287-beta,200,1,209,47,256,5,TRUE
meetup-web-components,0.1.24,0.1.33-beta,14,10,531,176,707,15,TRUE
meetup-web-components,0.1.148,0.1.149-beta,88,1,7,4,11,1,TRUE
meetup-web-components,0.1.150-beta,0.1.151,90,1,1,1,2,1,TRUE
meetup-web-components,0.1.290-beta,0.1.291-beta,204,1,7,4,11,1,TRUE
meetup-web-components,1.0.343,1.0.344-beta,247,1,7,4,11,1,TRUE
meetup-web-components,0.1.289-beta,0.1.290-beta,203,1,7,4,11,1,TRUE
meetup-web-components,0.1.219,0.1.220-beta,147,1,1,1,2,1,TRUE
meetup-web-components,0.1.203-beta,0.1.204,135,2,2,2,4,2,TRUE
meetup-web-components,0.1.201,0.1.202-beta,133,1,7,4,11,1,TRUE
re-app,0.9.0,0.10.0,9,2,72,46,118,5,FALSE
re-app,0.10.0,0.11.0,10,1,1,14,15,2,FALSE
re-app,0.7.18,0.9.0,8,8,838,8,846,18,FALSE
re-app,0.11.0,0.12.0,11,1,274,0,274,7,FALSE
re-app,0.12.1,0.13.0,13,1,12,1,13,2,FALSE
re-app,0.12.0,0.12.1,12,1,3,2,5,2,FALSE
re-app,0.13.6,0.13.7,20,1,3,3,6,2,FALSE
re-app,0.13.7,0.13.8,21,1,22,8,30,7,FALSE
re-app,0.13.4,0.13.5,18,1,30,12,42,3,FALSE
re-app,0.13.5,0.13.6,19,1,2,2,4,2,FALSE
re-app,0.13.3,0.13.4,17,1,12,9,21,2,FALSE
re-app,0.13.0,0.13.1,14,1,1,2,3,2,FALSE
re-app,0.13.2,0.13.3,16,1,2,1,3,2,FALSE
re-app,0.2.5,0.6.16,4,34,1070,381,1451,94,FALSE
re-app,0.6.18,0.7.18,7,5,194,122,316,27,FALSE
re-app,0.6.17,0.6.18,6,1,3,3,6,1,FALSE
re-app,0.6.16,0.6.17,5,1,3,3,6,1,FALSE
re-app,0.13.1,0.13.2,15,1,12,2,14,2,FALSE
re-app,0.0.1,0.0.2,1,3,6,6,12,3,FALSE
re-app,0.0.3,0.2.5,3,81,6332,1114,7446,444,FALSE
re-app,0.0.2,0.0.3,2,1,6,2,8,3,FALSE
re-app,0.22.0-dev.23,0.22.0-dev.24,56,1,4,2,6,3,FALSE
re-app,0.22.0-dev.22,0.22.0-dev.23,55,1,4,2,6,3,FALSE
re-app,0.22.0-dev.20,0.22.0-dev.21,53,1,4,2,6,3,FALSE
re-app,0.22.0-dev.27,0.22.0-dev.28,60,1,4,2,6,3,FALSE
re-app,0.22.0-dev.26,0.22.0-dev.27,59,1,4,2,6,3,FALSE
re-app,0.22.0-dev.25,0.22.0-dev.26,58,1,4,2,6,3,FALSE
re-app,0.22.0-dev.24,0.22.0-dev.25,57,1,4,2,6,3,FALSE
re-app,0.22.0-dev.29,0.22.0-dev.30,62,1,4,2,6,3,FALSE
re-app,0.22.0-dev.28,0.22.0-dev.29,61,1,4,2,6,3,FALSE
re-app,0.21.16,0.21.17,34,1,4,2,6,3,FALSE
re-app,0.22.0-dev.4,0.22.0-dev.5,39,1,4,2,6,3,FALSE
re-app,0.22.0-dev.5,0.22.0-dev.6,40,1,4,2,6,3,FALSE
re-app,0.22.0-dev.6,0.22.0-dev.7,41,1,4,2,6,3,FALSE
re-app,0.20.0,0.21.5,23,25,1358,156,1514,65,FALSE
re-app,0.22.0-dev.1,0.22.0-dev.2,36,1,4,2,6,3,FALSE
re-app,0.22.0-dev.2,0.22.0-dev.3,37,1,4,2,6,3,FALSE
re-app,0.22.0-dev.3,0.22.0-dev.4,38,1,4,2,6,3,FALSE
re-app,0.21.9,0.21.10,28,10,134,87,221,14,FALSE
re-app,0.21.8,0.21.9,27,1,5,1,6,2,FALSE
re-app,0.13.8,0.20.0,22,94,8890,3086,11976,408,FALSE
re-app,0.21.5,0.21.6,24,1,66,60,126,5,FALSE
re-app,0.22.0-dev.30,0.22.0-dev.31,63,1,4,2,6,3,FALSE
re-app,0.21.7,0.21.8,26,1,11,3,14,2,FALSE
re-app,0.22.0-dev.31,0.22.0-dev.32,64,1,4,2,6,3,FALSE
re-app,0.22.0-dev.16,0.22.0-dev.17,49,1,4,2,6,3,FALSE
re-app,0.22.0-dev.17,0.22.0-dev.18,50,1,4,2,6,3,FALSE
re-app,0.22.0-dev.14,0.22.0-dev.15,47,1,4,2,6,3,FALSE
re-app,0.22.0-dev.15,0.22.0-dev.16,48,1,4,2,6,3,FALSE
re-app,0.22.0-dev.12,0.22.0-dev.14,46,1,4,2,6,3,FALSE
re-app,0.22.0-dev.10,0.22.0-dev.12,45,1,4,2,6,3,FALSE
re-app,0.21.14,0.21.16,33,4,157,22,179,11,FALSE
re-app,0.21.17,0.22.0-dev.1,35,1,4,2,6,3,FALSE
re-app,0.21.6,0.21.7,25,1,5,3,8,1,FALSE
re-app,0.21.11,0.21.12,30,2,42,39,81,6,FALSE
re-app,0.21.10,0.21.11,29,7,81,53,134,9,FALSE
re-app,0.21.13,0.21.14,32,4,141,15,156,8,FALSE
re-app,0.21.12,0.21.13,31,1,1,4,5,2,FALSE
re-app,0.22.0-dev.18,0.22.0-dev.19,51,1,4,2,6,3,FALSE
re-app,0.22.0-dev.8,0.22.0-dev.9,43,1,4,2,6,3,FALSE
re-app,0.22.0-dev.21,0.22.0-dev.22,54,1,4,2,6,3,FALSE
re-app,0.22.0-dev.9,0.22.0-dev.10,44,1,4,2,6,3,FALSE
re-app,0.22.0-dev.7,0.22.0-dev.8,42,1,4,2,6,3,FALSE
re-app,0.22.0-dev.19,0.22.0-dev.20,52,1,4,2,6,3,FALSE
re-app,0.13.6,0.13.7,20,1,3,3,6,2,TRUE
re-app,0.0.3,0.2.5,3,81,6332,1114,7446,444,TRUE
re-app,0.2.5,0.6.16,4,34,1070,381,1451,94,TRUE
re-app,0.13.7,0.13.8,21,1,22,8,30,7,TRUE
re-app,0.22.0-dev.20,0.22.0-dev.21,53,1,4,2,6,3,TRUE
re-app,0.22.0-dev.27,0.22.0-dev.28,60,1,4,2,6,3,TRUE
re-app,0.22.0-dev.29,0.22.0-dev.30,62,1,4,2,6,3,TRUE
re-app,0.22.0-dev.17,0.22.0-dev.18,50,1,4,2,6,3,TRUE
re-app,0.22.0-dev.12,0.22.0-dev.14,46,1,4,2,6,3,TRUE
re-app,0.22.0-dev.10,0.22.0-dev.12,45,1,4,2,6,3,TRUE
re-app,0.22.0-dev.21,0.22.0-dev.22,54,1,4,2,6,3,TRUE
re-app,0.21.9,0.21.10,28,10,134,87,221,14,TRUE
re-app,0.21.14,0.21.16,33,4,157,22,179,11,TRUE
re-app,0.22.0-dev.5,0.22.0-dev.6,40,1,4,2,6,3,TRUE
re-app,0.20.0,0.21.5,23,25,1358,156,1514,65,TRUE
re-app,0.22.0-dev.26,0.22.0-dev.27,59,1,4,2,6,3,TRUE
re-app,0.22.0-dev.6,0.22.0-dev.7,41,1,4,2,6,3,TRUE
re-app,0.21.11,0.21.12,30,2,42,39,81,6,TRUE
re-app,0.22.0-dev.25,0.22.0-dev.26,58,1,4,2,6,3,TRUE
re-app,0.21.13,0.21.14,32,4,141,15,156,8,TRUE
query-dom,3.0.6,3.0.7,13,3,3,3,6,3,FALSE
query-dom,3.0.7,3.0.8,14,6,115,99,214,7,FALSE
query-dom,3.0.4,3.0.5,11,4,4,4,8,4,FALSE
query-dom,3.0.5,3.0.6,12,2,2,2,4,2,FALSE
query-dom,1.0.0,1.0.1,1,2,4,4,8,2,FALSE
query-dom,2.0.2,3.0.0,6,3,39,4,43,6,FALSE
query-dom,2.0.1,2.0.2,5,2,6,7,13,4,FALSE
query-dom,2.0.0,2.0.1,4,2,2,2,4,2,FALSE
query-dom,3.1.1,3.1.2,17,13,93,44,137,17,FALSE
query-dom,3.0.8,3.1.0,15,3,15,1,16,5,FALSE
query-dom,3.1.0,3.1.1,16,7,22,16,38,10,FALSE
query-dom,3.0.2,3.0.3,9,9,113,72,185,15,FALSE
query-dom,1.0.2,2.0.0,3,3,32,52,84,6,FALSE
query-dom,3.0.3,3.0.4,10,4,51,18,69,9,FALSE
query-dom,3.0.0,3.0.1,7,2,2,2,4,2,FALSE
query-dom,3.0.1,3.0.2,8,2,2,2,4,3,FALSE
query-dom,3.1.2,3.2.0,18,3,192,91,283,12,FALSE
query-dom,3.4.2,3.4.3,23,5,144,146,290,16,FALSE
query-dom,3.4.0,3.4.1,21,5,11,10,21,5,FALSE
query-dom,3.4.1,3.4.2,22,8,179,19,198,15,FALSE
query-dom,3.3.0,3.4.0,20,7,121,9,130,15,FALSE
query-dom,3.2.0,3.3.0,19,2,28,1,29,5,FALSE
query-dom,1.0.1,1.0.2,2,2,1,2,3,2,FALSE
query-dom,3.0.3,3.0.4,10,4,51,18,69,9,TRUE
query-dom,3.0.7,3.0.8,14,6,115,99,214,7,TRUE
query-dom,3.1.0,3.1.1,16,7,22,16,38,10,TRUE
query-dom,3.4.2,3.4.3,23,5,144,146,290,16,TRUE
query-dom,3.0.4,3.0.5,11,4,4,4,8,4,TRUE
query-dom,3.4.1,3.4.2,22,8,179,19,198,15,TRUE
react-split-pane-2,0.1.29,0.1.30,9,1,4,0,4,1,FALSE
react-split-pane-2,0.1.28,0.1.29,8,1,4,0,4,1,FALSE
react-split-pane-2,0.1.23,0.1.24,3,1,4,0,4,1,FALSE
react-split-pane-2,0.1.22,0.1.23,2,1,4,0,4,1,FALSE
react-split-pane-2,0.1.21,0.1.22,1,1,4,0,4,1,FALSE
react-split-pane-2,0.1.33,0.1.34,13,1,4,0,4,1,FALSE
react-split-pane-2,0.1.27,0.1.28,7,1,4,0,4,1,FALSE
react-split-pane-2,0.1.26,0.1.27,6,1,4,0,4,1,FALSE
react-split-pane-2,0.1.25,0.1.26,5,1,4,0,4,1,FALSE
react-split-pane-2,0.1.31,0.1.32,11,1,4,0,4,1,FALSE
react-split-pane-2,0.1.30,0.1.31,10,1,4,0,4,1,FALSE
react-split-pane-2,0.1.32,0.1.33,12,1,4,0,4,1,FALSE
react-split-pane-2,0.1.35,0.1.36,15,1,4,0,4,1,TRUE
react-split-pane-2,0.1.34,0.1.35,14,1,4,0,4,1,FALSE
react-split-pane-2,0.1.24,0.1.25,4,1,4,0,4,1,FALSE
react-split-pane-2,0.1.35,0.1.36,15,1,4,0,4,1,FALSE
mobx-react,4.1.4,4.1.5,47,3,27,5,32,6,FALSE
mobx-react,4.1.5,4.1.6,48,13,284,252,536,35,FALSE
mobx-react,4.1.6,4.1.7,49,3,25,22,47,5,FALSE
mobx-react,4.1.7,4.1.8,50,7,21,19,40,9,FALSE
mobx-react,4.1.0,4.1.1,43,12,63,30,93,19,FALSE
mobx-react,4.0.4,4.1.0,42,10,29,22,51,17,FALSE
mobx-react,4.0.2-rc,4.0.2,38,1,1,1,2,1,FALSE
mobx-react,4.1.3,4.1.4,46,7,76,21,97,11,FALSE
mobx-react,4.1.8,4.2.1,51,22,417,235,652,47,FALSE
mobx-react,4.0.0-beta.1,4.0.0-beta.2,30,1,112,8,120,5,FALSE
mobx-react,4.0.0-beta.2,4.0.0-rc.1,31,10,503,322,825,30,FALSE
mobx-react,4.0.0-rc.1,4.0.0-rc.2,32,9,3539,3808,7347,46,FALSE
mobx-react,4.0.0-rc.2,4.0.0-rc.3,33,3,145,30,175,10,FALSE
mobx-react,4.0.0-rc.3,4.0.0-rc.4,34,1,8,5,13,3,FALSE
mobx-react,4.0.0-rc.4,4.0.0,35,2,2220,1478,3698,22,FALSE
mobx-react,4.0.3-rc,4.0.3,40,2,40,10,50,4,FALSE
mobx-react,4.0.0,4.0.1,36,5,25,16,41,8,FALSE
mobx-react,4.0.3,4.0.4,41,7,82,13,95,10,FALSE
mobx-react,4.0.2,4.0.3-rc,39,1,1,1,2,1,FALSE
mobx-react,4.0.1,4.0.2-rc,37,6,27,32,59,8,FALSE
mobx-react,4.1.1,4.1.2,44,5,60,10,70,9,FALSE
mobx-react,4.1.2,4.1.3,45,5,44,32,76,6,FALSE
mobx-react,3.5.9,4.0.0-beta.1,29,10,377,44,421,30,FALSE
mobx-react,3.5.8,3.5.9,28,41,1137,183,1320,73,FALSE
mobx-react,3.5.7,3.5.8-fix134,24,13,425,87,512,21,FALSE
mobx-react,3.5.6,3.5.7,23,8,25,20,45,8,FALSE
mobx-react,3.5.5,3.5.6,22,11,64,9,73,13,FALSE
mobx-react,3.5.4,3.5.5,21,6,21,15,36,7,FALSE
mobx-react,3.5.8-observableprops,3.5.8-observableprops.1,26,14,172,80,252,17,FALSE
mobx-react,3.5.2-alpha.1,3.5.2,17,2,876,461,1337,21,FALSE
mobx-react,3.5.3,3.5.4-fix101,19,14,363,93,456,27,FALSE
mobx-react,3.5.2,3.5.3,18,3,3,4,7,3,FALSE
mobx-react,4.1.1,4.1.2,44,5,60,10,70,9,TRUE
mobx-react,3.5.0-fix85,3.5.0-fix85-2,13,1,3,1,4,1,FALSE
mobx-react,4.0.3,4.0.4,41,7,82,13,95,10,TRUE
mobx-react,3.4.0,3.5.0-fix85,12,27,1400,299,1699,59,FALSE
mobx-react,3.5.7,3.5.8-fix134,24,13,425,87,512,21,TRUE
mobx-react,3.5.1,3.5.2-alpha.1,16,9,1385,986,2371,29,FALSE
mobx-react,3.5.0,3.5.1,15,8,117,39,156,15,FALSE
mobx-react,3.4.0-beta.1,3.4.0,11,4,440,64,504,13,FALSE
mobx-react,3.0.4,3.0.5,5,2,58,4,62,8,FALSE
mobx-react,3.1.0,3.2.0,7,8,263,34,297,13,FALSE
mobx-react,3.0.2,3.0.3,3,6,41,57,98,10,FALSE
mobx-react,3.0.3,3.0.4,4,4,45,40,85,8,FALSE
mobx-react,3.0.0,3.0.1,1,4,92,21,113,6,FALSE
mobx-react,3.0.1,3.0.2,2,5,9,9,18,5,FALSE
mobx-react,3.0.5,3.1.0,6,7,112,27,139,17,FALSE
mobx-react,4.0.0,4.0.1,36,5,25,16,41,8,TRUE
mobx-react,3.3.1,3.4.0-beta.1,10,2,6,2,8,2,FALSE
mobx-react,3.3.0,3.3.1,9,5,43,5,48,8,FALSE
mobx-react,3.2.0,3.3.0,8,5,290,282,572,10,FALSE
mobx-react,3.0.4,3.0.5,5,2,58,4,62,8,TRUE
mobx-react,3.0.2,3.0.3,3,6,41,57,98,10,TRUE
mobx-react,3.0.3,3.0.4,4,4,45,40,85,8,TRUE
mobx-react,3.0.0,3.0.1,1,4,92,21,113,6,TRUE
mobx-react,3.0.1,3.0.2,2,5,9,9,18,5,TRUE
mobx-react,4.1.3,4.1.4,46,7,76,21,97,11,TRUE
mobx-react,4.1.8,4.2.1,51,22,417,235,652,47,TRUE
mobx-react,4.1.7,4.1.8,50,7,21,19,40,9,TRUE
mobx-react,4.1.2,4.1.3,45,5,44,32,76,6,TRUE
mobx-react,4.0.1,4.0.2-rc,37,6,27,32,59,8,TRUE
mobx-react,4.0.4,4.1.0,42,10,29,22,51,17,TRUE
mobx-react,3.4.0,3.5.0-fix85,12,27,1400,299,1699,59,TRUE
mobx-react,3.5.0,3.5.1,15,8,117,39,156,15,TRUE
mobx-react,3.0.5,3.1.0,6,7,112,27,139,17,TRUE
mobx-react,4.0.0-rc.1,4.0.0-rc.2,32,9,3539,3808,7347,46,TRUE
mobx-react,3.5.4,3.5.5,21,6,21,15,36,7,TRUE
mobx-react,4.1.0,4.1.1,43,12,63,30,93,19,TRUE
apptension-tools,1.0.4,1.0.5,4,2,8,24,32,3,FALSE
apptension-tools,1.0.1,1.0.2,1,2,3,2,5,2,FALSE
apptension-tools,1.0.2,1.0.3,2,2,2,2,4,2,FALSE
apptension-tools,1.0.3,1.0.4,3,2,11,16,27,2,FALSE
apptension-tools,5.0.18,5.1.0,112,4,42,118,160,4,FALSE
apptension-tools,5.0.12,5.0.13,106,2,2,2,4,2,FALSE
apptension-tools,5.0.13,5.0.14,107,2,6,1,7,2,FALSE
apptension-tools,5.0.10,5.0.11,104,2,2,1,3,2,FALSE
apptension-tools,5.0.11,5.0.12,105,2,5,3,8,2,FALSE
apptension-tools,5.0.16,5.0.17,110,2,3,2,5,2,FALSE
apptension-tools,5.0.17,5.0.18,111,2,57,41,98,3,FALSE
apptension-tools,5.0.14,5.0.15,108,2,3,3,6,2,FALSE
apptension-tools,5.0.15,5.0.16,109,2,3,2,5,2,FALSE
apptension-tools,5.0.0,5.0.1,94,2,6,2,8,3,FALSE
apptension-tools,4.5.1,4.5.2,86,1,1,1,2,1,FALSE
apptension-tools,5.0.2,5.0.3,96,2,6,1,7,2,FALSE
apptension-tools,5.2.2,5.2.3,116,2,12,3,15,3,FALSE
apptension-tools,5.2.3,5.2.4,117,2,4,1,5,2,FALSE
apptension-tools,5.2.0,5.2.1,114,2,2,1,3,2,FALSE
apptension-tools,5.2.1,5.2.2,115,2,16,3,19,2,FALSE
apptension-tools,5.2.6,5.2.7,120,2,2,2,4,2,FALSE
apptension-tools,5.2.7,5.2.8,121,2,3,1,4,3,FALSE
apptension-tools,5.2.4,5.2.5,118,2,2,7,9,2,FALSE
apptension-tools,5.2.5,5.2.6,119,2,7,1,8,2,FALSE
apptension-tools,4.5.4,4.5.5,89,3,4,2,6,4,FALSE
apptension-tools,5.2.8,5.2.9,122,2,2,2,4,2,FALSE
apptension-tools,5.2.9,5.2.10,123,1,1,1,2,1,FALSE
apptension-tools,4.5.5,4.5.6,90,1,2,3,5,1,FALSE
apptension-tools,4.5.0,4.5.1,85,1,1,1,2,1,FALSE
apptension-tools,5.0.1,5.0.2,95,2,12,6,18,2,FALSE
apptension-tools,4.5.2,4.5.3,87,5,7,7,14,5,FALSE
apptension-tools,4.5.3,4.5.4,88,4,12,6,18,4,FALSE
apptension-tools,5.0.4,5.0.5,98,2,1,5,6,2,FALSE
apptension-tools,5.0.5,5.0.6,99,2,12,4,16,3,FALSE
apptension-tools,4.5.6,4.5.7,91,1,1,1,2,1,FALSE
apptension-tools,5.0.7,5.0.8,101,2,5,4,9,3,FALSE
apptension-tools,5.0.8,5.0.9,102,2,4,3,7,2,FALSE
apptension-tools,5.0.9,5.0.10,103,2,6,5,11,2,FALSE
apptension-tools,4.5.7,4.5.8,92,5,22,5,27,7,FALSE
apptension-tools,4.3.2,4.4.0,82,74,453,593,1046,111,FALSE
apptension-tools,4.3.0,4.3.1,80,2,1,7,8,2,FALSE
apptension-tools,4.3.1,4.3.2,81,3,3,4,7,4,FALSE
apptension-tools,5.4.4,5.4.5,137,2,1,2,3,2,FALSE
apptension-tools,5.4.0,5.4.1,133,4,12,6,18,4,FALSE
apptension-tools,5.4.1,5.4.2,134,2,3,1,4,3,FALSE
apptension-tools,5.4.2,5.4.3,135,1,1,1,2,1,FALSE
apptension-tools,5.4.3,5.4.4,136,4,23,6,29,6,FALSE
apptension-tools,5.2.10,5.2.11,124,2,14,2,16,4,FALSE
apptension-tools,5.2.11,5.3.0,125,2,2,2,4,2,FALSE
apptension-tools,5.0.3,5.0.4,97,2,14,32,46,6,FALSE
apptension-tools,4.4.0,4.4.1,83,1,1,1,2,1,FALSE
apptension-tools,4.2.13,4.3.0,79,2,12,5,17,4,FALSE
apptension-tools,4.2.12,4.2.13,78,2,8,7,15,3,FALSE
apptension-tools,4.2.11,4.2.12,77,2,2,2,4,2,FALSE
apptension-tools,4.2.10,4.2.11,76,4,7,3,10,4,FALSE
apptension-tools,6.0.0-alpha11,6.0.0-alpha12,141,1,1,1,2,1,FALSE
apptension-tools,6.0.0-alpha10,6.0.0-alpha11,140,1,1,1,2,1,FALSE
apptension-tools,6.0.0-alpha8,6.0.0-alpha9,149,1,1,1,2,1,FALSE
apptension-tools,6.0.0-alpha7,6.0.0-alpha8,148,1,1,1,2,1,FALSE
apptension-tools,6.0.0-alpha6,6.0.0-alpha7,147,1,1,1,2,1,FALSE
apptension-tools,6.0.0-alpha5,6.0.0-alpha6,146,1,1,1,2,1,FALSE
apptension-tools,6.0.0-alpha4,6.0.0-alpha5,145,1,1,1,2,1,FALSE
apptension-tools,6.0.0-alpha3,6.0.0-alpha4,144,4,12,6,18,4,FALSE
apptension-tools,6.0.0-alpha2,6.0.0-alpha3,143,1,1,1,2,1,FALSE
apptension-tools,6.0.0-alpha1,6.0.0-alpha10,139,7,16,8,24,8,FALSE
apptension-tools,5.0.6,5.0.7,100,2,3,3,6,2,FALSE
apptension-tools,5.3.7,5.4.0,132,6,8,8,16,6,FALSE
apptension-tools,5.3.6,5.3.7,131,4,8,4,12,4,FALSE
apptension-tools,5.3.4,5.3.6,130,5,14,1,15,5,FALSE
apptension-tools,5.3.3,5.3.4,129,1,1,1,2,1,FALSE
apptension-tools,5.3.2,5.3.3,128,3,9,9,18,7,FALSE
apptension-tools,5.3.1,5.3.2,127,4,13,13,26,5,FALSE
apptension-tools,5.3.0,5.3.1,126,2,19,19,38,2,FALSE
apptension-tools,4.4.1,4.5.0,84,16,41,24,65,20,FALSE
apptension-tools,5.1.0,5.2.0,113,2,7,5,12,3,FALSE
apptension-tools,4.2.3,4.2.4,69,2,2,2,4,2,FALSE
apptension-tools,4.2.2,4.2.3,68,2,4,3,7,2,FALSE
apptension-tools,4.2.1,4.2.2,67,2,5,2,7,2,FALSE
apptension-tools,4.2.0,4.2.1,66,2,4,4,8,3,FALSE
apptension-tools,4.2.7,4.2.8,73,2,10,11,21,3,FALSE
apptension-tools,4.2.6,4.2.7,72,2,2,1,3,2,FALSE
apptension-tools,4.2.5,4.2.6,71,2,10,3,13,2,FALSE
apptension-tools,4.2.4,4.2.5,70,2,3,2,5,2,FALSE
apptension-tools,4.2.9,4.2.10,75,3,121,298,419,17,FALSE
apptension-tools,4.2.8,4.2.9,74,2,96,16,112,6,FALSE
apptension-tools,5.2.7,5.2.8,121,2,3,1,4,3,TRUE
apptension-tools,5.0.1,5.0.2,95,2,12,6,18,2,TRUE
apptension-tools,5.2.5,5.2.6,119,2,7,1,8,2,TRUE
apptension-tools,4.5.2,4.5.3,87,5,7,7,14,5,TRUE
apptension-tools,4.2.1,4.2.2,67,2,5,2,7,2,TRUE
apptension-tools,4.2.2,4.2.3,68,2,4,3,7,2,TRUE
apptension-tools,5.0.7,5.0.8,101,2,5,4,9,3,TRUE
apptension-tools,6.0.0-alpha3,6.0.0-alpha4,144,4,12,6,18,4,TRUE
apptension-tools,5.3.6,5.3.7,131,4,8,4,12,4,TRUE
apptension-tools,5.3.4,5.3.6,130,5,14,1,15,5,TRUE
apptension-tools,5.0.4,5.0.5,98,2,1,5,6,2,TRUE
apptension-tools,1.0.2,1.0.3,2,2,2,2,4,2,TRUE
apptension-tools,5.0.15,5.0.16,109,2,3,2,5,2,TRUE
apptension-tools,4.5.1,4.5.2,86,1,1,1,2,1,TRUE
apptension-tools,6.0.0-alpha8,6.0.0-alpha9,149,1,1,1,2,1,TRUE
apptension-tools,5.1.0,5.2.0,113,2,7,5,12,3,TRUE
apptension-tools,5.4.0,5.4.1,133,4,12,6,18,4,TRUE
apptension-tools,4.3.1,4.3.2,81,3,3,4,7,4,TRUE
apptension-tools,5.0.10,5.0.11,104,2,2,1,3,2,TRUE
apptension-tools,5.0.17,5.0.18,111,2,57,41,98,3,TRUE
apptension-tools,4.0.5,4.0.6,59,2,5,3,8,4,FALSE
apptension-tools,4.0.7,4.1.0,61,2,7,5,12,2,TRUE
apptension-tools,4.0.6,4.0.7,60,2,2,1,3,2,TRUE
apptension-tools,5.0.0,5.0.1,94,2,6,2,8,3,TRUE
apptension-tools,4.5.5,4.5.6,90,1,2,3,5,1,TRUE
apptension-tools,4.5.6,4.5.7,91,1,1,1,2,1,TRUE
apptension-tools,4.5.7,4.5.8,92,5,22,5,27,7,TRUE
apptension-tools,5.0.8,5.0.9,102,2,4,3,7,2,TRUE
apptension-tools,5.0.9,5.0.10,103,2,6,5,11,2,TRUE
apptension-tools,4.1.0,4.1.1,62,2,5,2,7,2,FALSE
apptension-tools,4.1.3,4.2.0,65,2,38,88,126,4,TRUE
apptension-tools,5.0.3,5.0.4,97,2,14,32,46,6,TRUE
apptension-tools,5.0.6,5.0.7,100,2,3,3,6,2,TRUE
apptension-tools,4.1.1,4.1.2,63,3,3,10,13,4,TRUE
apptension-tools,4.1.2,4.1.3,64,2,2,2,4,2,FALSE
apptension-tools,4.2.4,4.2.5,70,2,3,2,5,2,TRUE
apptension-tools,4.2.9,4.2.10,75,3,121,298,419,17,TRUE
apptension-tools,4.2.8,4.2.9,74,2,96,16,112,6,TRUE
apptension-tools,5.2.6,5.2.7,120,2,2,2,4,2,TRUE
apptension-tools,6.0.0-alpha7,6.0.0-alpha8,148,1,1,1,2,1,TRUE
apptension-tools,5.2.9,5.2.10,123,1,1,1,2,1,TRUE
apptension-tools,5.0.18,5.1.0,112,4,42,118,160,4,TRUE
apptension-tools,4.0.7,4.1.0,61,2,7,5,12,2,FALSE
apptension-tools,4.0.6,4.0.7,60,2,2,1,3,2,FALSE
apptension-tools,4.1.3,4.2.0,65,2,38,88,126,4,FALSE
apptension-tools,4.1.1,4.1.2,63,3,3,10,13,4,FALSE
apptension-tools,1.0.3,1.0.4,3,2,11,16,27,2,TRUE
apptension-tools,3.1.3,3.1.4,52,2,1,2,3,2,FALSE
apptension-tools,3.1.2,3.1.3,51,2,3,2,5,3,FALSE
apptension-tools,3.1.1,3.1.2,50,2,2,2,4,2,FALSE
apptension-tools,3.1.0,3.1.1,49,2,2,2,4,2,FALSE
apptension-tools,3.1.4,4.0.0,53,2,13,15,28,3,FALSE
apptension-tools,4.0.1,4.0.2,55,3,10,2,12,3,FALSE
apptension-tools,4.0.0,4.0.1,54,2,6,2,8,3,FALSE
apptension-tools,4.0.3,4.0.4,57,2,23,11,34,3,FALSE
apptension-tools,4.0.2,4.0.3,56,2,2,2,4,2,FALSE
apptension-tools,4.0.4,4.0.5,58,3,67,22,89,5,FALSE
apptension-tools,3.0.0,3.1.0,48,4,42,18,60,8,FALSE
apptension-tools,2.0.7,2.0.8,41,2,2,5,7,2,FALSE
apptension-tools,2.0.6,2.0.7,40,3,37,2,39,3,FALSE
apptension-tools,2.0.5,2.0.6,39,2,2,1,3,2,FALSE
apptension-tools,2.0.4,2.0.5,38,2,10,5,15,2,FALSE
apptension-tools,2.0.3,2.0.4,37,2,3,1,4,2,FALSE
apptension-tools,2.0.2,2.0.3,36,2,3,3,6,2,FALSE
apptension-tools,2.0.1,2.0.2,35,2,3,2,5,3,FALSE
apptension-tools,2.0.0,2.0.1,34,3,201,6,207,3,FALSE
apptension-tools,2.0.8,2.1.0,42,2,21,3,24,5,FALSE
apptension-tools,2.2.1,2.2.2,46,2,45,5,50,3,FALSE
apptension-tools,2.2.0,2.2.1,45,4,14,8,22,6,FALSE
apptension-tools,2.2.2,3.0.0,47,5,83,54,137,16,FALSE
apptension-tools,2.1.0,2.1.1,43,4,23,6,29,7,FALSE
apptension-tools,2.1.1,2.2.0,44,2,10,4,14,4,FALSE
apptension-tools,1.0.5,1.0.6,5,2,2,3,5,2,FALSE
apptension-tools,1.0.6,1.0.7,6,2,5,1,6,2,FALSE
apptension-tools,1.0.7,1.0.8,7,2,16,2,18,4,FALSE
apptension-tools,1.0.8,1.0.9,8,2,17,2,19,4,TRUE
apptension-tools,1.0.9,1.0.10,9,2,3,2,5,2,FALSE
apptension-tools,1.0.16,1.0.17,16,2,5,3,8,3,FALSE
apptension-tools,1.0.17,1.0.18,17,2,7,4,11,3,FALSE
apptension-tools,1.0.14,1.0.15,14,2,7,3,10,2,FALSE
apptension-tools,1.0.15,1.0.16,15,2,1,6,7,2,FALSE
apptension-tools,1.0.12,1.0.13,12,2,6,4,10,2,FALSE
apptension-tools,1.0.13,1.0.14,13,2,5,3,8,2,FALSE
apptension-tools,1.0.10,1.0.11,10,2,3,3,6,2,FALSE
apptension-tools,1.0.11,1.0.12,11,2,5,1,6,2,FALSE
apptension-tools,1.0.18,1.0.19,18,2,20,1,21,4,FALSE
apptension-tools,1.0.19,1.0.20,19,2,2,2,4,2,FALSE
apptension-tools,1.3.0,1.4.0,31,2,3,3,6,3,FALSE
apptension-tools,5.2.11,5.3.0,125,2,2,2,4,2,TRUE
apptension-tools,1.0.27,1.1.0,27,2,39,15,54,6,FALSE
apptension-tools,1.0.26,1.0.27,26,2,3,3,6,2,FALSE
apptension-tools,1.0.25,1.0.26,25,2,65,46,111,6,FALSE
apptension-tools,1.0.24,1.0.25,24,2,2,2,4,2,FALSE
apptension-tools,1.0.23,1.0.24,23,2,12,7,19,3,FALSE
apptension-tools,1.0.22,1.0.23,22,2,13,9,22,2,FALSE
apptension-tools,1.0.21,1.0.22,21,2,6,3,9,2,FALSE
apptension-tools,1.0.20,1.0.21,20,2,4,2,6,3,FALSE
apptension-tools,1.5.0,2.0.0,33,2,755,302,1057,30,FALSE
apptension-tools,5.4.1,5.4.2,134,2,3,1,4,3,TRUE
apptension-tools,1.1.0,1.2.0,28,2,7,16,23,2,TRUE
apptension-tools,1.4.0,1.5.0,32,2,17,1,18,4,FALSE
apptension-tools,1.2.0,1.2.1,29,2,8,6,14,3,FALSE
apptension-tools,1.2.1,1.3.0,30,2,13,3,16,3,FALSE
apptension-tools,5.3.3,5.3.4,129,1,1,1,2,1,TRUE
apptension-tools,5.3.2,5.3.3,128,3,9,9,18,7,TRUE
apptension-tools,1.0.8,1.0.9,8,2,17,2,19,4,FALSE
apptension-tools,1.1.0,1.2.0,28,2,7,16,23,2,FALSE
apptension-tools,1.0.25,1.0.26,25,2,65,46,111,6,TRUE
react-rating-svg,0.0.1-alpha.1,0.0.1-alpha.2,2,4,60,39,99,12,FALSE
react-rating-svg,0.0.1-alpha.0,0.0.1-alpha.1,1,3,15,7,22,6,FALSE
react-rating-svg,0.0.1-alpha.2,0.0.1,3,6,351,60,411,22,FALSE
react-rating-svg,0.0.1-alpha.2,0.0.1,3,6,351,60,411,22,TRUE
re-define,0.0.15-beta,0.0.15-rc,19,7,952,925,1877,93,FALSE
re-define,0.0.15,0.0.16,21,25,2769,2010,4779,209,FALSE
re-define,0.0.14,0.0.15-beta,18,17,883,1074,1957,111,FALSE
re-define,0.0.17,0.0.18,23,6,248,248,496,29,FALSE
re-define,0.0.16,0.0.17,22,1,25,11,36,4,FALSE
re-define,0.0.11,0.0.12,15,3,31,35,66,8,FALSE
re-define,0.0.10,0.0.11,14,6,206,95,301,21,FALSE
re-define,0.0.13,0.0.14,17,5,180,49,229,18,FALSE
re-define,0.0.12,0.0.13,16,2,102,69,171,12,FALSE
re-define,0.1.1,0.1.2,32,5,104,67,171,8,FALSE
re-define,0.1.2,0.1.3,33,8,482,326,808,40,FALSE
re-define,0.1.3,0.1.5,34,7,17,10,27,10,FALSE
re-define,0.0.19,0.0.20,25,3,34,12,46,6,FALSE
re-define,0.0.18,0.0.19,24,10,248,1213,1461,38,FALSE
re-define,0.1.6,0.1.7,36,2,9,6,15,3,FALSE
re-define,0.0.5,0.0.6,9,1,100,71,171,12,TRUE
re-define,0.0.4,0.0.5,8,4,73,78,151,14,FALSE
re-define,0.0.7,0.0.8,11,5,164,118,282,25,FALSE
re-define,0.0.6,0.0.7,10,1,10,8,18,3,FALSE
re-define,0.0.3,0.0.4,7,1,13,11,24,8,FALSE
re-define,0.0.9,0.0.10,13,4,234,166,400,34,FALSE
re-define,0.0.8,0.0.9,12,2,22,9,31,7,FALSE
re-define,0.1.5,0.1.6,35,2,3,3,6,3,FALSE
re-define,0.0.20,0.0.21,26,1,14,7,21,3,FALSE
re-define,0.0.21,0.0.22,27,5,126,89,215,29,FALSE
re-define,0.0.22,0.0.23,28,1,14,14,28,14,FALSE
re-define,0.0.23,0.0.24,29,5,188,67,255,20,FALSE
re-define,0.0.24,0.0.25,30,1,1,1,2,1,FALSE
re-define,0.0.25,0.1.1,31,48,3149,3405,6554,314,FALSE
re-define,1.10.18-react,1.10.18-react-2,84,2,2,1,3,2,FALSE
re-define,1.10.8,1.10.9,74,3,45,38,83,5,FALSE
re-define,1.10.9,1.10.10,75,3,2,3,5,3,FALSE
re-define,1.10.6,1.10.7,72,1,1,1,2,1,FALSE
re-define,1.10.7,1.10.8,73,3,36,18,54,11,FALSE
re-define,1.10.4,1.10.5,70,3,286,81,367,35,FALSE
re-define,1.10.5,1.10.6,71,3,2204,82,2286,29,FALSE
re-define,1.10.2,1.10.3,68,7,195,29,224,46,FALSE
re-define,1.10.3,1.10.4,69,1,1,2,3,1,FALSE
re-define,1.10.1,1.10.2,67,7,531,268,799,78,FALSE
re-define,1.10.0-beta,1.10.1,66,7,256,336,592,31,FALSE
re-define,1.14.2,1.14.3,112,2,51,38,89,15,FALSE
re-define,1.14.3,1.14.4,113,2,135,30,165,34,FALSE
re-define,1.14.0,1.14.1,110,3,16,17,33,6,FALSE
re-define,1.14.1,1.14.2,111,3,28,25,53,15,FALSE
re-define,1.14.6,1.14.7,116,3,39,22,61,24,FALSE
re-define,1.14.7,1.14.8,117,2,20,15,35,16,FALSE
re-define,1.10.18-react-2,1.10.18-react-3,85,2,5,7,12,2,FALSE
re-define,0.0.0-alpha,0.0.1-alpha,1,3,13,12,25,13,FALSE
re-define,1.13.1,1.13.2,103,2,149,121,270,13,FALSE
re-define,1.13.0,1.13.1,102,2,3,3,6,3,FALSE
re-define,1.13.3,1.13.4,105,4,245,103,348,29,FALSE
re-define,1.13.2,1.13.3,104,2,108,127,235,9,FALSE
re-define,1.13.5,1.13.6,107,5,108,101,209,15,FALSE
re-define,1.13.4,1.13.5,106,2,159,14,173,19,FALSE
re-define,1.13.7,1.14.0,109,21,1652,1346,2998,179,FALSE
re-define,1.11.3,1.11.4,91,2,101,22,123,10,FALSE
re-define,1.11.2,1.11.3,90,3,4,5,9,3,FALSE
re-define,1.11.1,1.11.2,89,6,18,12968,12986,16,FALSE
re-define,1.11.0,1.11.1,88,6,228,112,340,22,FALSE
re-define,1.11.7,1.11.8,95,4,5,15,20,6,FALSE
re-define,1.11.6,1.11.7,94,9,707,257,964,65,FALSE
re-define,1.11.5,1.11.6,93,3,19,13,32,6,FALSE
re-define,1.11.4,1.11.5,92,2,36,22,58,3,FALSE
re-define,1.11.9,1.11.10,97,5,206,56,262,43,FALSE
re-define,1.11.8,1.11.9,96,2,85,12,97,4,FALSE
re-define,1.11.10,1.11.11,98,5,398,280,678,64,FALSE
re-define,1.13.6,1.13.7,108,6,39,29,68,22,FALSE
re-define,1.8.16,1.8.17,56,2,74,59,133,6,FALSE
re-define,1.8.17,1.9.0,57,32,37577,20290,57867,248,FALSE
re-define,1.8.14,1.8.15,54,2,3,3,6,2,FALSE
re-define,1.8.15,1.8.16,55,3,33,22,55,13,FALSE
re-define,1.8.12,1.8.13,52,2,54,43,97,10,FALSE
re-define,1.8.13,1.8.14,53,2,48,2,50,4,FALSE
re-define,1.8.10,1.8.11,50,1,1,1,2,1,FALSE
re-define,1.8.11,1.8.12,51,3,40,19,59,8,FALSE
re-define,1.9.1,1.9.2,59,3,292,93,385,34,FALSE
re-define,1.9.0,1.9.1,58,2,18414,1182,19596,101,FALSE
re-define,1.9.3,1.9.4,61,2,58,93,151,14,FALSE
re-define,1.9.2,1.9.3,60,2,66,56,122,6,FALSE
re-define,1.9.5,1.9.6,63,4,29,29,58,4,FALSE
re-define,1.9.4,1.9.5,62,2,344,204,548,29,FALSE
re-define,1.9.7,1.10.0-beta,65,1,4,4,8,1,FALSE
re-define,1.9.6,1.9.7,64,5,135,133,268,30,FALSE
re-define,1.10.18,1.11.0,87,18,1642,118,1760,83,FALSE
re-define,1.10.14,1.10.15,80,1,14,14,28,14,FALSE
re-define,1.10.15,1.10.16,81,2,4,4,8,3,FALSE
re-define,1.10.16,1.10.17,82,2,4,5,9,3,FALSE
re-define,1.10.17,1.10.18-react,83,7,1109,48,1157,40,FALSE
re-define,1.10.10,1.10.11,76,2,189,15,204,17,FALSE
re-define,1.10.11,1.10.12,77,4,67,13,80,16,FALSE
re-define,1.10.12,1.10.13,78,1,14,14,28,14,FALSE
re-define,1.10.13,1.10.14,79,4,13197,64,13261,26,FALSE
re-define,1.11.12,1.12.13,100,5,91,95,186,23,FALSE
re-define,1.11.11,1.11.12,99,3,89,93,182,10,FALSE
re-define,0.1.7,1.7.8,37,12,958,1138,2096,101,FALSE
re-define,0.0.5,0.0.6,9,1,100,71,171,12,FALSE
re-define,0.0.1,0.0.2-alpha,3,476,93185,51349,144534,2824,FALSE
re-define,0.0.2,0.0.3-alpha,5,474,93228,51408,144636,2831,FALSE
re-define,1.8.8,1.8.9,48,4,425,437,862,7,FALSE
re-define,1.8.9,1.8.10,49,3,15,194,209,12,FALSE
re-define,1.7.9,1.8.0,39,3,168,77,245,21,FALSE
re-define,1.7.8,1.7.9,38,3,86,62,148,5,FALSE
re-define,1.8.4,1.8.5,44,1,1,1,2,1,FALSE
re-define,1.8.5,1.8.6,45,3,513,296,809,46,FALSE
re-define,1.8.6,1.8.7,46,2,76,124,200,16,FALSE
re-define,1.8.7,1.8.8,47,3,49,22,71,12,FALSE
re-define,1.8.0,1.8.1,40,2,1,6,7,2,FALSE
re-define,1.8.1,1.8.2,41,4,273,186,459,23,FALSE
re-define,1.8.2,1.8.3,42,3,7,5,12,5,FALSE
re-define,1.8.3,1.8.4,43,3,89,76,165,9,FALSE
re-define,1.12.13,1.13.0,101,5,163,193,356,43,FALSE
re-define,1.14.5,1.14.6,115,4,357,76,433,72,FALSE
re-define,1.14.4,1.14.5,114,2,188,42,230,36,FALSE
re-define,0.0.9,0.0.10,13,4,234,166,400,34,TRUE
re-define,1.11.8,1.11.9,96,2,85,12,97,4,TRUE
re-define,1.14.3,1.14.4,113,2,135,30,165,34,TRUE
re-define,1.9.3,1.9.4,61,2,58,93,151,14,TRUE
re-define,0.1.1,0.1.2,32,5,104,67,171,8,TRUE
re-define,1.14.6,1.14.7,116,3,39,22,61,24,TRUE
re-define,1.13.7,1.14.0,109,21,1652,1346,2998,179,TRUE
babel-connect,5.0.0,5.1.0,1,10,56,34,90,14,TRUE
babel-connect,6.0.1,6.0.2,4,1,1,1,2,1,FALSE
babel-connect,6.0.0,6.0.1,3,3,6,6,12,3,FALSE
babel-connect,5.1.0,6.0.0,2,2,2,2,4,2,FALSE
babel-connect,5.0.0,5.1.0,1,10,56,34,90,14,FALSE
vuetable,1.1.1,1.1.2,6,4,3381,2435,5816,28,FALSE
vuetable,1.1.0,1.1.1,5,6,105,26,131,11,FALSE
vuetable,1.1.2,1.2.0,7,15,1657,419,2076,39,TRUE
vuetable,1.0.9,1.0.10,1,8,72,23216,23288,22,FALSE
vuetable,1.5.10,1.5.12,24,4,20,11,31,6,FALSE
vuetable,1.0.12,1.1.0,4,5,758,2186,2944,20,FALSE
vuetable,1.0.10,1.0.11,2,4,687,3,690,8,FALSE
vuetable,1.0.11,1.0.12,3,16,475,85,560,24,FALSE
vuetable,1.4.0,1.4.1,12,11,92,67,159,15,FALSE
vuetable,1.4.1,1.5.0,13,9,169,57,226,14,FALSE
vuetable,1.5.9,1.5.10,23,2,4,6,10,6,FALSE
vuetable,1.5.8,1.5.9,22,2,8,8,16,4,FALSE
vuetable,1.5.5,1.5.6,19,8,103,22,125,13,FALSE
vuetable,1.5.4,1.5.5,18,5,35,25,60,8,FALSE
vuetable,1.5.7,1.5.8,21,6,60,26,86,8,FALSE
vuetable,1.5.6,1.5.7,20,8,115,38,153,14,FALSE
vuetable,1.5.1,1.5.2,15,1,11,4,15,4,FALSE
vuetable,1.5.0,1.5.1,14,2,18,16,34,5,FALSE
vuetable,1.5.3,1.5.4,17,5,12,5,17,5,TRUE
vuetable,1.5.2,1.5.3,16,12,31,31,62,22,FALSE
vuetable,1.3.1,1.4.0,11,4,86,13,99,7,FALSE
vuetable,1.3.0,1.3.1,10,3,16,8,24,7,FALSE
vuetable,1.2.0,1.2.1,8,16,253,107,360,27,FALSE
vuetable,1.2.1,1.3.0,9,16,237,110,347,24,FALSE
vuetable,1.1.2,1.2.0,7,15,1657,419,2076,39,FALSE
vuetable,1.5.10,1.5.12,24,4,20,11,31,6,TRUE
vuetable,1.5.3,1.5.4,17,5,12,5,17,5,FALSE
vuetable,1.2.1,1.3.0,9,16,237,110,347,24,TRUE
vuetable,1.5.9,1.5.10,23,2,4,6,10,6,TRUE
start-files,0.1.0,0.1.1,1,3,6,4,10,3,FALSE
start-files,0.1.1,0.2.0,2,2,17,5,22,5,FALSE
start-files,0.2.0,0.2.1,3,1,3,7,10,2,FALSE
start-files,1.0.0,2.0.0,8,10,2929,123,3052,20,FALSE
start-files,0.2.4,1.0.0,7,8,80,32,112,12,FALSE
start-files,0.2.3,0.2.4,6,3,5,5,10,4,FALSE
start-files,0.2.2,0.2.3,5,6,11,27,38,7,FALSE
start-files,0.2.1,0.2.2,4,5,60,32,92,8,FALSE
start-files,0.2.1,0.2.2,4,5,60,32,92,8,TRUE
frot,0.1.0,0.1.1,1,1,8,7,15,3,FALSE
frot,0.1.1,0.1.2,2,1,91,1,92,2,FALSE
frot,0.1.2,0.1.3,3,2,100,11,111,6,FALSE
frot,0.1.3,0.1.4,4,1,2,2,4,2,FALSE
frot,0.1.4,0.1.5,5,1,2,2,4,2,FALSE
frot,0.1.5,0.1.6,6,1,1,91,92,2,FALSE
frot,0.1.6,0.1.7,7,1,1,1,2,1,FALSE
frot,0.1.7,0.1.8,8,1,91,1,92,2,FALSE
frot,0.1.4,0.1.5,5,1,2,2,4,2,TRUE
gulp-helpers,1.0.6,1.1.0,6,3,45,45,90,10,FALSE
gulp-helpers,3.1.0,3.2.1,96,2,9,11,20,3,FALSE
gulp-helpers,6.1.0,6.2.0,109,1,3,3,6,1,FALSE
gulp-helpers,4.0.0,4.1.0,101,1,36,36,72,20,FALSE
gulp-helpers,1.6.2,1.6.3,53,3,13,6,19,3,FALSE
gulp-helpers,1.6.3,1.6.4,54,3,10,8,18,3,FALSE
gulp-helpers,1.6.0,1.6.1,51,1,10,5,15,2,FALSE
gulp-helpers,1.6.1,1.6.2,52,3,17,13,30,4,FALSE
gulp-helpers,1.6.4,1.7.0,55,4,23,16,39,10,FALSE
gulp-helpers,5.0.0,5.1.0,103,1,3,3,6,1,FALSE
gulp-helpers,1.1.1,1.1.2,8,1,33,1,34,2,FALSE
gulp-helpers,1.1.0,1.1.1,7,1,2,2,4,2,FALSE
gulp-helpers,2.0.17,3.0.0,88,1,9,9,18,1,FALSE
gulp-helpers,1.8.0,1.8.1,63,1,15,5,20,3,FALSE
gulp-helpers,1.7.2,1.7.3,58,1,21,17,38,3,FALSE
gulp-helpers,1.8.2,1.8.3,65,2,14,14,28,2,FALSE
gulp-helpers,1.8.3,1.9.0,66,3,45,7,52,5,FALSE
gulp-helpers,3.0.7,3.1.0,95,1,12,12,24,1,FALSE
gulp-helpers,3.0.4,3.0.5,93,4,38,20,58,4,FALSE
gulp-helpers,3.0.5,3.0.7,94,8,62,56,118,10,FALSE
gulp-helpers,3.0.2,3.0.3,91,1,5,7,12,1,FALSE
gulp-helpers,3.0.3,3.0.4,92,2,32,6,38,4,FALSE
gulp-helpers,3.0.0,3.0.1,89,1,2,1,3,1,FALSE
gulp-helpers,3.0.1,3.0.2,90,1,2,1,3,1,FALSE
gulp-helpers,4.1.0,5.0.0,102,1,1,2,3,1,FALSE
gulp-helpers,1.1.14,1.1.15,21,1,7,1,8,2,FALSE
gulp-helpers,6.2.0,6.3.0,110,2,10,11,21,2,FALSE
gulp-helpers,2.0.7,2.0.8,78,5,25,25,50,7,FALSE
gulp-helpers,2.0.6,2.0.7,77,1,4,1,5,2,FALSE
gulp-helpers,2.0.5,2.0.6,76,1,2,1,3,1,FALSE
gulp-helpers,2.0.4,2.0.5,75,5,29,29,58,7,FALSE
gulp-helpers,2.0.3,2.0.4,74,2,5,5,10,2,FALSE
gulp-helpers,2.0.2,2.0.3,73,2,13,9,22,3,FALSE
gulp-helpers,2.0.1,2.0.2,72,1,19,19,38,1,FALSE
gulp-helpers,2.0.0,2.0.1,71,1,4,1,5,2,FALSE
gulp-helpers,1.1.3,1.1.4,10,4,416,400,816,20,FALSE
gulp-helpers,2.0.9,2.0.10,80,4,9,17,26,4,FALSE
gulp-helpers,2.0.8,2.0.9,79,2,4,4,8,2,FALSE
gulp-helpers,6.0.0,6.0.1,105,2,1,2,3,2,FALSE
gulp-helpers,1.9.1,1.9.2,68,1,26,3,29,3,FALSE
gulp-helpers,1.9.0,1.9.1,67,1,20,6,26,2,FALSE
gulp-helpers,1.9.3,2.0.0,70,3,3,4,7,3,FALSE
gulp-helpers,1.9.2,1.9.3,69,1,1,3,4,2,FALSE
gulp-helpers,1.5.5,1.5.6,48,2,10,3,13,4,FALSE
gulp-helpers,1.5.4,1.5.5,47,3,17,15,32,3,FALSE
gulp-helpers,1.5.7,1.6.0,50,2,63,13,76,3,FALSE
gulp-helpers,1.5.6,1.5.7,49,1,7,7,14,1,FALSE
gulp-helpers,1.5.1,1.5.2,44,1,3,18,21,2,FALSE
gulp-helpers,1.5.0,1.5.1,43,1,1,1,2,1,FALSE
gulp-helpers,1.5.3,1.5.4,46,3,52,17,69,3,FALSE
gulp-helpers,1.5.2,1.5.3,45,1,3,3,6,1,FALSE
gulp-helpers,1.3.3,1.3.4,36,1,3,2,5,3,FALSE
gulp-helpers,1.3.2,1.3.3,35,3,6,5,11,4,FALSE
gulp-helpers,1.3.1,1.3.2,34,1,17,16,33,16,FALSE
gulp-helpers,1.3.0,1.3.1,33,2,173,146,319,20,FALSE
gulp-helpers,1.3.7,1.3.8,40,3,20,9,29,4,FALSE
gulp-helpers,1.3.6,1.3.7,39,1,4,4,8,3,FALSE
gulp-helpers,1.3.5,1.3.6,38,2,67,60,127,16,FALSE
gulp-helpers,1.3.4,1.3.5,37,3,6,5,11,3,FALSE
gulp-helpers,1.3.8,1.4.0,41,1,3,2,5,2,FALSE
gulp-helpers,6.3.0,6.3.1,111,3,3,3,6,3,FALSE
gulp-helpers,6.3.1,6.3.2,112,1,8,4,12,2,FALSE
gulp-helpers,6.3.2,6.4.0,113,5,23,23,46,5,FALSE
gulp-helpers,2.0.16,2.0.17,87,4,39,21,60,6,FALSE
gulp-helpers,6.0.3,6.1.0,108,3,3,3,6,3,TRUE
gulp-helpers,6.0.2,6.0.3,107,2,14,9,23,4,FALSE
gulp-helpers,6.0.1,6.0.2,106,1,7,3,10,2,FALSE
gulp-helpers,1.1.2,1.1.3,9,16,255,69,324,22,FALSE
gulp-helpers,1.1.5,1.1.6,12,3,4,2,6,3,FALSE
gulp-helpers,1.1.4,1.1.5,11,3,41,4,45,4,FALSE
gulp-helpers,1.1.7,1.1.8,14,2,3,3,6,2,FALSE
gulp-helpers,1.1.6,1.1.7,13,2,28,3,31,3,FALSE
gulp-helpers,1.1.9,1.1.10,16,2,2,1,3,2,FALSE
gulp-helpers,1.1.8,1.1.9,15,1,7,7,14,1,FALSE
gulp-helpers,1.7.6,1.8.0,62,6,42,15,57,10,FALSE
gulp-helpers,1.7.5,1.7.6,61,1,2,2,4,2,FALSE
gulp-helpers,1.7.4,1.7.5,60,1,5,4,9,2,FALSE
gulp-helpers,1.7.3,1.7.4,59,1,3,2,5,2,FALSE
gulp-helpers,1.8.1,1.8.2,64,1,41,14,55,6,FALSE
gulp-helpers,1.7.1,1.7.2,57,1,2,1,3,2,FALSE
gulp-helpers,1.7.0,1.7.1,56,1,5,3,8,2,FALSE
gulp-helpers,1.4.0,1.5.0,42,1,8,9,17,2,FALSE
gulp-helpers,1.2.6,1.2.7,29,3,10,9,19,3,FALSE
gulp-helpers,1.2.7,1.2.8,30,1,3,3,6,1,FALSE
gulp-helpers,1.2.4,1.2.5,27,3,3,3,6,3,FALSE
gulp-helpers,1.2.5,1.2.6,28,2,4,5,9,3,FALSE
gulp-helpers,1.2.2,1.2.3,25,4,10,20,30,7,FALSE
gulp-helpers,1.2.3,1.2.4,26,1,3,3,6,3,FALSE
gulp-helpers,1.2.0,1.2.1,23,1,14,3,17,4,FALSE
gulp-helpers,1.2.1,1.2.2,24,2,18,6,24,2,FALSE
gulp-helpers,1.1.13,1.1.14,20,1,1,16,17,2,FALSE
gulp-helpers,1.2.8,1.2.9,31,1,3,3,6,1,FALSE
gulp-helpers,1.2.9,1.3.0,32,1,19,19,38,1,FALSE
gulp-helpers,1.1.12,1.1.13,19,2,16,1,17,3,FALSE
gulp-helpers,1.1.15,1.2.0,22,3,82,7,89,7,FALSE
gulp-helpers,5.1.0,6.0.0,104,1,15,15,30,1,FALSE
gulp-helpers,3.2.4,4.0.0,100,1,19,21,40,1,FALSE
gulp-helpers,3.2.1,3.2.2,97,1,3,5,8,2,FALSE
gulp-helpers,3.2.2,3.2.3,98,6,36,38,74,8,FALSE
gulp-helpers,3.2.3,3.2.4,99,2,60,2,62,4,FALSE
gulp-helpers,1.1.11,1.1.12,18,1,2,1,3,1,FALSE
gulp-helpers,1.1.10,1.1.11,17,2,3,2,5,2,FALSE
gulp-helpers,2.0.15,2.0.16,86,2,56,8,64,4,FALSE
gulp-helpers,2.0.14,2.0.15,85,2,114,28,142,20,FALSE
gulp-helpers,2.0.13,2.0.14,84,2,2,10,12,6,FALSE
gulp-helpers,2.0.12,2.0.13,83,2,3,3,6,2,FALSE
gulp-helpers,2.0.11,2.0.12,82,6,117,25,142,9,FALSE
gulp-helpers,2.0.10,2.0.11,81,3,3,3,6,3,FALSE
gulp-helpers,6.0.3,6.1.0,108,3,3,3,6,3,FALSE
gulp-helpers,2.0.6,2.0.7,77,1,4,1,5,2,TRUE
gulp-helpers,1.6.0,1.6.1,51,1,10,5,15,2,TRUE
gulp-helpers,1.7.6,1.8.0,62,6,42,15,57,10,TRUE
gulp-helpers,1.9.3,2.0.0,70,3,3,4,7,3,TRUE
gulp-helpers,1.4.0,1.5.0,42,1,8,9,17,2,TRUE
gulp-helpers,1.5.7,1.6.0,50,2,63,13,76,3,TRUE
gulp-helpers,1.5.2,1.5.3,45,1,3,3,6,1,TRUE
gulp-helpers,2.0.9,2.0.10,80,4,9,17,26,4,TRUE
gulp-helpers,1.9.0,1.9.1,67,1,20,6,26,2,TRUE
gulp-helpers,1.8.2,1.8.3,65,2,14,14,28,2,TRUE
gulp-helpers,2.0.11,2.0.12,82,6,117,25,142,9,TRUE
gulp-helpers,3.0.3,3.0.4,92,2,32,6,38,4,TRUE
gulp-helpers,6.3.0,6.3.1,111,3,3,3,6,3,TRUE
gulp-helpers,1.3.7,1.3.8,40,3,20,9,29,4,TRUE
gulp-helpers,1.3.6,1.3.7,39,1,4,4,8,3,TRUE
gulp-helpers,1.0.5,1.0.6,5,21,502,30,532,43,FALSE
gulp-helpers,1.0.1,1.0.2,2,1,3,1,4,2,FALSE
gulp-helpers,1.0.2,1.0.3,3,1,5,22,27,2,FALSE
gulp-helpers,1.0.3,1.0.5,4,3,21,17,38,4,FALSE
gulp-helpers,5.0.0,5.1.0,103,1,3,3,6,1,TRUE
gulp-helpers,3.0.5,3.0.7,94,8,62,56,118,10,TRUE
gulp-helpers,2.0.3,2.0.4,74,2,5,5,10,2,TRUE
gulp-helpers,1.5.6,1.5.7,49,1,7,7,14,1,TRUE
gulp-helpers,1.3.4,1.3.5,37,3,6,5,11,3,TRUE
gulp-helpers,1.1.2,1.1.3,9,16,255,69,324,22,TRUE
gulp-helpers,1.1.10,1.1.11,17,2,3,2,5,2,TRUE
gulp-helpers,6.2.0,6.3.0,110,2,10,11,21,2,TRUE
gulp-helpers,2.0.8,2.0.9,79,2,4,4,8,2,TRUE
gulp-helpers,1.1.15,1.2.0,22,3,82,7,89,7,TRUE
gulp-helpers,1.1.5,1.1.6,12,3,4,2,6,3,TRUE
gulp-helpers,1.1.6,1.1.7,13,2,28,3,31,3,TRUE
gulp-helpers,1.2.4,1.2.5,27,3,3,3,6,3,TRUE
gulp-helpers,3.1.0,3.2.1,96,2,9,11,20,3,TRUE
gulp-helpers,1.3.8,1.4.0,41,1,3,2,5,2,TRUE
gulp-helpers,1.6.3,1.6.4,54,3,10,8,18,3,TRUE
gulp-helpers,1.2.1,1.2.2,24,2,18,6,24,2,TRUE
gulp-helpers,1.2.6,1.2.7,29,3,10,9,19,3,TRUE
gulp-helpers,1.6.2,1.6.3,53,3,13,6,19,3,TRUE
gulp-helpers,2.0.2,2.0.3,73,2,13,9,22,3,TRUE
gulp-helpers,2.0.15,2.0.16,86,2,56,8,64,4,TRUE
gulp-helpers,1.1.4,1.1.5,11,3,41,4,45,4,TRUE
gulp-helpers,1.1.7,1.1.8,14,2,3,3,6,2,TRUE
gulp-helpers,1.1.9,1.1.10,16,2,2,1,3,2,TRUE
gulp-helpers,2.0.1,2.0.2,72,1,19,19,38,1,TRUE
gulp-helpers,1.5.5,1.5.6,48,2,10,3,13,4,TRUE
gulp-helpers,1.3.1,1.3.2,34,1,17,16,33,16,TRUE
gulp-helpers,3.2.2,3.2.3,98,6,36,38,74,8,TRUE
onedrive-api,0.0.5,0.0.6,5,4,6,6,12,4,FALSE
onedrive-api,0.0.4,0.0.5,4,4,24,15,39,4,FALSE
onedrive-api,0.0.7,0.0.8,7,7,232,26,258,19,FALSE
onedrive-api,0.0.6,0.0.7,6,2,6,5,11,3,FALSE
onedrive-api,0.0.1,0.0.2,1,6,306,14,320,9,FALSE
onedrive-api,0.0.3,0.0.4,3,6,211,82,293,15,FALSE
onedrive-api,0.0.2,0.0.3,2,2,21,7,28,4,FALSE
onedrive-api,0.0.8,0.0.9,8,3,4,4,8,4,FALSE
onedrive-api,0.0.3,0.0.4,3,6,211,82,293,15,TRUE
ez-react,0.1.0,0.1.1,1,2,99,39,138,5,FALSE
ez-react,0.1.1,0.1.2,2,2,3,3,6,3,FALSE
ez-react,0.1.2,0.2.0,3,4,33,7,40,7,FALSE
ez-react,0.4.0,0.5.0,10,3,217,246,463,8,FALSE
ez-react,0.3.1,0.3.2,6,2,6,6,12,5,FALSE
ez-react,0.6.2,0.6.3,14,2,4,4,8,2,FALSE
ez-react,0.3.3,0.3.4,8,7,4942,443,5385,18,FALSE
ez-react,0.3.0,0.3.1,5,2,22,18,40,3,FALSE
ez-react,0.6.0,0.6.1,12,3,52,21,73,5,FALSE
ez-react,0.3.2,0.3.3,7,2,4,3,7,3,FALSE
ez-react,0.2.0,0.3.0,4,2,29,18,47,7,FALSE
ez-react,0.5.0,0.6.0,11,10,105,68,173,14,FALSE
ez-react,0.6.1,0.6.2,13,2,2,2,4,2,FALSE
ez-react,0.3.2,0.3.3,7,2,4,3,7,3,TRUE
ez-react,0.3.3,0.3.4,8,7,4942,443,5385,18,TRUE
ez-react,0.4.0,0.5.0,10,3,217,246,463,8,TRUE
redux-dialog,0.0.1,0.0.2,1,1,453,3,456,4,FALSE
redux-dialog,0.0.3,0.0.4,3,4,3976,388,4364,18,FALSE
redux-dialog,0.0.2,0.0.3,2,2,33,10,43,4,FALSE
redux-dialog,0.0.5,0.0.6,5,3,17,8,25,5,FALSE
redux-dialog,0.0.4,0.0.5,4,3,101,15,116,4,FALSE
redux-dialog,0.0.7,0.0.8,7,14,185,193,378,32,FALSE
redux-dialog,0.0.6,0.0.7,6,2,2,4,6,2,FALSE
redux-dialog,0.0.8,0.0.9,8,1,4410,1191,5601,5,FALSE
redux-dialog,0.0.1,0.0.2,1,1,453,3,456,4,TRUE
redux-dialog,0.0.7,0.0.8,7,14,185,193,378,32,TRUE
webrx-react,0.5.27,0.5.28,34,9,264,266,530,87,FALSE
webrx-react,0.5.21,0.5.22,28,4,64,26,90,8,FALSE
webrx-react,0.7.2,0.8.0,50,11,715,309,1024,23,TRUE
webrx-react,0.5.16,0.5.17,23,7,589,429,1018,17,FALSE
webrx-react,0.6.5,0.7.0,47,17,211,64,275,26,FALSE
webrx-react,0.5.18,0.5.19,25,11,676,540,1216,50,FALSE
webrx-react,0.5.19,0.5.20,26,7,70,30,100,17,FALSE
webrx-react,0.5.30,0.5.31,37,1,18,14,32,3,FALSE
webrx-react,0.5.17,0.5.18,24,5,24,22,46,10,FALSE
webrx-react,0.5.14,0.5.15,21,3,55,27,82,3,FALSE
webrx-react,0.5.15,0.5.16,22,37,1285,546,1831,79,FALSE
webrx-react,0.5.12,0.5.13,19,2,9,5,14,3,FALSE
webrx-react,0.5.13,0.5.14,20,2,19,1,20,2,FALSE
webrx-react,0.5.10,0.5.11,17,3,17,44,61,4,FALSE
webrx-react,0.5.11,0.5.12,18,2,16,1,17,3,FALSE
webrx-react,0.10.1,0.10.2,55,5,50,56,106,7,FALSE
webrx-react,0.10.0,0.10.1,54,6,53,14,67,9,FALSE
webrx-react,0.3.8,0.3.9,4,12,178,156,334,24,FALSE
webrx-react,0.3.9,0.4.0,5,8,66,30,96,9,FALSE
webrx-react,0.10.5,0.10.6,59,8,119,17,136,23,FALSE
webrx-react,0.10.4,0.10.5,58,8,80,14,94,15,TRUE
webrx-react,0.10.7,0.10.8,61,22,621,1341,1962,135,FALSE
webrx-react,0.10.6,0.10.7,60,12,281,239,520,35,FALSE
webrx-react,0.11.4,0.11.5,66,3,4,4,8,4,FALSE
webrx-react,0.10.8,0.11.0,62,9,4319,4333,8652,338,FALSE
webrx-react,0.6.1,0.6.2,43,17,384,130,514,35,FALSE
webrx-react,0.6.0,0.6.1,42,1,3,3,6,2,FALSE
webrx-react,0.11.0,0.11.1,63,19,333,253,586,100,FALSE
webrx-react,0.11.1,0.11.3,64,10,99,39,138,16,FALSE
webrx-react,0.7.0,0.7.1,48,1,3,7,10,2,FALSE
webrx-react,0.11.3,0.11.4,65,24,976,478,1454,162,FALSE
webrx-react,0.5.31,0.5.32,38,28,1999,659,2658,78,FALSE
webrx-react,0.12.2,0.12.3,71,4,25,3,28,6,FALSE
webrx-react,0.12.1,0.12.2,70,4,8,4,12,6,FALSE
webrx-react,0.12.0,0.12.1,69,75,2076,1791,3867,394,FALSE
webrx-react,0.5.8,0.5.9,15,2,3,3,6,2,FALSE
webrx-react,0.5.9,0.5.10,16,6,25,23,48,7,FALSE
webrx-react,0.12.4,0.12.5,73,2,3,3,6,3,FALSE
webrx-react,0.5.4,0.5.5,11,5,11,11,22,5,FALSE
webrx-react,0.5.5,0.5.6,12,6,124,86,210,8,FALSE
webrx-react,0.5.6,0.5.7,13,2,8,4,12,2,FALSE
webrx-react,0.5.7,0.5.8,14,3,23,8,31,5,FALSE
webrx-react,0.5.0,0.5.1,7,10,2009,1322,3331,17,FALSE
webrx-react,0.5.1,0.5.2,8,1,15,5,20,2,FALSE
webrx-react,0.5.2,0.5.3,9,2,7,3,10,2,FALSE
webrx-react,0.5.3,0.5.4,10,10,348,104,452,18,FALSE
webrx-react,0.9.0,0.10.0,53,49,4179,3360,7539,261,FALSE
webrx-react,0.5.26,0.5.27,33,8,291,144,435,26,FALSE
webrx-react,0.5.25,0.5.26,32,7,296,240,536,18,FALSE
webrx-react,0.5.24,0.5.25,31,9,262,166,428,27,FALSE
webrx-react,0.5.23,0.5.24,30,5,90,26,116,8,FALSE
webrx-react,0.5.22,0.5.23,29,1,3,3,6,2,FALSE
webrx-react,0.5.35,0.6.0,41,20,508,300,808,40,FALSE
webrx-react,0.5.20,0.5.21,27,4,12,14,26,7,FALSE
webrx-react,0.8.1,0.9.0,52,6,129,105,234,17,FALSE
webrx-react,0.10.3,0.10.4,57,18,397,85,482,46,FALSE
webrx-react,0.5.29,0.5.30,36,1,3,3,6,2,FALSE
webrx-react,0.8.0,0.8.1,51,38,1704,1080,2784,172,FALSE
webrx-react,0.10.2,0.10.3,56,5,28,10,38,6,FALSE
webrx-react,0.12.3,0.12.4,72,9,507,11,518,15,FALSE
webrx-react,0.4.0,0.5.0,6,45,1239,1169,2408,155,FALSE
webrx-react,0.5.28,0.5.29,35,12,282,142,424,34,FALSE
webrx-react,0.6.2,0.6.3,44,6,19,4,23,6,FALSE
webrx-react,0.5.32,0.5.33,39,7,266,94,360,11,FALSE
webrx-react,0.5.33,0.5.35,40,15,320,298,618,33,FALSE
webrx-react,0.6.4,0.6.5,46,1,4,3,7,2,FALSE
webrx-react,0.11.5,0.11.6,67,11,223,209,432,46,FALSE
webrx-react,0.6.3,0.6.4,45,1,6,1,7,2,FALSE
webrx-react,0.7.1,0.7.2,49,13,368,60,428,30,FALSE
webrx-react,0.10.4,0.10.5,58,8,80,14,94,15,FALSE
webrx-react,0.7.2,0.8.0,50,11,715,309,1024,23,FALSE
webrx-react,0.10.1,0.10.2,55,5,50,56,106,7,TRUE
webrx-react,0.3.6,0.3.7,2,5,132,17,149,6,FALSE
webrx-react,0.3.7,0.3.8,3,24,9483,9482,18965,179,FALSE
webrx-react,0.5.26,0.5.27,33,8,291,144,435,26,TRUE
webrx-react,0.3.5,0.3.6,1,1,1,1,2,1,FALSE
webrx-react,0.6.5,0.7.0,47,17,211,64,275,26,TRUE
webrx-react,0.5.9,0.5.10,16,6,25,23,48,7,TRUE
webrx-react,0.10.5,0.10.6,59,8,119,17,136,23,TRUE
webrx-react,0.6.0,0.6.1,42,1,3,3,6,2,TRUE
webrx-react,0.5.27,0.5.28,34,9,264,266,530,87,TRUE
webrx-react,0.3.7,0.3.8,3,24,9483,9482,18965,179,TRUE
webrx-react,0.5.16,0.5.17,23,7,589,429,1018,17,TRUE
webrx-react,0.5.18,0.5.19,25,11,676,540,1216,50,TRUE
webrx-react,0.5.14,0.5.15,21,3,55,27,82,3,TRUE
webrx-react,0.5.15,0.5.16,22,37,1285,546,1831,79,TRUE
webrx-react,0.5.12,0.5.13,19,2,9,5,14,3,TRUE
webrx-react,0.5.11,0.5.12,18,2,16,1,17,3,TRUE
webrx-react,0.10.0,0.10.1,54,6,53,14,67,9,TRUE
webrx-react,0.3.8,0.3.9,4,12,178,156,334,24,TRUE
webrx-react,0.10.6,0.10.7,60,12,281,239,520,35,TRUE
webrx-react,0.5.35,0.6.0,41,20,508,300,808,40,TRUE
webrx-react,0.7.0,0.7.1,48,1,3,7,10,2,TRUE
webrx-react,0.5.31,0.5.32,38,28,1999,659,2658,78,TRUE
webrx-react,0.5.5,0.5.6,12,6,124,86,210,8,TRUE
webrx-react,0.5.0,0.5.1,7,10,2009,1322,3331,17,TRUE
webrx-react,0.5.3,0.5.4,10,10,348,104,452,18,TRUE
webrx-react,0.9.0,0.10.0,53,49,4179,3360,7539,261,TRUE
webrx-react,0.5.25,0.5.26,32,7,296,240,536,18,TRUE
webrx-react,0.5.23,0.5.24,30,5,90,26,116,8,TRUE
webrx-react,0.8.1,0.9.0,52,6,129,105,234,17,TRUE
webrx-react,0.8.0,0.8.1,51,38,1704,1080,2784,172,TRUE
webrx-react,0.4.0,0.5.0,6,45,1239,1169,2408,155,TRUE
webrx-react,0.5.28,0.5.29,35,12,282,142,424,34,TRUE
webrx-react,0.6.2,0.6.3,44,6,19,4,23,6,TRUE
webrx-react,0.5.32,0.5.33,39,7,266,94,360,11,TRUE
webrx-react,0.5.33,0.5.35,40,15,320,298,618,33,TRUE
webrx-react,0.6.1,0.6.2,43,17,384,130,514,35,TRUE
webrx-react,0.7.1,0.7.2,49,13,368,60,428,30,TRUE
webrx-react,0.12.2,0.12.3,71,4,25,3,28,6,TRUE
webrx-react,0.12.0,0.12.1,69,75,2076,1791,3867,394,TRUE
webrx-react,0.5.4,0.5.5,11,5,11,11,22,5,TRUE
webrx-react,0.11.3,0.11.4,65,24,976,478,1454,162,TRUE
webrx-react,0.10.2,0.10.3,56,5,28,10,38,6,TRUE
webrx-react,0.12.3,0.12.4,72,9,507,11,518,15,TRUE
webrx-react,0.11.4,0.11.5,66,3,4,4,8,4,TRUE
webrx-react,0.11.5,0.11.6,67,11,223,209,432,46,TRUE
webrx-react,0.5.24,0.5.25,31,9,262,166,428,27,TRUE
webrx-react,0.5.2,0.5.3,9,2,7,3,10,2,TRUE
vainglory,1.1.0,1.2.0-beta,40,3,181,4,185,7,FALSE
vainglory,1.0.0,1.0.1,37,5,58,24,82,6,FALSE
vainglory,1.0.1,1.0.2,38,4,199,6,205,8,FALSE
vainglory,1.0.2,1.1.0,39,3,183,9,192,9,FALSE
vainglory,0.6.2,0.7.0,19,2,77,16,93,6,FALSE
vainglory,0.6.1,0.6.2,18,2,51,46,97,8,FALSE
vainglory,0.6.0,0.6.1,17,4,45,1106,1151,14,FALSE
vainglory,0.7.2,0.7.3,22,2,3,4,7,2,FALSE
vainglory,0.7.3,0.7.4,23,3,30,258,288,7,FALSE
vainglory,0.7.0,0.7.1,20,4,758,312,1070,14,FALSE
vainglory,0.7.1,0.7.2,21,2,1207,12,1219,13,FALSE
vainglory,0.9.0,0.9.1,27,2,4,5,9,3,FALSE
vainglory,0.9.1,0.9.2,28,2,153,33,186,10,FALSE
vainglory,0.9.2,0.9.3,29,3,8,8,16,3,FALSE
vainglory,0.9.3,0.9.4,30,2,1,2,3,2,FALSE
vainglory,0.9.4,0.9.5,31,4,37,20,57,4,FALSE
vainglory,0.9.5,0.9.6,32,7,117,50,167,15,FALSE
vainglory,0.9.6,0.9.7,33,1,1,1,2,1,FALSE
vainglory,0.9.7,0.9.8,34,5,167,60,227,24,TRUE
vainglory,0.9.8,0.9.9,35,3,217,74,291,10,FALSE
vainglory,0.9.9,1.0.0,36,1,190,8,198,14,FALSE
vainglory,0.8.1,0.9.0,26,5,8890,4518,13408,37,FALSE
vainglory,0.8.0,0.8.1,25,2,22,4,26,4,FALSE
vainglory,0.7.4,0.8.0,24,2,491,877,1368,27,FALSE
vainglory,0.3.1,0.3.2,13,5,156606,48,156654,12,FALSE
vainglory,0.0.10,0.1.0,9,5,250,264,514,18,FALSE
vainglory,0.2.0,0.3.0,11,3,260,54,314,21,FALSE
vainglory,0.1.0,0.2.0,10,2,111,84,195,8,FALSE
vainglory,0.0.5,0.0.6,4,2,320,18,338,5,FALSE
vainglory,0.0.4,0.0.5,3,1,3,8,11,4,FALSE
vainglory,0.0.7,0.0.8,6,1,3,0,3,1,FALSE
vainglory,0.0.6,0.0.7,5,1,9,8,17,3,FALSE
vainglory,0.0.2,0.0.4,2,4,50,16,66,6,FALSE
vainglory,0.3.2,0.4.0,14,2,543,77597,78140,22,FALSE
vainglory,0.3.0,0.3.1,12,2,4,5,9,2,FALSE
vainglory,0.0.9,0.0.10,8,2,46,188,234,8,FALSE
vainglory,0.0.8,0.0.9,7,2,337,11,348,12,FALSE
vainglory,0.4.0,0.5.0,15,2,602,91,693,17,FALSE
vainglory,0.5.0,0.6.0,16,2,3676,79522,83198,46,FALSE
vainglory,0.9.7,0.9.8,34,5,167,60,227,24,FALSE
vainglory,0.0.8,0.0.9,7,2,337,11,348,12,TRUE
vainglory,0.3.2,0.4.0,14,2,543,77597,78140,22,TRUE
eslint-config-laosdirg,0.0.5,0.0.6,5,2,6,1,7,2,FALSE
eslint-config-laosdirg,0.0.4,0.0.5,4,3,352,6,358,17,FALSE
eslint-config-laosdirg,0.0.7,0.0.8,7,1,1,1,2,1,FALSE
eslint-config-laosdirg,0.0.6,0.0.7,6,2,2,2,4,2,FALSE
eslint-config-laosdirg,0.0.3,0.0.4,3,2,5,6,11,3,FALSE
eslint-config-laosdirg,0.0.2,0.0.3,2,5,220,4,224,7,FALSE
eslint-config-laosdirg,0.0.9,0.0.10,9,2,2,2,4,2,FALSE
eslint-config-laosdirg,0.0.8,0.0.9,8,3,3,3,6,3,FALSE
eslint-config-laosdirg,0.0.1,0.0.2,1,5,788,158,946,13,FALSE
eslint-config-laosdirg,0.0.3,0.0.4,3,2,5,6,11,3,TRUE
react-typo-component,0.0.5,0.0.6,5,6,375,247,622,18,FALSE
react-typo-component,0.0.4,0.0.5,4,1,21,271,292,7,FALSE
react-typo-component,0.0.1,0.0.2,1,1,3,3,6,2,FALSE
react-typo-component,0.0.3,0.0.4,3,1,62,37,99,8,FALSE
react-typo-component,0.0.2,0.0.3,2,4,307,90,397,13,FALSE
react-typo-component,0.0.2,0.0.3,2,4,307,90,397,13,TRUE
quadrigacx,0.0.5,0.0.6,3,1,16,11,27,2,TRUE
quadrigacx,0.0.4,0.0.5,2,1,1,3,4,2,FALSE
quadrigacx,0.0.6,0.0.7,4,1,2,2,4,2,FALSE
quadrigacx,0.0.3,0.0.4,1,2,2,2,4,2,TRUE
teamleader-ui,0.0.5-alpha,0.0.6-alpha,5,47,1977,788,2765,106,FALSE
teamleader-ui,0.0.17-alpha,0.0.18-alpha,17,2,3,1,4,2,FALSE
teamleader-ui,0.0.16-alpha,0.0.17-alpha,16,2,2,6,8,2,FALSE
teamleader-ui,0.0.11-alpha,0.0.12-alpha,11,5,146,195,341,10,FALSE
teamleader-ui,0.0.4-alpha,0.0.5-alpha,4,22,113,264,377,37,FALSE
teamleader-ui,0.0.6-alpha,0.0.7-alpha,6,7,536,149,685,31,FALSE
teamleader-ui,0.0.10-alpha,0.0.11-alpha,10,3,5,2,7,3,FALSE
teamleader-ui,0.0.1-alpha,0.0.2-alpha,1,3,5,5,10,3,FALSE
teamleader-ui,0.0.7-alpha,0.0.8-alpha,7,3,4,2,6,3,FALSE
teamleader-ui,0.0.8-alpha,0.0.9-alpha,8,33,2097,816,2913,76,TRUE
teamleader-ui,0.0.18-alpha,0.0.19-alpha,18,5,34,19,53,17,FALSE
teamleader-ui,0.0.9-alpha,0.0.10-alpha,9,5,198,275,473,20,TRUE
teamleader-ui,0.0.2-alpha,0.0.3-alpha,2,2,6,1,7,2,FALSE
teamleader-ui,0.0.14-alpha,0.0.15-alpha,14,4,62,46,108,5,FALSE
teamleader-ui,0.0.12-alpha,0.0.13-alpha,12,3,4,3,7,3,FALSE
teamleader-ui,0.0.3-alpha,0.0.4-alpha,3,7,26,12,38,8,FALSE
teamleader-ui,0.0.15-alpha,0.0.16-alpha,15,2,8,2,10,2,FALSE
teamleader-ui,0.0.13-alpha,0.0.14-alpha,13,2,29,27,56,2,FALSE
teamleader-ui,0.0.8-alpha,0.0.9-alpha,8,33,2097,816,2913,76,FALSE
teamleader-ui,0.0.9-alpha,0.0.10-alpha,9,5,198,275,473,20,FALSE
teamleader-ui,0.0.3-alpha,0.0.4-alpha,3,7,26,12,38,8,TRUE
teamleader-ui,0.0.18-alpha,0.0.19-alpha,18,5,34,19,53,17,TRUE
teamleader-ui,0.0.4-alpha,0.0.5-alpha,4,22,113,264,377,37,TRUE
teamleader-ui,0.0.5-alpha,0.0.6-alpha,5,47,1977,788,2765,106,TRUE
direction,0.0.1,0.0.2,1,5,23,24,47,6,TRUE
direction,0.0.3,0.1.0,3,6,51,1146,1197,11,FALSE
direction,0.0.2,0.0.3,2,4,1163,4,1167,6,TRUE
direction,0.1.0,0.1.1,4,9,92,72,164,13,FALSE
direction,0.1.1,0.1.2,5,13,241,193,434,22,FALSE
direction,0.1.2,0.1.3,6,9,179,45,224,17,FALSE
direction,0.1.3,0.1.4,7,3,11,4,15,5,FALSE
direction,0.1.4,0.1.5,8,8,176,75,251,16,FALSE
direction,0.0.1,0.0.2,1,5,23,24,47,6,FALSE
direction,0.0.3,0.1.0,3,6,51,1146,1197,11,TRUE
direction,0.0.2,0.0.3,2,4,1163,4,1167,6,FALSE
direction,0.1.0,0.1.1,4,9,92,72,164,13,TRUE
corbel-js,0.3.1,0.3.2,40,10,3206,826,4032,66,FALSE
corbel-js,0.2.20,0.2.21,37,17,467,560,1027,59,FALSE
corbel-js,0.0.9,0.0.10,7,16,6731,5776,12507,150,FALSE
corbel-js,0.0.12,0.0.14,10,43,3372,1511,4883,164,FALSE
corbel-js,0.0.8,0.0.9,6,1,1,1,2,1,TRUE
corbel-js,0.0.15,0.0.16,12,1,1,1,2,1,FALSE
corbel-js,0.0.14,0.0.15,11,1,1,1,2,1,FALSE
corbel-js,0.2.5,0.2.6,22,4,357,126,483,13,FALSE
corbel-js,0.2.4,0.2.5,21,1,2,2,4,2,FALSE
corbel-js,0.2.3,0.2.4,20,1,1,1,2,1,FALSE
corbel-js,0.0.10,0.0.11,8,1,2,2,4,2,FALSE
corbel-js,0.2.1,0.2.2,18,1,1,1,2,1,FALSE
corbel-js,0.2.0,0.2.1,17,1,1,1,2,1,FALSE
corbel-js,0.1.0,0.1.1,14,1,1,1,2,1,FALSE
corbel-js,0.1.1,0.1.2,15,1,1,1,2,1,FALSE
corbel-js,0.1.2,0.2.0,16,1,1,1,2,1,FALSE
corbel-js,0.2.9,0.2.10,26,1,1,1,2,1,FALSE
corbel-js,0.2.8,0.2.9,25,10,2555,368,2923,98,FALSE
corbel-js,0.0.5,0.0.6,3,5,697,47,744,23,FALSE
corbel-js,0.0.7,0.0.8,5,5,2487,672,3159,30,FALSE
corbel-js,0.3.9,0.3.10,47,12,1650,749,2399,43,FALSE
corbel-js,0.0.1,0.0.2,1,2,53,42,95,4,FALSE
corbel-js,0.0.2,0.0.5,2,7,27,14,41,14,FALSE
corbel-js,0.3.2,0.3.3,41,27,1218,564,1782,101,FALSE
corbel-js,0.3.3,0.3.4,42,18,1962,853,2815,112,FALSE
corbel-js,0.3.0,0.3.1,39,10,179,203,382,24,FALSE
corbel-js,0.6.0,0.6.1,51,5,31,25,56,11,FALSE
corbel-js,0.3.6,0.3.7,44,5,167,111,278,14,FALSE
corbel-js,0.3.7,0.3.8,45,31,4899,3915,8814,108,FALSE
corbel-js,0.6.5,0.6.6,56,4,30,30,60,10,FALSE
corbel-js,0.6.4,0.6.5,55,13,415,147,562,54,FALSE
corbel-js,0.3.8,0.3.9,46,17,3015,363,3378,43,FALSE
corbel-js,0.4.0,0.5.0,49,33,3643,3031,6674,175,FALSE
corbel-js,0.3.4,0.3.6,43,33,2302,1036,3338,129,FALSE
corbel-js,0.3.10,0.4.0,48,22,722,445,1167,72,FALSE
corbel-js,0.2.19,0.2.20,36,9,336,46,382,30,FALSE
corbel-js,0.2.18,0.2.19,35,19,3741,847,4588,95,FALSE
corbel-js,0.2.17,0.2.18,34,23,4804,2806,7610,103,FALSE
corbel-js,0.2.16,0.2.17,33,1,2,2,4,2,FALSE
corbel-js,0.2.15,0.2.16,32,9,858,667,1525,32,FALSE
corbel-js,0.2.14,0.2.15,31,4,24,5,29,8,FALSE
corbel-js,0.2.13,0.2.14,30,3,16,4,20,4,FALSE
corbel-js,0.2.12,0.2.13,29,2,19,19,38,11,FALSE
corbel-js,0.2.11,0.2.12,28,1,4,4,8,4,FALSE
corbel-js,0.2.10,0.2.11,27,1,1,1,2,1,FALSE
corbel-js,0.0.6,0.0.7,4,1,14,200,214,4,FALSE
corbel-js,0.2.7,0.2.8,24,2,5,5,10,5,FALSE
corbel-js,0.2.6,0.2.7,23,10,549,285,834,29,FALSE
corbel-js,0.5.0,0.6.0,50,24,838,266,1104,81,FALSE
corbel-js,0.6.3,0.6.4,54,4,143,11,154,11,FALSE
corbel-js,0.0.16,0.1.0,13,1,1,1,2,1,FALSE
corbel-js,0.6.2,0.6.3,53,3,5,5,10,3,FALSE
corbel-js,0.0.11,0.0.12,9,3,395,78,473,23,FALSE
corbel-js,0.6.1,0.6.2,52,5,68,12,80,12,FALSE
corbel-js,0.2.2,0.2.3,19,1,1,1,2,1,FALSE
corbel-js,0.0.8,0.0.9,6,1,1,1,2,1,FALSE
corbel-js,0.2.9,0.2.10,26,1,1,1,2,1,TRUE
corbel-js,0.0.7,0.0.8,5,5,2487,672,3159,30,TRUE
corbel-js,0.0.11,0.0.12,9,3,395,78,473,23,TRUE
corbel-js,0.0.2,0.0.5,2,7,27,14,41,14,TRUE
corbel-js,0.0.6,0.0.7,4,1,14,200,214,4,TRUE
corbel-js,0.6.0,0.6.1,51,5,31,25,56,11,TRUE
corbel-js,0.3.8,0.3.9,46,17,3015,363,3378,43,TRUE
corbel-js,0.3.7,0.3.8,45,31,4899,3915,8814,108,TRUE
corbel-js,0.3.9,0.3.10,47,12,1650,749,2399,43,TRUE
redux-form-input-toggle,1.0.1,1.0.2,1,1,42,21,63,3,FALSE
redux-form-input-toggle,1.0.2,1.0.3,2,1,42,21,63,3,FALSE
redux-form-input-toggle,1.0.3,1.0.4,3,1,42,21,63,3,FALSE
redux-form-input-toggle,1.1.1,1.1.3,9,1,42,21,63,3,FALSE
redux-form-input-toggle,1.0.6,1.0.7,5,1,42,21,63,3,FALSE
redux-form-input-toggle,1.0.7,1.0.8,6,1,42,21,63,3,FALSE
redux-form-input-toggle,1.1.4,1.1.5,11,1,42,21,63,3,FALSE
redux-form-input-toggle,1.0.8,1.0.9,7,1,42,21,63,3,FALSE
redux-form-input-toggle,1.0.9,1.1.1,8,1,42,21,63,3,FALSE
redux-form-input-toggle,1.1.3,1.1.4,10,1,35498,0,35498,30,FALSE
redux-form-input-toggle,1.1.3,1.1.4,10,1,35498,0,35498,30,TRUE
react-player,0.6.0,0.7.0,32,5,69,109,178,12,FALSE
react-player,0.7.4,0.7.5,37,7,45,20,65,11,FALSE
react-player,0.7.5,0.8.0,38,4,47,46,93,11,FALSE
react-player,0.7.2,0.7.3,35,2,12,5,17,5,FALSE
react-player,0.7.3,0.7.4,36,2,10,3,13,5,FALSE
react-player,0.7.0,0.7.1,33,8,28,23,51,11,FALSE
react-player,0.8.0,0.9.0,39,5,35,16,51,14,FALSE
react-player,0.5.8,0.6.0,31,10,158,106,264,40,FALSE
react-player,0.5.5,0.5.6,28,6,29,8,37,11,FALSE
react-player,0.5.6,0.5.7,29,13,52,25,77,21,FALSE
react-player,0.7.1,0.7.2,34,6,52,20,72,9,FALSE
react-player,0.5.7,0.5.8,30,10,123,153,276,22,FALSE
react-player,0.15.0,0.16.0,50,13,480,144,624,39,FALSE
react-player,0.17.2,0.18.0,54,3,80,30,110,10,FALSE
react-player,0.17.0,0.17.1,52,3,11,4,15,5,FALSE
react-player,0.17.1,0.17.2,53,2,14,6,20,6,FALSE
react-player,0.16.0,0.17.0,51,4,66,21,87,9,FALSE
react-player,0.9.0,0.10.0,40,27,207,104,311,47,FALSE
react-player,0.3.6,0.3.7,18,6,37,19,56,11,FALSE
react-player,0.3.7,0.4.0,19,14,1225,259,1484,60,FALSE
react-player,0.2.1,0.3.0,11,9,376,248,624,45,FALSE
react-player,0.2.0,0.2.1,10,6,35,22,57,16,FALSE
react-player,0.10.0,0.11.0,41,2,17,6,23,8,FALSE
react-player,0.3.2,0.3.3,14,2,14,8,22,3,FALSE
react-player,0.3.3,0.3.4,15,3,13,5,18,4,FALSE
react-player,0.11.0,0.12.0,42,15,289,199,488,36,FALSE
react-player,0.3.4,0.3.5,16,6,53,17,70,9,FALSE
react-player,0.3.5,0.3.6,17,2,8,1,9,3,FALSE
react-player,0.12.1,0.13.0,44,14,135,27,162,33,FALSE
react-player,0.12.0,0.12.1,43,3,18,3,21,7,FALSE
react-player,0.5.4,0.5.5,27,8,178,72,250,24,FALSE
react-player,0.5.0,0.5.1,23,5,71,21,92,7,FALSE
react-player,0.5.1,0.5.2,24,4,29,11,40,5,FALSE
react-player,0.13.0,0.14.0,45,5,5308,42,5350,16,FALSE
react-player,0.5.3,0.5.4,26,7,40,17,57,11,FALSE
react-player,0.14.1,0.14.2,47,5,48,32,80,9,TRUE
react-player,0.14.0,0.14.1,46,2,10,4,14,5,FALSE
react-player,0.14.3,0.15.0,49,11,1629,1363,2992,27,FALSE
react-player,0.14.2,0.14.3,48,13,418,200,618,25,FALSE
react-player,0.4.1,0.4.2,21,4,44,57,101,12,FALSE
react-player,0.4.0,0.4.1,20,4,29,4,33,6,FALSE
react-player,0.3.1,0.3.2,13,7,87,101,188,18,FALSE
react-player,0.4.2,0.5.0,22,6,82,39,121,16,FALSE
react-player,0.5.2,0.5.3,25,12,182,43,225,17,FALSE
react-player,0.3.0,0.3.1,12,3,15,4,19,8,FALSE
react-player,0.14.1,0.14.2,47,5,48,32,80,9,FALSE
react-player,0.0.8,0.1.0,8,6,169,21,190,14,FALSE
react-player,0.1.0,0.2.0,9,12,264,31,295,33,FALSE
react-player,0.0.5,0.0.6,5,3,11,2,13,5,TRUE
react-player,0.0.4,0.0.5,4,4,33,32,65,10,FALSE
react-player,0.0.7,0.0.8,7,4,59,3,62,6,FALSE
react-player,0.0.6,0.0.7,6,4,8,4,12,4,FALSE
react-player,0.0.1,0.0.2,1,2,6,3,9,2,FALSE
react-player,0.0.3,0.0.4,3,3,7,2,9,4,FALSE
react-player,0.0.2,0.0.3,2,3,8,4,12,4,TRUE
react-player,0.7.2,0.7.3,35,2,12,5,17,5,TRUE
react-player,0.5.5,0.5.6,28,6,29,8,37,11,TRUE
react-player,0.7.3,0.7.4,36,2,10,3,13,5,TRUE
react-player,0.11.0,0.12.0,42,15,289,199,488,36,TRUE
react-player,0.0.5,0.0.6,5,3,11,2,13,5,FALSE
react-player,0.0.2,0.0.3,2,3,8,4,12,4,FALSE
react-player,0.12.0,0.12.1,43,3,18,3,21,7,TRUE
react-player,0.0.8,0.1.0,8,6,169,21,190,14,TRUE
react-player,0.17.2,0.18.0,54,3,80,30,110,10,TRUE
react-player,0.14.2,0.14.3,48,13,418,200,618,25,TRUE
react-player,0.1.0,0.2.0,9,12,264,31,295,33,TRUE
react-player,0.4.2,0.5.0,22,6,82,39,121,16,TRUE
react-player,0.5.3,0.5.4,26,7,40,17,57,11,TRUE
react-player,0.10.0,0.11.0,41,2,17,6,23,8,TRUE
react-player,0.5.1,0.5.2,24,4,29,11,40,5,TRUE
react-player,0.5.2,0.5.3,25,12,182,43,225,17,TRUE
react-player,0.17.0,0.17.1,52,3,11,4,15,5,TRUE
tapas-ui,0.1.1,0.1.3,1,4,51,6,57,13,FALSE
tapas-ui,0.1.3,0.1.4,2,1,15,6,21,3,FALSE
tapas-ui,0.1.1,0.1.3,1,4,51,6,57,13,TRUE
coleman-liau,0.0.1,0.1.0,1,16,690,214,904,37,FALSE
coleman-liau,0.0.1,0.1.0,1,16,690,214,904,37,TRUE
jsfile-epub,0.1.8,0.1.9,8,1,110,112,222,4,FALSE
jsfile-epub,0.1.9,0.2.0,9,1,1,1,2,1,FALSE
jsfile-epub,0.1.4,0.1.5,4,1,95,86,181,5,FALSE
jsfile-epub,0.1.5,0.1.6,5,1,237,259,496,14,FALSE
jsfile-epub,0.1.6,0.1.7,6,1,7,0,7,1,FALSE
jsfile-epub,0.1.7,0.1.8,7,5,31,4,35,5,FALSE
jsfile-epub,0.1.0,0.1.1,1,1,439,8,447,9,FALSE
jsfile-epub,0.1.1,0.1.3,2,3,238,28,266,13,FALSE
jsfile-epub,0.1.3,0.1.4,3,5,243,97,340,13,FALSE
jsfile-epub,0.1.4,0.1.5,4,1,95,86,181,5,TRUE
jsfile-epub,0.1.9,0.2.0,9,1,1,1,2,1,TRUE
jsfile-epub,0.1.1,0.1.3,2,3,238,28,266,13,TRUE
uxcore-date-form-field,0.3.1,0.3.2,9,1,8,4,12,4,FALSE
uxcore-date-form-field,0.2.3,0.3.0,7,1,7,3,10,3,FALSE
uxcore-date-form-field,0.2.2,0.2.3,6,2,25,10,35,5,FALSE
uxcore-date-form-field,0.2.1,0.2.2,5,1,19,7,26,4,FALSE
uxcore-date-form-field,0.2.0,0.2.1,4,1,89,338,427,12,FALSE
uxcore-date-form-field,0.1.1,0.1.2,1,1,7,2,9,2,FALSE
uxcore-date-form-field,0.1.2,0.1.3,2,1,91,51,142,5,FALSE
uxcore-date-form-field,0.1.3,0.2.0,3,1,5,3,8,2,FALSE
uxcore-date-form-field,0.3.2,0.4.0,10,1,5,2,7,2,FALSE
uxcore-date-form-field,0.3.0,0.3.1,8,1,31,7,38,4,FALSE
uxcore-date-form-field,0.6.0,0.6.1,23,5,67,19,86,14,FALSE
uxcore-date-form-field,0.7.2,0.7.3,27,4,10,6,16,6,FALSE
uxcore-date-form-field,0.7.3,0.7.4,28,3,11,6,17,5,FALSE
uxcore-date-form-field,0.7.0,0.7.1,25,1,35,13,48,4,FALSE
uxcore-date-form-field,0.7.1,0.7.2,26,2,24,9,33,6,FALSE
uxcore-date-form-field,0.4.0,0.4.1,11,1,325,253,578,7,FALSE
uxcore-date-form-field,0.4.3,0.4.4,14,1,16,7,23,4,FALSE
uxcore-date-form-field,0.4.2,0.4.3,13,1,24,20,44,3,FALSE
uxcore-date-form-field,0.4.5,0.4.7,16,12,761,220,981,37,FALSE
uxcore-date-form-field,0.5.1,0.5.2,19,5,631,201,832,17,FALSE
uxcore-date-form-field,0.5.3,0.5.4,21,2,17,6,23,5,FALSE
uxcore-date-form-field,0.8.1,0.8.2,31,4,10,6,16,6,FALSE
uxcore-date-form-field,0.8.0,0.8.1,30,2,20,9,29,5,FALSE
uxcore-date-form-field,0.8.2,0.8.3,32,3,11,6,17,5,FALSE
uxcore-date-form-field,0.4.1,0.4.2,12,1,11,3,14,4,FALSE
uxcore-date-form-field,0.6.1,0.7.0,24,1,7,3,10,2,FALSE
uxcore-date-form-field,0.5.0,0.5.1,18,1,9,1,10,3,FALSE
uxcore-date-form-field,0.4.4,0.4.5,15,2,12,5,17,4,FALSE
uxcore-date-form-field,0.5.2,0.5.3,20,2,40,7,47,6,FALSE
uxcore-date-form-field,0.4.3,0.4.4,14,1,16,7,23,4,TRUE
uxcore-date-form-field,0.4.4,0.4.5,15,2,12,5,17,4,TRUE
uxcore-date-form-field,0.4.2,0.4.3,13,1,24,20,44,3,TRUE
my-vanga,1.0.4,1.0.5,5,1,3,3,6,3,FALSE
my-vanga,1.0.5,1.0.6,6,1,2,2,4,2,FALSE
my-vanga,1.0.6,1.0.7,7,1,3,3,6,3,FALSE
my-vanga,1.0.7,1.0.8,8,1,2,2,4,2,FALSE
my-vanga,1.1.5,1.1.6,16,1,6,2,8,2,FALSE
my-vanga,1.1.4,1.1.5,15,1,17,9,26,4,FALSE
my-vanga,1.1.7,1.1.8,18,9,8646,7365,16011,45,FALSE
my-vanga,1.0.3,1.0.4,4,1,5,5,10,5,FALSE
my-vanga,1.1.8,2.1.8,19,1,3,3,6,5,FALSE
my-vanga,1.0.8,1.0.9,9,2,2,1,3,2,FALSE
my-vanga,1.0.9,1.1.0,10,1,43,6,49,2,FALSE
my-vanga,2.1.8,2.1.9,20,1,7,6,13,1,FALSE
my-vanga,1.1.2,1.1.3,13,1,1,7,8,2,FALSE
my-vanga,0.0.1,0.0.2,1,1,2,2,4,1,FALSE
my-vanga,0.0.3,1.0.3,3,1,1,1,2,1,FALSE
my-vanga,0.0.2,0.0.3,2,1,1,1,2,1,FALSE
my-vanga,1.1.6,1.1.7,17,2,19,9,28,3,FALSE
my-vanga,1.1.1,1.1.2,12,2,55,34,89,4,FALSE
my-vanga,1.1.0,1.1.1,11,1,2,2,4,2,FALSE
my-vanga,2.1.9,2.2.0,21,4,162,59,221,9,FALSE
my-vanga,1.1.3,1.1.4,14,2,23,12,35,3,FALSE
my-vanga,2.1.9,2.2.0,21,4,162,59,221,9,TRUE
my-vanga,1.1.8,2.1.8,19,1,3,3,6,5,TRUE
npm-travis,1.0.0,1.0.1,3,13,205,133,338,23,FALSE
npm-travis,0.0.1,1.0.0,2,6,124,27,151,7,TRUE
npm-travis,0.0.0,0.0.1,1,10,201,97,298,10,FALSE
npm-travis,1.0.1,1.0.2,4,4,30,18,48,13,FALSE
npm-travis,0.0.1,1.0.0,2,6,124,27,151,7,FALSE
pipelinedog,0.2.0,0.2.1,4,1,736,23,759,5,FALSE
pipelinedog,0.1.0,0.1.1,1,1,736,23,759,5,FALSE
pipelinedog,0.1.1,0.1.2,2,2,6,12,18,3,TRUE
pipelinedog,0.1.2,0.2.0,3,1,5,5,10,3,FALSE
pipelinedog,0.1.1,0.1.2,2,2,6,12,18,3,FALSE
stc-cdn,1.0.4,1.0.5,4,2,11,2,13,2,FALSE
stc-cdn,1.0.5,1.0.6,5,2,18,11,29,2,FALSE
stc-cdn,1.0.6,1.0.7,6,2,2,1,3,2,FALSE
stc-cdn,1.0.7,1.0.8,7,3,3,3,6,3,FALSE
stc-cdn,1.0.1,1.0.2,1,2,10,1,11,2,FALSE
stc-cdn,1.0.2,1.0.3,2,2,2,1,3,2,FALSE
stc-cdn,1.0.3,1.0.4,3,2,7,4,11,2,FALSE
stc-cdn,1.0.7,1.0.8,7,3,3,3,6,3,TRUE
isitworking,1.2.1,2.0.0,4,4,298,1318,1616,14,FALSE
isitworking,1.0.1,1.0.3,1,7,48,20,68,18,TRUE
isitworking,1.2.0,1.2.1,3,3,22,22,44,4,FALSE
isitworking,1.0.3,1.2.0,2,5,16,12,28,10,FALSE
isitworking,1.0.1,1.0.3,1,7,48,20,68,18,FALSE
alexia,1.0.0,1.0.1,2,5,105,58,163,12,FALSE
alexia,2.0.2,2.1.0,13,12,695,251,946,46,FALSE
alexia,2.0.1,2.0.2,12,7,421,29,450,16,FALSE
alexia,2.0.0,2.0.1,11,11,3789,3791,7580,142,TRUE
alexia,2.3.0,2.4.0,19,7,381,21,402,28,FALSE
alexia,2.2.0,2.2.1,15,3,39,17,56,9,FALSE
alexia,1.3.1,1.3.2,9,9,445,149,594,42,FALSE
alexia,1.3.2,2.0.0,10,3,113,69,182,17,FALSE
alexia,1.2.4,1.3.0,7,7,90,11,101,14,FALSE
alexia,1.3.0,1.3.1,8,4,45,18,63,7,FALSE
alexia,1.2.2,1.2.3,5,1,1,3,4,2,FALSE
alexia,1.2.3,1.2.4,6,1,30,11,41,6,FALSE
alexia,2.2.3,2.3.0,18,3,177,55,232,7,FALSE
alexia,2.2.2,2.2.3,17,3,35,7,42,5,FALSE
alexia,1.2.0,1.2.2,4,3,26,9,35,5,TRUE
alexia,2.2.1,2.2.2,16,1,2,2,4,1,FALSE
alexia,2.1.0,2.2.0,14,7,1299,237,1536,55,FALSE
alexia,1.0.1,1.2.0,3,39,1871,630,2501,143,FALSE
alexia,2.0.0,2.0.1,11,11,3789,3791,7580,142,FALSE
alexia,1.2.0,1.2.2,4,3,26,9,35,5,FALSE
alexia,2.0.1,2.0.2,12,7,421,29,450,16,TRUE
alexia,1.3.2,2.0.0,10,3,113,69,182,17,TRUE
alexia,1.3.0,1.3.1,8,4,45,18,63,7,TRUE
alexia,1.0.1,1.2.0,3,39,1871,630,2501,143,TRUE
alexia,2.0.2,2.1.0,13,12,695,251,946,46,TRUE
react-customized-scrollbar,1.0.4,1.0.5,4,2,4,1,5,2,FALSE
react-customized-scrollbar,1.0.5,1.0.6,5,3,56,32,88,5,FALSE
react-customized-scrollbar,1.0.6,1.0.7,6,2,3,5,8,2,FALSE
react-customized-scrollbar,1.0.7,1.0.8,7,2,6,4,10,3,FALSE
react-customized-scrollbar,1.0.0,1.0.1,1,2,59,76,135,7,FALSE
react-customized-scrollbar,1.0.1,1.0.3,2,5,31,30,61,6,FALSE
react-customized-scrollbar,1.0.3,1.0.4,3,2,4548,4715,9263,3,FALSE
react-customized-scrollbar,1.1.0,1.1.1,12,2,4,2,6,2,FALSE
react-customized-scrollbar,1.0.8,1.0.9,8,2,7,6,13,3,FALSE
react-customized-scrollbar,1.0.9,1.0.10,9,2,2,2,4,2,FALSE
react-customized-scrollbar,1.1.2,1.1.3,14,1,148,131,279,6,FALSE
react-customized-scrollbar,1.1.1,1.1.2,13,5,177,139,316,12,FALSE
react-customized-scrollbar,1.0.10,1.0.11,10,2,11,13,24,2,FALSE
react-customized-scrollbar,1.0.11,1.1.0,11,2,52,30,82,5,FALSE
react-customized-scrollbar,1.1.2,1.1.3,14,1,148,131,279,6,TRUE
react-gql,0.1.0-rc10,0.1.0-rc11,2,2,37,5,42,5,FALSE
react-gql,0.1.0-rc8,0.1.0-rc9,9,7,279,252,531,19,FALSE
react-gql,0.1.0-rc4,0.1.0-rc5,5,4,196,60,256,7,FALSE
react-gql,0.1.0-rc5,0.1.0-rc6,6,3,337,125,462,13,FALSE
react-gql,0.1.0-rc6,0.1.0-rc7,7,9,1042,194,1236,72,FALSE
react-gql,0.1.0-rc7,0.1.0-rc8,8,4,363,109,472,31,FALSE
react-gql,0.1.0-rc1,0.1.0-rc10,1,43,4585,2003,6588,258,TRUE
react-gql,0.1.0-rc2,0.1.0-rc4,4,8,1299,194,1493,45,FALSE
react-gql,0.1.0-rc1,0.1.0-rc10,1,43,4585,2003,6588,258,FALSE
react-gql,0.1.0-rc6,0.1.0-rc7,7,9,1042,194,1236,72,TRUE
react-gql,0.1.0-rc5,0.1.0-rc6,6,3,337,125,462,13,TRUE
papi,0.15.0,0.16.0,4,16,704,179,883,32,FALSE
papi,0.14.1,0.15.0,3,6,286,30,316,14,FALSE
papi,0.14.0,0.14.1,2,1,257,9,266,6,FALSE
papi,0.22.0,0.23.0,15,1,4,1,5,2,FALSE
papi,0.21.1,0.22.0,14,5,38,15,53,6,FALSE
papi,0.21.0,0.21.1,13,1,2,2,4,2,FALSE
papi,0.25.1,0.26.0,19,3,14,3,17,4,FALSE
papi,0.25.0,0.25.1,18,3,38,36,74,7,FALSE
papi,0.24.0,0.25.0,17,5,443,109,552,12,FALSE
papi,0.17.0,0.18.0,7,1,43,5,48,4,FALSE
papi,0.20.0,0.21.0,12,3,8,2,10,7,FALSE
papi,0.16.1,0.17.0,6,7,346,159,505,13,FALSE
papi,0.16.0,0.16.1,5,1,17,28,45,3,FALSE
papi,0.19.2,0.20.0,11,1,45,1,46,3,FALSE
papi,0.18.0,0.19.0,8,1,7,7,14,4,FALSE
papi,0.26.0,0.27.0,20,1,53,5,58,3,FALSE
papi,0.23.0,0.24.0,16,4,12,5,17,5,FALSE
papi,0.19.0,0.19.1,9,1,5,6,11,2,FALSE
papi,0.13.0,0.14.0,1,2,34,34,68,6,FALSE
papi,0.19.1,0.19.2,10,1,4,3,7,2,FALSE
papi,0.25.0,0.25.1,18,3,38,36,74,7,TRUE
papi,0.17.0,0.18.0,7,1,43,5,48,4,TRUE
papi,0.18.0,0.19.0,8,1,7,7,14,4,TRUE
js-makedepend,1.0.4,1.0.5,23,3,8,8,16,3,FALSE
js-makedepend,1.0.5,1.0.6,24,6,10,10,20,6,FALSE
js-makedepend,1.0.6,2.0.0,25,13,1668,1438,3106,65,FALSE
js-makedepend,1.0.0,1.0.1,19,5,70,70,140,9,FALSE
js-makedepend,1.0.1,1.0.2,20,8,115,27,142,15,FALSE
js-makedepend,2.0.1,2.1.0,27,9,952,389,1341,53,FALSE
js-makedepend,1.0.3,1.0.4,22,4,4,4,8,4,FALSE
js-makedepend,2.2.2,2.2.3,31,5,60,51,111,6,FALSE
js-makedepend,0.1.8,0.1.9,8,6,13,12,25,8,FALSE
js-makedepend,0.1.9,0.1.10,9,6,465,439,904,21,FALSE
js-makedepend,0.2.4,0.3.0,16,69,4953,2392,7345,327,FALSE
js-makedepend,0.2.3,0.2.4,15,6,11,12,23,6,FALSE
js-makedepend,0.2.2,0.2.3,14,3,5,5,10,3,FALSE
js-makedepend,0.2.0,0.2.1,12,6,5210,391,5601,7,FALSE
js-makedepend,2.1.0,2.2.0,28,8,247,63,310,22,FALSE
js-makedepend,0.1.5,0.1.6,5,4,7,8,15,4,FALSE
js-makedepend,0.1.6,0.1.7,6,2,3,3,6,2,FALSE
js-makedepend,0.1.7,0.1.8,7,8,513,476,989,19,FALSE
js-makedepend,1.0.2,1.0.3,21,4,6,11,17,6,FALSE
js-makedepend,0.3.0,0.4.0,17,19,921,306,1227,50,FALSE
js-makedepend,2.0.0,2.0.1,26,6,144,89,233,8,FALSE
js-makedepend,0.4.0,1.0.0,18,7,28,28,56,10,FALSE
js-makedepend,0.2.1,0.2.2,13,7,246,5065,5311,10,FALSE
js-makedepend,0.1.10,0.1.11,10,10,121,17,138,12,FALSE
js-makedepend,0.1.11,0.2.0,11,19,146,60,206,72,FALSE
js-makedepend,2.2.1,2.2.2,30,3,9,8,17,3,FALSE
js-makedepend,2.2.0,2.2.1,29,9,53,53,106,13,FALSE
js-makedepend,0.2.2,0.2.3,14,3,5,5,10,3,TRUE
js-makedepend,0.1.1,0.1.2,1,2,2,1,3,2,FALSE
js-makedepend,0.1.2,0.1.3,2,3,8,8,16,4,FALSE
js-makedepend,0.1.3,0.1.4,3,9,243,73,316,10,FALSE
js-makedepend,0.1.4,0.1.5,4,9,40,27,67,11,FALSE
js-makedepend,0.1.5,0.1.6,5,4,7,8,15,4,TRUE
js-makedepend,2.2.0,2.2.1,29,9,53,53,106,13,TRUE
js-makedepend,1.0.6,2.0.0,25,13,1668,1438,3106,65,TRUE
js-makedepend,2.2.2,2.2.3,31,5,60,51,111,6,TRUE
js-makedepend,0.1.10,0.1.11,10,10,121,17,138,12,TRUE
js-makedepend,1.0.5,1.0.6,24,6,10,10,20,6,TRUE
js-makedepend,1.0.2,1.0.3,21,4,6,11,17,6,TRUE
js-makedepend,0.2.1,0.2.2,13,7,246,5065,5311,10,TRUE
bootprint,0.7.5,0.7.6,26,3,9,2,11,4,FALSE
bootprint,0.2.0,0.3.0,4,1,1,1,2,1,FALSE
bootprint,0.1.0,0.1.1,1,4,46,8,54,5,FALSE
bootprint,0.1.1,0.1.2,2,2,5,1,6,2,FALSE
bootprint,0.1.2,0.2.0,3,2,157,182,339,10,FALSE
bootprint,0.3.0,0.4.0,5,9,54,70,124,12,FALSE
bootprint,0.6.0,0.7.0,21,4,11,6,17,4,FALSE
bootprint,0.7.2,0.7.3,24,3,11,4,15,4,FALSE
bootprint,0.7.3,0.7.5,25,8,189,742,931,24,FALSE
bootprint,0.7.0,0.7.1,22,3,12,6,18,4,FALSE
bootprint,0.7.1,0.7.2,23,5,14,7,21,6,FALSE
bootprint,0.4.9,0.4.10,15,4,17,3,20,5,FALSE
bootprint,0.4.8,0.4.9,14,4,25,20,45,6,FALSE
bootprint,0.4.1,0.4.2,7,9,310,165,475,13,FALSE
bootprint,0.4.0,0.4.1,6,4,163,21,184,10,TRUE
bootprint,0.4.3,0.4.4,9,4,142,38,180,9,FALSE
bootprint,0.4.2,0.4.3,8,3,109,13,122,5,FALSE
bootprint,0.4.5,0.4.6,11,3,3,3,6,3,FALSE
bootprint,0.5.1,0.6.0,20,4,40,18,58,7,FALSE
bootprint,0.4.7,0.4.8,13,7,213,99,312,8,FALSE
bootprint,0.4.6,0.4.7,12,6,55,14,69,9,FALSE
bootprint,0.4.11,0.4.12,17,3,12,8,20,4,FALSE
bootprint,0.4.10,0.4.11,16,5,19,21,40,7,FALSE
bootprint,0.4.12,0.5.0,18,3,69,29,98,8,FALSE
bootprint,0.5.0,0.5.1,19,4,31,11,42,7,FALSE
bootprint,0.4.4,0.4.5,10,5,301,130,431,27,FALSE
bootprint,0.4.0,0.4.1,6,4,163,21,184,10,FALSE
bootprint,0.4.4,0.4.5,10,5,301,130,431,27,TRUE
bootprint,1.0.0,2.0.0,37,11,199,33,232,16,FALSE
bootprint,0.10.0,1.0.0,36,3,143,181,324,16,FALSE
bootprint,0.7.8,0.8.0,29,10,183,26,209,18,FALSE
bootprint,0.7.6,0.7.7,27,5,82,151,233,10,FALSE
bootprint,0.7.7,0.7.8,28,3,20,3,23,4,FALSE
bootprint,0.9.0,0.10.0,35,2,78,2,80,9,FALSE
bootprint,0.8.5,0.9.0,34,7,182,73,255,21,FALSE
bootprint,0.8.4,0.8.5,33,2,7,3,10,4,FALSE
bootprint,0.8.0,0.8.2,30,5,1280,461,1741,42,FALSE
bootprint,0.8.3,0.8.4,32,3,38,10,48,7,FALSE
bootprint,0.8.2,0.8.3,31,9,37,27,64,13,FALSE
bootprint,0.6.0,0.7.0,21,4,11,6,17,4,TRUE
bootprint,0.4.7,0.4.8,13,7,213,99,312,8,TRUE
bootprint,0.9.0,0.10.0,35,2,78,2,80,9,TRUE
gulp-webpack-build,0.6.0,0.6.1,22,5,30,39,69,12,FALSE
gulp-webpack-build,0.11.0,0.11.1,31,2,5,1,6,2,FALSE
gulp-webpack-build,0.2.7,0.2.8,11,3,10,6,16,5,FALSE
gulp-webpack-build,0.2.6,0.2.7,10,3,188,44,232,12,FALSE
gulp-webpack-build,0.2.5,0.2.6,9,2,18,12,30,3,FALSE
gulp-webpack-build,0.2.4,0.2.5,8,5,342,41,383,12,FALSE
gulp-webpack-build,0.2.3,0.2.4,7,2,5,4,9,3,FALSE
gulp-webpack-build,0.2.2,0.2.3,6,2,38,29,67,5,FALSE
gulp-webpack-build,0.2.1,0.2.2,5,2,3,3,6,3,FALSE
gulp-webpack-build,0.2.0,0.2.1,4,2,3,3,6,3,FALSE
gulp-webpack-build,0.1.0,0.1.1,1,5,17,13,30,9,FALSE
gulp-webpack-build,0.1.1,0.1.2,2,2,5,5,10,3,FALSE
gulp-webpack-build,0.1.2,0.2.0,3,3,431,173,604,12,FALSE
gulp-webpack-build,0.2.9,0.3.0,13,7,245,152,397,22,FALSE
gulp-webpack-build,0.2.8,0.2.9,12,1,4,4,8,2,FALSE
gulp-webpack-build,0.10.1,0.11.0,30,2,2,2,4,2,FALSE
gulp-webpack-build,0.10.0,0.10.1,29,2,2,2,4,2,FALSE
gulp-webpack-build,0.3.2,0.3.3,16,7,99,51,150,10,FALSE
gulp-webpack-build,0.3.3,0.4.0,17,2,202,326,528,14,FALSE
gulp-webpack-build,0.6.1,0.7.0,23,2,7,7,14,2,FALSE
gulp-webpack-build,0.3.1,0.3.2,15,12,96,35,131,20,FALSE
gulp-webpack-build,0.7.2,0.8.0,26,2,13,13,26,2,FALSE
gulp-webpack-build,0.11.1,0.12.0,32,2,6,6,12,2,FALSE
gulp-webpack-build,0.7.0,0.7.1,24,3,10,10,20,3,FALSE
gulp-webpack-build,0.7.1,0.7.2,25,3,3,3,6,3,FALSE
gulp-webpack-build,0.12.2,0.12.3,35,1,1,1,2,1,FALSE
gulp-webpack-build,0.12.1,0.12.2,34,26,3690,2014,5704,172,FALSE
gulp-webpack-build,0.12.0,0.12.1,33,2,3,3,6,2,FALSE
gulp-webpack-build,0.4.1,0.5.0,19,3,389,404,793,20,FALSE
gulp-webpack-build,0.4.0,0.4.1,18,2,3,3,6,3,FALSE
gulp-webpack-build,0.5.0,0.5.1,20,3,12,16,28,3,FALSE
gulp-webpack-build,0.5.1,0.6.0,21,5,39,18,57,26,FALSE
gulp-webpack-build,0.13.0,0.13.1,37,3,13,2,15,3,FALSE
gulp-webpack-build,0.9.0,0.10.0,28,5,162,64,226,11,FALSE
gulp-webpack-build,0.8.0,0.9.0,27,6,96,79,175,8,FALSE
gulp-webpack-build,0.3.0,0.3.1,14,3,5,12,17,5,FALSE
gulp-webpack-build,0.10.1,0.11.0,30,2,2,2,4,2,TRUE
gulp-webpack-build,0.7.1,0.7.2,25,3,3,3,6,3,TRUE
gulp-webpack-build,0.10.0,0.10.1,29,2,2,2,4,2,TRUE
gulp-webpack-build,0.7.0,0.7.1,24,3,10,10,20,3,TRUE
gulp-webpack-build,0.8.0,0.9.0,27,6,96,79,175,8,TRUE
gulp-webpack-build,0.2.4,0.2.5,8,5,342,41,383,12,TRUE
gulp-webpack-build,0.12.1,0.12.2,34,26,3690,2014,5704,172,TRUE
gulp-webpack-build,0.4.1,0.5.0,19,3,389,404,793,20,TRUE
gulp-webpack-build,0.3.1,0.3.2,15,12,96,35,131,20,TRUE
gulp-webpack-build,0.5.1,0.6.0,21,5,39,18,57,26,TRUE
react-spinkit,2.0.0,2.1.0,25,5,4502,226,4728,21,FALSE
react-spinkit,1.1.9,1.1.10,22,4,12,8,20,5,FALSE
react-spinkit,1.1.8,1.1.9,21,13,1902,1038,2940,76,FALSE
react-spinkit,1.1.11,2.0.0,24,12,964,724,1688,44,FALSE
react-spinkit,2.1.2,3.0.0,28,9,1381,2911,4292,89,FALSE
react-spinkit,1.1.10,1.1.11,23,1,1,1,2,1,FALSE
react-spinkit,2.1.0,2.1.1,26,2,7329,117,7446,7,FALSE
react-spinkit,2.1.1,2.1.2,27,5,51,15,66,8,FALSE
react-spinkit,1.1.1,1.1.2,15,3,4,11,15,3,FALSE
react-spinkit,1.1.0,1.1.1,14,2,2,2,4,2,FALSE
react-spinkit,1.1.2,1.1.4,16,4,6,7,13,4,FALSE
react-spinkit,1.1.5,1.1.6,18,1,1,1,2,1,FALSE
react-spinkit,1.0.1,1.0.2,12,2,24,16,40,2,FALSE
react-spinkit,1.0.2,1.1.0,13,4,37,46,83,8,FALSE
react-spinkit,1.1.6,1.1.7,19,2,10,10,20,2,FALSE
react-spinkit,1.1.7,1.1.8,20,4,21,14,35,5,FALSE
react-spinkit,1.0.0,1.0.1,11,2,10,9,19,3,FALSE
react-spinkit,1.1.4,1.1.5,17,4,5,6,11,4,FALSE
react-spinkit,0.7.0,1.0.0,10,3,47,62,109,8,FALSE
react-spinkit,0.3.0,0.3.1,4,4,11,3,14,4,FALSE
react-spinkit,0.3.1,0.4.0,5,13,700,12,712,32,FALSE
react-spinkit,0.1.1,0.2.0,2,3,34,2,36,4,FALSE
react-spinkit,0.1.0,0.1.1,1,1,3,0,3,1,FALSE
react-spinkit,0.2.0,0.3.0,3,2,8,6,14,2,FALSE
react-spinkit,0.4.1,0.5.0,7,4,15,11,26,4,FALSE
react-spinkit,0.6.0,0.7.0,9,4,22,10,32,4,FALSE
react-spinkit,0.5.0,0.6.0,8,12,377,287,664,21,FALSE
react-spinkit,0.4.0,0.4.1,6,1,1,1,2,1,FALSE
react-spinkit,0.7.0,1.0.0,10,3,47,62,109,8,TRUE
react-spinkit,0.3.1,0.4.0,5,13,700,12,712,32,TRUE
react-spinkit,1.1.2,1.1.4,16,4,6,7,13,4,TRUE
react-spinkit,0.4.1,0.5.0,7,4,15,11,26,4,TRUE
react-spinkit,1.1.11,2.0.0,24,12,964,724,1688,44,TRUE
postcss-colormin,1.2.6,1.2.7,9,4,16,3,19,6,FALSE
postcss-colormin,1.2.7,2.0.0,10,2,12,8,20,4,FALSE
postcss-colormin,1.2.4,1.2.5,7,3,20,14,34,5,FALSE
postcss-colormin,1.2.5,1.2.6,8,2,20,4,24,4,FALSE
postcss-colormin,1.2.3,1.2.4,6,3,11,10,21,4,FALSE
postcss-colormin,1.1.0,1.2.0,2,2,18,6,24,5,TRUE
postcss-colormin,1.0.0,1.1.0,1,2,25,2,27,5,FALSE
postcss-colormin,2.0.0,2.1.0,11,6,80,57,137,11,FALSE
postcss-colormin,2.1.8,2.2.0,20,18,54,101,155,22,FALSE
postcss-colormin,2.2.1,2.2.2,22,5,13,4,17,6,TRUE
postcss-colormin,2.2.0,2.2.1,21,10,85,45,130,14,FALSE
postcss-colormin,2.2.2,4.0.0-rc.0,23,1,1,1,2,1,FALSE
postcss-colormin,2.1.2,2.1.3,14,5,314,81,395,13,FALSE
postcss-colormin,2.1.3,2.1.4,15,2,6,1,7,3,FALSE
postcss-colormin,2.1.0,2.1.1,12,2,11,2,13,4,FALSE
postcss-colormin,2.1.1,2.1.2,13,4,16,13,29,8,TRUE
postcss-colormin,2.1.6,2.1.7,18,2,9,2,11,4,FALSE
postcss-colormin,2.1.7,2.1.8,19,4,272,525,797,26,FALSE
postcss-colormin,2.1.4,2.1.5,16,6,417,261,678,24,TRUE
postcss-colormin,2.1.5,2.1.6,17,2,36,9,45,5,FALSE
postcss-colormin,1.2.2,1.2.3,5,4,41,22,63,7,TRUE
postcss-colormin,1.2.0,1.2.1,3,2,18,11,29,6,FALSE
postcss-colormin,1.2.1,1.2.2,4,3,16,5,21,5,FALSE
postcss-colormin,1.1.0,1.2.0,2,2,18,6,24,5,FALSE
postcss-colormin,1.2.2,1.2.3,5,4,41,22,63,7,FALSE
postcss-colormin,2.2.1,2.2.2,22,5,13,4,17,6,FALSE
postcss-colormin,1.2.4,1.2.5,7,3,20,14,34,5,TRUE
postcss-colormin,2.1.1,2.1.2,13,4,16,13,29,8,FALSE
postcss-colormin,2.1.4,2.1.5,16,6,417,261,678,24,FALSE
postcss-colormin,2.1.8,2.2.0,20,18,54,101,155,22,TRUE
gatsby,1.0.0-alpha.9,1.0.0-alpha.10,106,3,27,15,42,5,FALSE
gatsby,1.0.0-alpha.8,1.0.0-alpha.9,105,3,7,7,14,3,FALSE
gatsby,1.0.0-alpha.test3,1.0.0-alpha.test5,110,3,5,4,9,5,FALSE
gatsby,1.0.0-alpha.test2,1.0.0-alpha.test3,109,2,2,1,3,2,FALSE
gatsby,1.0.0-alpha.test5,1.0.0-alpha.test6,111,1,2,2,4,1,FALSE
gatsby,1.0.0-alpha.test7,1.0.0-alpha.test8,113,1,2,2,4,1,FALSE
gatsby,1.0.0-alpha.test6,1.0.0-alpha.test7,112,1,2,2,4,1,FALSE
gatsby,1.0.0-alpha.test8,1.0.0-alpha.testing1,114,23,113,79,192,38,FALSE
gatsby,1.0.0-alpha.3,1.0.0-alpha.4,100,2,2,2,4,3,FALSE
gatsby,1.0.0-alpha.5,1.0.0-alpha.6,102,2,5,5,10,2,FALSE
gatsby,1.0.0-alpha.4,1.0.0-alpha.5,101,13,43,32,75,23,FALSE
gatsby,1.0.0-alpha.7,1.0.0-alpha.8,104,3,11,11,22,6,FALSE
gatsby,1.0.0-alpha.6,1.0.0-alpha.7,103,2,2,2,4,2,FALSE
gatsby,1.0.0-alpha1,1.0.0-alpha10,123,252,75281,28543,103824,837,FALSE
gatsby,0.12.19,0.12.20,73,77,53441,33150,86591,474,FALSE
gatsby,0.12.18,0.12.19,72,17,564,869,1433,30,FALSE
gatsby,0.3.2,0.4.0,11,5,56,23,79,5,FALSE
gatsby,0.12.12,0.12.13,66,79,8876,302,9178,117,FALSE
gatsby,0.12.11,0.12.12,65,2,2,2,4,2,FALSE
gatsby,0.12.17,0.12.18,71,1,1,1,2,1,FALSE
gatsby,0.8.10,0.8.11,38,15,122,150,272,40,FALSE
gatsby,0.12.15,0.12.16,69,2,31,11,42,2,FALSE
gatsby,0.12.14,0.12.15,68,8,7739,24,7763,33,FALSE
gatsby,0.7.2,0.7.3,22,2,2,2,4,2,FALSE
gatsby,1.0.0-alpha10-test1,1.0.0-alpha10-test2,125,3,6,4,10,3,FALSE
gatsby,0.12.44,0.12.45,96,10,842,820,1662,73,FALSE
gatsby,1.0.0-alpha10-test3,1.0.0-alpha11,127,207,149532,24402,173934,1550,FALSE
gatsby,1.0.0-alpha10-test2,1.0.0-alpha10-test3,126,2,2,2,4,2,FALSE
gatsby,1.0.0-alpha8-test2,1.0.0-alpha8-test3,282,2,13,2,15,3,FALSE
gatsby,1.0.0-alpha8-test1,1.0.0-alpha8-test2,281,2,2,2,4,2,FALSE
gatsby,0.12.42,0.12.43,94,6,6171,2366,8537,193,FALSE
gatsby,1.0.0-alpha8-test4,1.0.0-alpha9,284,10,61,28,89,12,FALSE
gatsby,1.0.0-alpha5,1.0.0-alpha6,277,31,29665,1375,31040,180,FALSE
gatsby,1.0.0-alpha-testing-6,1.0.0-alpha-testing-7,121,12,8422,100,8522,19,FALSE
gatsby,0.12.34,0.12.36,87,15,7974,2314,10288,153,FALSE
gatsby,0.12.37,0.12.38,89,6,257,334,591,11,FALSE
gatsby,0.12.36,0.12.37,88,5,788,612,1400,15,FALSE
gatsby,0.12.31,0.12.32,84,9,64737,6937,71674,582,FALSE
gatsby,0.12.30,0.12.31,83,1,1,1,2,1,FALSE
gatsby,0.12.32,0.12.33,85,17,291,132,423,27,FALSE
gatsby,0.12.38,0.12.39,90,46,12906,49170,62076,407,FALSE
gatsby,1.0.0-alpha3,1.0.0-alpha4,275,17,148,70,218,23,FALSE
gatsby,1.0.0-alpha-3,1.0.0-alpha-testing-5,119,28,8555,156,8711,40,FALSE
gatsby,0.12.22,0.12.23,76,2,24,12,36,2,FALSE
gatsby,0.12.23,0.12.24,77,2,2,1,3,2,FALSE
gatsby,0.12.20,0.12.21,74,12,8036,371,8407,70,FALSE
gatsby,0.12.21,0.12.22,75,19,4126,1286,5412,84,FALSE
gatsby,0.12.27,0.12.28,80,43,19304,3022,22326,184,FALSE
gatsby,0.12.24,0.12.25,78,2,7,7,14,2,FALSE
gatsby,0.12.25,0.12.27,79,10,193,105,298,50,FALSE
gatsby,0.12.28,0.12.29,81,80,34885,2788,37673,414,FALSE
gatsby,0.12.13,0.12.14,67,6,21352,468,21820,117,FALSE
gatsby,0.11.5,0.11.6,52,6,374,50,424,86,FALSE
gatsby,0.6.1,0.6.2,18,4,11,4,15,4,FALSE
gatsby,0.3.1,0.3.2,10,3,6,5,11,3,FALSE
gatsby,0.8.11,0.9.0,39,31,637,575,1212,123,FALSE
gatsby,0.12.16,0.12.17,70,2,1,9,10,2,FALSE
gatsby,0.12.29,0.12.30,82,17,1884,3466,5350,73,FALSE
gatsby,0.11.4,0.11.5,51,4,28,11,39,5,FALSE
gatsby,0.6.2,0.7.0,19,27,236,177,413,46,FALSE
gatsby,0.11.6,0.11.7,53,16,279,82,361,29,FALSE
gatsby,0.6.0,0.6.1,17,2,270,266,536,10,FALSE
gatsby,0.11.0,0.11.1,47,14,161,45,206,17,FALSE
gatsby,0.11.1,0.11.2,48,4,32,28,60,4,FALSE
gatsby,0.11.2,0.11.3,49,6,39,23,62,8,FALSE
gatsby,0.11.3,0.11.4,50,14,169,75,244,23,FALSE
gatsby,0.4.1,0.4.2,13,2,2,2,4,2,FALSE
gatsby,0.4.0,0.4.1,12,8,759,246,1005,26,FALSE
gatsby,0.4.3,0.5.0,15,14,610,137,747,21,FALSE
gatsby,0.4.2,0.4.3,14,6,80,41,121,8,FALSE
gatsby,0.8.9,0.8.10,37,6,34,16,50,8,FALSE
gatsby,0.11.7,0.12.0,54,7,55,66,121,14,FALSE
gatsby,0.8.5,0.8.6,33,9,53,39,92,11,FALSE
gatsby,0.8.4,0.8.5,32,18,86,43,129,27,FALSE
gatsby,0.8.7,0.8.8,35,5,41,20,61,5,FALSE
gatsby,0.8.6,0.8.7,34,6,36,1,37,6,FALSE
gatsby,0.8.1,0.8.2,29,2,10,8,18,4,FALSE
gatsby,0.8.0,0.8.1,28,4,22,13,35,7,FALSE
gatsby,0.8.3,0.8.4,31,6,24,10,34,7,FALSE
gatsby,0.8.2,0.8.3,30,2,2,1,3,2,FALSE
gatsby,1.0.0-alpha8-test3,1.0.0-alpha8-test4,283,1,4,4,8,1,FALSE
gatsby,0.12.45,0.12.46,97,23,4120,2011,6131,343,FALSE
gatsby,0.12.46,0.12.47,98,225,37597,49779,87376,1630,FALSE
gatsby,0.12.40,0.12.41,92,3,1219,1162,2381,25,TRUE
gatsby,0.12.41,0.12.42,93,4,38,375,413,5,FALSE
gatsby,0.12.43,0.12.44,95,2,391,404,795,38,FALSE
gatsby,1.0.0-alpha.test,1.0.0-alpha.test2,108,3,13,11,24,3,FALSE
gatsby,0.2.2,0.2.3,7,13,31,334,365,22,TRUE
gatsby,0.12.33,0.12.34,86,3,5,5,10,3,FALSE
gatsby,0.12.10,0.12.11,64,3,6,2,8,3,FALSE
gatsby,0.2.4,0.3.1,9,5,38,9,47,8,FALSE
gatsby,0.2.3,0.2.4,8,9,58,21,79,18,FALSE
gatsby,0.2.1,0.2.2,6,2,1,2,3,2,FALSE
gatsby,0.2.0,0.2.1,5,3,143,1,144,3,FALSE
gatsby,0.1.0,0.2.0,4,36,1412,1526,2938,133,FALSE
gatsby,0.8.8,0.8.9,36,14,345,179,524,25,FALSE
gatsby,0.10.1,0.10.2,45,3,5,4,9,3,FALSE
gatsby,0.10.0,0.10.1,44,24,277,287,564,52,FALSE
gatsby,0.10.2,0.11.0,46,26,761,275,1036,73,FALSE
gatsby,0.0.3,0.1.0,3,9,287,196,483,26,FALSE
gatsby,1.0.0-alpha6,1.0.0-alpha7,278,3,11,3,14,3,FALSE
gatsby,0.12.39,0.12.40,91,35,3490,2116,5606,121,FALSE
gatsby,0.7.4,0.7.5,24,3,7,5,12,6,FALSE
gatsby,0.7.5,0.7.6,25,3,19,7,26,8,FALSE
gatsby,1.0.0-alpha2,1.0.0-alpha3,274,73,563,283,846,112,FALSE
gatsby,0.7.3,0.7.4,23,17,1852,1529,3381,88,FALSE
gatsby,0.7.0,0.7.1,20,12,647,454,1101,28,FALSE
gatsby,0.7.1,0.7.2,21,3,3,1,4,3,FALSE
gatsby,0.12.3,0.12.4,58,14,65,32,97,15,FALSE
gatsby,0.12.2,0.12.3,57,6,95,43,138,8,FALSE
gatsby,0.12.1,0.12.2,56,6,34,28,62,7,FALSE
gatsby,0.12.0,0.12.1,55,2,2,2,4,2,FALSE
gatsby,0.12.7,0.12.9,62,46,1772,2053,3825,183,FALSE
gatsby,0.12.6,0.12.7,61,2,2,2,4,2,FALSE
gatsby,0.12.5,0.12.6,60,18,1324,148,1472,36,FALSE
gatsby,0.12.4,0.12.5,59,3,3,3,6,3,FALSE
gatsby,0.12.9,0.12.10,63,10,222,131,353,22,FALSE
gatsby,0.5.0,0.6.0,16,9,627,562,1189,24,FALSE
gatsby,0.9.0,0.9.1,40,27,711,252,963,53,FALSE
gatsby,0.9.1,0.9.2,41,14,274,71,345,35,FALSE
gatsby,0.9.2,0.9.3,42,15,480,125,605,65,FALSE
gatsby,1.0.0-alpha.testing1,1.0.0-alpha.testing2,115,1,2,2,4,1,FALSE
gatsby,1.0.0-alpha.testing2,1.0.0-alpha.testing3,116,2,17,7,24,3,FALSE
gatsby,1.0.0-alpha.testing3,1.0.0-alpha.testing4,117,3,3,3,6,3,FALSE
gatsby,1.0.0-alpha7,1.0.0-alpha8,279,29,2195,2423,4618,68,FALSE
gatsby,0.7.7,0.8.0,27,19,938,946,1884,88,FALSE
gatsby,0.0.2,0.0.3,2,4,74,39,113,11,FALSE
gatsby,0.9.3,0.10.0,43,3,14,8,22,3,FALSE
gatsby,0.7.6,0.7.7,26,4,30,6,36,6,FALSE
gatsby,1.0.0-alpha4,1.0.0-alpha5,276,13,8437,100,8537,20,FALSE
gatsby,0.12.40,0.12.41,92,3,1219,1162,2381,25,FALSE
gatsby,0.2.2,0.2.3,7,13,31,334,365,22,FALSE
gatsby,1.0.0-alpha15,1.0.0-alpha15-alpha.14012332,255,40,2492,1148,3640,206,FALSE
gatsby,1.0.0-alpha5,1.0.0-alpha6,277,31,29665,1375,31040,180,TRUE
gatsby,0.8.8,0.8.9,36,14,345,179,524,25,TRUE
gatsby,0.11.5,0.11.6,52,6,374,50,424,86,TRUE
gatsby,0.12.46,0.12.47,98,225,37597,49779,87376,1630,TRUE
gatsby,0.8.4,0.8.5,32,18,86,43,129,27,TRUE
gatsby,0.8.5,0.8.6,33,9,53,39,92,11,TRUE
gatsby,0.9.3,0.10.0,43,3,14,8,22,3,TRUE
gatsby,1.0.0-alpha15,1.0.0-alpha15-alpha.14012332,255,40,2492,1148,3640,206,TRUE
gatsby,0.12.19,0.12.20,73,77,53441,33150,86591,474,TRUE
gatsby,0.12.38,0.12.39,90,46,12906,49170,62076,407,TRUE
gatsby,1.0.0-alpha-testing-6,1.0.0-alpha-testing-7,121,12,8422,100,8522,19,TRUE
gatsby,1.0.0-alpha-3,1.0.0-alpha-testing-5,119,28,8555,156,8711,40,TRUE
gatsby,1.0.0-alpha4,1.0.0-alpha5,276,13,8437,100,8537,20,TRUE
gatsby,0.7.0,0.7.1,20,12,647,454,1101,28,TRUE
gatsby,0.9.0,0.9.1,40,27,711,252,963,53,TRUE
gatsby,1.0.0-alpha.7,1.0.0-alpha.8,104,3,11,11,22,6,TRUE
gatsby,1.0.0-alpha8-test4,1.0.0-alpha9,284,10,61,28,89,12,TRUE
gatsby,0.10.0,0.10.1,44,24,277,287,564,52,TRUE
gatsby,1.0.0-alpha6,1.0.0-alpha7,278,3,11,3,14,3,TRUE
gatsby,0.12.18,0.12.19,72,17,564,869,1433,30,TRUE
gatsby,0.7.6,0.7.7,26,4,30,6,36,6,TRUE
gatsby,0.2.0,0.2.1,5,3,143,1,144,3,TRUE
gatsby,0.1.0,0.2.0,4,36,1412,1526,2938,133,TRUE
gatsby,0.12.3,0.12.4,58,14,65,32,97,15,TRUE
gatsby,0.11.0,0.11.1,47,14,161,45,206,17,TRUE
gatsby,0.12.9,0.12.10,63,10,222,131,353,22,TRUE
gatsby,1.0.0-alpha7,1.0.0-alpha8,279,29,2195,2423,4618,68,TRUE
gatsby,0.11.2,0.11.3,49,6,39,23,62,8,TRUE
gatsby,0.8.10,0.8.11,38,15,122,150,272,40,TRUE
gatsby,0.4.0,0.4.1,12,8,759,246,1005,26,TRUE
gatsby,0.12.14,0.12.15,68,8,7739,24,7763,33,TRUE
gatsby,0.12.21,0.12.22,75,19,4126,1286,5412,84,TRUE
gatsby,0.11.7,0.12.0,54,7,55,66,121,14,TRUE
gatsby,0.2.3,0.2.4,8,9,58,21,79,18,TRUE
gatsby,0.0.3,0.1.0,3,9,287,196,483,26,TRUE
gatsby,1.0.0-alpha10-test2,1.0.0-alpha10-test3,126,2,2,2,4,2,TRUE
gatsby,1.0.0-alpha3,1.0.0-alpha4,275,17,148,70,218,23,TRUE
gatsby,0.11.4,0.11.5,51,4,28,11,39,5,TRUE
gatsby,0.4.3,0.5.0,15,14,610,137,747,21,TRUE
gatsby,0.8.3,0.8.4,31,6,24,10,34,7,TRUE
gatsby,1.0.0-alpha.test8,1.0.0-alpha.testing1,114,23,113,79,192,38,TRUE
gatsby,0.12.42,0.12.43,94,6,6171,2366,8537,193,TRUE
gatsby,1.0.0-alpha2,1.0.0-alpha3,274,73,563,283,846,112,TRUE
gatsby,1.0.0-alpha.testing3,1.0.0-alpha.testing4,117,3,3,3,6,3,TRUE
gatsby,0.8.6,0.8.7,34,6,36,1,37,6,TRUE
gatsby,0.12.1,0.12.2,56,6,34,28,62,7,TRUE
gatsby,0.12.5,0.12.6,60,18,1324,148,1472,36,TRUE
gatsby,0.7.1,0.7.2,21,3,3,1,4,3,TRUE
gatsby,0.12.20,0.12.21,74,12,8036,371,8407,70,TRUE
gatsby,1.0.0-alpha1,1.0.0-alpha10,123,252,75281,28543,103824,837,TRUE
gatsby,0.11.6,0.11.7,53,16,279,82,361,29,TRUE
gatsby,0.10.1,0.10.2,45,3,5,4,9,3,TRUE
gatsby,0.12.37,0.12.38,89,6,257,334,591,11,TRUE
gatsby,0.9.1,0.9.2,41,14,274,71,345,35,TRUE
gatsby,0.8.11,0.9.0,39,31,637,575,1212,123,TRUE
gatsby,0.10.2,0.11.0,46,26,761,275,1036,73,TRUE
gateblu-log-tracer,1.1.1,1.2.0,1,1,14,8,22,2,FALSE
gateblu-log-tracer,1.3.1,1.3.2,4,1,13,7,20,3,FALSE
gateblu-log-tracer,1.3.0,1.3.1,3,1,25,3,28,3,FALSE
gateblu-log-tracer,1.2.0,1.3.0,2,1,114,3,117,7,FALSE
gateblu-log-tracer,1.3.0,1.3.1,3,1,25,3,28,3,TRUE
bacon.react.html,1.4.0,1.4.1,14,2,12,12,24,3,FALSE
bacon.react.html,1.1.0,1.1.2,10,4,75,137,212,8,FALSE
bacon.react.html,1.1.2,1.2.0,11,1,25,18,43,3,FALSE
bacon.react.html,1.0.0,1.1.0,9,1,65,8,73,3,FALSE
bacon.react.html,1.2.0,1.3.0,12,1,4,3,7,2,FALSE
bacon.react.html,3.0.0,3.1.0,17,1,7,5,12,2,FALSE
bacon.react.html,1.4.1,2.0.0,15,5,33,12,45,6,TRUE
bacon.react.html,0.6.0,1.0.0,8,2,15,9,24,4,FALSE
bacon.react.html,0.5.1,0.6.0,7,4,84,39,123,6,FALSE
bacon.react.html,2.0.0,3.0.0,16,1,6,6,12,1,FALSE
bacon.react.html,3.1.0,3.1.1,18,4,6,3,9,5,FALSE
bacon.react.html,0.2.1,0.4.0,4,7,253,209,462,13,FALSE
bacon.react.html,0.2.0,0.2.1,3,2,2,1,3,2,FALSE
bacon.react.html,0.4.1,0.5.1,6,4,105,54,159,7,FALSE
bacon.react.html,0.4.0,0.4.1,5,1,7,7,14,2,FALSE
bacon.react.html,1.3.0,1.4.0,13,8,56,21,77,9,FALSE
bacon.react.html,0.1.4,0.1.5,1,1,63,57,120,3,FALSE
bacon.react.html,0.1.5,0.2.0,2,3,126,31,157,5,FALSE
bacon.react.html,1.4.1,2.0.0,15,5,33,12,45,6,FALSE
bacon.react.html,2.0.0,3.0.0,16,1,6,6,12,1,TRUE
bacon.react.html,1.1.2,1.2.0,11,1,25,18,43,3,TRUE
gitdown,1.0.4,1.0.5,11,3,26,12,38,6,FALSE
gitdown,1.0.5,1.0.6,12,2,10,13,23,3,FALSE
gitdown,1.0.6,1.1.0,13,3,300,191,491,26,FALSE
gitdown,1.0.1,1.0.2,8,4,95,51,146,6,FALSE
gitdown,2.0.1,2.0.2,30,2,70,14,84,9,FALSE
gitdown,1.0.3,1.0.4,10,6,73,55,128,16,FALSE
gitdown,2.2.1,2.3.0,34,2,14,3,17,3,FALSE
gitdown,2.2.0,2.2.1,33,2,1,3,4,2,FALSE
gitdown,2.1.0,2.2.0,32,2,42,7,49,4,FALSE
gitdown,1.3.1,1.3.2,26,2,2,2,4,2,FALSE
gitdown,2.0.2,2.1.0,31,7,30,14,44,8,FALSE
gitdown,1.0.2,1.0.3,9,8,151,110,261,14,FALSE
gitdown,2.0.0,2.0.1,29,3,16,11,27,5,FALSE
gitdown,1.2.8,1.2.9,23,1,1,1,2,1,FALSE
gitdown,1.3.0,1.3.1,25,2,68,50,118,6,FALSE
gitdown,1.2.9,1.3.0,24,2,65,62,127,6,FALSE
gitdown,2.3.0,2.3.1,35,3,5,3,8,4,FALSE
gitdown,2.3.1,2.4.0,36,2,9,3,12,2,FALSE
gitdown,1.2.6,1.2.7,21,9,343,204,547,40,FALSE
gitdown,1.2.7,1.2.8,22,1,1,1,2,1,FALSE
gitdown,1.2.4,1.2.5,19,2,2,2,4,2,FALSE
gitdown,1.2.5,1.2.6,20,6,96,6,102,10,FALSE
gitdown,1.2.2,1.2.3,17,7,105,24,129,16,FALSE
gitdown,1.2.3,1.2.4,18,2,44,24,68,5,FALSE
gitdown,1.2.0,1.2.1,15,4,11,10,21,7,FALSE
gitdown,1.2.1,1.2.2,16,5,62,4,66,11,FALSE
gitdown,2.4.2,2.4.4,39,12,91,66,157,19,FALSE
gitdown,2.4.1,2.4.2,38,2,3,3,6,2,FALSE
gitdown,2.4.0,2.4.1,37,14,890,948,1838,37,FALSE
gitdown,2.4.7,2.4.8,43,4,24,30,54,6,FALSE
gitdown,2.4.6,2.4.7,42,3,23,19,42,4,FALSE
gitdown,2.4.5,2.4.6,41,2,6,6,12,2,FALSE
gitdown,2.4.4,2.4.5,40,3,20,15,35,4,FALSE
gitdown,1.1.0,1.2.0,14,10,179,111,290,27,FALSE
gitdown,1.3.3,2.0.0,28,9,963,804,1767,64,FALSE
gitdown,1.3.2,1.3.3,27,3,34,51,85,4,FALSE
gitdown,2.4.10,2.5.0,46,9,1622,1588,3210,37,FALSE
gitdown,2.4.9,2.4.10,45,11,199,268,467,39,FALSE
gitdown,2.4.8,2.4.9,44,3,9,9,18,5,FALSE
gitdown,2.4.7,2.4.8,43,4,24,30,54,6,TRUE
gitdown,2.4.0,2.4.1,37,14,890,948,1838,37,TRUE
gitdown,2.0.2,2.1.0,31,7,30,14,44,8,TRUE
gitdown,1.3.3,2.0.0,28,9,963,804,1767,64,TRUE
gitdown,2.4.10,2.5.0,46,9,1622,1588,3210,37,TRUE
gitdown,1.3.0,1.3.1,25,2,68,50,118,6,TRUE
gitdown,2.4.1,2.4.2,38,2,3,3,6,2,TRUE
vusion-vue-loader,12.0.1,12.0.2,4,11,854,284,1138,43,FALSE
vusion-vue-loader,12.0.0,12.0.1,3,7,69,51,120,12,FALSE
vusion-vue-loader,12.0.4,12.0.5,7,1,2,2,4,2,FALSE
vusion-vue-loader,12.0.3,12.0.4,6,10,87,81,168,19,FALSE
vusion-vue-loader,12.0.2,12.0.3,5,7,174,19,193,13,FALSE
vusion-vue-loader,0.2.1,12.0.0,2,13,12783,513,13296,124,FALSE
vusion-vue-loader,0.2.0,0.2.1,1,25,487,336,823,63,FALSE
vusion-vue-loader,0.2.0,0.2.1,1,25,487,336,823,63,TRUE
vusion-vue-loader,0.2.1,12.0.0,2,13,12783,513,13296,124,TRUE
vusion-vue-loader,12.0.2,12.0.3,5,7,174,19,193,13,TRUE
vusion-vue-loader,12.0.3,12.0.4,6,10,87,81,168,19,TRUE
vusion-vue-loader,12.0.1,12.0.2,4,11,854,284,1138,43,TRUE
react-berry,0.2.7,0.2.8,13,1,10,5,15,3,FALSE
react-berry,0.2.6,0.2.7,12,1,10,5,15,3,FALSE
react-berry,0.2.5,0.2.6,11,1,609,39,648,10,FALSE
react-berry,0.2.4,0.2.5,10,1,10,5,15,3,FALSE
react-berry,0.2.3,0.2.4,9,1,272,110,382,10,FALSE
react-berry,0.2.2,0.2.3,8,1,10,5,15,3,FALSE
react-berry,0.2.1,0.2.2,7,1,350,196,546,16,FALSE
react-berry,0.2.0,0.2.1,6,1,10,5,15,3,FALSE
react-berry,0.1.0,0.1.1,1,1,10,5,15,3,FALSE
react-berry,0.1.1,0.1.2,2,1,398,129,527,17,FALSE
react-berry,0.1.2,0.1.3,3,1,10,5,15,3,FALSE
react-berry,0.1.3,0.1.4,4,1,10,5,15,3,FALSE
react-berry,0.1.4,0.2.0,5,1,10,5,15,3,FALSE
react-berry,0.2.8,0.2.9,14,1,10,5,15,3,FALSE
react-berry,0.2.0,0.2.1,6,1,10,5,15,3,TRUE
react-berry,0.2.5,0.2.6,11,1,609,39,648,10,TRUE
react-berry,0.2.6,0.2.7,12,1,10,5,15,3,TRUE
react-berry,0.2.4,0.2.5,10,1,10,5,15,3,TRUE
react-berry,0.2.7,0.2.8,13,1,10,5,15,3,TRUE
react-berry,0.2.3,0.2.4,9,1,272,110,382,10,TRUE
react-berry,0.2.2,0.2.3,8,1,10,5,15,3,TRUE
react-berry,0.2.1,0.2.2,7,1,350,196,546,16,TRUE
react-berry,0.1.1,0.1.2,2,1,398,129,527,17,TRUE
react-berry,0.1.4,0.2.0,5,1,10,5,15,3,TRUE
graphql-rabbitmq-subscriptions,1.0.1,1.0.2,1,1,227,0,227,2,FALSE
graphql-rabbitmq-subscriptions,1.0.2,1.0.3,2,2,240,243,483,3,FALSE
graphql-rabbitmq-subscriptions,1.0.3,1.0.4,3,1,2,3,5,1,FALSE
graphql-rabbitmq-subscriptions,1.0.4,1.0.5,4,5,66,261,327,12,FALSE
graphql-rabbitmq-subscriptions,1.0.5,1.0.6,5,2,12,17,29,4,FALSE
graphql-rabbitmq-subscriptions,1.0.6,1.0.7,6,2,118,105,223,5,FALSE
graphql-rabbitmq-subscriptions,1.0.7,1.0.8,7,2,9,5,14,3,FALSE
graphql-rabbitmq-subscriptions,1.0.8,1.0.9,8,1,7,4,11,2,FALSE
graphql-rabbitmq-subscriptions,1.0.4,1.0.5,4,5,66,261,327,12,TRUE
graphql-rabbitmq-subscriptions,1.0.7,1.0.8,7,2,9,5,14,3,TRUE
graphql-rabbitmq-subscriptions,1.0.2,1.0.3,2,2,240,243,483,3,TRUE
graphql-rabbitmq-subscriptions,1.0.3,1.0.4,3,1,2,3,5,1,TRUE
react-native-button-component,0.0.5,0.0.6,5,6,1512,31,1543,9,FALSE
react-native-button-component,0.0.4,0.0.5,4,2,21,16,37,4,FALSE
react-native-button-component,0.1.10,0.1.11,10,3,19,27,46,3,FALSE
react-native-button-component,0.0.6,0.1.6,6,3,359,305,664,6,FALSE
react-native-button-component,0.0.1,0.0.2,1,3,5,2,7,3,FALSE
react-native-button-component,0.1.12,0.1.13,12,6,221,211,432,8,FALSE
react-native-button-component,0.0.3,0.0.4,3,10,103,60,163,11,FALSE
react-native-button-component,0.0.2,0.0.3,2,13,1269,356,1625,35,FALSE
react-native-button-component,0.1.15,0.1.16,15,3,32,10,42,5,FALSE
react-native-button-component,0.1.13,0.1.14,13,2,1,6,7,2,FALSE
react-native-button-component,0.1.9,0.1.10,9,4,22,4,26,4,FALSE
react-native-button-component,0.1.11,0.1.12,11,2,3,3,6,2,FALSE
react-native-button-component,0.1.14,0.1.15,14,2,3,2,5,2,FALSE
react-native-button-component,0.1.16,0.1.17,16,3,5502,292576,298078,97,FALSE
react-native-button-component,0.1.6,0.1.7,7,3,3,3,6,3,FALSE
react-native-button-component,0.1.7,0.1.9,8,2,14,4,18,5,FALSE
react-native-button-component,0.1.9,0.1.10,9,4,22,4,26,4,TRUE
react-native-button-component,0.1.14,0.1.15,14,2,3,2,5,2,TRUE
secp256k1,2.0.7,2.0.8,34,10,40,51,91,18,FALSE
secp256k1,2.0.6,2.0.7,33,2,10,5,15,4,FALSE
secp256k1,2.0.5,2.0.6,32,8,468,94,562,23,FALSE
secp256k1,2.0.4,2.0.5,31,3,15,3,18,3,FALSE
secp256k1,2.0.3,2.0.4,30,3,15,13,28,11,FALSE
secp256k1,2.0.2,2.0.3,29,2,4,4,8,4,FALSE
secp256k1,2.0.1,2.0.2,28,2,38,50,88,26,FALSE
secp256k1,2.0.0,2.0.1,27,2,40,34,74,6,FALSE
secp256k1,2.0.9,2.0.10,36,6,41,41,82,12,FALSE
secp256k1,2.0.8,2.0.9,35,8,50,10,60,11,FALSE
secp256k1,1.1.1,1.1.2,21,6,59,45,104,11,FALSE
secp256k1,1.1.0,1.1.1,20,4,18,5,23,6,FALSE
secp256k1,1.1.3,1.1.4,23,4,8,12,20,6,FALSE
secp256k1,1.1.2,1.1.3,22,1,2,2,4,1,FALSE
secp256k1,1.0.0,1.0.1,18,1,2,2,4,1,FALSE
secp256k1,1.0.1,1.1.0,19,1,18,10,28,3,FALSE
secp256k1,1.1.6,2.0.0,26,22,8368,2976,11344,247,FALSE
secp256k1,0.0.15,0.0.16,15,10,281,252,533,20,FALSE
secp256k1,0.0.14,0.0.15,14,4,17,19,36,4,FALSE
secp256k1,0.0.17,1.0.0,17,12,1036,1158,2194,26,TRUE
secp256k1,0.0.16,0.0.17,16,8,166,141,307,11,FALSE
secp256k1,0.0.11,0.0.12,11,2,42,35,77,3,FALSE
secp256k1,0.0.10,0.0.11,10,2,3,3,6,2,FALSE
secp256k1,0.0.13,0.0.14,13,14,196,259,455,18,FALSE
secp256k1,0.0.12,0.0.13,12,12,470,6264,6734,61,FALSE
secp256k1,1.1.5,1.1.6,25,3,195,123,318,18,FALSE
secp256k1,1.1.4,1.1.5,24,9,75,56,131,11,FALSE
secp256k1,0.0.5,0.0.6,5,1,99,1,100,3,FALSE
secp256k1,0.0.4,0.0.5,4,7,143,91,234,12,FALSE
secp256k1,0.0.7,0.0.8,7,2,3,2,5,2,TRUE
secp256k1,0.0.6,0.0.7,6,3,125,77,202,12,FALSE
secp256k1,0.0.1,0.0.2,1,2,33,1,34,2,FALSE
secp256k1,3.0.0,3.0.1,38,26,2833,1467,4300,96,FALSE
secp256k1,0.0.3,0.0.4,3,6,80,26,106,7,FALSE
secp256k1,0.0.2,0.0.3,2,5,13,104,117,9,FALSE
secp256k1,3.0.1,3.1.0,39,20,4289,4947,9236,168,TRUE
secp256k1,0.0.9,0.0.10,9,8,51,51,102,13,FALSE
secp256k1,3.1.0,3.2.0,40,16,825,450,1275,51,FALSE
secp256k1,3.2.0,3.2.2,41,8,58,16,74,10,FALSE
secp256k1,3.2.2,3.2.5,42,12,93,106,199,19,FALSE
secp256k1,0.0.8,0.0.9,8,6,45,6,51,8,FALSE
secp256k1,2.0.10,3.0.0,37,77,15657,9555,25212,471,FALSE
secp256k1,2.0.7,2.0.8,34,10,40,51,91,18,TRUE
secp256k1,3.0.1,3.1.0,39,20,4289,4947,9236,168,FALSE
secp256k1,2.0.10,3.0.0,37,77,15657,9555,25212,471,TRUE
secp256k1,0.0.17,1.0.0,17,12,1036,1158,2194,26,FALSE
secp256k1,0.0.7,0.0.8,7,2,3,2,5,2,FALSE
secp256k1,1.1.3,1.1.4,23,4,8,12,20,6,TRUE
secp256k1,2.0.4,2.0.5,31,3,15,3,18,3,TRUE
cacheman-promise,1.4.0,1.4.1,8,2,50,6,56,5,FALSE
cacheman-promise,1.1.0,1.2.0,5,2,2,2,4,2,FALSE
cacheman-promise,1.4.2,1.4.3,10,2,3,2,5,2,FALSE
cacheman-promise,1.4.3,1.4.4,11,7,426,634,1060,19,FALSE
cacheman-promise,1.0.0,1.1.0,4,4,87,55,142,7,FALSE
cacheman-promise,1.4.5,1.4.7,13,4,531,219,750,7,FALSE
cacheman-promise,1.4.1,1.4.2,9,2,27,32,59,5,FALSE
cacheman-promise,1.5.5,1.6.0,19,3,13,8,21,5,FALSE
cacheman-promise,1.5.4,1.5.5,18,2,2,2,4,2,FALSE
cacheman-promise,1.4.7,1.5.1,14,7,57,654,711,21,FALSE
cacheman-promise,1.5.1,1.5.2,15,4,5,18,23,5,FALSE
cacheman-promise,1.5.3,1.5.4,17,1,2,2,4,1,FALSE
cacheman-promise,0.0.2,0.1.0,2,3,60,12,72,5,FALSE
cacheman-promise,1.3.0,1.4.0,7,6,122,8,130,8,FALSE
cacheman-promise,1.2.0,1.3.0,6,4,33,7,40,7,FALSE
cacheman-promise,0.1.0,1.0.0,3,5,119,18,137,8,FALSE
cacheman-promise,0.0.1,0.0.2,1,4,114,11,125,6,FALSE
cacheman-promise,1.5.2,1.5.3,16,1,8,5,13,2,FALSE
cacheman-promise,1.4.4,1.4.5,12,2,2,2,4,2,FALSE
cacheman-promise,0.0.2,0.1.0,2,3,60,12,72,5,TRUE
cacheman-promise,0.1.0,1.0.0,3,5,119,18,137,8,TRUE
cacheman-promise,1.4.2,1.4.3,10,2,3,2,5,2,TRUE
rmc-cascader,3.0.4,3.0.5,32,1,22,8656,8678,17,FALSE
rmc-cascader,3.0.5,3.0.7,33,7,185,310,495,30,TRUE
rmc-cascader,4.1.0,4.1.1,35,1,10,74,84,3,FALSE
rmc-cascader,3.0.3,3.0.4,31,1,2,2,4,2,FALSE
rmc-cascader,3.0.0,3.0.1,28,1,2,2,4,2,FALSE
rmc-cascader,3.0.1,3.0.2,29,1,3,3,6,3,FALSE
rmc-cascader,2.2.5,2.2.6,26,1,13,5,18,2,FALSE
rmc-cascader,2.2.4,2.2.5,25,2,42,31,73,6,FALSE
rmc-cascader,2.2.6,3.0.0,27,1,93,142,235,9,FALSE
rmc-cascader,2.2.3,2.2.4,24,1,3,3,6,2,FALSE
rmc-cascader,4.2.0,4.2.1,38,1,14,6,20,4,FALSE
rmc-cascader,3.0.2,3.0.3,30,3,44,31,75,13,FALSE
rmc-cascader,4.1.2,4.2.0,37,2,15,14,29,5,FALSE
rmc-cascader,4.1.1,4.1.2,36,3,5,5,10,3,FALSE
rmc-cascader,2.2.0,2.2.1,21,1,31,19,50,2,FALSE
rmc-cascader,2.0.1,2.2.0,20,1,19,18,37,9,FALSE
rmc-cascader,2.0.0,2.0.1,19,2,15,18,33,4,FALSE
rmc-cascader,1.1.0,1.2.0,17,2,9,12,21,6,FALSE
rmc-cascader,3.0.5,3.0.7,33,7,185,310,495,30,FALSE
rmc-cascader,1.0.0,1.1.0,16,1,37,178,215,6,FALSE
rmc-cascader,2.2.2,2.2.3,23,1,18,13,31,3,FALSE
rmc-cascader,0.2.7,0.2.8,9,1,2,2,4,2,FALSE
rmc-cascader,0.2.6,0.2.7,8,2,10,5,15,4,FALSE
rmc-cascader,0.2.5,0.2.6,7,1,99,1,100,4,FALSE
rmc-cascader,0.2.4,0.2.5,6,2,44,13,57,7,FALSE
rmc-cascader,0.2.3,0.2.4,5,1,27,1,28,3,FALSE
rmc-cascader,0.2.1,0.2.2,3,2,37,27,64,5,FALSE
rmc-cascader,0.2.0,0.2.1,2,1,24,19,43,2,FALSE
rmc-cascader,0.2.9,0.2.10,11,1,37,36,73,5,FALSE
rmc-cascader,0.2.8,0.2.9,10,1,23,17,40,4,FALSE
rmc-cascader,0.3.3,1.0.0,15,2,62,44,106,7,FALSE
rmc-cascader,0.3.0,0.3.1,13,1,12,12,24,2,FALSE
rmc-cascader,0.2.10,0.3.0,12,1,62,16,78,3,FALSE
rmc-cascader,1.2.0,2.0.0,18,1,366,121,487,24,FALSE
rmc-cascader,0.1.0,0.2.0,1,4,40,38,78,8,FALSE
rmc-cascader,0.3.1,0.3.3,14,1,82,68,150,13,FALSE
rmc-cascader,2.2.1,2.2.2,22,1,8714,42,8756,18,FALSE
rmc-cascader,0.2.2,0.2.3,4,1,8,4,12,3,FALSE
rmc-cascader,0.2.7,0.2.8,9,1,2,2,4,2,TRUE
rmc-cascader,1.1.0,1.2.0,17,2,9,12,21,6,TRUE
rmc-cascader,3.0.4,3.0.5,32,1,22,8656,8678,17,TRUE
rmc-cascader,2.2.2,2.2.3,23,1,18,13,31,3,TRUE
rmc-cascader,3.0.2,3.0.3,30,3,44,31,75,13,TRUE
rmc-cascader,4.1.2,4.2.0,37,2,15,14,29,5,TRUE
rmc-cascader,0.3.3,1.0.0,15,2,62,44,106,7,TRUE
rmc-cascader,3.0.1,3.0.2,29,1,3,3,6,3,TRUE
rmc-cascader,4.2.0,4.2.1,38,1,14,6,20,4,TRUE
rmc-cascader,1.2.0,2.0.0,18,1,366,121,487,24,TRUE
rmc-cascader,0.3.1,0.3.3,14,1,82,68,150,13,TRUE
rmc-cascader,2.2.1,2.2.2,22,1,8714,42,8756,18,TRUE
transformime-react,0.0.1,0.0.2,1,2,46,1,47,2,FALSE
transformime-react,0.0.2,0.1.0,2,5,152,97,249,11,FALSE
transformime-react,0.2.1,0.2.2,5,2,9,3,12,2,FALSE
transformime-react,0.2.0,0.2.1,4,3,129,3,132,3,FALSE
transformime-react,0.1.0,0.2.0,3,11,786,28,814,30,FALSE
transformime-react,1.0.1,1.0.2,15,5,91,75,166,21,FALSE
transformime-react,1.0.2,1.1.0,16,4,206,78,284,24,FALSE
transformime-react,0.6.2,0.7.0,12,6,132,76,208,18,FALSE
transformime-react,0.3.0,0.4.0,7,19,361,891,1252,72,FALSE
transformime-react,0.6.0,0.6.1,10,3,3,3,6,3,FALSE
transformime-react,0.7.0,1.0.0,13,1,1,1,2,1,FALSE
transformime-react,0.2.2,0.3.0,6,11,179,15,194,22,FALSE
transformime-react,0.4.0,0.5.0,8,5,33,37,70,5,FALSE
transformime-react,0.5.0,0.6.0,9,4,15,11,26,4,FALSE
transformime-react,0.6.1,0.6.2,11,1,1,1,2,1,FALSE
transformime-react,1.0.0,1.0.1,14,3,3,3,6,3,FALSE
transformime-react,0.6.0,0.6.1,10,3,3,3,6,3,TRUE
transformime-react,0.4.0,0.5.0,8,5,33,37,70,5,TRUE
transformime-react,1.0.1,1.0.2,15,5,91,75,166,21,TRUE
transformime-react,1.0.2,1.1.0,16,4,206,78,284,24,TRUE
backed,0.3.0-alpha3,0.3.0,21,2,33,24,57,8,FALSE
backed,0.3.2,0.3.3,24,3,34,18,52,15,FALSE
backed,0.3.3,0.3.4,25,2,9,9,18,8,FALSE
backed,0.3.0,0.3.1,22,2,45,21,66,8,FALSE
backed,0.3.1,0.3.2,23,1,1,0,1,1,FALSE
backed,0.3.4,0.4.0,26,4,68,42,110,11,FALSE
backed,0.2.6,0.3.0-alpha1,18,1,1,0,1,1,FALSE
backed,0.2.5,0.2.6,17,2,24,13,37,9,FALSE
backed,0.2.4,0.2.5,16,2,23,85,108,9,FALSE
backed,0.2.3,0.2.4,15,2,143,311,454,12,FALSE
backed,0.2.2,0.2.3,14,2,6,3,9,2,FALSE
backed,0.3.0-alpha1,0.3.0-alpha2,19,4,616,405,1021,18,FALSE
backed,0.3.0-alpha2,0.3.0-alpha3,20,1,4,4,8,2,FALSE
backed,0.3.0-alpha1,0.3.0-alpha2,19,4,616,405,1021,18,TRUE
backed,0.0.0-alpha.1,0.0.0-alpha.2,1,5,85,88,173,13,FALSE
backed,0.0.0-alpha.2,0.0.0-alpha.4,2,3,66,11,77,6,FALSE
backed,0.0.0-alpha.4,0.0.0-alpha.5,3,2,34,25,59,6,FALSE
backed,0.0.0-alpha.5,0.0.0-alpha.6,4,5,458,10,468,14,FALSE
backed,0.2.1,0.2.2,13,3,2317,472,2789,12,FALSE
backed,0.2.0,0.2.1,12,2,13,9,22,9,FALSE
backed,0.1.0,0.1.1,9,4,37,37,74,12,FALSE
backed,0.1.1,0.1.2,10,2,17,13,30,9,FALSE
backed,0.1.2,0.2.0,11,3,120,132,252,10,FALSE
backed,0.0.1,0.0.2,7,3,16,16,32,5,FALSE
backed,0.0.0,0.0.1,6,16,645,136,781,41,FALSE
backed,0.0.2,0.1.0,8,15,842,476,1318,47,TRUE
backed,0.0.2,0.1.0,8,15,842,476,1318,47,FALSE
react-rich-editor,0.0.5,0.0.6,4,1,3,3,6,3,FALSE
react-rich-editor,0.0.4,0.0.5,3,1,12,9,21,4,FALSE
react-rich-editor,0.0.7,0.0.8,6,6,228,203,431,27,FALSE
react-rich-editor,0.0.6,0.0.7,5,1,31,18,49,7,FALSE
react-rich-editor,0.0.1,0.0.3,1,16,2002,1185,3187,179,FALSE
react-rich-editor,0.0.3,0.0.4,2,1,36,32,68,8,FALSE
react-rich-editor,0.0.8,0.1.0,7,5,454,936,1390,80,FALSE
react-rich-editor,0.1.0,0.1.1,8,1,11,7,18,6,FALSE
react-rich-editor,0.1.1,0.1.2,9,3,23,20,43,9,FALSE
react-rich-editor,0.1.2,0.1.3,10,1,14,17,31,6,FALSE
react-rich-editor,0.1.2,0.1.3,10,1,14,17,31,6,TRUE
react-rich-editor,0.0.1,0.0.3,1,16,2002,1185,3187,179,TRUE
react-rich-editor,0.0.4,0.0.5,3,1,12,9,21,4,TRUE
react-rich-editor,0.1.1,0.1.2,9,3,23,20,43,9,TRUE
react-rich-editor,0.0.8,0.1.0,7,5,454,936,1390,80,TRUE
loopback-connector-ibm-connections-activities,0.0.1,0.0.2,1,4,19,15,34,6,TRUE
loopback-connector-ibm-connections-activities,0.0.3,0.0.4,3,2,3,3,6,2,TRUE
loopback-connector-ibm-connections-activities,0.0.2,0.0.3,2,4,12,12,24,4,FALSE
loopback-connector-ibm-connections-activities,0.0.1,0.0.2,1,4,19,15,34,6,FALSE
loopback-connector-ibm-connections-activities,0.0.3,0.0.4,3,2,3,3,6,2,FALSE
react-tj-treeview,1.1.3,2.0.0,6,3,66,38,104,10,FALSE
react-tj-treeview,0.0.1,0.0.2,1,2,63,28,91,8,FALSE
react-tj-treeview,1.0.1,1.0.2,4,3,233,204,437,18,FALSE
react-tj-treeview,1.0.2,1.1.3,5,3,116,69,185,10,FALSE
react-tj-treeview,0.0.2,1.0.0,2,4,599,295,894,25,TRUE
react-tj-treeview,1.0.0,1.0.1,3,1,98,46,144,5,FALSE
react-tj-treeview,0.0.2,1.0.0,2,4,599,295,894,25,FALSE
react-tj-treeview,1.0.1,1.0.2,4,3,233,204,437,18,TRUE
phridge,1.0.4,1.0.5,10,3,47,10,57,5,FALSE
phridge,1.0.5,1.0.6,11,3,57,27,84,6,FALSE
phridge,1.0.6,1.0.7,12,4,19,2,21,5,FALSE
phridge,1.0.7,1.0.8,13,15,78,29,107,19,FALSE
phridge,1.0.0,1.0.1,6,2,137,24,161,6,FALSE
phridge,1.0.1,1.0.2,7,2,12,3,15,3,FALSE
phridge,1.0.2,1.0.3,8,5,108,53,161,10,FALSE
phridge,1.0.3,1.0.4,9,8,46,94,140,13,FALSE
phridge,1.1.0,1.2.0,15,26,710,464,1174,66,FALSE
phridge,1.0.8,1.1.0,14,8,126,54,180,8,FALSE
phridge,1.2.2,2.0.0,18,12,113,100,213,33,FALSE
phridge,1.2.0,1.2.1,16,5,498,269,767,31,FALSE
phridge,1.2.1,1.2.2,17,3,21,1,22,4,FALSE
phridge,0.1.0,0.1.1,1,4,79,41,120,4,FALSE
phridge,0.1.1,0.1.2,2,4,6,6,12,5,FALSE
phridge,0.1.2,0.1.4,3,6,44,9,53,6,FALSE
phridge,0.1.4,0.1.5,4,5,23,15,38,5,FALSE
phridge,0.1.5,1.0.0,5,7,1242,1293,2535,51,FALSE
phridge,1.0.6,1.0.7,12,4,19,2,21,5,TRUE
phridge,1.0.4,1.0.5,10,3,47,10,57,5,TRUE
phridge,1.0.8,1.1.0,14,8,126,54,180,8,TRUE
phridge,1.1.0,1.2.0,15,26,710,464,1174,66,TRUE
phridge,1.0.0,1.0.1,6,2,137,24,161,6,TRUE
tle-parser,0.3.0,1.0.1,5,9,26,15,41,9,FALSE
tle-parser,0.2.0,0.3.0,4,7,54,32,86,10,FALSE
tle-parser,0.1.0,0.1.2,1,4,115,23,138,7,FALSE
tle-parser,0.1.2,0.1.4,2,5,134,20,154,12,FALSE
tle-parser,0.1.4,0.2.0,3,10,173,64,237,19,FALSE
tle-parser,0.2.0,0.3.0,4,7,54,32,86,10,TRUE
outrigger,0.3.0-rc.1,0.3.0-rc.2,10,1,1,1,2,1,FALSE
outrigger,0.3.0-rc.0,0.3.0-rc.1,9,3,7,7,14,3,FALSE
outrigger,0.3.0,0.4.0-rc.0,12,36,2279,1096,3375,168,FALSE
outrigger,0.3.0-rc.2,0.3.0,11,6,202,142,344,32,FALSE
outrigger,0.5.0-rc.1,0.5.0-rc.2,18,7,1392,349,1741,57,FALSE
outrigger,0.5.0-rc.0,0.5.0-rc.1,17,6,73,71,144,10,FALSE
outrigger,0.4.0-rc.2,0.4.0,15,18,1137,223,1360,55,FALSE
outrigger,0.4.0-rc.0,0.4.0-rc.1,13,4,210,19,229,20,FALSE
outrigger,0.4.0-rc.1,0.4.0-rc.2,14,40,2460,1306,3766,162,FALSE
outrigger,0.2.2,0.3.0-rc.0,8,35,2007,2536,4543,143,FALSE
outrigger,0.2.1,0.2.2,7,3,5,7,12,5,FALSE
outrigger,0.2.0,0.2.1,6,4,295,7,302,10,FALSE
outrigger,0.1.0,0.1.1,2,3,13,23,36,5,FALSE
outrigger,0.1.1,0.1.2,3,3,14,6,20,3,FALSE
outrigger,0.1.2,0.1.3,4,1,1,1,2,1,FALSE
outrigger,0.1.3,0.2.0,5,31,462,85,547,48,FALSE
outrigger,0.4.0,0.5.0-rc.0,16,22,13944,1312,15256,112,FALSE
outrigger,0.5.0-rc.1,0.5.0-rc.2,18,7,1392,349,1741,57,TRUE
outrigger,0.5.0-rc.0,0.5.0-rc.1,17,6,73,71,144,10,TRUE
outrigger,0.4.0,0.5.0-rc.0,16,22,13944,1312,15256,112,TRUE
outrigger,0.1.3,0.2.0,5,31,462,85,547,48,TRUE
outrigger,0.4.0-rc.1,0.4.0-rc.2,14,40,2460,1306,3766,162,TRUE
outrigger,0.2.2,0.3.0-rc.0,8,35,2007,2536,4543,143,TRUE
outrigger,0.1.1,0.1.2,3,3,14,6,20,3,TRUE
outrigger,0.4.0-rc.2,0.4.0,15,18,1137,223,1360,55,TRUE
uglifyjs-webpack-plugin,0.4.2,0.4.3,14,1,63,125,188,10,FALSE
uglifyjs-webpack-plugin,0.4.0,0.4.1,12,1,63,125,188,10,FALSE
uglifyjs-webpack-plugin,0.3.0,0.3.1,10,1,63,125,188,10,FALSE
uglifyjs-webpack-plugin,0.3.1,0.4.0,11,1,63,125,188,10,FALSE
uglifyjs-webpack-plugin,0.1.0,0.1.1,1,4,29,4,33,3,FALSE
uglifyjs-webpack-plugin,0.2.2,0.3.0,9,1,63,125,188,10,FALSE
uglifyjs-webpack-plugin,0.2.1,0.2.2,8,1,63,125,188,10,FALSE
uglifyjs-webpack-plugin,0.2.0,0.2.1,7,1,63,125,188,10,FALSE
uglifyjs-webpack-plugin,0.4.1,0.4.2,13,1,63,125,188,10,FALSE
uglifyjs-webpack-plugin,0.1.1,0.1.2,2,3,8,1,9,3,FALSE
uglifyjs-webpack-plugin,0.1.3,0.1.4,4,3,8,3,11,3,FALSE
uglifyjs-webpack-plugin,0.1.4,0.1.5,5,1,8,2,10,1,FALSE
uglifyjs-webpack-plugin,0.1.5,0.2.0,6,1,63,125,188,10,FALSE
uglifyjs-webpack-plugin,0.1.2,0.1.3,3,5,8,3,11,4,FALSE
uglifyjs-webpack-plugin,0.4.1,0.4.2,13,1,63,125,188,10,TRUE
uglifyjs-webpack-plugin,0.3.0,0.3.1,10,1,63,125,188,10,TRUE
uglifyjs-webpack-plugin,0.2.2,0.3.0,9,1,63,125,188,10,TRUE
uglifyjs-webpack-plugin,0.1.3,0.1.4,4,3,8,3,11,3,TRUE
futamata,0.0.5,0.0.6,6,4,55,90,145,16,FALSE
futamata,0.0.4,0.0.5,5,8,252,32,284,26,FALSE
futamata,0.0.7,0.0.8,8,8,120,29,149,17,FALSE
futamata,0.0.6,0.0.7,7,5,279,182,461,36,FALSE
futamata,0.0.1,0.0.2,2,2,12,8,20,3,FALSE
futamata,0.0.3,0.0.4,4,12,357,137,494,51,FALSE
futamata,0.0.2,0.0.3,3,7,360,155,515,40,FALSE
futamata,0.0.9,0.0.10,10,2,2,2,4,2,FALSE
futamata,0.0.8,0.0.9,9,2,2,2,4,2,FALSE
futamata,0.0.11,0.0.13,12,6,128,20,148,14,FALSE
futamata,0.0.10,0.0.11,11,5,43,26,69,14,FALSE
futamata,0.0.13,0.0.14,13,4,64,12,76,8,FALSE
futamata,0.0.0,0.0.1,1,25,1097,263,1360,93,FALSE
futamata,0.0.2,0.0.3,3,7,360,155,515,40,TRUE
futamata,0.0.5,0.0.6,6,4,55,90,145,16,TRUE
futamata,0.0.4,0.0.5,5,8,252,32,284,26,TRUE
futamata,0.0.7,0.0.8,8,8,120,29,149,17,TRUE
futamata,0.0.6,0.0.7,7,5,279,182,461,36,TRUE
futamata,0.0.0,0.0.1,1,25,1097,263,1360,93,TRUE
futamata,0.0.3,0.0.4,4,12,357,137,494,51,TRUE
futamata,0.0.11,0.0.13,12,6,128,20,148,14,TRUE
futamata,0.0.10,0.0.11,11,5,43,26,69,14,TRUE
futamata,0.0.13,0.0.14,13,4,64,12,76,8,TRUE
luminous-lightbox,0.3.2,1.0.0,15,5,146,122,268,24,FALSE
luminous-lightbox,0.3.0,0.3.1,13,4,31,30,61,12,FALSE
luminous-lightbox,0.3.1,0.3.2,14,3,18,14,32,10,FALSE
luminous-lightbox,0.2.7,0.3.0,12,4,1211,109,1320,32,FALSE
luminous-lightbox,0.2.6,0.2.7,11,3,52,14,66,14,FALSE
luminous-lightbox,0.2.5,0.2.6,10,4,29,23,52,12,FALSE
luminous-lightbox,0.2.4,0.2.5,9,9,42,32,74,16,FALSE
luminous-lightbox,0.2.3,0.2.4,8,3,38,64,102,16,FALSE
luminous-lightbox,0.2.2,0.2.3,7,2,5,5,10,5,FALSE
luminous-lightbox,0.2.1,0.2.2,6,6,187,61,248,24,FALSE
luminous-lightbox,0.2.0,0.2.1,5,3,35,34,69,10,FALSE
luminous-lightbox,0.1.0,0.1.1,1,8,20,19,39,11,FALSE
luminous-lightbox,0.1.1,0.1.2,2,7,286,105,391,26,FALSE
luminous-lightbox,0.1.2,0.1.3,3,9,28,28,56,23,FALSE
luminous-lightbox,0.1.3,0.2.0,4,5,214,70,284,30,FALSE
luminous-lightbox,1.0.0,1.0.1,16,9,242,127,369,26,FALSE
luminous-lightbox,0.2.4,0.2.5,9,9,42,32,74,16,TRUE
ts-babel,0.1.0,0.2.0,1,1,47,133,180,6,FALSE
ts-babel,0.2.0,0.3.0,2,1,29,9,38,3,FALSE
ts-babel,1.0.4,1.0.5,36,1,5,5,10,1,FALSE
ts-babel,1.0.5,1.0.6,37,1,10,10,20,2,FALSE
ts-babel,1.0.6,1.0.7,38,1,47,133,180,6,FALSE
ts-babel,1.0.7,1.0.8,39,1,47,133,180,6,FALSE
ts-babel,1.0.0,1.0.1,32,1,47,133,180,6,FALSE
ts-babel,1.0.1,1.0.2,33,1,47,133,180,6,FALSE
ts-babel,1.0.2,1.0.3,34,1,47,133,180,6,FALSE
ts-babel,1.0.3,1.0.4,35,1,18,12,30,4,FALSE
ts-babel,1.3.4,1.3.5,59,1,3,3,6,1,TRUE
ts-babel,1.0.8,1.0.9,40,1,47,133,180,6,FALSE
ts-babel,1.0.9,1.0.10,41,1,47,133,180,6,FALSE
ts-babel,1.1.2,1.1.3,48,1,5,5,10,2,FALSE
ts-babel,1.3.5,1.3.6,60,1,47,133,180,6,FALSE
ts-babel,0.6.5,0.6.6,20,1,8,4,12,2,FALSE
ts-babel,1.1.5,1.2.0,51,1,47,133,180,6,FALSE
ts-babel,1.1.4,1.1.5,50,1,11,16,27,5,FALSE
ts-babel,0.6.9,0.7.0,24,1,34,15,49,2,FALSE
ts-babel,0.6.8,0.6.9,23,1,47,133,180,6,FALSE
ts-babel,3.0.0,3.0.1,71,1,75,2104,2179,6,FALSE
ts-babel,0.6.3,0.6.4,18,1,155,12,167,5,FALSE
ts-babel,0.6.2,0.6.3,17,1,47,133,180,6,FALSE
ts-babel,0.6.1,0.6.2,16,1,2,3,5,2,FALSE
ts-babel,0.6.0,0.6.1,15,1,47,133,180,6,FALSE
ts-babel,0.6.7,0.6.8,22,1,6,3,9,2,FALSE
ts-babel,0.6.6,0.6.7,21,1,47,133,180,6,FALSE
ts-babel,0.7.0,0.8.0,25,1,147,138,285,4,FALSE
ts-babel,0.6.4,0.6.5,19,1,3,5,8,2,FALSE
ts-babel,1.0.12,1.0.13,44,1,47,133,180,6,FALSE
ts-babel,1.0.13,1.1.0,45,1,9,5,14,2,TRUE
ts-babel,1.0.10,1.0.11,42,1,47,133,180,6,FALSE
ts-babel,1.0.11,1.0.12,43,3,106,16,122,4,FALSE
ts-babel,1.4.0,1.4.1,64,1,51,1,52,4,FALSE
ts-babel,1.4.1,1.4.2,65,1,47,133,180,6,FALSE
ts-babel,1.1.1,1.1.2,47,1,47,133,180,6,FALSE
ts-babel,1.4.3,1.4.4,67,1,102,42,144,5,FALSE
ts-babel,1.4.4,1.4.5,68,1,138,151,289,4,FALSE
ts-babel,1.4.5,2.0.0,69,1,2,0,2,1,FALSE
ts-babel,0.8.4,0.8.6,30,1,47,133,180,6,FALSE
ts-babel,1.4.2,1.4.3,66,1,47,133,180,6,FALSE
ts-babel,0.8.6,1.0.0,31,2,16,14,30,5,FALSE
ts-babel,0.8.1,0.8.2,27,1,47,133,180,6,FALSE
ts-babel,0.8.0,0.8.1,26,1,4,4,8,1,FALSE
ts-babel,0.8.3,0.8.4,29,1,47,133,180,6,FALSE
ts-babel,0.8.2,0.8.3,28,1,47,133,180,6,FALSE
ts-babel,1.3.3,1.3.4,58,2,142,60,202,4,TRUE
ts-babel,1.3.2,1.3.3,57,1,2,2,4,2,FALSE
ts-babel,1.3.1,1.3.2,56,1,2,2,4,2,FALSE
ts-babel,1.3.0,1.3.1,55,1,17,9,26,3,FALSE
ts-babel,1.2.2,1.3.0,54,1,26,32,58,3,FALSE
ts-babel,1.3.6,1.3.7,61,1,10,5,15,2,FALSE
ts-babel,1.2.0,1.2.1,52,1,47,133,180,6,FALSE
ts-babel,1.2.1,1.2.2,53,1,47,133,180,6,FALSE
ts-babel,2.0.0,3.0.0,70,1,57,723,780,13,FALSE
ts-babel,1.3.8,1.4.0,63,2,2921,215,3136,26,FALSE
ts-babel,1.1.0,1.1.1,46,1,156,2431,2587,9,FALSE
ts-babel,1.3.7,1.3.8,62,1,47,133,180,6,FALSE
ts-babel,1.1.3,1.1.4,49,1,4,4,8,2,FALSE
ts-babel,1.3.4,1.3.5,59,1,3,3,6,1,FALSE
ts-babel,1.3.3,1.3.4,58,2,142,60,202,4,FALSE
ts-babel,1.1.5,1.2.0,51,1,47,133,180,6,TRUE
ts-babel,0.6.6,0.6.7,21,1,47,133,180,6,TRUE
ts-babel,1.0.13,1.1.0,45,1,9,5,14,2,FALSE
ts-babel,1.4.4,1.4.5,68,1,138,151,289,4,TRUE
ts-babel,1.3.6,1.3.7,61,1,10,5,15,2,TRUE
ts-babel,0.4.3,0.4.4,7,1,47,133,180,6,FALSE
ts-babel,0.4.2,0.4.3,6,2,367,49,416,9,FALSE
ts-babel,0.4.4,0.4.5,8,1,47,133,180,6,FALSE
ts-babel,0.6.9,0.7.0,24,1,34,15,49,2,TRUE
ts-babel,0.7.0,0.8.0,25,1,147,138,285,4,TRUE
ts-babel,0.5.4,0.6.0,14,1,254,38,292,9,FALSE
ts-babel,0.4.0,0.4.1,4,1,2,3,5,2,FALSE
ts-babel,0.5.0,0.5.1,10,1,47,133,180,6,FALSE
ts-babel,0.5.1,0.5.2,11,1,47,133,180,6,FALSE
ts-babel,0.5.2,0.5.3,12,1,47,133,180,6,FALSE
ts-babel,0.5.3,0.5.4,13,1,9,3,12,2,FALSE
ts-babel,0.4.1,0.4.2,5,1,47,133,180,6,FALSE
ts-babel,0.4.5,0.5.0,9,2,22,79,101,5,FALSE
ts-babel,0.5.4,0.6.0,14,1,254,38,292,9,TRUE
fliplet-cli,3.6.0,3.6.2,84,12,329,140,469,44,FALSE
fliplet-cli,3.4.0,3.4.1,81,12,101,10,111,14,FALSE
fliplet-cli,3.4.1,3.5.0,82,3,3,3,6,3,FALSE
fliplet-cli,3.3.0,3.3.1,74,1,5,2,7,2,FALSE
fliplet-cli,3.3.6,3.3.8,79,5,38,18,56,7,FALSE
fliplet-cli,3.5.0,3.6.0,83,10,209,111,320,31,FALSE
fliplet-cli,3.2.4,3.2.5,72,5,201,33,234,16,FALSE
fliplet-cli,3.2.5,3.3.0,73,2,72,23,95,5,FALSE
fliplet-cli,3.3.3,3.3.4,76,1,7,2,9,1,FALSE
fliplet-cli,3.3.5,3.3.6,78,2,16,3,19,4,FALSE
fliplet-cli,3.3.4,3.3.5,77,10,151,19,170,16,FALSE
fliplet-cli,3.2.2,3.2.3,70,10,154,14,168,13,FALSE
fliplet-cli,3.2.3,3.2.4,71,3,39,11,50,5,FALSE
fliplet-cli,3.3.8,3.4.0,80,1,11,11,22,1,FALSE
fliplet-cli,3.3.1,3.3.3,75,4,73,17,90,6,FALSE
fliplet-cli,3.1.2,3.1.4,65,5,92,187,279,11,FALSE
fliplet-cli,3.1.1,3.1.2,64,7,555,140,695,23,FALSE
fliplet-cli,3.1.0,3.1.1,63,1,355,3,358,4,FALSE
fliplet-cli,3.0.2,3.0.3,61,41,642,178,820,85,FALSE
fliplet-cli,3.0.3,3.1.0,62,8,880,69,949,34,FALSE
fliplet-cli,3.1.5,3.2.0,67,22,1407,417,1824,62,FALSE
fliplet-cli,3.1.4,3.1.5,66,8,1098,618,1716,38,FALSE
fliplet-cli,1.9.5,1.9.6,54,3,32,4,36,5,FALSE
fliplet-cli,2.0.2,3.0.0,58,12,706,87,793,39,FALSE
fliplet-cli,3.0.0,3.0.1,59,33,370,65,435,63,FALSE
fliplet-cli,3.0.1,3.0.2,60,4,920,6,926,10,FALSE
fliplet-cli,1.8.8,1.8.9,47,1,16,4,20,2,FALSE
fliplet-cli,1.8.9,1.9.0,48,1,3,3,6,2,FALSE
fliplet-cli,1.9.1,1.9.2,50,1,2,2,4,2,FALSE
fliplet-cli,1.8.5,1.8.6,44,1,9,34,43,2,FALSE
fliplet-cli,1.9.3,1.9.4,52,1,9,0,9,1,FALSE
fliplet-cli,1.8.7,1.8.8,46,1,3,2,5,2,FALSE
fliplet-cli,1.7.3,1.8.0,39,1,34,11,45,2,FALSE
fliplet-cli,1.9.4,1.9.5,53,2,11,3,14,3,FALSE
fliplet-cli,1.8.2,1.8.4,42,2,4,2,6,4,FALSE
fliplet-cli,1.9.6,2.0.0,55,4,162,6,168,10,FALSE
fliplet-cli,2.0.1,2.0.2,57,1,5,2,7,2,FALSE
fliplet-cli,1.7.1,1.7.2,37,1,4,3,7,3,FALSE
fliplet-cli,1.8.1,1.8.2,41,1,10,2,12,3,FALSE
fliplet-cli,1.8.4,1.8.5,43,1,5,3,8,2,FALSE
fliplet-cli,1.9.0,1.9.1,49,1,2,2,4,2,FALSE
fliplet-cli,1.8.6,1.8.7,45,1,2,1,3,2,FALSE
fliplet-cli,2.0.0,2.0.1,56,1,2,2,4,2,FALSE
fliplet-cli,1.9.2,1.9.3,51,12,331,25,356,21,FALSE
fliplet-cli,1.7.0,1.7.1,36,2,16,16,32,6,FALSE
fliplet-cli,1.8.0,1.8.1,40,1,22,5,27,3,FALSE
fliplet-cli,3.2.0,3.2.1,68,1,2,1,3,2,FALSE
fliplet-cli,1.7.2,1.7.3,38,1,3,3,6,2,FALSE
fliplet-cli,3.2.1,3.2.2,69,2,567,97,664,16,FALSE
fliplet-cli,1.0.4,1.0.5,5,1,2,2,4,2,FALSE
fliplet-cli,1.0.5,1.0.6,6,1,17,2,19,2,FALSE
fliplet-cli,1.0.6,1.0.7,7,1,9,2,11,2,FALSE
fliplet-cli,1.0.7,1.0.8,8,1,3,1,4,1,FALSE
fliplet-cli,1.0.2,1.0.3,3,1,146,5,151,8,FALSE
fliplet-cli,1.0.3,1.0.4,4,1,2,2,4,2,FALSE
fliplet-cli,1.0.8,1.0.9,9,1,2,2,4,2,FALSE
fliplet-cli,1.0.9,1.0.10,10,1,32,3,35,4,FALSE
fliplet-cli,1.0.16,1.0.17,16,1,27,8,35,5,FALSE
fliplet-cli,1.4.2,1.4.3,24,2,15,4,19,3,FALSE
fliplet-cli,1.0.17,1.0.18,17,1,8,4,12,2,FALSE
fliplet-cli,1.6.2,1.6.3,31,1,1,1,2,1,FALSE
fliplet-cli,1.6.3,1.6.4,32,1,2,2,4,2,FALSE
fliplet-cli,1.0.14,1.0.16,15,1,12,4,16,3,FALSE
fliplet-cli,1.6.1,1.6.2,30,1,3,2,5,2,FALSE
fliplet-cli,1.0.12,1.0.13,13,1,43,15,58,7,FALSE
fliplet-cli,1.0.13,1.0.14,14,1,11,8,19,3,FALSE
fliplet-cli,1.0.10,1.0.11,11,1,14,5,19,5,FALSE
fliplet-cli,1.0.11,1.0.12,12,1,12,2,14,2,FALSE
fliplet-cli,1.0.18,1.1.0,18,3,17,8,25,6,FALSE
fliplet-cli,1.6.6,1.7.0,35,1,190,6,196,15,FALSE
fliplet-cli,1.4.0,1.4.1,22,1,1,2,3,2,FALSE
fliplet-cli,1.4.1,1.4.2,23,1,2,3,5,2,FALSE
fliplet-cli,1.4.3,1.4.4,25,1,2,2,4,2,FALSE
fliplet-cli,1.4.4,1.5.0,26,1,8,5,13,3,FALSE
fliplet-cli,1.6.4,1.6.5,33,6,141,7,148,15,FALSE
fliplet-cli,1.1.0,1.2.0,19,1,23,6,29,4,FALSE
fliplet-cli,1.6.5,1.6.6,34,10,131,81,212,28,FALSE
fliplet-cli,1.5.1,1.5.2,28,2,4,4,8,4,FALSE
fliplet-cli,1.5.0,1.5.1,27,1,3,1,4,2,FALSE
fliplet-cli,1.5.2,1.6.1,29,2,49,24,73,7,FALSE
fliplet-cli,1.2.0,1.2.1,20,1,6,4,10,2,FALSE
fliplet-cli,1.2.1,1.4.0,21,5,256,413,669,26,FALSE
fliplet-cli,3.4.1,3.5.0,82,3,3,3,6,3,TRUE
fliplet-cli,1.0.0,1.0.1,1,1,34,4,38,4,FALSE
fliplet-cli,1.0.1,1.0.2,2,1,79,5,84,6,FALSE
fliplet-cli,3.2.4,3.2.5,72,5,201,33,234,16,TRUE
fliplet-cli,3.0.3,3.1.0,62,8,880,69,949,34,TRUE
fliplet-cli,1.8.4,1.8.5,43,1,5,3,8,2,TRUE
fliplet-cli,1.4.4,1.5.0,26,1,8,5,13,3,TRUE
fliplet-cli,1.6.4,1.6.5,33,6,141,7,148,15,TRUE
fliplet-cli,3.1.5,3.2.0,67,22,1407,417,1824,62,TRUE
teasim-core,3.0.0-1,3.0.1-alpha.1,73,1,72,83,155,9,FALSE
teasim-core,3.0.0-0,3.0.0-1,72,1,72,83,155,9,FALSE
teasim-core,2.1.0-0,3.0.0-0,71,1,72,83,155,9,FALSE
teasim-core,1.0.0,1.0.1,60,8,546,45,591,21,FALSE
teasim-core,1.0.1,1.0.2,61,1,5311,5595,10906,257,FALSE
teasim-core,1.0.2,1.0.3,62,2,807,695,1502,79,TRUE
teasim-core,0.7.2,0.8.0,55,1,72,83,155,9,FALSE
teasim-core,0.3.4,0.3.5,24,1,72,83,155,9,FALSE
teasim-core,0.3.5,0.3.6,25,1,72,83,155,9,FALSE
teasim-core,0.3.8,0.3.10,27,1,72,83,155,9,FALSE
teasim-core,0.6.3,0.6.4,51,1,72,83,155,9,FALSE
teasim-core,0.3.0,0.3.4,23,1,72,83,155,9,FALSE
teasim-core,0.6.0,0.6.3,50,1,72,83,155,9,FALSE
teasim-core,0.3.6,0.3.8,26,1,72,83,155,9,FALSE
teasim-core,0.7.0,0.7.2,54,1,72,83,155,9,FALSE
teasim-core,0.6.4,0.6.16,52,1,72,83,155,9,FALSE
teasim-core,0.4.9,0.4.10,39,1,72,83,155,9,FALSE
teasim-core,0.4.8,0.4.9,38,1,72,83,155,9,FALSE
teasim-core,0.4.1,0.4.4,34,1,72,83,155,9,FALSE
teasim-core,0.4.0,0.4.1,33,1,72,83,155,9,FALSE
teasim-core,0.4.5,0.4.7,36,1,72,83,155,9,FALSE
teasim-core,0.4.4,0.4.5,35,1,72,83,155,9,FALSE
teasim-core,0.4.7,0.4.8,37,1,72,83,155,9,FALSE
teasim-core,0.3.10,0.3.11,28,1,72,83,155,9,FALSE
teasim-core,0.4.11,0.4.12,41,1,72,83,155,9,FALSE
teasim-core,0.4.10,0.4.11,40,1,72,83,155,9,FALSE
teasim-core,0.4.13,0.4.14,43,1,72,83,155,9,FALSE
teasim-core,0.4.12,0.4.13,42,1,72,83,155,9,TRUE
teasim-core,0.4.15,0.4.16,45,1,72,83,155,9,FALSE
teasim-core,0.4.14,0.4.15,44,1,72,83,155,9,FALSE
teasim-core,0.4.17,0.5.0,47,1,72,83,155,9,FALSE
teasim-core,0.4.16,0.4.17,46,1,72,83,155,9,FALSE
teasim-core,0.8.4,1.0.0,59,1,18625,0,18625,326,FALSE
teasim-core,0.8.1,0.8.3,57,1,72,83,155,9,FALSE
teasim-core,0.8.0,0.8.1,56,1,31,0,31,2,FALSE
teasim-core,0.8.3,0.8.4,58,1,72,83,155,9,FALSE
teasim-core,0.3.14,0.4.0,32,1,72,83,155,9,FALSE
teasim-core,0.3.11,0.3.12,29,1,72,83,155,9,FALSE
teasim-core,0.5.0,0.5.1,48,1,72,83,155,9,FALSE
teasim-core,0.5.1,0.6.0,49,1,72,83,155,9,FALSE
teasim-core,0.3.12,0.3.13,30,1,72,83,155,9,FALSE
teasim-core,0.3.13,0.3.14,31,1,72,83,155,9,FALSE
teasim-core,0.6.16,0.7.0,53,1,72,83,155,9,FALSE
teasim-core,1.1.1,1.1.2,65,1,72,83,155,9,FALSE
teasim-core,1.1.2,1.1.4,66,1,72,83,155,9,FALSE
teasim-core,1.0.3,1.0.9,63,1,72,83,155,9,FALSE
teasim-core,0.0.9,0.0.10,9,1,72,83,155,9,FALSE
teasim-core,0.2.0,0.2.1,16,1,72,83,155,9,FALSE
teasim-core,1.0.9,1.1.1,64,1,72,83,155,9,FALSE
teasim-core,0.2.6,0.3.0,22,1,72,83,155,9,FALSE
teasim-core,0.2.5,0.2.6,21,1,72,83,155,9,FALSE
teasim-core,0.2.4,0.2.5,20,1,72,83,155,9,FALSE
teasim-core,0.2.3,0.2.4,19,1,72,83,155,9,FALSE
teasim-core,0.0.10,0.1.0,10,1,72,83,155,9,FALSE
teasim-core,0.2.1,0.2.2,17,1,72,83,155,9,FALSE
teasim-core,0.1.0,0.1.1,11,1,72,83,155,9,FALSE
teasim-core,0.1.1,0.1.2,12,1,72,83,155,9,FALSE
teasim-core,0.1.2,0.1.3,13,1,72,83,155,9,FALSE
teasim-core,0.1.3,0.1.4,14,1,72,83,155,9,FALSE
teasim-core,0.1.4,0.2.0,15,1,72,83,155,9,FALSE
teasim-core,1.1.4,1.1.5,67,1,72,83,155,9,FALSE
teasim-core,0.0.5,0.0.6,5,1,72,83,155,9,FALSE
teasim-core,0.0.4,0.0.5,4,1,72,83,155,9,FALSE
teasim-core,0.0.7,0.0.8,7,1,72,83,155,9,FALSE
teasim-core,0.0.6,0.0.7,6,1,72,83,155,9,FALSE
teasim-core,0.0.1,0.0.2,1,1,72,83,155,9,FALSE
teasim-core,0.0.3,0.0.4,3,1,72,83,155,9,FALSE
teasim-core,0.0.2,0.0.3,2,1,72,83,155,9,FALSE
teasim-core,0.0.8,0.0.9,8,1,72,83,155,9,FALSE
teasim-core,1.1.5,2.0.0-alpha.0,68,8,55116,12112,67228,433,FALSE
teasim-core,2.0.0,2.1.0-0,70,2,532,1,533,9,FALSE
teasim-core,0.2.2,0.2.3,18,1,72,83,155,9,FALSE
teasim-core,1.1.4,1.1.5,67,1,72,83,155,9,TRUE
teasim-core,1.0.2,1.0.3,62,2,807,695,1502,79,FALSE
teasim-core,3.0.0-1,3.0.1-alpha.1,73,1,72,83,155,9,TRUE
teasim-core,0.4.12,0.4.13,42,1,72,83,155,9,FALSE
teasim-core,0.4.4,0.4.5,35,1,72,83,155,9,TRUE
teasim-core,0.1.0,0.1.1,11,1,72,83,155,9,TRUE
teasim-core,0.7.0,0.7.2,54,1,72,83,155,9,TRUE
teasim-core,1.0.1,1.0.2,61,1,5311,5595,10906,257,TRUE
teasim-core,0.1.2,0.1.3,13,1,72,83,155,9,TRUE
teasim-core,0.8.4,1.0.0,59,1,18625,0,18625,326,TRUE
teasim-core,0.4.0,0.4.1,33,1,72,83,155,9,TRUE
teasim-core,1.0.0,1.0.1,60,8,546,45,591,21,TRUE
teasim-core,0.3.14,0.4.0,32,1,72,83,155,9,TRUE
teasim-core,0.2.2,0.2.3,18,1,72,83,155,9,TRUE
teasim-core,0.2.1,0.2.2,17,1,72,83,155,9,TRUE
teasim-core,0.7.2,0.8.0,55,1,72,83,155,9,TRUE
teasim-core,0.8.0,0.8.1,56,1,31,0,31,2,TRUE
teasim-core,3.0.0-0,3.0.0-1,72,1,72,83,155,9,TRUE
teasim-core,0.2.6,0.3.0,22,1,72,83,155,9,TRUE
teasim-core,0.6.4,0.6.16,52,1,72,83,155,9,TRUE
teasim-core,0.3.0,0.3.4,23,1,72,83,155,9,TRUE
teasim-core,2.0.0,2.1.0-0,70,2,532,1,533,9,TRUE
teasim-core,0.4.17,0.5.0,47,1,72,83,155,9,TRUE
teasim-core,0.3.11,0.3.12,29,1,72,83,155,9,TRUE
teasim-core,0.5.0,0.5.1,48,1,72,83,155,9,TRUE
violet-paginator,1.1.0,1.2.0,12,4,131,24,155,11,FALSE
violet-paginator,2.0.5,3.0.0-beta-1,40,1,2,2,4,2,FALSE
violet-paginator,2.0.4,2.0.5,39,3,96,99,195,17,FALSE
violet-paginator,1.0.0,1.1.0,11,3,5,5,10,3,FALSE
violet-paginator,2.0.2,2.0.4,38,5,5,4,9,5,FALSE
violet-paginator,2.0.1,2.0.2,37,4,90,82,172,17,FALSE
violet-paginator,2.0.0,2.0.1,36,2,121,97,218,2,FALSE
violet-paginator,1.7.2,1.8.0,24,4,354,89,443,22,FALSE
violet-paginator,0.4.0,1.0.0,10,3,361,5,366,6,FALSE
violet-paginator,0.3.2,0.3.3,6,3,3,3,6,3,FALSE
violet-paginator,0.3.3,0.3.4,7,3,12,8,20,3,FALSE
violet-paginator,0.3.4,0.3.5,8,3,11,4,15,4,FALSE
violet-paginator,0.3.5,0.4.0,9,7,550,22,572,22,FALSE
violet-paginator,1.6.0,1.6.1,20,2,13,5,18,4,FALSE
violet-paginator,1.6.1,1.7.0,21,7,653,285,938,23,FALSE
violet-paginator,1.9.1,1.10.0,31,4,63,6,69,9,FALSE
violet-paginator,1.9.0,1.9.1,30,3,39,48,87,3,FALSE
violet-paginator,1.8.0,1.8.1,25,5,76,84,160,18,FALSE
violet-paginator,1.8.1,1.8.2,26,5,95,74,169,18,FALSE
violet-paginator,1.8.2,1.8.3,27,2,3,3,6,3,FALSE
violet-paginator,1.8.3,1.8.4,28,10,97,93,190,24,FALSE
violet-paginator,1.4.0,1.5.0,17,4,162,17,179,15,TRUE
violet-paginator,3.0.0-beta-4,3.0.0-beta-5,44,1,2,2,4,2,FALSE
violet-paginator,3.0.0-beta-1,3.0.0-beta-2,41,1,2,2,4,2,FALSE
violet-paginator,3.0.0-beta-3,3.0.0-beta-4,43,1,2,2,4,2,FALSE
violet-paginator,3.0.0-beta-2,3.0.0-beta-3,42,1,2,2,4,2,FALSE
violet-paginator,1.5.1,1.6.0,19,4,638,393,1031,15,FALSE
violet-paginator,1.5.0,1.5.1,18,2,8,8,16,5,FALSE
violet-paginator,1.8.4,1.9.0,29,16,6027,1577,7604,123,FALSE
violet-paginator,1.3.1,1.4.0,16,6,344,249,593,19,FALSE
violet-paginator,1.3.0,1.3.1,15,2,97,1,98,4,FALSE
violet-paginator,1.2.0,1.2.1,13,2,50,5,55,4,FALSE
violet-paginator,1.2.1,1.3.0,14,3,143,8,151,8,FALSE
violet-paginator,1.11.1,2.0.0,35,8,4165,6786,10951,218,FALSE
violet-paginator,1.11.0,1.11.1,34,3,5,5,10,3,FALSE
violet-paginator,1.10.0,1.10.1,32,4,91,82,173,17,FALSE
violet-paginator,1.10.1,1.11.0,33,4,38,9,47,6,FALSE
violet-paginator,1.7.1,1.7.2,23,2,9,4,13,3,FALSE
violet-paginator,1.7.0,1.7.1,22,2,17,49,66,2,FALSE
violet-paginator,0.2.0,0.3.0,3,4,129,49,178,16,FALSE
violet-paginator,0.1.0,0.1.1,1,1,1157,2,1159,19,FALSE
violet-paginator,0.1.1,0.2.0,2,4,515,15,530,13,FALSE
violet-paginator,0.3.0,0.3.1,4,3,21,15,36,5,FALSE
violet-paginator,0.3.1,0.3.2,5,7,62,29,91,12,FALSE
violet-paginator,1.4.0,1.5.0,17,4,162,17,179,15,FALSE
violet-paginator,3.0.0-beta-1,3.0.0-beta-2,41,1,2,2,4,2,TRUE
violet-paginator,0.1.1,0.2.0,2,4,515,15,530,13,TRUE
violet-paginator,2.0.5,3.0.0-beta-1,40,1,2,2,4,2,TRUE
violet-paginator,1.8.1,1.8.2,26,5,95,74,169,18,TRUE
violet-paginator,1.10.0,1.10.1,32,4,91,82,173,17,TRUE
violet-paginator,1.9.1,1.10.0,31,4,63,6,69,9,TRUE
violet-paginator,2.0.4,2.0.5,39,3,96,99,195,17,TRUE
violet-paginator,2.0.2,2.0.4,38,5,5,4,9,5,TRUE
violet-paginator,1.7.2,1.8.0,24,4,354,89,443,22,TRUE
violet-paginator,1.3.0,1.3.1,15,2,97,1,98,4,TRUE
rsuite-schema,0.0.1-alpha.9,0.0.2,10,1,1,1,2,1,FALSE
rsuite-schema,0.0.1-alpha.8,0.0.1-alpha.9,9,2,4,2,6,3,FALSE
rsuite-schema,0.0.3,0.0.4,12,10,365,142,507,27,FALSE
rsuite-schema,0.0.2,0.0.3,11,1,21,4,25,3,FALSE
rsuite-schema,0.0.1-alpha.3,0.0.1-alpha.4,4,1,1,1,2,1,FALSE
rsuite-schema,0.0.1-alpha.2,0.0.1-alpha.3,3,1,36,6,42,5,FALSE
rsuite-schema,0.0.1-alpha.5,0.0.1-alpha.6,6,1,7,2,9,2,FALSE
rsuite-schema,0.0.1-alpha.4,0.0.1-alpha.5,5,1,12,3,15,2,FALSE
rsuite-schema,0.0.1-alpha.7,0.0.1-alpha.8,8,2,3,3,6,3,FALSE
rsuite-schema,0.0.1-alpha.6,0.0.1-alpha.7,7,2,2,2,4,2,FALSE
rsuite-schema,0.0.1-alpha.1,0.0.1-alpha.2,2,4,254,127,381,12,FALSE
rsuite-schema,0.0.1-alpha,0.0.1-alpha.1,1,2,3,3,6,2,FALSE
rsuite-schema,0.0.1-alpha.5,0.0.1-alpha.6,6,1,7,2,9,2,TRUE
electron-compilers,2.0.7,2.1.0,22,5,81,9,90,14,FALSE
electron-compilers,2.0.6,2.0.7,21,5,10,3,13,5,FALSE
electron-compilers,2.0.5,2.0.6,20,2,2,1,3,2,FALSE
electron-compilers,2.0.4,2.0.5,19,4,8,8,16,4,FALSE
electron-compilers,1.0.0,1.0.1,11,6,16,11,27,6,FALSE
electron-compilers,1.0.1,2.0.0-beta1,12,50,1530,972,2502,109,FALSE
electron-compilers,2.0.1,2.0.2,16,3,40,3,43,3,FALSE
electron-compilers,2.0.0,2.0.1,15,1,27,8,35,1,FALSE
electron-compilers,2.0.0-beta1,2.0.0-beta2,13,1,1,1,2,1,FALSE
electron-compilers,2.0.0-beta2,2.0.0,14,11,704,280,984,34,FALSE
electron-compilers,5.1.1,5.2.0,47,8,323,15,338,12,FALSE
electron-compilers,3.1.1,3.1.2,30,1,7,7,14,1,FALSE
electron-compilers,3.1.0,3.1.1,29,8,237,73,310,13,FALSE
electron-compilers,2.0.3,2.0.4,18,1,0,1,1,1,FALSE
electron-compilers,2.1.2,2.1.3,25,3,25,25,50,3,FALSE
electron-compilers,2.1.3,2.1.4,26,3,24,7,31,3,FALSE
electron-compilers,2.1.0,2.1.1,23,3,7,7,14,3,FALSE
electron-compilers,2.1.1,2.1.2,24,3,25,25,50,3,FALSE
electron-compilers,5.0.0,5.0.1,44,2,3,3,6,3,FALSE
electron-compilers,2.1.4,3.0.0,27,3,8,8,16,7,FALSE
electron-compilers,2.0.2,2.0.3,17,2,1,5,6,2,FALSE
electron-compilers,4.0.1,4.0.2,37,3,15,17,32,3,FALSE
electron-compilers,4.0.0,4.0.1,36,1,1,1,2,1,FALSE
electron-compilers,4.0.3,4.0.4,39,3,7,4,11,4,FALSE
electron-compilers,4.0.2,4.0.3,38,2,5,2,7,2,FALSE
electron-compilers,4.0.5,4.0.6,41,2,2,2,4,2,FALSE
electron-compilers,3.1.5,3.1.6,34,5,28,13,41,5,FALSE
electron-compilers,4.0.6,4.0.7,42,4,5,5,10,5,FALSE
electron-compilers,0.6.2,0.7.0,4,11,174,23,197,13,FALSE
electron-compilers,0.6.1,0.6.2,3,2,9,4,13,2,FALSE
electron-compilers,3.1.4,3.1.5,33,2,3,3,6,3,FALSE
electron-compilers,0.7.2,0.8.0,7,7,62,16,78,7,FALSE
electron-compilers,0.7.0,0.7.1,5,3,3,3,6,3,FALSE
electron-compilers,0.7.1,0.7.2,6,2,2,2,4,2,FALSE
electron-compilers,5.2.4,5.2.5,52,2,2,2,4,2,FALSE
electron-compilers,5.8.0,5.8.1,63,5,9,4,13,5,FALSE
electron-compilers,5.8.1,5.8.2,64,2,4,6,10,2,FALSE
electron-compilers,5.8.2,5.8.3,65,5,22,34,56,5,FALSE
electron-compilers,5.8.3,5.9.0,66,5,84,4,88,6,FALSE
electron-compilers,0.5.0,0.6.0,1,1,2,2,4,1,FALSE
electron-compilers,5.7.0-beta.1,5.7.0,61,1,1,1,2,1,FALSE
electron-compilers,5.5.1,5.6.0,59,6,67,35,102,9,FALSE
electron-compilers,3.0.0,3.1.0,28,6,123,38,161,10,FALSE
electron-compilers,5.5.0,5.5.1,58,2,2,2,4,2,FALSE
electron-compilers,0.8.1,0.8.2,9,2,5,1,6,2,FALSE
electron-compilers,0.8.0,0.8.1,8,2,2,2,4,2,FALSE
electron-compilers,0.8.2,1.0.0,10,6,30,140,170,9,FALSE
electron-compilers,5.2.2,5.2.3,50,4,33,15,48,6,FALSE
electron-compilers,5.2.3,5.2.4,51,3,3,3,6,3,FALSE
electron-compilers,5.2.0,5.2.1,48,4,27,9,36,4,FALSE
electron-compilers,5.2.1,5.2.2,49,4,53,35,88,7,FALSE
electron-compilers,3.1.3,3.1.4,32,3,14,11,25,3,FALSE
electron-compilers,5.2.5,5.3.0,53,2,33,33,66,3,FALSE
electron-compilers,5.4.0,5.5.0,57,22,433,300,733,38,FALSE
electron-compilers,5.3.2,5.4.0,56,11,324,141,465,25,FALSE
electron-compilers,5.3.1,5.3.2,55,2,2,4,6,2,FALSE
electron-compilers,4.0.4,4.0.5,40,2,2,2,4,2,FALSE
electron-compilers,5.3.0,5.3.1,54,3,3,3,6,3,FALSE
electron-compilers,5.0.1,5.1.0,45,6,245,5,250,9,FALSE
electron-compilers,3.1.6,4.0.0,35,11,136,54,190,19,FALSE
electron-compilers,5.1.0,5.1.1,46,2,6,3,9,3,FALSE
electron-compilers,5.7.0,5.8.0,62,4,72,2,74,8,FALSE
electron-compilers,3.1.2,3.1.3,31,5,24,34,58,13,FALSE
electron-compilers,5.6.0,5.7.0-beta.1,60,2,2,2,4,2,FALSE
electron-compilers,0.6.0,0.6.1,2,2,2,2,4,2,FALSE
electron-compilers,0.5.0,0.6.0,1,1,2,2,4,1,TRUE
electron-compilers,5.2.2,5.2.3,50,4,33,15,48,6,TRUE
electron-compilers,2.0.7,2.1.0,22,5,81,9,90,14,TRUE
electron-compilers,2.1.2,2.1.3,25,3,25,25,50,3,TRUE
electron-compilers,3.1.5,3.1.6,34,5,28,13,41,5,TRUE
electron-compilers,0.7.0,0.7.1,5,3,3,3,6,3,TRUE
electron-compilers,5.4.0,5.5.0,57,22,433,300,733,38,TRUE
electron-compilers,0.6.0,0.6.1,2,2,2,2,4,2,TRUE
electron-compilers,5.5.1,5.6.0,59,6,67,35,102,9,TRUE
electron-compilers,4.0.2,4.0.3,38,2,5,2,7,2,TRUE
electron-compilers,5.8.1,5.8.2,64,2,4,6,10,2,TRUE
electron-compilers,5.8.3,5.9.0,66,5,84,4,88,6,TRUE
electron-compilers,4.0.1,4.0.2,37,3,15,17,32,3,TRUE
electron-compilers,4.0.0,4.0.1,36,1,1,1,2,1,TRUE
electron-compilers,5.3.2,5.4.0,56,11,324,141,465,25,TRUE
electron-compilers,5.6.0,5.7.0-beta.1,60,2,2,2,4,2,TRUE
electron-compilers,0.6.2,0.7.0,4,11,174,23,197,13,TRUE
electron-compilers,3.1.6,4.0.0,35,11,136,54,190,19,TRUE
arid,0.9.0,0.10.0,13,2,19,15,34,6,FALSE
arid,0.10.0,0.11.0,14,2,13,13,26,4,FALSE
arid,0.6.0,0.7.0,10,1,31,31,62,4,FALSE
arid,0.11.0,0.12.0,15,2,21,14,35,4,FALSE
arid,0.7.0,0.8.0,11,3,572,160,732,7,FALSE
arid,0.17.0,0.18.0,21,2,91,109,200,5,FALSE
arid,0.12.0,0.13.0,16,2,183,184,367,6,FALSE
arid,0.20.0,0.21.0,24,2,57,15,72,5,FALSE
arid,0.16.0,0.17.0,20,1,48,22,70,9,FALSE
arid,0.4.0,0.5.0,8,5,2147,331,2478,11,FALSE
arid,0.23.0,0.24.0,27,2,326,311,637,5,FALSE
arid,0.5.0,0.6.0,9,1,42,25,67,7,FALSE
arid,0.13.0,0.14.0,17,2,132,128,260,9,TRUE
arid,0.15.0,0.16.0,19,2,86,65,151,5,FALSE
arid,0.19.0,0.20.0,23,2,116,115,231,5,FALSE
arid,0.14.0,0.15.0,18,2,36,35,71,6,FALSE
arid,0.22.0,0.23.0,26,2,116,135,251,5,FALSE
arid,0.24.0,0.25.0,28,3,78,75,153,6,FALSE
arid,0.21.0,0.22.0,25,1,24,66,90,3,FALSE
arid,0.8.0,0.9.0,12,2,9,9,18,4,FALSE
arid,0.18.0,0.19.0,22,2,54,47,101,5,FALSE
arid,0.18.0,0.19.0,22,2,54,47,101,5,TRUE
arid,0.13.0,0.14.0,17,2,132,128,260,9,FALSE
arid,0.12.0,0.13.0,16,2,183,184,367,6,TRUE
ng2-avatar,1.0.0,1.0.1,1,4,276,429,705,33,FALSE
ng2-avatar,1.0.1,1.0.2,2,2,7,7,14,2,FALSE
ng2-avatar,1.0.2,1.0.3,3,3,4,4,8,3,FALSE
ng2-avatar,1.0.0,1.0.1,1,4,276,429,705,33,TRUE
react-plotlyjs,0.4.0,0.4.1,14,1,3,2,5,1,FALSE
react-plotlyjs,0.3.6,0.3.7,12,3,28,18,46,4,FALSE
react-plotlyjs,0.3.7,0.4.0,13,5,30,32,62,6,FALSE
react-plotlyjs,0.1.0,0.1.1,1,1,70,2,72,3,FALSE
react-plotlyjs,0.1.1,0.1.2,2,1,8,5,13,4,FALSE
react-plotlyjs,0.1.2,0.2.0,3,1,13,11,24,3,FALSE
react-plotlyjs,0.3.2,0.3.3,8,1,3,1,4,1,FALSE
react-plotlyjs,0.3.3,0.3.4,9,5,13,5,18,7,FALSE
react-plotlyjs,0.3.0,0.3.1,6,4,15,15,30,6,FALSE
react-plotlyjs,0.3.1,0.3.2,7,2,6,2,8,3,FALSE
react-plotlyjs,0.3.4,0.3.5,10,2,9,9,18,3,FALSE
react-plotlyjs,0.3.5,0.3.6,11,3,11,20,31,5,FALSE
react-plotlyjs,0.2.1,0.3.0,5,3,30,6,36,4,FALSE
react-plotlyjs,0.2.0,0.2.1,4,5,12,16,28,7,FALSE
react-plotlyjs,0.3.0,0.3.1,6,4,15,15,30,6,TRUE
react-plotlyjs,0.3.1,0.3.2,7,2,6,2,8,3,TRUE
rawblock,1.0.0,1.0.1,66,5,134,43,177,21,FALSE
rawblock,1.0.1,2.0.0,67,21,26190,12321,38511,257,FALSE
rawblock,2.0.0,2.1.0,68,15,21705,15610,37315,344,FALSE
rawblock,2.3.0,2.3.1,77,10,6838,2466,9304,122,FALSE
rawblock,2.3.1,2.3.2,78,2,591,15,606,8,FALSE
rawblock,2.2.1,2.2.2,74,1,196,243,439,8,FALSE
rawblock,2.2.0,2.2.1,73,2,1229,536,1765,32,FALSE
rawblock,2.2.3,2.3.0,76,2,38,9,47,7,FALSE
rawblock,2.2.2,2.2.3,75,3,1202,894,2096,46,FALSE
rawblock,2.1.2,2.1.3,71,4,575,200,775,26,FALSE
rawblock,2.1.3,2.2.0,72,6,482,185,667,21,FALSE
rawblock,2.1.0,2.1.1,69,2,651,102,753,21,FALSE
rawblock,2.1.1,2.1.2,70,7,4797,2568,7365,198,FALSE
rawblock,0.2.24,0.3.1,31,10,821,167,988,31,FALSE
rawblock,0.3.1,0.3.3,32,6,309,38,347,14,FALSE
rawblock,0.2.22,0.2.23,29,1,48,1,49,2,FALSE
rawblock,0.2.23,0.2.24,30,1,3,2,5,2,FALSE
rawblock,0.2.20,0.2.21,27,1,14,2,16,3,FALSE
rawblock,0.2.21,0.2.22,28,1,6,11,17,3,FALSE
rawblock,0.3.6,0.3.8,35,4,38,9,47,6,FALSE
rawblock,0.2.0,0.2.1,7,3,872,707,1579,13,FALSE
rawblock,0.2.7,0.2.8,14,6,137,120,257,28,FALSE
rawblock,0.2.6,0.2.7,13,69,12146,4637,16783,651,FALSE
rawblock,0.2.5,0.2.6,12,35,3296,2874,6170,214,FALSE
rawblock,0.2.4,0.2.5,11,30,3177,2376,5553,252,FALSE
rawblock,0.2.3,0.2.4,10,2,27,30,57,5,FALSE
rawblock,0.2.2,0.2.3,9,9,289,250,539,18,FALSE
rawblock,0.2.1,0.2.2,8,9,3284,662,3946,50,FALSE
rawblock,0.1.1,0.1.2,1,7,688,466,1154,21,FALSE
rawblock,0.1.2,0.1.3,2,16,1920,1231,3151,106,FALSE
rawblock,0.1.3,0.1.4,3,14,711,612,1323,83,FALSE
rawblock,0.1.4,0.1.5,4,27,3748,3455,7203,136,FALSE
rawblock,0.1.5,0.1.6,5,8,770,594,1364,39,FALSE
rawblock,0.2.9,0.2.10,16,4,266,235,501,27,FALSE
rawblock,0.2.8,0.2.9,15,2,94,58,152,8,FALSE
rawblock,0.7.8,0.7.9,64,7,209,4806,5015,242,FALSE
rawblock,0.7.9,1.0.0,65,4,1816,1987,3803,67,FALSE
rawblock,0.6.3,0.6.4,56,1,196,243,439,8,FALSE
rawblock,0.3.3,0.3.4,33,2,53,6,59,7,FALSE
rawblock,0.6.1,0.6.2,54,1,196,243,439,8,FALSE
rawblock,0.6.0,0.6.1,53,3,61,13,74,6,FALSE
rawblock,0.7.2,0.7.3,61,18,1221,617,1838,49,FALSE
rawblock,0.7.3,0.7.4,62,8,304,182,486,16,FALSE
rawblock,0.3.4,0.3.6,34,3,12,18,30,5,FALSE
rawblock,0.6.4,0.6.5,57,2,6,6,12,4,FALSE
rawblock,0.5.8,0.5.10,50,7,297,155,452,18,FALSE
rawblock,0.1.6,0.2.0,6,25,2779,2405,5184,174,FALSE
rawblock,0.4.1,0.4.2,38,29,2277,1587,3864,141,FALSE
rawblock,0.5.5,0.5.6,47,3,293,46,339,11,FALSE
rawblock,0.4.3,0.4.4,40,2,4,3,7,3,FALSE
rawblock,0.4.2,0.4.3,39,4,96,66,162,4,FALSE
rawblock,0.4.4,0.5.0,41,27,1306,566,1872,55,FALSE
rawblock,0.5.3,0.5.4,45,2,102,11,113,7,FALSE
rawblock,0.5.11,0.6.0,52,5,144,126,270,11,FALSE
rawblock,0.2.19,0.2.20,26,2,132,122,254,2,FALSE
rawblock,0.2.18,0.2.19,25,5,63,32,95,16,FALSE
rawblock,0.2.17,0.2.18,24,3,182,94,276,14,FALSE
rawblock,0.2.16,0.2.17,23,5,280,173,453,19,FALSE
rawblock,0.2.15,0.2.16,22,5,185,109,294,18,FALSE
rawblock,0.2.14,0.2.15,21,8,224,83,307,15,FALSE
rawblock,0.2.13,0.2.14,20,1,13,3,16,2,FALSE
rawblock,0.3.8,0.3.10,36,21,1496,1319,2815,115,FALSE
rawblock,0.2.11,0.2.12,18,1,27,6,33,3,FALSE
rawblock,0.2.12,0.2.13,19,4,926,703,1629,16,FALSE
rawblock,0.5.4,0.5.5,46,1,1,1,2,1,FALSE
rawblock,0.6.5,0.7.0,58,29,894,548,1442,73,FALSE
rawblock,0.2.10,0.2.11,17,8,465,224,689,53,FALSE
rawblock,0.5.6,0.5.7,48,1,65,41,106,7,FALSE
rawblock,0.5.7,0.5.8,49,1,196,243,439,8,FALSE
rawblock,0.7.0,0.7.1,59,4,60,38,98,4,FALSE
rawblock,0.5.0,0.5.1,42,9,357,153,510,27,FALSE
rawblock,0.5.10,0.5.11,51,2,41,96,137,13,FALSE
rawblock,0.5.1,0.5.2,43,2,21,7,28,6,FALSE
rawblock,0.5.2,0.5.3,44,3,26,11,37,4,FALSE
rawblock,0.6.2,0.6.3,55,1,21,7,28,3,FALSE
rawblock,0.7.1,0.7.2,60,2,97,2,99,5,FALSE
rawblock,0.7.4,0.7.8,63,6,37,13,50,6,FALSE
rawblock,2.1.1,2.1.2,70,7,4797,2568,7365,198,TRUE
rawblock,0.2.5,0.2.6,12,35,3296,2874,6170,214,TRUE
rawblock,0.2.2,0.2.3,9,9,289,250,539,18,TRUE
rawblock,0.5.4,0.5.5,46,1,1,1,2,1,TRUE
rawblock,0.7.4,0.7.8,63,6,37,13,50,6,TRUE
rawblock,0.6.0,0.6.1,53,3,61,13,74,6,TRUE
rawblock,0.6.5,0.7.0,58,29,894,548,1442,73,TRUE
rawblock,0.1.5,0.1.6,5,8,770,594,1364,39,TRUE
rawblock,0.2.4,0.2.5,11,30,3177,2376,5553,252,TRUE
rawblock,0.1.6,0.2.0,6,25,2779,2405,5184,174,TRUE
rawblock,0.1.3,0.1.4,3,14,711,612,1323,83,TRUE
rawblock,0.2.8,0.2.9,15,2,94,58,152,8,TRUE
rawblock,0.2.6,0.2.7,13,69,12146,4637,16783,651,TRUE
rawblock,0.2.14,0.2.15,21,8,224,83,307,15,TRUE
rawblock,0.2.12,0.2.13,19,4,926,703,1629,16,TRUE
formidable-playbook-docs,1.1.1,1.1.2,3,1,1,1,2,1,FALSE
formidable-playbook-docs,1.1.0,1.1.1,2,6,34,12,46,6,FALSE
formidable-playbook-docs,1.0.0,1.1.0,1,2,4,5,9,2,FALSE
formidable-playbook-docs,1.0.0,1.1.0,1,2,4,5,9,2,TRUE
theo,2.0.2,2.0.22,31,1,8,13,21,1,FALSE
theo,2.0.1,2.0.2,30,1,8,13,21,1,FALSE
theo,2.0.0,2.0.1,29,1,8,13,21,1,FALSE
theo,0.1.8,0.1.9,18,1,8,13,21,1,FALSE
theo,0.1.9,0.1.10,19,1,8,13,21,1,FALSE
theo,0.1.0,0.1.1,10,1,8,13,21,1,FALSE
theo,0.1.1,0.1.2,11,1,8,13,21,1,FALSE
theo,0.1.2,0.1.3,12,1,8,13,21,1,FALSE
theo,0.1.3,0.1.4,13,1,8,13,21,1,FALSE
theo,0.1.4,0.1.5,14,1,8,13,21,1,FALSE
theo,0.1.5,0.1.6,15,1,8,13,21,1,FALSE
theo,0.1.6,0.1.7,16,1,8,13,21,1,FALSE
theo,0.1.7,0.1.8,17,1,8,13,21,1,FALSE
theo,0.0.5,0.0.6,5,1,8,13,21,1,FALSE
theo,0.0.4,0.0.5,4,1,8,13,21,1,FALSE
theo,0.0.7,0.0.8,7,1,8,13,21,1,FALSE
theo,0.0.1,0.0.2,1,1,8,13,21,1,FALSE
theo,0.0.3,0.0.4,3,1,8,13,21,1,FALSE
theo,0.0.2,0.0.3,2,1,8,13,21,1,FALSE
theo,0.1.23,2.0.0,28,1,8,13,21,1,FALSE
theo,0.1.22,0.1.23,27,1,8,13,21,1,FALSE
theo,0.1.21,0.1.22,26,1,8,13,21,1,FALSE
theo,0.1.20,0.1.21,25,1,8,13,21,1,FALSE
theo,0.0.9,0.1.0,9,1,8,13,21,1,FALSE
theo,0.0.8,0.0.9,8,1,8,13,21,1,FALSE
theo,2.0.26,2.1.0,36,1,8,13,21,1,FALSE
theo,2.0.24,2.0.25,34,1,8,13,21,1,FALSE
theo,2.0.25,2.0.26,35,1,8,13,21,1,FALSE
theo,2.0.22,2.0.23,32,1,8,13,21,1,FALSE
theo,2.0.23,2.0.24,33,1,8,13,21,1,FALSE
theo,2.1.0,2.1.1,37,1,8,13,21,1,FALSE
theo,0.0.6,0.0.7,6,1,8,13,21,1,FALSE
theo,0.1.12,0.1.13,22,1,8,13,21,1,FALSE
theo,0.1.13,0.1.14,23,1,8,13,21,1,FALSE
theo,0.1.10,0.1.11,20,1,8,13,21,1,FALSE
theo,0.1.11,0.1.12,21,1,8,13,21,1,FALSE
theo,0.1.14,0.1.20,24,1,8,13,21,1,FALSE
theo,6.0.0-alpha.2,6.0.0-alpha.3,79,2,2,3,5,2,FALSE
theo,6.0.0-alpha.3,6.0.0-alpha.4,80,2,5,1,6,2,FALSE
theo,6.0.0-alpha.1,6.0.0-alpha.2,78,9,734,165,899,24,FALSE
theo,6.0.0-alpha.4,6.0.0-alpha.5,81,10,157,9,166,15,FALSE
theo,6.0.0-alpha.5,6.0.0-alpha.6,82,12,457,235,692,18,FALSE
theo,5.0.0-rc.3,5.0.0-rc.4,72,1,8,13,21,1,FALSE
theo,5.0.0-rc.2,5.0.0-rc.3,71,1,8,13,21,1,FALSE
theo,5.0.0-rc.1,5.0.0-rc.2,70,1,8,13,21,1,FALSE
theo,5.0.0-rc.7,5.0.0,76,1,8,13,21,1,FALSE
theo,5.0.0-beta.7,5.0.0-rc.1,69,1,8,13,21,1,FALSE
theo,5.0.0-rc.5,5.0.0-rc.6,74,1,8,13,21,1,FALSE
theo,5.0.0-rc.4,5.0.0-rc.5,73,1,8,13,21,1,FALSE
theo,5.0.0-rc.6,5.0.0-rc.7,75,1,8,13,21,1,FALSE
theo,5.0.0,6.0.0-alpha.1,77,39,5845,185,6030,129,FALSE
theo,5.0.0-beta.3,5.0.0-beta.4,65,1,8,13,21,1,FALSE
theo,5.0.0-beta.1,5.0.0-beta.2,63,1,8,13,21,1,FALSE
theo,5.0.0-beta.6,5.0.0-beta.7,68,1,8,13,21,1,FALSE
theo,5.0.0-beta.4,5.0.0-beta.5,66,1,8,13,21,1,FALSE
theo,5.0.0-beta.5,5.0.0-beta.6,67,1,8,13,21,1,FALSE
theo,5.0.0-beta.2,5.0.0-beta.3,64,1,8,13,21,1,FALSE
theo,4.2.1,4.3.0,61,1,8,13,21,1,TRUE
theo,4.3.0,5.0.0-beta.1,62,1,8,13,21,1,FALSE
theo,3.0.6,3.0.7,45,1,8,13,21,1,FALSE
theo,3.0.7,3.0.8,46,1,8,13,21,1,FALSE
theo,3.0.4,3.0.5,43,1,8,13,21,1,FALSE
theo,3.0.5,3.0.6,44,1,8,13,21,1,FALSE
theo,3.0.2,3.0.3,41,1,8,13,21,1,FALSE
theo,3.0.8,3.0.9,47,1,8,13,21,1,FALSE
theo,3.0.9,3.0.10,48,1,8,13,21,1,FALSE
theo,3.1.0,3.2.0,52,1,8,13,21,1,FALSE
theo,2.1.1,3.0.0,38,1,8,13,21,1,FALSE
theo,3.0.3,3.0.4,42,1,8,13,21,1,FALSE
theo,4.0.1,4.1.0,58,1,8,13,21,1,FALSE
theo,4.0.0,4.0.1,57,1,8,13,21,1,FALSE
theo,4.0.0-beta2,4.0.0-beta3,55,1,8,13,21,1,FALSE
theo,4.1.0,4.2.0,59,1,8,13,21,1,FALSE
theo,3.0.0,3.0.1,39,1,8,13,21,1,FALSE
theo,3.0.1,3.0.2,40,1,8,13,21,1,FALSE
theo,3.0.12,3.1.0,51,1,8,13,21,1,FALSE
theo,3.0.10,3.0.11,49,1,8,13,21,1,FALSE
theo,3.0.11,3.0.12,50,1,8,13,21,1,FALSE
theo,4.0.0-beta3,4.0.0,56,1,8,13,21,1,FALSE
theo,4.2.1,4.3.0,61,1,8,13,21,1,FALSE
theo,4.2.0,4.2.1,60,1,8,13,21,1,FALSE
theo,3.2.0,4.0.0-beta1,53,1,8,13,21,1,FALSE
theo,4.0.0-beta1,4.0.0-beta2,54,1,8,13,21,1,FALSE
theo,0.1.11,0.1.12,21,1,8,13,21,1,TRUE
theo,3.0.4,3.0.5,43,1,8,13,21,1,TRUE
theo,0.1.13,0.1.14,23,1,8,13,21,1,TRUE
theo,3.0.3,3.0.4,42,1,8,13,21,1,TRUE
theo,6.0.0-alpha.1,6.0.0-alpha.2,78,9,734,165,899,24,TRUE
theo,3.0.5,3.0.6,44,1,8,13,21,1,TRUE
theo,3.0.8,3.0.9,47,1,8,13,21,1,TRUE
theo,0.1.5,0.1.6,15,1,8,13,21,1,TRUE
theo,0.1.3,0.1.4,13,1,8,13,21,1,TRUE
theo,5.0.0-beta.2,5.0.0-beta.3,64,1,8,13,21,1,TRUE
express-json-data,1.1.1,1.1.2,4,21,120,87,207,34,FALSE
express-json-data,1.1.0,1.1.1,3,3,52,16,68,5,FALSE
express-json-data,1.0.0,1.0.1,1,2,3,3,6,2,FALSE
express-json-data,1.0.1,1.1.0,2,3,10,10,20,3,FALSE
express-json-data,1.0.1,1.1.0,2,3,10,10,20,3,TRUE
date-time-format-timezone,1.0.16,1.0.17,4,9,397209,1271,398480,958,FALSE
date-time-format-timezone,1.0.17,1.0.18,5,2,204,16,220,14,FALSE
date-time-format-timezone,1.0.19-0,1.0.20-alpha.1,7,2,19,12,31,3,FALSE
date-time-format-timezone,1.0.20-alpha.2,1.0.20,9,3,47,1,48,5,FALSE
date-time-format-timezone,1.0.21-alpha.1,1.0.21-alpha.2,12,8,283,52,335,21,FALSE
date-time-format-timezone,1.0.20-alpha.1,1.0.20-alpha.2,8,1,10,9,19,1,FALSE
date-time-format-timezone,1.0.21-alpha.0,1.0.21-alpha.1,11,12,1341,208,1549,31,FALSE
date-time-format-timezone,1.0.18,1.0.19-0,6,1,1,1,2,1,FALSE
date-time-format-timezone,1.0.20,1.0.21-alpha.0,10,1,1,1,2,1,FALSE
date-time-format-timezone,1.0.14,1.0.15,2,1,1,1,2,1,FALSE
date-time-format-timezone,1.0.13,1.0.14,1,1,1,1,2,1,FALSE
date-time-format-timezone,1.0.15,1.0.16,3,1,1,1,2,1,FALSE
date-time-format-timezone,1.0.21-alpha.0,1.0.21-alpha.1,11,12,1341,208,1549,31,TRUE
cdkey,1.0.4,1.0.5,6,3,11,4,15,5,FALSE
cdkey,1.0.5,1.0.6,7,3,22,10,32,7,FALSE
cdkey,1.0.0,1.0.1,2,1,33,6,39,4,FALSE
cdkey,1.0.1,1.0.2,3,5,347,205,552,13,TRUE
cdkey,1.0.2,1.0.3,4,1,2,1,3,1,FALSE
cdkey,1.0.3,1.0.4,5,1,14,12,26,5,FALSE
cdkey,1.0.1,1.0.2,3,5,347,205,552,13,FALSE
asyncbox,2.3.0,2.3.1,18,3,3,3,6,3,FALSE
asyncbox,1.0.4,1.0.5,5,2,2,1,3,2,FALSE
asyncbox,1.0.5,1.0.6,6,3,13,7,20,3,FALSE
asyncbox,1.0.6,1.0.7,7,2,2,4,6,2,FALSE
asyncbox,1.0.7,1.0.8,8,2,66,4,70,3,FALSE
asyncbox,1.0.0,1.0.1,1,2,80,9,89,4,FALSE
asyncbox,1.0.1,1.0.2,2,2,4,11,15,3,FALSE
asyncbox,1.0.2,1.0.3,3,2,67,5,72,5,FALSE
asyncbox,1.0.3,1.0.4,4,2,53,3,56,4,FALSE
asyncbox,1.0.8,1.0.9,9,2,31,1,32,3,FALSE
asyncbox,2.0.4,2.1.0,15,2,96,3,99,4,FALSE
asyncbox,2.0.3,2.0.4,14,2,3,3,6,2,FALSE
asyncbox,2.0.2,2.0.3,13,2,4,4,8,2,TRUE
asyncbox,2.0.1,2.0.2,12,1,1,1,2,1,FALSE
asyncbox,2.0.0,2.0.1,11,2,13,9,22,4,FALSE
asyncbox,2.2.0,2.3.0,17,8,199,93,292,15,FALSE
asyncbox,2.1.0,2.2.0,16,3,45,15,60,5,FALSE
asyncbox,1.0.5,1.0.6,6,3,13,7,20,3,TRUE
asyncbox,1.0.9,2.0.0,10,2,31,61,92,6,FALSE
asyncbox,2.0.2,2.0.3,13,2,4,4,8,2,FALSE
asyncbox,1.0.3,1.0.4,4,2,53,3,56,4,TRUE
asyncbox,2.3.0,2.3.1,18,3,3,3,6,3,TRUE
trail-instrument-http,1.1.0,2.0.0,6,1,1,1,2,1,FALSE
trail-instrument-http,1.0.0,1.0.1,3,3,12,4,16,3,FALSE
trail-instrument-http,1.0.1,1.0.2,4,3,31,33,64,11,FALSE
trail-instrument-http,1.0.2,1.1.0,5,5,51,20,71,12,FALSE
trail-instrument-http,2.0.0,2.1.0,7,1,1,1,2,1,FALSE
trail-instrument-http,2.3.0,2.4.0,10,1,1,1,2,1,FALSE
trail-instrument-http,2.2.0,2.3.0,9,1,1,1,2,1,FALSE
trail-instrument-http,0.1.0,0.1.1,1,3,18,26,44,4,FALSE
trail-instrument-http,0.1.1,1.0.0,2,3,10,5,15,5,FALSE
trail-instrument-http,2.1.0,2.2.0,8,1,1,1,2,1,FALSE
trail-instrument-http,2.2.0,2.3.0,9,1,1,1,2,1,TRUE
trail-instrument-http,0.1.0,0.1.1,1,3,18,26,44,4,TRUE
webpack-angularity-solution,1.1.0,1.2.0,27,1,78,11,89,5,FALSE
webpack-angularity-solution,1.0.0,1.0.1,25,1,1,2,3,2,FALSE
webpack-angularity-solution,1.0.1,1.1.0,26,2,3,3,6,3,FALSE
webpack-angularity-solution,1.4.1,1.4.2,31,1,4,6,10,2,FALSE
webpack-angularity-solution,0.9.0,0.9.1,14,1,41,31,72,3,FALSE
webpack-angularity-solution,0.2.1,0.3.0,5,1,11,15,26,2,FALSE
webpack-angularity-solution,0.2.0,0.2.1,4,1,4,4,8,1,FALSE
webpack-angularity-solution,0.1.1,0.2.0,3,1,43,13,56,3,FALSE
webpack-angularity-solution,0.12.0,0.13.0,18,1,2,2,4,2,FALSE
webpack-angularity-solution,0.10.0,0.11.0,16,1,69,38,107,5,FALSE
webpack-angularity-solution,0.0.1,0.0.2,1,1,16,1,17,2,FALSE
webpack-angularity-solution,0.0.2,0.1.1,2,3,32,94,126,6,FALSE
webpack-angularity-solution,0.3.0,0.4.0,6,1,11,9,20,2,FALSE
webpack-angularity-solution,0.6.0,0.8.0,11,4,113,84,197,14,FALSE
webpack-angularity-solution,0.11.0,0.12.0,17,1,11,9,20,2,FALSE
webpack-angularity-solution,1.6.0,1.6.1,35,1,57,16,73,9,FALSE
webpack-angularity-solution,0.16.0,0.17.0,23,28,814,1467,2281,69,FALSE
webpack-angularity-solution,0.4.0,0.5.0,7,1,13,13,26,2,FALSE
webpack-angularity-solution,0.5.0,0.5.1,8,1,2,2,4,1,FALSE
webpack-angularity-solution,0.5.1,0.5.2,9,1,3,3,6,1,FALSE
webpack-angularity-solution,0.5.2,0.6.0,10,4,583,252,835,22,FALSE
webpack-angularity-solution,0.13.1,0.14.0,20,4,24,26,50,19,FALSE
webpack-angularity-solution,0.15.0,0.16.0,22,1,9,5,14,3,FALSE
webpack-angularity-solution,0.9.1,0.10.0,15,1,240,110,350,13,FALSE
webpack-angularity-solution,1.4.2,1.5.0,32,1,5730,19,5749,5,FALSE
webpack-angularity-solution,0.14.0,0.15.0,21,4,40,22,62,5,FALSE
webpack-angularity-solution,0.8.1,0.9.0,13,2,10,4,14,7,FALSE
webpack-angularity-solution,1.5.1,1.6.0,34,2,153,39,192,5,FALSE
webpack-angularity-solution,0.8.0,0.8.1,12,1,109,51,160,3,FALSE
webpack-angularity-solution,1.5.0,1.5.1,33,2,1,5674,5675,2,FALSE
webpack-angularity-solution,1.3.0,1.4.0,29,10,298,118,416,31,FALSE
webpack-angularity-solution,1.2.0,1.3.0,28,1,2,2,4,1,FALSE
webpack-angularity-solution,1.4.0,1.4.1,30,1,7,2,9,2,FALSE
webpack-angularity-solution,0.13.0,0.13.1,19,1,2,2,4,2,FALSE
webpack-angularity-solution,0.4.0,0.5.0,7,1,13,13,26,2,TRUE
webpack-angularity-solution,0.5.2,0.6.0,10,4,583,252,835,22,TRUE
webpack-angularity-solution,0.14.0,0.15.0,21,4,40,22,62,5,TRUE
webpack-angularity-solution,0.11.0,0.12.0,17,1,11,9,20,2,TRUE
webpack-angularity-solution,0.2.0,0.2.1,4,1,4,4,8,1,TRUE
webpack-angularity-solution,0.1.1,0.2.0,3,1,43,13,56,3,TRUE
webpack-angularity-solution,1.4.0,1.4.1,30,1,7,2,9,2,TRUE
webpack-angularity-solution,0.12.0,0.13.0,18,1,2,2,4,2,TRUE
json-views-express-middleware,1.0.4,1.0.5,3,3,16,12,28,5,FALSE
json-views-express-middleware,1.0.5,1.0.6,4,1,11,10,21,2,FALSE
json-views-express-middleware,1.0.6,1.0.7,5,3,9,7,16,4,FALSE
json-views-express-middleware,1.0.7,1.0.8,6,1,6,7,13,6,FALSE
json-views-express-middleware,1.0.2,1.0.3,1,1,1,1,2,1,FALSE
json-views-express-middleware,1.0.3,1.0.4,2,3,18,4,22,7,FALSE
json-views-express-middleware,1.0.8,1.1.0,7,1,2,2,4,1,FALSE
json-views-express-middleware,1.0.5,1.0.6,4,1,11,10,21,2,TRUE
json-views-express-middleware,1.0.6,1.0.7,5,3,9,7,16,4,TRUE
json-views-express-middleware,1.0.8,1.1.0,7,1,2,2,4,1,TRUE
build-control,0.0.1,0.2.0,1,42,15258,3626,18884,277,FALSE
build-control,0.3.2,0.3.3,3,3,30,3,33,3,FALSE
build-control,0.3.3,0.3.4,4,8,35,37,72,10,FALSE
build-control,0.3.6,0.3.7,7,5,50,18,68,10,FALSE
build-control,0.3.7,0.3.8,8,2,12,14,26,4,FALSE
build-control,0.3.4,0.3.5,5,2,5,5,10,3,FALSE
build-control,0.3.5,0.3.6,6,4,34,30,64,5,FALSE
build-control,0.2.0,0.3.2,2,29,614,7590,8204,53,FALSE
build-control,0.2.0,0.3.2,2,29,614,7590,8204,53,TRUE
react-password-mask,2.4.3,2.4.4,27,2,3,3,6,2,FALSE
react-password-mask,2.4.2,2.4.3,26,2,15,10,25,5,FALSE
react-password-mask,2.4.1,2.4.2,25,2,2,2,4,2,FALSE
react-password-mask,2.4.0,2.4.1,24,2,5,3,8,3,FALSE
react-password-mask,2.4.4,2.4.5,28,3,15,9,24,5,FALSE
react-password-mask,1.1.1,1.1.2,4,3,73,51,124,7,FALSE
react-password-mask,1.1.0,1.1.1,3,2,30,5,35,6,FALSE
react-password-mask,1.1.3,2.0.0,6,3,15,50,65,9,FALSE
react-password-mask,1.1.2,1.1.3,5,2,8,11,19,6,FALSE
react-password-mask,2.0.3,2.1.0,10,23,785,640,1425,59,FALSE
react-password-mask,1.0.1,1.0.2,1,2,5,1,6,2,FALSE
react-password-mask,1.0.2,1.1.0,2,4,21730,9,21739,12,FALSE
react-password-mask,2.0.0,2.0.1,7,3,35,26,61,8,FALSE
react-password-mask,2.2.0,2.3.0,13,4,76,20,96,9,FALSE
react-password-mask,2.1.0,2.1.1,11,1,1,1,2,1,FALSE
react-password-mask,2.1.1,2.2.0,12,21,170,176,346,36,FALSE
react-password-mask,2.0.2,2.0.3,9,10,442,21757,22199,24,FALSE
react-password-mask,2.0.1,2.0.2,8,4,96,8,104,6,FALSE
react-password-mask,2.3.8,2.3.9,22,4,6,310,316,5,FALSE
react-password-mask,2.3.9,2.4.0,23,4,144,195,339,14,FALSE
react-password-mask,2.3.0,2.3.1,14,9,353,41,394,23,FALSE
react-password-mask,2.3.1,2.3.2,15,2,1,3,4,3,FALSE
react-password-mask,2.3.2,2.3.3,16,5,232,404,636,17,FALSE
react-password-mask,2.3.3,2.3.4,17,2,6,6,12,4,FALSE
react-password-mask,2.3.4,2.3.5,18,2,2,2,4,2,FALSE
react-password-mask,2.3.5,2.3.6,19,7,28,50,78,11,FALSE
react-password-mask,2.3.6,2.3.7,20,4,3,18,21,5,FALSE
react-password-mask,2.3.7,2.3.8,21,2,3,3,6,3,FALSE
react-password-mask,2.4.5,2.4.6,29,11,111,90,201,20,FALSE
react-password-mask,2.3.6,2.3.7,20,4,3,18,21,5,TRUE
react-password-mask,2.3.1,2.3.2,15,2,1,3,4,3,TRUE
react-password-mask,2.2.0,2.3.0,13,4,76,20,96,9,TRUE
react-password-mask,2.3.0,2.3.1,14,9,353,41,394,23,TRUE
react-password-mask,2.1.1,2.2.0,12,21,170,176,346,36,TRUE
react-password-mask,2.3.9,2.4.0,23,4,144,195,339,14,TRUE
pact,1.0.0-rc.3,1.0.0-rc.4,6,4,64,29,93,11,FALSE
pact,1.0.0,2.0.0,9,26,2552,1973,4525,107,FALSE
pact,2.0.1,2.1.0,11,3,10,11,21,7,FALSE
pact,2.0.0,2.0.1,10,3,7,7,14,3,FALSE
pact,2.3.1,2.3.2,15,10,214,59,273,18,FALSE
pact,2.3.2,2.3.3,16,3,331,5,336,27,FALSE
pact,2.3.3,2.3.4,17,12,107,26,133,21,FALSE
pact,2.3.4,2.4.0,18,5,125,58,183,13,FALSE
pact,1.0.0-rc.5,1.0.0,8,23,2535,626,3161,90,FALSE
pact,1.0.0-rc.4,1.0.0-rc.5,7,10,3658,37284,40942,108,FALSE
pact,2.2.1,2.3.1,14,5,10,4,14,5,FALSE
pact,2.2.0,2.2.1,13,9,306,23,329,12,FALSE
pact,2.4.2,2.5.0,21,5,17,18,35,10,FALSE
pact,2.1.0,2.2.0,12,2,6,2,8,2,FALSE
pact,2.4.0,2.4.1,19,6,99,48,147,17,FALSE
pact,2.4.1,2.4.2,20,1,4,4,8,1,FALSE
pact,1.0.0-rc.2,1.0.0-rc.3,5,3,261,283,544,15,FALSE
pact,1.0.0-rc,1.0.0-rc.2,4,8,4799,991,5790,49,FALSE
pact,2.4.2,2.5.0,21,5,17,18,35,10,TRUE
pact,1.0.0-rc.5,1.0.0,8,23,2535,626,3161,90,TRUE
ceylon,0.6.0,0.6.1,24,3,481,544,1025,15,FALSE
ceylon,0.2.0,0.3.0,15,13,250,79,329,25,FALSE
ceylon,0.0.11,0.0.12,11,3,345,68,413,14,FALSE
ceylon,0.0.10,0.0.11,10,23,809,701,1510,71,FALSE
ceylon,0.0.13,0.1.0,13,11,4324,3676,8000,101,FALSE
ceylon,0.0.12,0.0.13,12,9,751,93,844,36,FALSE
ceylon,0.1.0,0.2.0,14,11,611,218,829,41,FALSE
ceylon,0.3.2,0.3.3,18,2,12,5,17,5,FALSE
ceylon,0.6.2,0.7.0,26,6,145,413,558,24,FALSE
ceylon,0.6.1,0.6.2,25,2,26,25,51,2,FALSE
ceylon,0.3.1,0.3.2,17,2,2,2,4,2,FALSE
ceylon,0.0.9,0.0.10,9,3,2,3,5,3,FALSE
ceylon,0.0.8,0.0.9,8,1,62,1,63,3,FALSE
ceylon,0.7.0,0.8.0,27,2,2,230,232,6,FALSE
ceylon,0.4.1,0.5.0,21,6,575,9,584,16,FALSE
ceylon,0.4.0,0.4.1,20,3,17,8,25,4,FALSE
ceylon,0.5.0,0.5.1,22,2,333,2,335,10,FALSE
ceylon,0.5.1,0.6.0,23,2,770,11,781,10,FALSE
ceylon,0.9.0,0.9.1,29,1,1,1,2,1,FALSE
ceylon,0.8.0,0.9.0,28,8,578,11,589,10,FALSE
ceylon,0.3.3,0.4.0,19,5,2681,2497,5178,39,FALSE
ceylon,0.3.0,0.3.1,16,4,13,250,263,4,FALSE
ceylon,0.2.0,0.3.0,15,13,250,79,329,25,TRUE
ceylon,0.6.1,0.6.2,25,2,26,25,51,2,TRUE
ceylon,0.7.0,0.8.0,27,2,2,230,232,6,TRUE
ceylon,0.4.1,0.5.0,21,6,575,9,584,16,TRUE
ceylon,0.9.0,0.9.1,29,1,1,1,2,1,TRUE
ceylon,0.8.0,0.9.0,28,8,578,11,589,10,TRUE
ceylon,0.6.2,0.7.0,26,6,145,413,558,24,TRUE
ceylon,0.0.5,0.0.6,5,3,9,4,13,4,FALSE
ceylon,0.0.4,0.0.5,4,32,310,351,661,60,FALSE
ceylon,0.0.7,0.0.8,7,6,93,10,103,11,FALSE
ceylon,0.0.6,0.0.7,6,1,3,5,8,2,FALSE
ceylon,0.0.3,0.0.4,3,2,3,3,6,3,FALSE
ceylon,0.0.2,0.0.3,2,6,465,19,484,19,FALSE
ceylon,0.0.13,0.1.0,13,11,4324,3676,8000,101,TRUE
timhwang21-react-popover,0.4.5,0.5.0,1,4,10,10,20,4,FALSE
timhwang21-react-popover,0.4.5,0.5.0,1,4,10,10,20,4,TRUE
d2,24.1.9,24.1.10,57,7,294,2228,2522,25,FALSE
d2,24.2.4,24.2.5,70,1,1259,251,1510,22,FALSE
d2,24.2.5,24.2.6,71,79,15035,5962,20997,372,FALSE
d2,24.2.3,24.2.4,69,1,1259,251,1510,22,FALSE
d2,24.2.0,24.2.1,67,1,1259,251,1510,22,FALSE
d2,24.2.1,24.2.3,68,15,3424,1963,5387,69,FALSE
d2,24.1.1,24.1.2,49,2,270,178,448,5,FALSE
d2,24.1.0,24.1.1,48,2,7,4,11,2,FALSE
d2,24.1.3,24.1.4,51,1,1,1,2,1,FALSE
d2,24.1.2,24.1.3,50,4,6,6,12,4,FALSE
d2,24.1.5,24.1.6,53,3,6,5,11,5,FALSE
d2,24.1.4,24.1.5,52,2,2,2,4,2,FALSE
d2,24.1.7,24.1.8,55,2,18,2,20,3,FALSE
d2,24.1.6,24.1.7,54,2,2,3,5,2,FALSE
d2,24.1.18,24.1.21,62,8,57,26,83,9,FALSE
d2,0.0.36,24.0.1,35,5,739,513,1252,10,FALSE
d2,24.1.15,24.1.18,61,21,270,113,383,35,FALSE
d2,24.1.14,24.1.15,60,4,25,10,35,4,FALSE
d2,0.0.35,0.0.36,34,4,70,63,133,29,FALSE
d2,0.0.34,0.0.35,33,7,1281,95,1376,36,FALSE
d2,24.1.11,24.1.14,59,8,63,27,90,28,FALSE
d2,24.1.10,24.1.11,58,2,7,7,14,6,FALSE
d2,0.0.31,0.0.32,30,2,29,2,31,3,FALSE
d2,0.0.30,0.0.31,29,4,847,3,850,12,FALSE
d2,25.0.11,25.0.12,75,2,13,13,26,8,FALSE
d2,25.0.12,25.0.13,76,2,2,2,4,2,FALSE
d2,0.0.33,0.0.34,32,2,29,2,31,3,FALSE
d2,0.0.23,0.0.24,22,4,227,29,256,7,FALSE
d2,24.1.8,24.1.9,56,4,49,29,78,7,FALSE
d2,24.0.10,24.0.11,44,8,347,224,571,16,FALSE
d2,0.0.32,0.0.33,31,3,6,6,12,4,FALSE
d2,25.0.1,25.0.8,73,19,248,94,342,29,FALSE
d2,25.0.8,25.0.11,74,9,67,36,103,15,FALSE
d2,24.1.21,24.1.22,63,40,1006,682,1688,94,FALSE
d2,24.1.22,24.1.23,64,7,8522,12,8534,12,FALSE
d2,24.1.23,24.1.24,65,23,3623,2003,5626,84,FALSE
d2,24.0.11,24.0.12,45,18,84,48,132,24,FALSE
d2,0.0.26,0.0.27,25,9,43068,34052,77120,29,FALSE
d2,0.0.27,0.0.28,26,7,82,20,102,15,FALSE
d2,0.0.28,0.0.29,27,13,360,200,560,29,FALSE
d2,0.0.29,0.0.30,28,2,63,6,69,4,FALSE
d2,0.0.22,0.0.23,21,13,2311,1778,4089,96,FALSE
d2,24.0.5,24.0.6,39,2,6,2,8,2,FALSE
d2,24.0.6,24.0.7,40,2,1344,15,1359,5,FALSE
d2,24.0.7,24.0.8,41,2,8,1,9,2,FALSE
d2,24.0.1,24.0.2,36,3,19,2,21,4,FALSE
d2,24.0.2,24.0.3,37,2,10,1,11,2,FALSE
d2,24.0.3,24.0.5,38,4,14,4,18,4,FALSE
d2,0.0.24,0.0.25,23,13,633,1404,2037,37,FALSE
d2,24.0.12,24.0.13,46,7,294,2228,2522,25,FALSE
d2,24.0.8,24.0.9,42,2,6,2,8,2,FALSE
d2,24.0.9,24.0.10,43,2,28,20,48,3,FALSE
d2,0.0.25,0.0.26,24,4,56512,47499,104011,19,FALSE
d2,0.0.1,0.0.2,1,1,1259,251,1510,22,FALSE
d2,26.1.9,26.1.10,116,2,5,5,10,3,FALSE
d2,26.1.8,26.1.9,115,3,19,14,33,4,FALSE
d2,26.0.0,26.0.1,103,2,29,22,51,7,FALSE
d2,26.1.3,26.1.4,110,3,3,5,8,3,FALSE
d2,26.1.1,26.1.3,109,10,3474,2315,5789,121,FALSE
d2,25.1.15,25.2.0,93,3,38,26,64,5,TRUE
d2,26.1.7,26.1.8,114,2,443,1,444,5,FALSE
d2,26.1.6,26.1.7,113,1,1,1,2,1,FALSE
d2,26.1.5,26.1.6,112,5,3137,129,3266,62,FALSE
d2,26.1.4,26.1.5,111,9,398,60,458,19,TRUE
d2,26.1.12,26.2.0,119,4,1207,589,1796,16,FALSE
d2,26.1.10,26.1.11,117,50,9391,4424,13815,179,FALSE
d2,27.0.0-6,27.0.0-7,128,2,86,49,135,3,FALSE
d2,27.0.0-7,27.0.0-8,129,3,570,517,1087,5,FALSE
d2,25.1.0,25.1.1,78,1,1259,251,1510,22,FALSE
d2,25.1.1,25.1.2,79,5,36,40,76,7,FALSE
d2,25.1.2,25.1.3,80,1,1,1,2,1,FALSE
d2,25.1.3,25.1.4,81,2,3,2,5,2,FALSE
d2,25.1.4,25.1.5,82,2,29,21,50,3,FALSE
d2,25.1.5,25.1.6,83,2,7,1,8,3,FALSE
d2,25.1.6,25.1.7,84,2,2,1,3,2,FALSE
d2,25.1.7,25.1.8,85,3,63,9,72,4,FALSE
d2,25.1.8,25.1.9,86,2,2,2,4,2,FALSE
d2,25.1.9,25.1.10,87,1,1,1,2,1,FALSE
d2,27.0.0-2,27.0.0-3,124,9,988,621,1609,17,FALSE
d2,27.0.0-3,27.0.0-4,125,4,687,619,1306,7,FALSE
d2,27.0.0-0,27.0.0-1,122,3,48,8,56,7,FALSE
d2,27.0.0-1,27.0.0-2,123,5,2267,592,2859,22,FALSE
d2,26.2.0,26.2.1,120,14,1678,1241,2919,25,FALSE
d2,27.0.0-4,27.0.0-5,126,4,142,6,148,11,FALSE
d2,27.0.0-5,27.0.0-6,127,2,2322,3,2325,9,FALSE
d2,25.3.0,25.3.1,101,14,1678,1241,2919,25,FALSE
d2,25.1.12,25.1.13,90,2,4188,2,4190,3,FALSE
d2,25.1.13,25.1.14,91,2,4189,3,4192,4,FALSE
d2,26.0.4,26.1.0,107,5,922,833,1755,7,FALSE
d2,26.0.2,26.0.3,105,3,9,2,11,4,FALSE
d2,26.0.3,26.0.4,106,2,114,1,115,3,FALSE
d2,25.1.14,25.1.15,92,4,160,13,173,9,FALSE
d2,26.0.1,26.0.2,104,2,8,1,9,3,FALSE
d2,26.1.0,26.1.1,108,1,1,1,2,1,FALSE
d2,25.2.7,25.3.0,100,4,1207,589,1796,16,FALSE
d2,25.2.6,25.2.7,99,46,10114,2745,12859,214,FALSE
d2,25.2.5,25.2.6,98,9,398,60,458,19,TRUE
d2,25.2.4,25.2.5,97,3,3,5,8,3,FALSE
d2,25.2.2,25.2.4,96,34,7617,4959,12576,198,FALSE
d2,25.2.1,25.2.2,95,2,327,156,483,7,FALSE
d2,25.2.0,25.2.1,94,1,1,1,2,1,FALSE
d2,25.1.10,25.1.11,88,3,16,9,25,4,FALSE
d2,25.1.11,25.1.12,89,3,145,7,152,5,FALSE
d2,0.0.5,0.0.6,5,4,63,145,208,9,FALSE
d2,0.0.4,0.0.5,4,4,98,39,137,13,FALSE
d2,0.0.7,0.0.8,7,2,32,2,34,3,FALSE
d2,0.0.6,0.0.7,6,3,67,15,82,6,FALSE
d2,0.0.3,0.0.4,3,7,1090,100,1190,39,FALSE
d2,0.0.2,0.0.3,2,1,1259,251,1510,22,FALSE
d2,0.0.19,0.0.20,18,3,39,164,203,22,FALSE
d2,0.0.9,0.0.10,9,2,36,1,37,3,FALSE
d2,0.0.8,0.0.9,8,18,397,175,572,30,FALSE
d2,0.0.20,0.0.21,19,16,4273,2709,6982,95,FALSE
d2,0.0.17,0.0.18,16,2,99,86,185,29,FALSE
d2,0.0.16,0.0.17,15,23,1493,207,1700,59,FALSE
d2,0.0.11,0.0.12,11,2,298,89,387,8,FALSE
d2,0.0.10,0.0.11,10,2,6,6,12,6,FALSE
d2,0.0.12,0.0.14,12,12,2213,97,2310,29,FALSE
d2,0.0.14,0.0.15,13,3,460,460,920,24,FALSE
d2,0.0.18,0.0.19,17,16,432,310,742,23,FALSE
d2,0.0.15,0.0.16,14,2,43,5,48,6,FALSE
d2,0.0.21,0.0.22,20,38,1439,780,2219,91,FALSE
d2,25.1.15,25.2.0,93,3,38,26,64,5,FALSE
d2,26.1.4,26.1.5,111,9,398,60,458,19,FALSE
d2,25.0.13,25.1.0,77,11,820,569,1389,48,FALSE
d2,25.2.5,25.2.6,98,9,398,60,458,19,FALSE
d2,0.0.5,0.0.6,5,4,63,145,208,9,TRUE
d2,27.0.0-5,27.0.0-6,127,2,2322,3,2325,9,TRUE
d2,0.0.7,0.0.8,7,2,32,2,34,3,TRUE
d2,26.1.10,26.1.11,117,50,9391,4424,13815,179,TRUE
d2,27.0.0-2,27.0.0-3,124,9,988,621,1609,17,TRUE
d2,26.0.4,26.1.0,107,5,922,833,1755,7,TRUE
d2,26.0.3,26.0.4,106,2,114,1,115,3,TRUE
d2,27.0.0-1,27.0.0-2,123,5,2267,592,2859,22,TRUE
d2,26.1.9,26.1.10,116,2,5,5,10,3,TRUE
d2,0.0.15,0.0.16,14,2,43,5,48,6,TRUE
d2,0.0.18,0.0.19,17,16,432,310,742,23,TRUE
d2,0.0.24,0.0.25,23,13,633,1404,2037,37,TRUE
d2,27.0.0-6,27.0.0-7,128,2,86,49,135,3,TRUE
d2,26.1.7,26.1.8,114,2,443,1,444,5,TRUE
d2,24.0.3,24.0.5,38,4,14,4,18,4,TRUE
d2,0.0.26,0.0.27,25,9,43068,34052,77120,29,TRUE
d2,26.1.5,26.1.6,112,5,3137,129,3266,62,TRUE
mongo-helpr,0.6.0,0.6.2,25,5,36,34,70,9,FALSE
mongo-helpr,0.1.8,0.1.9,2,3,12,2,14,4,FALSE
mongo-helpr,0.1.9,0.1.10,3,3,26,8,34,4,FALSE
mongo-helpr,0.2.5,0.3.0,9,3,32,12,44,7,FALSE
mongo-helpr,0.2.4,0.2.5,8,5,10,14,24,7,FALSE
mongo-helpr,0.2.2,0.2.4,7,4,37,15,52,11,FALSE
mongo-helpr,0.2.1,0.2.2,6,3,14,14,28,6,TRUE
mongo-helpr,0.2.0,0.2.1,5,3,46,30,76,8,FALSE
mongo-helpr,0.1.5,0.1.8,1,8,67,109,176,24,FALSE
mongo-helpr,0.3.2,0.3.3,12,3,52,18,70,6,FALSE
mongo-helpr,0.3.3,0.4.1,13,5,73,9,82,11,FALSE
mongo-helpr,0.3.0,0.3.1,10,3,12,8,20,4,FALSE
mongo-helpr,0.3.1,0.3.2,11,3,10,8,18,6,FALSE
mongo-helpr,0.7.0,0.7.1,28,3,2,6,8,4,FALSE
mongo-helpr,0.7.1,0.8.0,29,3,220,8,228,6,FALSE
mongo-helpr,0.4.9,0.5.0,20,3,162,14,176,11,FALSE
mongo-helpr,0.4.8,0.4.9,19,3,4,2,6,4,FALSE
mongo-helpr,0.4.1,0.4.3,14,5,188,174,362,15,FALSE
mongo-helpr,0.4.3,0.4.4,15,3,7660,26,7686,9,FALSE
mongo-helpr,0.4.5,0.4.7,17,5,39,11,50,9,FALSE
mongo-helpr,0.5.1,0.5.2,22,3,6,4,10,6,FALSE
mongo-helpr,0.5.2,0.5.3,23,3,300,182,482,8,FALSE
mongo-helpr,0.5.3,0.6.0,24,3,162,4,166,7,FALSE
mongo-helpr,0.9.0,0.9.2,31,5,81,43,124,12,FALSE
mongo-helpr,0.8.0,0.9.0,30,3,74,4,78,6,FALSE
mongo-helpr,0.1.10,0.2.0,4,3,68,6,74,7,FALSE
mongo-helpr,0.5.0,0.5.1,21,3,18,18,36,9,FALSE
mongo-helpr,0.4.4,0.4.5,16,3,10,8,18,6,FALSE
mongo-helpr,0.6.3,0.7.0,27,3,120,4,124,6,TRUE
mongo-helpr,0.4.7,0.4.8,18,3,36,18,54,7,FALSE
mongo-helpr,0.6.2,0.6.3,26,2,2,2,4,2,FALSE
mongo-helpr,0.2.1,0.2.2,6,3,14,14,28,6,FALSE
mongo-helpr,0.6.3,0.7.0,27,3,120,4,124,6,FALSE
mongo-helpr,0.7.1,0.8.0,29,3,220,8,228,6,TRUE
mongo-helpr,0.5.2,0.5.3,23,3,300,182,482,8,TRUE
mongo-helpr,0.1.10,0.2.0,4,3,68,6,74,7,TRUE
mongo-helpr,0.3.3,0.4.1,13,5,73,9,82,11,TRUE
mongo-helpr,0.9.0,0.9.2,31,5,81,43,124,12,TRUE
thrux,3.0.4,3.0.5,49,1,26,21,47,3,FALSE
thrux,3.0.2,3.0.3,47,1,933,393,1326,8,FALSE
thrux,3.0.3,3.0.4,48,1,672,503,1175,13,FALSE
thrux,3.0.0,3.0.1,45,1,88,75,163,7,FALSE
thrux,3.0.1,3.0.2,46,1,77,72,149,8,FALSE
thrux,2.6.1,2.6.2,39,1,7,7,14,6,FALSE
thrux,2.6.0,2.6.1,38,1,151,145,296,6,FALSE
thrux,2.6.2,2.7.0,40,1,75,16,91,2,FALSE
thrux,2.7.0,2.7.1,41,1,666,526,1192,7,FALSE
thrux,2.7.1,2.7.2,42,1,16,7,23,8,FALSE
thrux,3.0.8,3.1.0,53,2,8731,295,9026,17,FALSE
thrux,2.7.3,3.0.0,44,1,84,41,125,3,FALSE
thrux,2.7.2,2.7.3,43,1,23,9,32,7,FALSE
thrux,1.1.0,1.2.0,8,2,2390,1832,4222,10,FALSE
thrux,2.0.0,2.1.0,11,1,62,15,77,3,FALSE
thrux,3.1.1,3.2.0,55,1,163,63,226,5,FALSE
thrux,2.2.5,2.2.6,22,1,1,1,2,1,FALSE
thrux,2.2.4,2.2.5,21,1,0,1,1,1,FALSE
thrux,2.2.6,2.3.0,23,1,26,19,45,6,FALSE
thrux,2.2.1,2.2.2,18,1,1,147,148,2,FALSE
thrux,2.2.0,2.2.1,17,1,14,14,28,5,FALSE
thrux,2.2.3,2.2.4,20,3,9,5,14,5,FALSE
thrux,2.2.2,2.2.3,19,1,5,5,10,2,FALSE
thrux,2.1.2,2.1.3,14,1,1,1,2,1,FALSE
thrux,2.1.3,2.1.4,15,2,398,411,809,8,FALSE
thrux,2.1.0,2.1.1,12,7,4119,2654,6773,20,FALSE
thrux,2.1.1,2.1.2,13,3,14,5,19,6,FALSE
thrux,2.4.1,2.5.0,31,1,734,933,1667,9,FALSE
thrux,2.1.4,2.2.0,16,1,9,6,15,3,FALSE
thrux,2.5.5,2.6.0,37,1,1645,274,1919,11,FALSE
thrux,2.5.3,2.5.4,35,1,1,1,2,1,FALSE
thrux,3.1.0,3.1.1,54,1,835,3343,4178,15,FALSE
thrux,2.3.0,2.3.1,24,2,19,2,21,4,FALSE
thrux,2.3.1,2.3.2,25,1,1,1,2,1,FALSE
thrux,2.3.2,2.3.3,26,1,1,1,2,5,FALSE
thrux,2.3.3,2.3.4,27,1,1,0,1,1,FALSE
thrux,2.3.4,2.3.5,28,1,5905,5651,11556,8,FALSE
thrux,2.3.5,2.4.0,29,1,100,31,131,4,FALSE
thrux,1.3.0,2.0.0,10,4,159,32,191,10,FALSE
thrux,1.2.0,1.3.0,9,3,3654,2259,5913,9,FALSE
thrux,2.5.4,2.5.5,36,1,70,122,192,2,FALSE
thrux,2.4.0,2.4.1,30,1,1115,768,1883,6,FALSE
thrux,2.5.2,2.5.3,34,1,6,5,11,1,FALSE
thrux,0.0.0-development,0.0.0,1,1,264,34,298,10,FALSE
thrux,2.5.0,2.5.1,32,1,30,10,40,8,FALSE
thrux,2.5.1,2.5.2,33,2,61,40,101,7,FALSE
thrux,3.2.0,3.2.1,56,1,440,220,660,13,FALSE
thrux,3.2.1,3.2.2,57,1,117,72,189,3,FALSE
thrux,1.0.0,1.1.0,7,1,3111,14,3125,12,FALSE
thrux,0.3.0,1.0.0,6,2,22,5,27,3,FALSE
thrux,3.0.6,3.0.7,51,1,23,23,46,3,FALSE
thrux,3.0.5,3.0.6,50,4,564,553,1117,12,FALSE
thrux,3.0.1,3.0.2,46,1,77,72,149,8,TRUE
thrux,3.0.7,3.0.8,52,1,10,17,27,2,FALSE
thrux,2.4.1,2.5.0,31,1,734,933,1667,9,TRUE
thrux,0.2.1,0.3.0,5,5,1376,90,1466,17,FALSE
thrux,0.2.0,0.2.1,4,3,330,18,348,7,FALSE
thrux,3.1.0,3.1.1,54,1,835,3343,4178,15,TRUE
thrux,3.0.8,3.1.0,53,2,8731,295,9026,17,TRUE
react-formless,0.0.1,0.1.0,1,2,242,80,322,13,FALSE
react-formless,0.1.8,0.1.9,10,1,4,2,6,3,FALSE
react-formless,0.1.9,0.1.10,11,1,4,2,6,3,FALSE
react-formless,0.1.0,0.1.1,2,2,8,2,10,3,FALSE
react-formless,0.1.1,0.1.2,3,2,24159,10,24169,5,FALSE
react-formless,0.1.2,0.1.3,4,2,2252,575,2827,41,TRUE
react-formless,0.1.3,0.1.4,5,1,2,1,3,2,FALSE
react-formless,0.1.4,0.1.5,6,2,4,796,800,53,FALSE
react-formless,0.1.5,0.1.6,7,2,2935,49,2984,61,FALSE
react-formless,0.1.6,0.1.7,8,1,137,137,274,40,FALSE
react-formless,0.1.7,0.1.8,9,1,217,89,306,3,FALSE
react-formless,0.1.2,0.1.3,4,2,2252,575,2827,41,FALSE
constellate,0.0.21,0.0.22,22,3,1290,170,1460,31,FALSE
constellate,0.0.22,0.0.23,23,2,158,209,367,21,FALSE
constellate,0.0.23,0.0.24,24,2,70,17,87,6,FALSE
constellate,0.0.24,0.0.25,25,1,120,1104,1224,18,FALSE
constellate,0.0.25,0.0.26,26,2,115,103,218,9,FALSE
constellate,0.0.26,0.0.27,27,3,69,24,93,10,FALSE
constellate,0.0.27,0.0.28,28,2,28,70,98,9,FALSE
constellate,0.0.15,0.0.16,16,3,13,51,64,6,FALSE
constellate,0.0.13,0.0.14,14,2,3,3,6,3,FALSE
constellate,0.0.14,0.0.15,15,2,4,3,7,3,FALSE
constellate,0.0.12,0.0.13,13,2,71,22,93,6,FALSE
constellate,0.0.9,0.0.10,10,2,54,52,106,10,FALSE
constellate,0.0.17,0.0.18,18,6,109,268,377,48,FALSE
constellate,0.0.20,0.0.21,21,2,8308,127,8435,19,FALSE
constellate,0.0.21,0.0.22,22,3,1290,170,1460,31,TRUE
constellate,0.0.11,0.0.12,12,2,13,6,19,3,FALSE
constellate,0.0.10,0.0.11,11,3,29,28,57,17,FALSE
constellate,0.0.16,0.0.17,17,5,372,248,620,31,FALSE
constellate,0.0.19,0.0.20,20,2,47,4,51,6,FALSE
constellate,0.0.18,0.0.19,19,2,7,5,12,5,FALSE
constellate,0.0.8,0.0.9,9,11,1795,993,2788,95,FALSE
constellate,0.0.5,0.0.6,6,4,119,44,163,23,FALSE
constellate,0.0.7,0.0.8,8,2,32,89,121,15,FALSE
constellate,0.0.6,0.0.7,7,2,73,28,101,9,FALSE
constellate,0.0.12,0.0.13,13,2,71,22,93,6,TRUE
constellate,0.0.20,0.0.21,21,2,8308,127,8435,19,TRUE
constellate,0.0.16,0.0.17,17,5,372,248,620,31,TRUE
constellate,0.0.4,0.0.5,5,6,544,449,993,54,FALSE
constellate,0.0.1,0.0.2,2,2,8,5,13,6,FALSE
constellate,0.0.3,0.0.4,4,8,603,2854,3457,55,FALSE
constellate,0.0.2,0.0.3,3,2,3075,67,3142,30,FALSE
node-uci,1.1.0,1.2.0,3,26,4773,720,5493,80,FALSE
node-uci,1.0.0,1.1.0,2,10,669,621,1290,28,FALSE
node-uci,1.2.0,1.2.1,4,13,83,237,320,17,FALSE
node-uci,1.2.1,1.3.0,5,12,6925,3740,10665,78,FALSE
node-uci,0.0.1,1.0.0,1,26,2590,879,3469,57,FALSE
node-uci,1.0.0,1.1.0,2,10,669,621,1290,28,TRUE
node-uci,0.0.1,1.0.0,1,26,2590,879,3469,57,TRUE
node-uci,1.1.0,1.2.0,3,26,4773,720,5493,80,TRUE
microservices,0.0.1,0.0.2,2,2,65,1,66,2,FALSE
microservices,0.0.0,0.0.1,1,2,7,1,8,2,FALSE
microservices,0.0.3,0.1.0,4,2,72,51,123,10,FALSE
microservices,0.0.2,0.0.3,3,3,104,120,224,8,FALSE
microservices,0.0.3,0.1.0,4,2,72,51,123,10,TRUE
reactables,0.2.6,0.3.0,12,2,31,13,44,6,FALSE
reactables,0.2.5,0.2.6,11,8,2954,862,3816,70,FALSE
reactables,0.2.4,0.2.5,10,1,10,27,37,3,FALSE
reactables,0.2.3,0.2.4,9,1,23,18,41,3,FALSE
reactables,0.2.2,0.2.3,8,2,189,1,190,5,FALSE
reactables,0.2.1,0.2.2,7,4,1364,8,1372,24,FALSE
reactables,0.2.0,0.2.1,6,2,280,59,339,11,FALSE
reactables,0.1.0,0.1.2,2,4,13,8,21,4,FALSE
reactables,0.4.1-beta.11,0.4.1-beta.12,60,3,8,8,16,10,FALSE
reactables,0.4.1-beta.12,0.4.1-beta.13,61,1,7,6,13,2,FALSE
reactables,0.1.3,0.1.4,4,1,1,5,6,3,FALSE
reactables,0.1.4,0.2.0,5,1,250,12,262,8,FALSE
reactables,0.1.2,0.1.3,3,2,205,152,357,3,FALSE
reactables,0.4.1-beta.8,0.4.1-beta.9,57,4,190,103,293,29,FALSE
reactables,0.4.0-beta.1,0.4.0-beta.2,37,3,128,90,218,25,FALSE
reactables,0.3.8,0.3.9,21,2,24,5,29,3,FALSE
reactables,0.4.1-beta.13,0.4.1-beta.14,62,4,63,15,78,18,FALSE
reactables,0.0.0,0.1.0,1,4,1189,36,1225,8,FALSE
reactables,0.3.2,0.3.3,15,2,111,24,135,8,FALSE
reactables,0.3.3,0.3.4,16,1,190,216,406,10,FALSE
reactables,0.3.0,0.3.1,13,2,268,5,273,9,FALSE
reactables,0.3.1,0.3.2,14,2,606,306,912,20,FALSE
reactables,0.3.6,0.3.7,19,1,278,4,282,6,FALSE
reactables,0.3.7,0.3.8,20,1,8,2,10,3,FALSE
reactables,0.3.4,0.3.5,17,1,56,22,78,6,FALSE
reactables,0.3.5,0.3.6,18,1,5,5,10,5,FALSE
reactables,0.4.0-beta.2,0.4.0-beta.3,38,5,1252,629,1881,58,FALSE
reactables,0.3.18,0.3.19,31,11,538,128,666,23,FALSE
reactables,0.3.19,0.3.20,32,7,519,235,754,18,FALSE
reactables,0.3.14,0.3.15,27,13,4253,723,4976,73,FALSE
reactables,0.3.15,0.3.16,28,2,30,3,33,5,FALSE
reactables,0.3.16,0.3.17,29,4,91,69,160,14,FALSE
reactables,0.3.17,0.3.18,30,1,97,21,118,6,FALSE
reactables,0.3.10,0.3.11,23,2,14,5,19,4,FALSE
reactables,0.3.11,0.3.12,24,2,30,25,55,6,TRUE
reactables,0.3.12,0.3.13,25,4,41,13,54,8,FALSE
reactables,0.3.13,0.3.14,26,1,20,11,31,6,FALSE
reactables,0.4.1-beta.9,0.4.1-beta.10,58,58,3567,13383,16950,488,FALSE
reactables,0.4.0-beta.11,0.4.0-beta.12,46,20,2140,410,2550,65,FALSE
reactables,0.4.0-beta.10,0.4.0-beta.11,45,17,739,206,945,31,FALSE
reactables,0.4.0-beta.13,0.4.0-beta.14,48,2,6,6,12,14,FALSE
reactables,0.4.0-beta.12,0.4.0-beta.13,47,4,31,27,58,16,FALSE
reactables,0.4.0-beta.14,0.4.1-beta.1,49,2,887,1843,2730,80,FALSE
reactables,0.4.1-beta.2,0.4.1-beta.3,51,1,1067,629,1696,68,FALSE
reactables,0.3.9,0.3.10,22,2,33,24,57,4,TRUE
reactables,0.4.1-beta.15,0.4.1-beta.16,64,1,3,2,5,1,FALSE
reactables,0.4.1-beta.3,0.4.1-beta.4,52,1,376,267,643,38,FALSE
reactables,0.4.1-beta.14,0.4.1-beta.15,63,1,6,8,14,4,FALSE
reactables,0.4.0-beta.3,0.4.0-beta.4,39,2,460,37,497,24,FALSE
reactables,0.4.1-beta.10,0.4.1-beta.11,59,6,240,150,390,31,FALSE
reactables,0.3.21,0.3.22,34,1,34,34,68,4,FALSE
reactables,0.3.20,0.3.21,33,1,51,36,87,4,FALSE
reactables,0.3.23,0.4.0-beta.1,36,87,7901,8237,16138,312,FALSE
reactables,0.3.22,0.3.23,35,3,35,38,73,4,FALSE
reactables,0.4.0-beta.5,0.4.0-beta.6,41,4,203,122,325,23,FALSE
reactables,0.4.0-beta.4,0.4.0-beta.5,40,22,880,575,1455,215,FALSE
reactables,0.4.0-beta.6,0.4.0-beta.8,42,4,195,182,377,32,FALSE
reactables,0.4.0-beta.9,0.4.0-beta.10,44,2,21,14,35,15,FALSE
reactables,0.4.0-beta.8,0.4.0-beta.9,43,13,803,385,1188,45,FALSE
reactables,0.4.1-beta.1,0.4.1-beta.2,50,1,127,35,162,16,FALSE
reactables,0.4.1-beta.6,0.4.1-beta.7,55,4,31,32,63,36,FALSE
reactables,0.4.1-beta.7,0.4.1-beta.8,56,3,372,58,430,29,FALSE
reactables,0.4.1-beta.4,0.4.1-beta.5,53,3,380,23,403,26,FALSE
reactables,0.4.1-beta.5,0.4.1-beta.6,54,1,5,5,10,17,FALSE
reactables,0.3.9,0.3.10,22,2,33,24,57,4,FALSE
reactables,0.3.11,0.3.12,24,2,30,25,55,6,FALSE
reactables,0.3.8,0.3.9,21,2,24,5,29,3,TRUE
reactables,0.4.1-beta.2,0.4.1-beta.3,51,1,1067,629,1696,68,TRUE
reactables,0.4.0-beta.6,0.4.0-beta.8,42,4,195,182,377,32,TRUE
reactables,0.3.19,0.3.20,32,7,519,235,754,18,TRUE
reactables,0.3.14,0.3.15,27,13,4253,723,4976,73,TRUE
reactables,0.3.22,0.3.23,35,3,35,38,73,4,TRUE
reactables,0.4.0-beta.9,0.4.0-beta.10,44,2,21,14,35,15,TRUE
reactables,0.4.1-beta.3,0.4.1-beta.4,52,1,376,267,643,38,TRUE
reactables,0.3.23,0.4.0-beta.1,36,87,7901,8237,16138,312,TRUE
reactables,0.4.0-beta.1,0.4.0-beta.2,37,3,128,90,218,25,TRUE
reactables,0.3.3,0.3.4,16,1,190,216,406,10,TRUE
reactables,0.4.1-beta.13,0.4.1-beta.14,62,4,63,15,78,18,TRUE
reactables,0.4.0-beta.5,0.4.0-beta.6,41,4,203,122,325,23,TRUE
reactables,0.4.0-beta.4,0.4.0-beta.5,40,22,880,575,1455,215,TRUE
mbuild,0.2.2,0.3.0,15,2,77,33,110,8,FALSE
mbuild,0.2.1,0.2.2,14,1,11,11,22,4,FALSE
mbuild,0.2.0,0.2.1,13,1,7,2,9,2,FALSE
mbuild,0.1.0,0.1.2,9,2,91,73,164,11,FALSE
mbuild,0.1.2,0.1.3,10,1,24,23,47,7,FALSE
mbuild,0.1.3,0.1.4,11,1,10,27,37,8,FALSE
mbuild,0.1.4,0.2.0,12,3,196,246,442,26,FALSE
mbuild,0.0.5,0.0.6,5,1,7,2,9,2,FALSE
mbuild,0.0.4,0.0.5,4,2,95,33,128,14,FALSE
mbuild,0.0.7,0.0.8,7,2,112,83,195,10,FALSE
mbuild,0.0.6,0.0.7,6,1,7,2,9,2,FALSE
mbuild,0.0.1,0.0.2,1,2,275,11,286,14,FALSE
mbuild,0.0.3,0.0.4,3,1,12,3,15,4,FALSE
mbuild,0.0.2,0.0.3,2,1,7,2,9,2,FALSE
mbuild,0.3.2,0.3.3,18,1,63,24,87,10,FALSE
mbuild,0.3.3,0.3.5,19,2,39,3,42,6,FALSE
mbuild,0.3.0,0.3.1,16,2,104,10,114,9,FALSE
mbuild,0.3.1,0.3.2,17,1,7,2,9,2,FALSE
mbuild,0.3.6,0.3.7,21,1,7,2,9,2,FALSE
mbuild,0.0.8,0.1.0,8,1,127,74,201,6,FALSE
mbuild,0.3.5,0.3.6,20,1,13,9,22,3,FALSE
mbuild,0.3.6,0.3.7,21,1,7,2,9,2,TRUE
mbuild,0.3.2,0.3.3,18,1,63,24,87,10,TRUE
geocoder-promise,0.2.1,0.2.2,5,1,5,0,5,1,FALSE
geocoder-promise,0.2.0,0.2.1,4,1,5,0,5,1,FALSE
geocoder-promise,0.1.0,0.1.1,1,6,4463,2,4465,9,FALSE
geocoder-promise,0.1.1,0.1.2,2,2,3,3,6,3,FALSE
geocoder-promise,0.1.2,0.2.0,3,1,916,30,946,10,FALSE
geocoder-promise,0.1.0,0.1.1,1,6,4463,2,4465,9,TRUE
retake,0.0.5,0.0.6,5,2,42,1,43,4,FALSE
retake,0.0.4,0.0.5,4,2,5,5,10,2,FALSE
retake,0.0.7,0.0.8,7,1,1,1,2,1,FALSE
retake,0.0.6,0.0.7,6,6,47,38,85,18,FALSE
retake,0.0.1,0.0.2,1,1,5,3,8,1,FALSE
retake,0.0.3,0.0.4,3,3,49,9,58,4,FALSE
retake,0.0.2,0.0.3,2,2,41,6,47,2,FALSE
retake,0.0.8,0.1.0,8,4,43,16,59,7,FALSE
retake,0.0.6,0.0.7,6,6,47,38,85,18,TRUE
sri4node,1.1.18,1.1.19,34,3,5,5,10,3,FALSE
sri4node,1.2.25,1.2.27,54,6,29,17,46,7,FALSE
sri4node,1.2.24,1.2.25,53,1,12,8,20,1,FALSE
sri4node,1.2.27,1.2.28,55,2,2,2,4,2,FALSE
sri4node,1.2.21,1.2.22,50,1,378,10,388,14,FALSE
sri4node,1.1.4,1.1.7,24,24,8363,2520,10883,92,FALSE
sri4node,1.1.7,1.1.8,25,4,168,179,347,13,FALSE
sri4node,1.2.22,1.2.23,51,2,24,3,27,4,FALSE
sri4node,1.1.9,1.1.10,27,6,26,597,623,9,FALSE
sri4node,1.1.8,1.1.9,26,2,4,18,22,4,FALSE
sri4node,1.2.29,1.2.30,57,1,1,1,2,1,FALSE
sri4node,1.2.28,1.2.29,56,1,26,26,52,1,FALSE
sri4node,1.2.20,1.2.21,49,2,5,9,14,2,FALSE
sri4node,1.1.24,1.2.0,40,8,349,213,562,21,FALSE
sri4node,1.1.20,1.1.21,36,1,1,1,2,1,FALSE
sri4node,1.2.23,1.2.24,52,2,2,2,4,2,FALSE
sri4node,1.1.22,1.1.23,38,7,12,10,22,7,FALSE
sri4node,1.1.23,1.1.24,39,25,481,499,980,58,FALSE
sri4node,1.2.13,1.2.14,46,1,2,1,3,1,FALSE
sri4node,1.2.14,1.2.19,47,33,1203,500,1703,85,FALSE
sri4node,1.2.30,1.2.31,58,7,65,24,89,12,FALSE
sri4node,1.2.19,1.2.20,48,9,272,17,289,17,FALSE
sri4node,1.2.6,1.2.7,44,3,57,43,100,3,FALSE
sri4node,1.2.7,1.2.13,45,35,2781,1570,4351,104,FALSE
sri4node,1.2.2,1.2.3,42,2,80,3,83,4,FALSE
sri4node,1.2.3,1.2.6,43,36,776,391,1167,68,FALSE
sri4node,1.2.0,1.2.2,41,9,219,344,563,21,FALSE
sri4node,1.1.21,1.1.22,37,2,2,252,254,3,FALSE
sri4node,1.1.3,1.1.4,23,11,86,20,106,11,FALSE
sri4node,1.1.19,1.1.20,35,11,1499,1535,3034,39,FALSE
sri4node,1.1.11,1.1.12,29,15,1428,929,2357,55,FALSE
sri4node,1.1.10,1.1.11,28,17,1040,508,1548,53,FALSE
sri4node,1.1.13,1.1.15,31,2,2,2,4,2,FALSE
sri4node,1.1.12,1.1.13,30,2,2,2,4,2,FALSE
sri4node,1.1.15,1.1.17,32,39,1143,491,1634,77,TRUE
sri4node,1.1.17,1.1.18,33,8,333,182,515,19,FALSE
sri4node,1.1.15,1.1.17,32,39,1143,491,1634,77,FALSE
sri4node,1.0.4,1.0.5,5,2,3,2,5,2,FALSE
sri4node,1.0.5,1.0.6,6,2,2,2,4,2,FALSE
sri4node,1.0.6,1.0.7,7,2,192,98,290,5,FALSE
sri4node,1.0.7,1.0.8,8,2,135,27,162,5,FALSE
sri4node,1.0.0,1.0.1,1,25,89274,88140,177414,1361,FALSE
sri4node,1.0.1,1.0.2,2,3,322,249,571,6,FALSE
sri4node,1.0.2,1.0.3,3,5,64,93,157,13,FALSE
sri4node,1.0.3,1.0.4,4,3,4,5,9,5,FALSE
sri4node,1.0.8,1.0.9,9,5,21,17,38,7,FALSE
sri4node,1.0.9,1.0.10,10,35,1200,353,1553,44,FALSE
sri4node,1.0.16,1.0.17,17,2,77,11,88,5,FALSE
sri4node,1.0.17,1.0.18,18,5,818,653,1471,19,FALSE
sri4node,1.0.14,1.0.15,15,2,5,5,10,3,FALSE
sri4node,1.0.15,1.0.16,16,2,188,222,410,6,FALSE
sri4node,1.0.12,1.0.13,13,4,141,32,173,7,FALSE
sri4node,1.0.13,1.0.14,14,2,11,8,19,4,FALSE
sri4node,1.0.10,1.0.11,11,16,302,67,369,25,FALSE
sri4node,1.0.11,1.0.12,12,3,46,18,64,4,FALSE
sri4node,1.0.18,1.0.19,19,3,28,6,34,4,FALSE
sri4node,1.0.19,1.0.20,20,2,8,6,14,3,FALSE
sri4node,1.0.21,1.1.3,22,83,17983,9890,27873,277,FALSE
sri4node,1.0.20,1.0.21,21,2,76,24,100,9,FALSE
sri4node,1.2.22,1.2.23,51,2,24,3,27,4,TRUE
alinex-config,1.0.4,1.0.5,18,9,88,42,130,12,FALSE
alinex-config,1.0.5,1.0.6,19,2,9,4,13,3,FALSE
alinex-config,1.0.6,1.0.7,20,4,19,9,28,8,FALSE
alinex-config,1.0.7,1.0.8,21,5,29,10,39,7,FALSE
alinex-config,1.0.0,1.0.1,14,2,23,15,38,4,FALSE
alinex-config,1.0.1,1.0.2,15,6,61,38,99,12,FALSE
alinex-config,1.0.2,1.0.3,16,2,26,4,30,4,FALSE
alinex-config,1.0.3,1.0.4,17,6,132,210,342,9,FALSE
alinex-config,1.0.8,1.0.9,22,2,7,4,11,3,FALSE
alinex-config,1.0.9,1.0.10,23,6,281,115,396,16,FALSE
alinex-config,0.2.2,0.3.0,5,15,180,31,211,23,FALSE
alinex-config,0.2.1,0.2.2,4,17,385,127,512,31,FALSE
alinex-config,0.2.0,0.2.1,3,2,16,4,20,4,FALSE
alinex-config,0.1.0,0.2.0,2,10,300,95,395,25,FALSE
alinex-config,0.0.1,0.1.0,1,1,15,2,17,2,FALSE
alinex-config,0.3.2,0.3.3,8,10,320,57,377,17,FALSE
alinex-config,0.3.3,0.3.4,9,2,34,5,39,4,FALSE
alinex-config,0.3.0,0.3.1,6,11,298,302,600,19,FALSE
alinex-config,0.3.1,0.3.2,7,9,35,14,49,10,FALSE
alinex-config,0.3.4,0.4.0,10,12,656,555,1211,22,FALSE
alinex-config,1.0.16,1.0.17,30,2,8,4,12,3,FALSE
alinex-config,1.0.17,1.0.18,31,2,8,4,12,3,FALSE
alinex-config,1.0.14,1.0.15,28,2,9,5,14,3,FALSE
alinex-config,1.0.15,1.0.16,29,2,10,6,16,3,FALSE
alinex-config,1.0.12,1.0.13,26,2,8,4,12,3,FALSE
alinex-config,1.0.13,1.0.14,27,4,16,24,40,5,FALSE
alinex-config,1.0.10,1.0.11,24,5,26,25,51,8,FALSE
alinex-config,1.0.11,1.0.12,25,2,10,6,16,3,FALSE
alinex-config,0.4.1,0.4.5,12,10,73,11,84,15,FALSE
alinex-config,0.4.0,0.4.1,11,1,5,1,6,2,FALSE
alinex-config,0.4.5,1.0.0,13,38,8592,4038,12630,162,FALSE
alinex-config,1.0.18,1.0.19,32,2,9,5,14,3,FALSE
alinex-config,1.0.19,1.1.0,33,4,50,39,89,8,FALSE
alinex-config,1.1.1,1.1.2,35,3,14,6,20,4,FALSE
alinex-config,1.1.0,1.1.1,34,2,23,19,42,6,FALSE
alinex-config,0.4.0,0.4.1,11,1,5,1,6,2,TRUE
alinex-config,1.4.0,1.4.1,44,4,34,33,67,5,FALSE
alinex-config,1.4.1,1.4.2,45,10,45,19,64,12,FALSE
alinex-config,1.3.0,1.4.0,43,5,128,6,134,8,FALSE
alinex-config,1.1.2,1.1.3,36,3,50,405,455,10,FALSE
alinex-config,1.1.5,1.1.6,39,2,8,4,12,3,FALSE
alinex-config,1.1.4,1.1.5,38,2,9,5,14,3,FALSE
alinex-config,1.1.6,1.2.0,40,3,162,27,189,14,TRUE
alinex-config,1.2.0,1.2.1,41,2,9,1,10,3,FALSE
alinex-config,1.2.1,1.3.0,42,19,1063,689,1752,31,FALSE
alinex-config,1.1.3,1.1.4,37,1,7,1,8,2,FALSE
alinex-config,1.1.6,1.2.0,40,3,162,27,189,14,FALSE
alinex-config,1.1.3,1.1.4,37,1,7,1,8,2,TRUE
alinex-config,1.3.0,1.4.0,43,5,128,6,134,8,TRUE
alinex-config,0.1.0,0.2.0,2,10,300,95,395,25,TRUE
alinex-config,0.3.3,0.3.4,9,2,34,5,39,4,TRUE
alinex-config,1.0.6,1.0.7,20,4,19,9,28,8,TRUE
retext-smartypants,1.0.0,2.0.0,18,2,571,1313,1884,20,FALSE
retext-smartypants,2.0.0,3.0.0,19,7,969,1142,2111,19,FALSE
retext-smartypants,0.0.5,0.0.6,5,2,3,3,6,3,FALSE
retext-smartypants,0.0.4,0.0.5,4,16,353,321,674,19,FALSE
retext-smartypants,0.0.7,0.0.8,7,5,4022,10,4032,9,FALSE
retext-smartypants,0.0.6,0.0.7,6,4,19,27,46,6,FALSE
retext-smartypants,0.0.1,0.0.2,1,1,1104,0,1104,10,TRUE
retext-smartypants,0.0.3,0.0.4,3,5,8,16,24,5,FALSE
retext-smartypants,0.0.2,0.0.3,2,2,3,2,5,2,FALSE
retext-smartypants,0.3.0,0.4.0,13,6,214,228,442,16,FALSE
retext-smartypants,0.0.8,0.1.0-rc.1,8,7,121,4045,4166,9,FALSE
retext-smartypants,0.4.1,0.4.2,15,6,112,13,125,12,FALSE
retext-smartypants,0.2.1,0.3.0,12,5,187,173,360,7,FALSE
retext-smartypants,0.2.0,0.2.1,11,6,43,28,71,14,FALSE
retext-smartypants,0.1.0,0.2.0,10,16,1038,535,1573,22,FALSE
retext-smartypants,0.4.0,0.4.1,14,7,22,14,36,9,FALSE
retext-smartypants,0.1.0-rc.1,0.1.0,9,7,46,7,53,13,FALSE
retext-smartypants,0.4.2,0.4.3,16,16,145,78,223,20,FALSE
retext-smartypants,0.4.3,1.0.0,17,3,1649,1415,3064,25,FALSE
retext-smartypants,0.0.1,0.0.2,1,1,1104,0,1104,10,FALSE
retext-smartypants,2.0.0,3.0.0,19,7,969,1142,2111,19,TRUE
retext-smartypants,0.0.7,0.0.8,7,5,4022,10,4032,9,TRUE
retext-smartypants,0.0.6,0.0.7,6,4,19,27,46,6,TRUE
retext-smartypants,0.2.0,0.2.1,11,6,43,28,71,14,TRUE
retext-smartypants,1.0.0,2.0.0,18,2,571,1313,1884,20,TRUE
et-parser,0.1.7,0.1.8,21,2,51,1,52,3,FALSE
et-parser,0.0.14,0.1.0,14,2,11,12,23,7,FALSE
et-parser,0.0.11,0.0.12,11,1,1,1,2,1,FALSE
et-parser,0.0.10,0.0.11,10,1,1,1,2,1,FALSE
et-parser,0.0.13,0.0.14,13,1,1,1,2,1,FALSE
et-parser,0.0.12,0.0.13,12,1,1,1,2,1,FALSE
et-parser,0.1.0,0.1.2,15,4,54,51,105,21,TRUE
et-parser,0.1.2,0.1.3,16,1,3,3,6,2,FALSE
et-parser,0.1.3,0.1.4,17,2,123,189,312,8,TRUE
et-parser,0.1.4,0.1.5,18,2,2611,19,2630,8,TRUE
et-parser,0.1.5,0.1.6,19,2,144,22,166,6,FALSE
et-parser,0.1.6,0.1.7,20,5,194,89,283,18,TRUE
et-parser,0.1.7,0.1.8,21,2,51,1,52,3,TRUE
et-parser,0.0.5,0.0.6,5,1,1,1,2,1,FALSE
et-parser,0.0.4,0.0.5,4,1,1,1,2,1,FALSE
et-parser,0.0.7,0.0.8,7,1,1,1,2,1,FALSE
et-parser,0.0.6,0.0.7,6,1,1,1,2,1,FALSE
et-parser,0.0.1,0.0.2,1,1,1,1,2,1,FALSE
et-parser,0.0.3,0.0.4,3,1,1,1,2,1,FALSE
et-parser,0.0.2,0.0.3,2,4,11,10,21,8,FALSE
et-parser,0.0.9,0.0.10,9,1,1,1,2,1,FALSE
et-parser,0.0.8,0.0.9,8,1,1,1,2,1,FALSE
et-parser,0.1.3,0.1.4,17,2,123,189,312,8,FALSE
et-parser,0.1.4,0.1.5,18,2,2611,19,2630,8,FALSE
et-parser,0.1.0,0.1.2,15,4,54,51,105,21,FALSE
et-parser,0.1.6,0.1.7,20,5,194,89,283,18,FALSE
ubivar,0.1.7-beta,0.1.8-beta,18,1,47,25,72,6,FALSE
ubivar,0.1.8-beta,0.1.9-beta,19,1,6,4,10,5,FALSE
ubivar,0.1.10-beta,0.1.11-beta,21,7,31,20,51,15,FALSE
ubivar,0.1.12-beta,0.1.13-beta,23,4,6,6,12,6,FALSE
ubivar,0.1.11-beta,0.1.12-beta,22,4,23,20,43,8,FALSE
ubivar,0.1.6-beta,0.1.7-beta,17,1,12,13,25,5,FALSE
ubivar,0.1.3-beta16,0.1.3-beta17,7,11,138,475,613,21,FALSE
ubivar,0.1.3-beta15,0.1.3-beta16,6,9,143,86,229,15,FALSE
ubivar,0.1.3-beta12,0.1.3-beta13,4,4,626,531,1157,13,FALSE
ubivar,0.1.3-beta13,0.1.3-beta15,5,5,406,272,678,24,FALSE
ubivar,0.1.3-beta10,0.1.3-beta11,2,4,116,58,174,10,FALSE
ubivar,0.1.3-beta11,0.1.3-beta12,3,22,167,164,331,28,FALSE
ubivar,0.1.13-beta,0.1.14-beta,24,2,168,18,186,13,FALSE
ubivar,0.1.9-beta,0.1.10-beta,20,1,124,33,157,10,FALSE
ubivar,0.1.4-beta,0.1.5-beta,15,1,26,2,28,5,FALSE
ubivar,0.1.3-beta8,0.1.3-beta9,13,2,106,12,118,7,FALSE
ubivar,0.1.3-beta9,0.1.4-beta,14,59,1707,1611,3318,118,FALSE
ubivar,0.6.0-beta,0.8.0-beta,27,4,27,316,343,27,FALSE
ubivar,0.1.3-beta6,0.1.3-beta7,11,30,1268,257,1525,93,FALSE
ubivar,0.1.3-beta7,0.1.3-beta8,12,4,129,26,155,4,FALSE
ubivar,0.1.3-beta1,0.1.3-beta10,1,39,1613,319,1932,110,FALSE
ubivar,0.1.3-beta2,0.1.3-beta3,9,1,124,33,157,10,FALSE
ubivar,0.1.3-beta3,0.1.3-beta6,10,1,124,33,157,10,TRUE
ubivar,0.1.15-beta,0.6.0-beta,26,5,4,83,87,10,FALSE
ubivar,0.8.0-beta,0.8.1-beta,28,4,8,17,25,5,FALSE
ubivar,0.1.5-beta,0.1.6-beta,16,2,25,2,27,5,FALSE
ubivar,0.1.14-beta,0.1.15-beta,25,7,95,78,173,15,FALSE
ubivar,0.1.3-beta3,0.1.3-beta6,10,1,124,33,157,10,FALSE
ubivar,0.1.3-beta6,0.1.3-beta7,11,30,1268,257,1525,93,TRUE
api-tailor,1.1.1,1.1.2,4,2,2,2,4,2,FALSE
api-tailor,1.1.0,1.1.1,3,4,37,85,122,8,FALSE
api-tailor,1.0.0,1.0.1,1,2,1,4,5,2,FALSE
api-tailor,1.0.1,1.1.0,2,3,140,29,169,5,FALSE
api-tailor,1.1.0,1.1.1,3,4,37,85,122,8,TRUE
api-tailor,1.1.1,1.1.2,4,2,2,2,4,2,TRUE
raku-orm,1.0.4,1.0.5,5,2,51,20,71,5,FALSE
raku-orm,1.0.5,1.1.0,6,1,22,3,25,3,FALSE
raku-orm,1.1.1,1.1.2,8,3,23,20,43,6,FALSE
raku-orm,1.1.2,1.1.3,9,1,13,2,15,2,FALSE
raku-orm,1.0.2,1.0.3,3,1,5,1,6,2,FALSE
raku-orm,1.0.3,1.0.4,4,1,5,1,6,2,FALSE
raku-orm,1.1.0,1.1.1,7,1,1,1,2,1,FALSE
raku-orm,1.0.0,1.0.1,1,3,19,18,37,3,FALSE
raku-orm,1.0.1,1.0.2,2,1,5,1,6,2,FALSE
raku-orm,2.0.0,2.0.1,11,3,111,97,208,6,FALSE
raku-orm,1.1.3,2.0.0,10,2,1002,876,1878,19,FALSE
raku-orm,3.0.0,3.1.0,14,2,296,23,319,12,FALSE
raku-orm,3.1.1,3.1.2,16,5,242,108,350,10,FALSE
raku-orm,3.1.0,3.1.1,15,3,713,33,746,11,FALSE
raku-orm,2.0.1,2.0.2,12,1,5,1,6,2,FALSE
raku-orm,2.0.2,3.0.0,13,5,924,313,1237,14,FALSE
raku-orm,1.0.4,1.0.5,5,2,51,20,71,5,TRUE
ssc-grid,0.37.0,0.37.2,54,5,132,61,193,10,FALSE
ssc-grid,0.37.2,0.38.0,55,1,7,0,7,1,FALSE
ssc-grid,0.68.0,0.68.1,134,3,57,28,85,5,FALSE
ssc-grid,0.68.1,0.68.2,135,2,8,1,9,2,FALSE
ssc-grid,0.35.0,0.35.1,51,2,314,8,322,8,FALSE
ssc-grid,0.35.1,0.36.0,52,8,711,548,1259,53,FALSE
ssc-grid,0.18.3,0.18.4,26,2,18,6,24,3,FALSE
ssc-grid,0.18.4,0.19.0,27,2,225,17,242,11,FALSE
ssc-grid,0.17.3,0.18.0,23,1,1,1,2,1,FALSE
ssc-grid,0.68.6,0.68.7,140,1,1,1,2,1,FALSE
ssc-grid,0.68.7,0.69.0,141,5,115,60,175,9,FALSE
ssc-grid,0.58.0,0.59.0,104,1,109,195,304,4,FALSE
ssc-grid,0.25.0,0.26.0,35,2,80,15,95,5,FALSE
ssc-grid,0.18.1,0.18.3,25,4,148,60,208,14,FALSE
ssc-grid,0.18.0,0.18.1,24,8,224,98,322,12,FALSE
ssc-grid,0.68.2,0.68.3,136,3,142,139,281,7,FALSE
ssc-grid,0.68.3,0.68.4,137,2,9,1,10,2,FALSE
ssc-grid,0.68.4,0.68.5,138,4,111,86,197,19,FALSE
ssc-grid,0.68.5,0.68.6,139,6,45,17,62,9,FALSE
ssc-grid,0.27.1,0.28.0,39,1,1,1,2,1,FALSE
ssc-grid,0.27.0,0.27.1,38,3,134,8,142,13,FALSE
ssc-grid,0.62.0,0.63.0,108,3,81,18,99,6,FALSE
ssc-grid,0.49.0,0.50.0,90,1,7,0,7,1,FALSE
ssc-grid,0.42.4,0.42.5,72,2,174,111,285,3,FALSE
ssc-grid,0.42.5,0.43.0,73,3,40,34,74,5,FALSE
ssc-grid,0.42.0,0.42.1,68,2,5,1,6,2,FALSE
ssc-grid,0.42.1,0.42.2,69,5,1754,337,2091,21,FALSE
ssc-grid,0.42.2,0.42.3,70,2,6,2,8,2,FALSE
ssc-grid,0.42.3,0.42.4,71,2,191,79,270,6,FALSE
ssc-grid,0.36.0,0.37.0,53,1,1,1,2,1,FALSE
ssc-grid,0.43.1,0.44.0,75,5,99,12,111,12,FALSE
ssc-grid,0.64.2,0.64.3,111,4,81,43,124,5,FALSE
ssc-grid,0.40.0,0.41.0,66,1,1,1,2,1,FALSE
ssc-grid,0.43.0,0.43.1,74,2,2,2,4,2,FALSE
ssc-grid,0.64.3,0.64.4,112,1,1,1,2,1,FALSE
ssc-grid,0.34.3,0.35.0,50,2,59,6,65,2,FALSE
ssc-grid,0.34.2,0.34.3,49,2,27,3,30,4,FALSE
ssc-grid,0.34.1,0.34.2,48,2,7,7,14,2,FALSE
ssc-grid,0.34.0,0.34.1,47,3,57,11,68,7,FALSE
ssc-grid,0.23.1,0.24.0,33,2,8,6,14,3,FALSE
ssc-grid,0.23.0,0.23.1,32,2,88,5,93,8,FALSE
ssc-grid,0.55.0,0.56.0,98,1,1,1,2,1,FALSE
ssc-grid,0.22.0,0.23.0,31,1,1,1,2,1,FALSE
ssc-grid,0.57.2,0.58.0,103,4,599,238,837,8,FALSE
ssc-grid,0.57.0,0.57.1,101,2,2,2,4,2,FALSE
ssc-grid,0.57.1,0.57.2,102,3,16,3,19,4,FALSE
ssc-grid,0.46.0,0.47.0,80,3,75,27,102,5,FALSE
ssc-grid,0.28.0,0.29.0,40,2,60,5,65,7,FALSE
ssc-grid,0.69.0,0.69.1,142,4,24,8,32,9,FALSE
ssc-grid,0.44.0,0.45.0,76,1,1,1,2,1,FALSE
ssc-grid,0.39.6,0.40.0,65,2,251,2,253,12,FALSE
ssc-grid,0.63.0,0.64.0,109,1,1,1,2,1,FALSE
ssc-grid,0.30.0,0.31.0,42,1,1,1,2,1,FALSE
ssc-grid,0.39.4,0.39.5,63,3,198,26,224,8,FALSE
ssc-grid,0.60.0,0.61.0,106,1,7,0,7,1,FALSE
ssc-grid,0.31.0,0.32.0,43,2,230,7,237,13,FALSE
ssc-grid,0.51.0,0.51.1,92,2,2,2,4,2,FALSE
ssc-grid,0.51.1,0.52.0,93,2,5,2,7,2,FALSE
ssc-grid,0.53.2,0.55.0,97,4,154,130,284,11,FALSE
ssc-grid,0.69.1,0.69.2,143,2,7,7,14,5,FALSE
ssc-grid,0.53.0,0.53.2,96,4,6,3,9,4,FALSE
ssc-grid,0.39.5,0.39.6,64,2,2,2,4,2,FALSE
ssc-grid,0.39.2,0.39.3,61,2,2,2,4,2,FALSE
ssc-grid,0.39.3,0.39.4,62,3,64,13,77,6,FALSE
ssc-grid,0.39.0,0.39.1,59,2,126,4,130,6,FALSE
ssc-grid,0.39.1,0.39.2,60,4,72,22,94,6,FALSE
ssc-grid,0.64.14,0.65.0,123,3,84,81,165,6,FALSE
ssc-grid,0.20.0,0.21.0,29,3,183,5,188,15,FALSE
ssc-grid,0.64.13,0.64.14,122,3,47,2,49,5,FALSE
ssc-grid,0.64.10,0.64.11,119,1,1,1,2,1,FALSE
ssc-grid,0.64.11,0.64.12,120,3,54,17,71,4,FALSE
ssc-grid,0.64.12,0.64.13,121,2,64,1,65,3,FALSE
ssc-grid,0.21.0,0.22.0,30,2,10,1,11,3,FALSE
ssc-grid,0.41.0,0.42.0,67,3,428,18,446,19,FALSE
ssc-grid,0.29.0,0.30.0,41,3,211,21,232,17,FALSE
ssc-grid,0.47.1,0.48.0,82,5,19,2,21,5,FALSE
ssc-grid,0.47.0,0.47.1,81,4,423,318,741,10,FALSE
ssc-grid,0.64.8,0.64.9,117,3,123,9,132,6,FALSE
ssc-grid,0.64.9,0.64.10,118,5,283,195,478,6,FALSE
ssc-grid,0.64.4,0.64.5,113,2,21,6,27,2,FALSE
ssc-grid,0.64.5,0.64.6,114,4,150,8,158,9,FALSE
ssc-grid,0.64.6,0.64.7,115,4,172,43,215,9,FALSE
ssc-grid,0.64.7,0.64.8,116,3,11,3,14,3,FALSE
ssc-grid,0.64.0,0.64.2,110,4,41,9,50,5,FALSE
ssc-grid,0.45.2,0.46.0,79,2,43,14,57,3,FALSE
ssc-grid,0.45.1,0.45.2,78,3,15,10,25,3,FALSE
ssc-grid,0.45.0,0.45.1,77,2,28,13,41,2,FALSE
ssc-grid,0.33.0,0.33.1,45,2,73,21,94,7,FALSE
ssc-grid,0.33.1,0.34.0,46,2,6,4,10,2,FALSE
ssc-grid,0.66.4,0.66.5,131,3,453,2,455,16,FALSE
ssc-grid,0.66.5,0.67.0,132,5,97,82,179,23,FALSE
ssc-grid,0.66.2,0.66.3,129,8,931,389,1320,36,FALSE
ssc-grid,0.66.3,0.66.4,130,2,10,1,11,2,FALSE
ssc-grid,0.66.0,0.66.1,127,5,262,253,515,6,FALSE
ssc-grid,0.66.1,0.66.2,128,2,3,3,6,2,FALSE
ssc-grid,0.61.0,0.62.0,107,4,306,139,445,10,FALSE
ssc-grid,0.32.0,0.33.0,44,2,187,4,191,11,FALSE
ssc-grid,0.56.1,0.57.0,100,2,8,5,13,3,FALSE
ssc-grid,0.56.0,0.56.1,99,2,174,28,202,10,FALSE
ssc-grid,0.50.0,0.51.0,91,2,2,2,4,2,FALSE
ssc-grid,0.38.2,0.39.0,58,4,34,9,43,4,FALSE
ssc-grid,0.38.1,0.38.2,57,2,30,10,40,3,FALSE
ssc-grid,0.38.0,0.38.1,56,2,42,22,64,4,FALSE
ssc-grid,0.52.1,0.53.0,95,12,195,27,222,15,FALSE
ssc-grid,0.52.0,0.52.1,94,3,40,14,54,4,FALSE
ssc-grid,0.59.0,0.60.0,105,4,69,70,139,6,FALSE
ssc-grid,0.19.0,0.20.0,28,7,4858,4171,9029,36,FALSE
ssc-grid,0.24.0,0.25.0,34,2,95,1,96,7,FALSE
ssc-grid,0.26.0,0.26.1,36,3,76,9,85,4,FALSE
ssc-grid,0.26.1,0.27.0,37,1,1,1,2,1,FALSE
ssc-grid,0.65.1,0.65.2,125,4,16,7,23,4,FALSE
ssc-grid,0.65.0,0.65.1,124,3,96,33,129,7,FALSE
ssc-grid,0.65.2,0.66.0,126,2,106,101,207,5,FALSE
ssc-grid,0.67.0,0.68.0,133,2,818,11,829,7,FALSE
ssc-grid,0.48.6,0.49.0,89,2,35,14,49,3,FALSE
ssc-grid,0.48.4,0.48.5,87,3,5,2,7,3,FALSE
ssc-grid,0.48.5,0.48.6,88,3,3,9,12,3,FALSE
ssc-grid,0.48.2,0.48.3,85,3,95,17,112,6,FALSE
ssc-grid,0.48.3,0.48.4,86,1,1,1,2,1,FALSE
ssc-grid,0.48.0,0.48.1,83,3,181,102,283,12,FALSE
ssc-grid,0.48.1,0.48.2,84,1,1,1,2,1,FALSE
ssc-grid,0.15.0,0.16.0,18,3,72,17,89,6,FALSE
ssc-grid,0.10.1,0.11.0,15,2,82,1,83,4,FALSE
ssc-grid,0.10.0,0.10.1,14,2,5,5,10,3,FALSE
ssc-grid,0.6.0,0.7.0,10,5,144,19,163,12,FALSE
ssc-grid,0.11.0,0.14.0,16,28,1005,806,1811,72,FALSE
ssc-grid,0.7.0,0.8.0,11,2,218,182,400,8,FALSE
ssc-grid,0.17.2,0.17.3,22,3,4,3,7,3,FALSE
ssc-grid,0.17.0,0.17.1,20,1,1,1,2,1,FALSE
ssc-grid,0.17.1,0.17.2,21,3,27,12,39,4,FALSE
ssc-grid,0.16.0,0.17.0,19,5,208,42,250,10,FALSE
ssc-grid,0.5.0,0.6.0,9,4,85,31,116,8,FALSE
ssc-grid,0.9.0,0.10.0,13,2,66,39,105,4,FALSE
ssc-grid,0.14.0,0.15.0,17,2,95,19,114,5,FALSE
ssc-grid,0.8.0,0.9.0,12,2,194,174,368,8,FALSE
ssc-grid,0.3.0,0.4.0,6,14,341,51,392,27,FALSE
ssc-grid,0.4.1,0.5.0,8,5,99,34,133,9,FALSE
ssc-grid,0.4.0,0.4.1,7,1,1,0,1,1,FALSE
ssc-grid,0.2.5,0.3.0,5,11,261,204,465,21,FALSE
ssc-grid,0.2.4,0.2.5,4,2,2,2,4,2,FALSE
ssc-grid,0.2.3,0.2.4,3,6,37,8,45,6,FALSE
ssc-grid,0.2.2,0.2.3,2,1,1,1,2,1,FALSE
ssc-grid,0.47.1,0.48.0,82,5,19,2,21,5,TRUE
ssc-grid,0.35.1,0.36.0,52,8,711,548,1259,53,TRUE
ssc-grid,0.2.1,0.2.2,1,11,5149,216,5365,80,FALSE
ssc-grid,0.43.1,0.44.0,75,5,99,12,111,12,TRUE
ssc-grid,0.18.1,0.18.3,25,4,148,60,208,14,TRUE
ssc-grid,0.39.5,0.39.6,64,2,2,2,4,2,TRUE
ssc-grid,0.8.0,0.9.0,12,2,194,174,368,8,TRUE
ssc-grid,0.33.1,0.34.0,46,2,6,4,10,2,TRUE
ssc-grid,0.64.6,0.64.7,115,4,172,43,215,9,TRUE
ssc-grid,0.66.1,0.66.2,128,2,3,3,6,2,TRUE
ssc-grid,0.43.0,0.43.1,74,2,2,2,4,2,TRUE
ssc-grid,0.34.3,0.35.0,50,2,59,6,65,2,TRUE
ssc-grid,0.10.0,0.10.1,14,2,5,5,10,3,TRUE
ssc-grid,0.58.0,0.59.0,104,1,109,195,304,4,TRUE
ssc-grid,0.57.1,0.57.2,102,3,16,3,19,4,TRUE
ssc-grid,0.48.0,0.48.1,83,3,181,102,283,12,TRUE
ssc-grid,0.66.2,0.66.3,129,8,931,389,1320,36,TRUE
ssc-grid,0.2.5,0.3.0,5,11,261,204,465,21,TRUE
ssc-grid,0.63.0,0.64.0,109,1,1,1,2,1,TRUE
ssc-grid,0.48.1,0.48.2,84,1,1,1,2,1,TRUE
ssc-grid,0.37.0,0.37.2,54,5,132,61,193,10,TRUE
ssc-grid,0.17.2,0.17.3,22,3,4,3,7,3,TRUE
ssc-grid,0.68.2,0.68.3,136,3,142,139,281,7,TRUE
ssc-grid,0.42.5,0.43.0,73,3,40,34,74,5,TRUE
ssc-grid,0.16.0,0.17.0,19,5,208,42,250,10,TRUE
ssc-grid,0.39.6,0.40.0,65,2,251,2,253,12,TRUE
ssc-grid,0.42.0,0.42.1,68,2,5,1,6,2,TRUE
ssc-grid,0.42.1,0.42.2,69,5,1754,337,2091,21,TRUE
sorting-visualiser,0.1.12,0.1.13,13,3,7,7,14,3,FALSE
sorting-visualiser,0.1.13,0.2.0,14,10,39,17,56,14,FALSE
sorting-visualiser,0.1.10,0.1.11,11,2,32,2,34,3,FALSE
sorting-visualiser,0.1.11,0.1.12,12,2,4,1,5,2,FALSE
sorting-visualiser,0.1.8,0.1.9,9,2,2,2,4,2,FALSE
sorting-visualiser,0.1.9,0.1.10,10,2,25,3,28,3,FALSE
sorting-visualiser,0.1.0,0.1.1,1,2,5,5,10,3,FALSE
sorting-visualiser,0.1.1,0.1.2,2,2,30,26,56,3,FALSE
sorting-visualiser,0.1.2,0.1.3,3,2,120,33,153,6,FALSE
sorting-visualiser,0.1.3,0.1.4,4,2,28,30,58,5,FALSE
sorting-visualiser,0.1.4,0.1.5,5,2,4,1,5,2,FALSE
sorting-visualiser,0.1.5,0.1.6,6,2,2,2,4,2,FALSE
sorting-visualiser,0.1.6,0.1.7,7,7,76,398,474,24,FALSE
sorting-visualiser,0.1.7,0.1.8,8,4,11,6,17,6,FALSE
sorting-visualiser,0.1.12,0.1.13,13,3,7,7,14,3,TRUE
react-ja-date-picker,0.0.0,0.0.2,1,2,2,2,4,2,FALSE
react-ja-date-picker,0.0.3,0.1.1,3,16,442,228,670,42,FALSE
react-ja-date-picker,0.0.2,0.0.3,2,3,97,70,167,12,FALSE
react-ja-date-picker,2.0.0,2.1.0,11,2,2,2,4,2,FALSE
react-ja-date-picker,0.1.8,2.0.0,10,20,541,333,874,59,FALSE
react-ja-date-picker,0.1.6,0.1.7,8,14,798,490,1288,35,FALSE
react-ja-date-picker,0.1.1,0.1.2,4,17,431,236,667,51,FALSE
react-ja-date-picker,0.1.3,0.1.5,6,10,617,537,1154,35,FALSE
react-ja-date-picker,0.1.5,0.1.6,7,7,188,95,283,11,FALSE
react-ja-date-picker,0.1.2,0.1.3,5,2,4,4,8,2,FALSE
react-ja-date-picker,0.1.7,0.1.8,9,1,1,1,2,1,FALSE
react-ja-date-picker,0.1.3,0.1.5,6,10,617,537,1154,35,TRUE
react-ja-date-picker,0.0.3,0.1.1,3,16,442,228,670,42,TRUE
smitty,1.1.1,1.2.0,12,4,10,11,21,4,FALSE
smitty,1.1.0,1.1.1,11,1,23,4,27,3,FALSE
smitty,1.0.0,1.0.1,9,11,197,47,244,14,FALSE
smitty,1.0.1,1.1.0,10,6,50,20,70,8,FALSE
smitty,0.0.2,0.1.0,1,2,3,3,6,3,FALSE
smitty,0.3.0,0.3.1,7,4,102,2,104,4,FALSE
smitty,0.3.1,1.0.0,8,11,46,38,84,15,FALSE
smitty,0.1.0,0.1.1,2,2,13,9,22,3,FALSE
smitty,0.2.2,0.3.0,6,2,28,2,30,3,FALSE
smitty,0.2.1,0.2.2,5,5,8,2,10,5,FALSE
smitty,0.2.0,0.2.1,4,12,57,50,107,16,FALSE
smitty,0.1.1,0.2.0,3,8,69,26,95,9,FALSE
smitty,0.1.1,0.2.0,3,8,69,26,95,9,TRUE
smitty,1.3.0,2.0.0,14,16,1028,402,1430,41,FALSE
smitty,2.0.2,2.0.3,17,2,192,226,418,6,FALSE
smitty,2.0.1,2.0.2,16,3,306,180,486,6,FALSE
smitty,2.0.0,2.0.1,15,3,107,11,118,5,FALSE
smitty,1.0.0,1.0.1,9,11,197,47,244,14,TRUE
smitty,0.3.1,1.0.0,8,11,46,38,84,15,TRUE
smitty,1.2.0,1.3.0,13,10,970,362,1332,30,FALSE
dash-docset-generator,0.0.1,0.0.2,1,2,5,13,18,3,FALSE
dash-docset-generator,0.0.2,0.1.0,2,1,93,4,97,3,FALSE
dash-docset-generator,0.3.0,1.0.0,6,5,30,24,54,11,FALSE
dash-docset-generator,0.2.0,0.3.0,5,2,10139,60,10199,52,FALSE
dash-docset-generator,0.1.0,0.1.1,3,2,5,7,12,2,FALSE
dash-docset-generator,0.1.1,0.2.0,4,2,6841,213,7054,39,FALSE
dash-docset-generator,0.3.0,1.0.0,6,5,30,24,54,11,TRUE
neoui-sparrow,1.1.1,1.1.2,6,1,10,13,23,7,FALSE
neoui-sparrow,1.1.0,1.1.1,5,1,23,4243,4266,30,FALSE
neoui-sparrow,1.1.3,1.1.4,8,1,3,1,4,1,FALSE
neoui-sparrow,1.0.7,1.0.8,3,2,72,161,233,8,FALSE
neoui-sparrow,1.0.0,1.0.1,1,5,7562,43,7605,31,FALSE
neoui-sparrow,1.0.1,1.0.7,2,14,6427,5569,11996,121,FALSE
neoui-sparrow,1.1.7,1.1.8,12,1,3,1,4,1,FALSE
neoui-sparrow,1.1.6,1.1.7,11,1,3,1,4,1,FALSE
neoui-sparrow,1.1.9,1.1.10,14,1,4251,41,4292,11,FALSE
neoui-sparrow,1.1.8,1.1.9,13,1,3,1,4,1,FALSE
neoui-sparrow,1.0.8,1.1.0,4,1,4060,3,4063,22,FALSE
neoui-sparrow,1.1.2,1.1.3,7,2,23,12,35,3,FALSE
neoui-sparrow,1.1.5,1.1.6,10,1,3,1,4,1,FALSE
neoui-sparrow,1.1.4,1.1.5,9,1,3,1,4,1,FALSE
neoui-sparrow,1.4.3,1.4.4,25,1,320,320,640,5,FALSE
neoui-sparrow,1.4.0,1.4.1,22,5,367,23,390,17,FALSE
neoui-sparrow,1.4.1,1.4.2,23,1,20,15,35,5,FALSE
neoui-sparrow,1.4.2,1.4.3,24,3,335,341,676,13,FALSE
neoui-sparrow,1.1.10,1.1.11,15,2,761,737,1498,20,FALSE
neoui-sparrow,1.4.4,1.4.5,26,2,6,6,12,6,FALSE
neoui-sparrow,1.4.5,1.4.6,27,2,6,6,12,6,FALSE
neoui-sparrow,1.4.6,1.4.7,28,1,3,3,6,3,FALSE
neoui-sparrow,1.4.7,1.4.10,29,1,3,3,6,3,FALSE
neoui-sparrow,1.4.12,1.4.13,32,2,168,116,284,10,FALSE
neoui-sparrow,1.3.0,1.4.0,21,1,2,2,4,2,FALSE
neoui-sparrow,1.2.2,1.2.3,19,2,119,114,233,14,FALSE
neoui-sparrow,1.2.3,1.3.0,20,1,4,1,5,2,FALSE
neoui-sparrow,1.2.0,1.2.1,17,1,2,1,3,2,FALSE
neoui-sparrow,1.2.1,1.2.2,18,2,5,5,10,4,FALSE
neoui-sparrow,1.1.11,1.2.0,16,1,8,8,16,27,FALSE
neoui-sparrow,1.4.13,1.4.14,33,1,3,3,6,3,FALSE
neoui-sparrow,1.4.10,1.4.11,30,6,1202,1057,2259,29,FALSE
neoui-sparrow,1.4.11,1.4.12,31,3,605,531,1136,15,FALSE
neoui-sparrow,1.4.14,1.4.15,34,1,3,3,6,3,FALSE
neoui-sparrow,1.4.15,1.4.16,35,3,24,18,42,8,FALSE
neoui-sparrow,1.4.0,1.4.1,22,5,367,23,390,17,TRUE
neoui-sparrow,1.4.5,1.4.6,27,2,6,6,12,6,TRUE
neoui-sparrow,1.1.9,1.1.10,14,1,4251,41,4292,11,TRUE
neoui-sparrow,1.2.2,1.2.3,19,2,119,114,233,14,TRUE
neoui-sparrow,1.4.10,1.4.11,30,6,1202,1057,2259,29,TRUE
ng2-intl,1.0.0-rc.13,1.0.0-rc.15,13,7,151,137,288,12,FALSE
ng2-intl,1.0.0-rc.12,1.0.0-rc.13,12,3,79,18,97,14,FALSE
ng2-intl,1.0.0-rc.11,1.0.0-rc.12,11,4,2101,34,2135,45,FALSE
ng2-intl,1.0.0-rc.10,1.0.0-rc.11,10,2,2,5,7,2,FALSE
ng2-intl,1.0.0-rc.7,1.0.0-rc.8,7,2,137,86,223,6,FALSE
ng2-intl,1.0.0-rc.9,1.0.0-rc.10,9,3,296,44,340,40,FALSE
ng2-intl,1.0.0-rc.8,1.0.0-rc.9,8,3,758,64,822,23,FALSE
ng2-intl,1.0.0-rc.12,1.0.0-rc.13,12,3,79,18,97,14,TRUE
ng2-intl,1.0.0-rc.6,1.0.0-rc.7,6,2,30,18,48,5,FALSE
ng2-intl,1.0.0-rc.5,1.0.0-rc.6,5,2,263,127,390,20,FALSE
ng2-intl,1.0.0-rc.4,1.0.0-rc.5,4,1,3,2,5,1,FALSE
ng2-intl,1.0.0-rc.5,1.0.0-rc.6,5,2,263,127,390,20,TRUE
ng2-intl,1.0.0-rc.3,1.0.0-rc.4,3,3,168,18,186,12,FALSE
ng2-intl,1.0.0-rc.2,1.0.0-rc.3,2,2,1,2,3,2,FALSE
ng2-intl,1.0.0-rc.1,1.0.0-rc.2,1,4,6,5,11,4,FALSE
ng2-intl,1.0.0-rc.7,1.0.0-rc.8,7,2,137,86,223,6,TRUE
ng2-intl,1.0.0-rc.6,1.0.0-rc.7,6,2,30,18,48,5,TRUE
ng2-intl,1.0.0-rc.3,1.0.0-rc.4,3,3,168,18,186,12,TRUE
ng2-intl,1.0.0-rc.2,1.0.0-rc.3,2,2,1,2,3,2,TRUE
ng2-intl,1.0.0-rc.1,1.0.0-rc.2,1,4,6,5,11,4,TRUE
ng2-intl,1.0.0-rc.8,1.0.0-rc.9,8,3,758,64,822,23,TRUE
hyperpotamus,0.31.2,0.31.3,105,5,129,21,150,8,FALSE
hyperpotamus,0.31.3,0.32.0,106,16,707,309,1016,35,FALSE
hyperpotamus,0.31.0,0.31.1,103,5,11,8,19,6,FALSE
hyperpotamus,0.31.1,0.31.2,104,16,589,99,688,33,FALSE
hyperpotamus,0.32.1,0.32.2,108,4,91,18,109,4,FALSE
hyperpotamus,0.32.0,0.32.1,107,2,8,5,13,3,FALSE
hyperpotamus,0.32.2,0.33.0,109,4,165,2,167,6,FALSE
hyperpotamus,0.28.4,0.28.5,94,2,1,4,5,2,FALSE
hyperpotamus,0.24.18,0.24.19,75,1,4,4,8,1,FALSE
hyperpotamus,0.24.19,0.25.0,76,4,62,14,76,6,FALSE
hyperpotamus,0.28.5,0.28.6,95,9,10,1,11,50,FALSE
hyperpotamus,0.24.12,0.24.13,69,3,216,43,259,11,FALSE
hyperpotamus,0.24.13,0.24.14,70,2,6,2,8,2,FALSE
hyperpotamus,0.24.10,0.24.11,67,2,2,1,3,2,FALSE
hyperpotamus,0.24.11,0.24.12,68,2,9,5,14,2,FALSE
hyperpotamus,0.24.16,0.24.17,73,1,35,1,36,2,FALSE
hyperpotamus,0.24.14,0.24.15,71,2,10,5,15,3,FALSE
hyperpotamus,0.24.15,0.24.16,72,2,10,8,18,2,FALSE
hyperpotamus,0.28.7,0.29.0,97,26,5363,2127,7490,425,FALSE
hyperpotamus,0.28.0,0.28.1,90,3,22,25,47,11,FALSE
hyperpotamus,0.24.17,0.24.18,74,2,19,8,27,2,FALSE
hyperpotamus,0.34.1,0.34.2,112,2,9,299,308,5,FALSE
hyperpotamus,0.34.0,0.34.1,111,4,3,7,10,4,FALSE
hyperpotamus,0.24.9,0.24.10,66,2,6,5,11,3,FALSE
hyperpotamus,0.25.5,0.26.0,82,45,3106,3043,6149,277,FALSE
hyperpotamus,0.25.4,0.25.5,81,4,8,3,11,4,FALSE
hyperpotamus,0.25.1,0.25.2,78,2,2,2,4,3,FALSE
hyperpotamus,0.25.0,0.25.1,77,2,63,1,64,3,FALSE
hyperpotamus,0.25.3,0.25.4,80,2,2,2,4,2,FALSE
hyperpotamus,0.25.2,0.25.3,79,3,41,1,42,5,FALSE
hyperpotamus,0.29.0,0.30.0,98,13,3048,1576,4624,124,FALSE
hyperpotamus,0.26.2,0.26.3,85,2,18,10,28,3,FALSE
hyperpotamus,0.26.3,0.26.4,86,15,652,182,834,27,FALSE
hyperpotamus,0.28.6,0.28.7,96,3,63,52,115,21,FALSE
hyperpotamus,0.26.1,0.26.2,84,2,15,3,18,2,FALSE
hyperpotamus,0.26.6,0.28.0,89,17,953,927,1880,96,FALSE
hyperpotamus,0.28.1,0.28.2,91,3,29,17,46,3,FALSE
hyperpotamus,0.28.2,0.28.3,92,2,2,2,4,2,FALSE
hyperpotamus,0.28.3,0.28.4,93,2,30,10,40,2,FALSE
hyperpotamus,0.26.5,0.26.6,88,24,456,215,671,73,FALSE
hyperpotamus,0.26.4,0.26.5,87,3,4,4,8,3,FALSE
hyperpotamus,0.26.0,0.26.1,83,1,74,22,96,4,FALSE
hyperpotamus,0.33.0,0.34.0,110,28,1086,335,1421,75,FALSE
hyperpotamus,0.30.3,0.31.0,102,27,1863,1315,3178,213,FALSE
hyperpotamus,0.30.2,0.30.3,101,7,81,50,131,9,FALSE
hyperpotamus,0.30.1,0.30.2,100,22,1072,582,1654,147,FALSE
hyperpotamus,0.30.0,0.30.1,99,8,259,90,349,27,FALSE
hyperpotamus,0.15.12,0.16.0,30,1,1,1,2,1,FALSE
hyperpotamus,0.15.10,0.15.11,28,1,8,3,11,2,FALSE
hyperpotamus,0.15.11,0.15.12,29,5,136,99,235,23,FALSE
hyperpotamus,0.17.0,0.18.0,37,1,13,18,31,6,FALSE
hyperpotamus,0.18.1,0.18.2,39,1,2,2,4,2,FALSE
hyperpotamus,0.18.0,0.18.1,38,1,3,7,10,2,FALSE
hyperpotamus,0.18.2,0.19.0,40,6,369,293,662,71,FALSE
hyperpotamus,0.15.6,0.15.7,24,1,28,36,64,5,FALSE
hyperpotamus,0.22.1,0.22.2,52,2,117,11,128,13,FALSE
hyperpotamus,0.16.5,0.17.0,36,8,145,133,278,24,FALSE
hyperpotamus,0.16.4,0.16.5,35,1,5,3,8,3,FALSE
hyperpotamus,0.16.3,0.16.4,34,1,3,2,5,2,FALSE
hyperpotamus,0.16.2,0.16.3,33,1,31,5,36,4,FALSE
hyperpotamus,0.16.1,0.16.2,32,1,28,16,44,3,FALSE
hyperpotamus,0.16.0,0.16.1,31,1,64,34,98,5,FALSE
hyperpotamus,0.23.0,0.24.0,56,4,36,23,59,8,FALSE
hyperpotamus,0.22.4,0.23.0,55,9,65,30,95,9,FALSE
hyperpotamus,0.15.3,0.15.5,22,7,554,253,807,34,FALSE
hyperpotamus,0.22.2,0.22.3,53,2,51,60,111,8,FALSE
hyperpotamus,0.15.5,0.15.6,23,2,74,7,81,5,FALSE
hyperpotamus,0.22.0,0.22.1,51,1,223,84,307,13,FALSE
hyperpotamus,0.15.7,0.15.8,25,9,128,33,161,32,FALSE
hyperpotamus,0.15.8,0.15.9,26,5,52,22,74,7,FALSE
hyperpotamus,0.15.9,0.15.10,27,1,117,31,148,3,FALSE
hyperpotamus,0.20.4,0.20.5,46,1,42,35,77,4,FALSE
hyperpotamus,0.20.5,0.20.6,47,1,12,4,16,2,FALSE
hyperpotamus,0.20.6,0.20.7,48,1,4,7,11,2,FALSE
hyperpotamus,0.20.7,0.21.0,49,7,389,154,543,32,FALSE
hyperpotamus,0.20.0,0.20.1,42,1,2,2,4,2,FALSE
hyperpotamus,0.20.1,0.20.2,43,1,32,33,65,3,FALSE
hyperpotamus,0.20.2,0.20.3,44,2,35,31,66,10,FALSE
hyperpotamus,0.20.3,0.20.4,45,1,3,2,5,3,FALSE
hyperpotamus,0.21.0,0.22.0,50,3,731,398,1129,78,FALSE
hyperpotamus,0.22.3,0.22.4,54,1,1,1,2,1,FALSE
hyperpotamus,0.24.8,0.24.9,65,2,22,2,24,4,FALSE
hyperpotamus,0.19.0,0.20.0,41,4,214,162,376,35,FALSE
hyperpotamus,0.24.0,0.24.1,57,2,21,3,24,3,FALSE
hyperpotamus,0.24.1,0.24.2,58,2,7,3,10,3,FALSE
hyperpotamus,0.24.2,0.24.3,59,2,8,2,10,3,FALSE
hyperpotamus,0.24.3,0.24.4,60,2,77,22,99,4,FALSE
hyperpotamus,0.24.4,0.24.5,61,3,15,37,52,29,FALSE
hyperpotamus,0.24.5,0.24.6,62,2,11,6,17,4,FALSE
hyperpotamus,0.24.6,0.24.7,63,1,1,1,2,1,FALSE
hyperpotamus,0.24.7,0.24.8,64,4,138,6,144,8,FALSE
hyperpotamus,0.18.0,0.18.1,38,1,3,7,10,2,TRUE
hyperpotamus,0.15.2,0.15.3,21,1,103,0,103,4,FALSE
hyperpotamus,0.15.0,0.15.1,19,3,34,1,35,4,FALSE
hyperpotamus,0.15.1,0.15.2,20,1,1,1,2,1,FALSE
hyperpotamus,0.28.6,0.28.7,96,3,63,52,115,21,TRUE
hyperpotamus,0.28.2,0.28.3,92,2,2,2,4,2,TRUE
hyperpotamus,0.11.0,0.12.0,12,6,60,39,99,15,FALSE
hyperpotamus,0.20.3,0.20.4,45,1,3,2,5,3,TRUE
hyperpotamus,0.13.0,0.14.0,16,4,92,12,104,15,FALSE
hyperpotamus,0.14.1,0.15.0,18,1,146,185,331,27,FALSE
hyperpotamus,0.14.0,0.14.1,17,1,1,63,64,2,FALSE
hyperpotamus,0.8.0,0.9.0,9,10,155,52,207,16,FALSE
hyperpotamus,0.10.0,0.11.0,11,3,191,33,224,7,FALSE
hyperpotamus,0.12.2,0.13.0,15,6,32,12,44,9,FALSE
hyperpotamus,0.12.1,0.12.2,14,1,2,2,4,2,FALSE
hyperpotamus,0.12.0,0.12.1,13,1,5,1,6,1,FALSE
hyperpotamus,0.9.0,0.10.0,10,3,67,23,90,7,FALSE
hyperpotamus,0.15.10,0.15.11,28,1,8,3,11,2,TRUE
hyperpotamus,0.20.7,0.21.0,49,7,389,154,543,32,TRUE
hyperpotamus,0.3.0,0.4.0,3,11,557,296,853,76,FALSE
hyperpotamus,0.24.18,0.24.19,75,1,4,4,8,1,TRUE
hyperpotamus,0.6.0,0.7.0,7,3,108,74,182,14,FALSE
hyperpotamus,0.20.0,0.20.1,42,1,2,2,4,2,TRUE
hyperpotamus,0.4.1,0.5.0,5,2,249,165,414,5,FALSE
hyperpotamus,0.4.0,0.4.1,4,1,2,2,4,1,FALSE
hyperpotamus,0.2.0,0.3.0,2,5,163,69,232,12,FALSE
hyperpotamus,0.1.0,0.2.0,1,1,63,16,79,8,FALSE
hyperpotamus,0.7.0,0.8.0,8,5,108,26,134,11,FALSE
hyperpotamus,0.5.0,0.6.0,6,10,896,623,1519,78,TRUE
hyperpotamus,0.16.5,0.17.0,36,8,145,133,278,24,TRUE
hyperpotamus,0.5.0,0.6.0,6,10,896,623,1519,78,FALSE
hyperpotamus,0.29.0,0.30.0,98,13,3048,1576,4624,124,TRUE
hyperpotamus,0.31.2,0.31.3,105,5,129,21,150,8,TRUE
hyperpotamus,0.31.3,0.32.0,106,16,707,309,1016,35,TRUE
hyperpotamus,0.31.0,0.31.1,103,5,11,8,19,6,TRUE
hyperpotamus,0.31.1,0.31.2,104,16,589,99,688,33,TRUE
hyperpotamus,0.32.1,0.32.2,108,4,91,18,109,4,TRUE
hyperpotamus,0.33.0,0.34.0,110,28,1086,335,1421,75,TRUE
hyperpotamus,0.30.0,0.30.1,99,8,259,90,349,27,TRUE
hyperpotamus,0.26.3,0.26.4,86,15,652,182,834,27,TRUE
hyperpotamus,0.28.5,0.28.6,95,9,10,1,11,50,TRUE
hyperpotamus,0.16.2,0.16.3,33,1,31,5,36,4,TRUE
hyperpotamus,0.22.3,0.22.4,54,1,1,1,2,1,TRUE
hyperpotamus,0.17.0,0.18.0,37,1,13,18,31,6,TRUE
hyperpotamus,0.24.16,0.24.17,73,1,35,1,36,2,TRUE
hyperpotamus,0.15.3,0.15.5,22,7,554,253,807,34,TRUE
hyperpotamus,0.30.3,0.31.0,102,27,1863,1315,3178,213,TRUE
hyperpotamus,0.11.0,0.12.0,12,6,60,39,99,15,TRUE
hyperpotamus,0.19.0,0.20.0,41,4,214,162,376,35,TRUE
hyperpotamus,0.24.4,0.24.5,61,3,15,37,52,29,TRUE
speechmatics,1.0.0,1.0.1,4,2,36,8,44,7,FALSE
speechmatics,1.0.1,2.0.0,5,2,8,8,16,5,FALSE
speechmatics,2.0.0,2.1.0,6,5,91,5,96,9,FALSE
speechmatics,0.0.2,0.1.2,2,6,370,34,404,12,FALSE
speechmatics,0.0.1,0.0.2,1,2,2,1,3,2,FALSE
speechmatics,0.1.2,1.0.0,3,2,38,12,50,4,FALSE
speechmatics,0.0.2,0.1.2,2,6,370,34,404,12,TRUE
react-universal-renderer,0.0.11,0.0.12,3,1,28,16,44,5,TRUE
react-universal-renderer,0.0.9,0.0.10,1,2,613,2,615,22,FALSE
react-universal-renderer,0.0.10,0.0.11,2,1,2,2,4,2,FALSE
react-universal-renderer,0.0.12,0.0.13,4,1,31,24,55,4,FALSE
react-universal-renderer,0.0.11,0.0.12,3,1,28,16,44,5,FALSE
split-tweet,0.3.0,0.3.1,6,4,3,6,9,4,FALSE
split-tweet,0.3.1,0.4.0,7,8,1351,580,1931,38,FALSE
split-tweet,0.2.2,0.3.0,5,13,3525,395,3920,51,FALSE
split-tweet,0.2.1,0.2.2,4,3,6,3,9,6,FALSE
split-tweet,0.2.0,0.2.1,3,5,1158,9,1167,22,FALSE
split-tweet,0.4.1,0.4.2,9,3,10,10,20,10,FALSE
split-tweet,0.4.0,0.4.1,8,4,360,135,495,21,FALSE
split-tweet,0.1.0,0.1.2,1,6,12,12,24,9,FALSE
split-tweet,0.1.2,0.2.0,2,29,1481,641,2122,90,FALSE
split-tweet,0.4.0,0.4.1,8,4,360,135,495,21,TRUE
redux-ab-test,6.5.1-alpha,6.6.0,57,1,219,67,286,5,FALSE
redux-ab-test,6.6.1,6.6.2,59,1,219,67,286,5,FALSE
redux-ab-test,6.6.0,6.6.1,58,1,219,67,286,5,FALSE
redux-ab-test,6.6.3,6.6.5,61,1,219,67,286,5,FALSE
redux-ab-test,6.6.2,6.6.3,60,1,219,67,286,5,FALSE
redux-ab-test,6.0.3,6.0.4,53,2,2,2,4,2,FALSE
redux-ab-test,6.0.2,6.0.3,52,3,6,6,12,3,FALSE
redux-ab-test,6.0.1,6.0.2,51,1,7,3,10,2,FALSE
redux-ab-test,6.0.5,6.1.0-beta,55,1,219,67,286,5,FALSE
redux-ab-test,6.0.4,6.0.5,54,2,30,7,37,2,FALSE
redux-ab-test,2.0.7,2.0.8,7,1,42,46,88,5,FALSE
redux-ab-test,2.0.6,2.0.7,6,1,1,1,2,1,FALSE
redux-ab-test,2.0.5,2.0.6,5,2,139,23,162,8,FALSE
redux-ab-test,3.0.5,3.0.6,16,22,1925,3037,4962,201,FALSE
redux-ab-test,2.0.3,2.0.5,4,3,5,4,9,3,FALSE
redux-ab-test,2.0.2,2.0.3,3,3,62,47,109,6,FALSE
redux-ab-test,2.0.1,2.0.2,2,1,2,3,5,1,FALSE
redux-ab-test,2.0.0,2.0.1,1,1,3,3,6,2,FALSE
redux-ab-test,2.0.9,2.0.10,9,2,303,26,329,7,FALSE
redux-ab-test,2.0.8,2.0.9,8,8,314,29,343,15,FALSE
redux-ab-test,3.1.0,3.2.0,18,3,857,682,1539,32,FALSE
redux-ab-test,3.0.2,3.0.3,14,3,1042,459,1501,42,FALSE
redux-ab-test,3.0.3,3.0.5,15,2,2,2,4,2,FALSE
redux-ab-test,4.0.1,4.0.2,39,2,50,40,90,9,FALSE
redux-ab-test,4.0.0,4.0.1,38,3,128,72,200,8,FALSE
redux-ab-test,4.0.3,4.1.0,41,2,80,7,87,3,FALSE
redux-ab-test,4.0.2,4.0.3,40,2,2,2,4,2,FALSE
redux-ab-test,4.1.0,4.1.1,42,2,2,1,3,2,FALSE
redux-ab-test,4.1.1,4.1.2,43,1,724,576,1300,2,FALSE
redux-ab-test,4.1.2,4.3.0,44,8,43,152,195,10,FALSE
redux-ab-test,3.3.0,3.3.1,26,1,1,1,2,1,FALSE
redux-ab-test,3.3.3,3.3.5,29,1,7,5,12,2,FALSE
redux-ab-test,3.3.2,3.3.3,28,1,10,2,12,2,FALSE
redux-ab-test,3.3.5,3.3.6,30,4,26,9,35,5,FALSE
redux-ab-test,5.0.0,5.0.1,46,2,5,2,7,3,FALSE
redux-ab-test,3.4.3,3.5.0,36,2,20,2,22,3,FALSE
redux-ab-test,3.3.6,3.3.7,31,1,2,0,2,1,FALSE
redux-ab-test,5.0.2,5.0.3,48,2,1,3,4,2,FALSE
redux-ab-test,5.0.3,5.1.0,49,2,59,48,107,4,FALSE
redux-ab-test,3.0.1-alpha,3.0.2,13,3,1,48,49,4,FALSE
redux-ab-test,3.4.2,3.4.3,35,2,8,7,15,2,FALSE
redux-ab-test,5.0.1,5.0.2,47,2,4,4,8,2,FALSE
redux-ab-test,3.4.0,3.4.1,33,4,23,4,27,8,FALSE
redux-ab-test,3.4.1,3.4.2,34,2,2,2,4,2,FALSE
redux-ab-test,6.1.0-beta,6.5.1-alpha,56,1,219,67,286,5,FALSE
redux-ab-test,5.1.0,6.0.1,50,6,121,235,356,14,FALSE
redux-ab-test,3.5.0,4.0.0,37,4,194,66,260,7,FALSE
redux-ab-test,3.3.1,3.3.2,27,1,7,7,14,3,FALSE
redux-ab-test,3.2.5,3.2.6,22,2,779,653,1432,30,FALSE
redux-ab-test,3.2.6,3.2.7,23,2,25,16,41,2,FALSE
redux-ab-test,3.2.7,3.2.8,24,2,2,2,4,2,FALSE
redux-ab-test,3.2.0,3.2.2,19,2,108,33,141,5,FALSE
redux-ab-test,3.3.7,3.4.0,32,5,501,273,774,24,FALSE
redux-ab-test,3.2.2,3.2.3,20,1,11,4,15,3,FALSE
redux-ab-test,3.2.3,3.2.5,21,1,19,13,32,5,FALSE
redux-ab-test,3.0.6,3.1.0,17,1,208,69,277,8,FALSE
redux-ab-test,3.2.8,3.3.0,25,5,774,294,1068,12,FALSE
redux-ab-test,2.0.12,3.0.1-alpha,12,11,1340,2144,3484,68,FALSE
redux-ab-test,2.0.11,2.0.12,11,3,1662,614,2276,69,FALSE
redux-ab-test,2.0.10,2.0.11,10,11,1661,597,2258,88,FALSE
redux-ab-test,4.1.2,4.3.0,44,8,43,152,195,10,TRUE
redux-ab-test,5.0.2,5.0.3,48,2,1,3,4,2,TRUE
redux-ab-test,3.5.0,4.0.0,37,4,194,66,260,7,TRUE
redux-ab-test,3.3.7,3.4.0,32,5,501,273,774,24,TRUE
redux-ab-test,2.0.8,2.0.9,8,8,314,29,343,15,TRUE
redux-ab-test,3.0.5,3.0.6,16,22,1925,3037,4962,201,TRUE
redux-ab-test,2.0.5,2.0.6,5,2,139,23,162,8,TRUE
redux-ab-test,3.2.5,3.2.6,22,2,779,653,1432,30,TRUE
redux-ab-test,3.0.6,3.1.0,17,1,208,69,277,8,TRUE
postal-codes,1.0.6,1.0.7,6,1,2,1,3,2,FALSE
postal-codes,1.0.7,1.0.8,7,5,179,146,325,11,FALSE
postal-codes,1.0.8,1.0.9,8,1,1,1,2,1,FALSE
postal-codes,1.0.9,1.0.10,9,1,1,1,2,1,FALSE
postal-codes,1.0.172,1.0.173,172,1,1,1,2,1,FALSE
postal-codes,1.0.173,1.0.174,173,1,1,1,2,1,FALSE
postal-codes,1.0.170,1.0.171,170,1,1,1,2,1,FALSE
postal-codes,1.0.171,1.0.172,171,1,1,1,2,1,FALSE
postal-codes,1.0.176,1.0.177,176,1,1,1,2,1,FALSE
postal-codes,1.0.177,1.0.178,177,1,1,1,2,1,FALSE
postal-codes,1.0.174,1.0.175,174,1,1,1,2,1,FALSE
postal-codes,1.0.175,1.0.176,175,1,1,1,2,1,FALSE
postal-codes,1.0.178,1.0.179,178,1,1,1,2,1,FALSE
postal-codes,1.0.179,1.0.180,179,1,1,1,2,1,FALSE
postal-codes,1.0.374,1.0.375,374,1,1,1,2,1,FALSE
postal-codes,1.0.375,1.0.376,375,1,1,1,2,1,FALSE
postal-codes,1.0.376,1.0.377,376,1,1,1,2,1,FALSE
postal-codes,1.0.377,1.0.378,377,1,1,1,2,1,FALSE
postal-codes,1.0.370,1.0.371,370,1,1,1,2,1,FALSE
postal-codes,1.0.371,1.0.372,371,1,1,1,2,1,FALSE
postal-codes,1.0.372,1.0.373,372,1,1,1,2,1,FALSE
postal-codes,1.0.373,1.0.374,373,1,1,1,2,1,FALSE
postal-codes,1.0.85,1.0.86,85,1,1,1,2,1,FALSE
postal-codes,1.0.84,1.0.85,84,1,1,1,2,1,FALSE
postal-codes,1.0.87,1.0.88,87,1,1,1,2,1,FALSE
postal-codes,1.0.86,1.0.87,86,1,1,1,2,1,FALSE
postal-codes,1.0.81,1.0.82,81,1,1,1,2,1,FALSE
postal-codes,1.0.80,1.0.81,80,1,1,1,2,1,FALSE
postal-codes,1.0.83,1.0.84,83,1,1,1,2,1,FALSE
postal-codes,1.0.82,1.0.83,82,1,1,1,2,1,FALSE
postal-codes,1.0.107,1.0.108,107,1,1,1,2,1,FALSE
postal-codes,1.0.106,1.0.107,106,1,1,1,2,1,FALSE
postal-codes,1.0.105,1.0.106,105,1,1,1,2,1,FALSE
postal-codes,1.0.104,1.0.105,104,1,1,1,2,1,FALSE
postal-codes,1.0.103,1.0.104,103,1,1,1,2,1,FALSE
postal-codes,1.0.102,1.0.103,102,1,1,1,2,1,FALSE
postal-codes,1.0.101,1.0.102,101,1,1,1,2,1,FALSE
postal-codes,1.0.100,1.0.101,100,1,1,1,2,1,FALSE
postal-codes,1.0.109,1.0.110,109,1,1,1,2,1,FALSE
postal-codes,1.0.108,1.0.109,108,1,1,1,2,1,FALSE
postal-codes,1.0.30,1.0.31,30,1,1,1,2,1,FALSE
postal-codes,1.0.31,1.0.32,31,1,1,1,2,1,FALSE
postal-codes,1.0.32,1.0.33,32,1,1,1,2,1,FALSE
postal-codes,1.0.33,1.0.34,33,1,1,1,2,1,FALSE
postal-codes,1.0.34,1.0.35,34,1,1,1,2,1,FALSE
postal-codes,1.0.35,1.0.36,35,1,1,1,2,1,FALSE
postal-codes,1.0.36,1.0.37,36,1,1,1,2,1,FALSE
postal-codes,1.0.37,1.0.38,37,1,1,1,2,1,FALSE
postal-codes,1.0.38,1.0.39,38,1,1,1,2,1,FALSE
postal-codes,1.0.39,1.0.40,39,1,1,1,2,1,FALSE
postal-codes,1.0.451,1.0.452,451,1,1,1,2,1,FALSE
postal-codes,1.0.450,1.0.451,450,1,1,1,2,1,FALSE
postal-codes,1.0.453,1.0.454,453,1,1,1,2,1,FALSE
postal-codes,1.0.452,1.0.453,452,1,1,1,2,1,FALSE
postal-codes,1.0.455,1.0.456,455,1,1,1,2,1,FALSE
postal-codes,1.0.454,1.0.455,454,1,1,1,2,1,FALSE
postal-codes,1.0.457,1.0.458,457,1,1,1,2,1,FALSE
postal-codes,1.0.456,1.0.457,456,1,1,1,2,1,FALSE
postal-codes,1.0.225,1.0.226,225,1,1,1,2,1,FALSE
postal-codes,1.0.208,1.0.209,208,1,1,1,2,1,FALSE
postal-codes,1.0.209,1.0.210,209,1,1,1,2,1,FALSE
postal-codes,1.0.204,1.0.205,204,1,1,1,2,1,FALSE
postal-codes,1.0.205,1.0.206,205,1,1,1,2,1,FALSE
postal-codes,1.0.206,1.0.207,206,1,1,1,2,1,FALSE
postal-codes,1.0.207,1.0.208,207,1,1,1,2,1,FALSE
postal-codes,1.0.200,1.0.201,200,1,1,1,2,1,FALSE
postal-codes,1.0.201,1.0.202,201,1,1,1,2,1,FALSE
postal-codes,1.0.202,1.0.203,202,1,1,1,2,1,FALSE
postal-codes,1.0.203,1.0.204,203,1,1,1,2,1,FALSE
postal-codes,1.0.326,1.0.327,326,1,1,1,2,1,FALSE
postal-codes,1.0.228,1.0.229,228,1,1,1,2,1,FALSE
postal-codes,1.0.229,1.0.230,229,1,1,1,2,1,FALSE
postal-codes,1.0.338,1.0.339,338,1,1,1,2,1,FALSE
postal-codes,1.0.339,1.0.340,339,1,1,1,2,1,FALSE
postal-codes,1.0.330,1.0.331,330,1,1,1,2,1,FALSE
postal-codes,1.0.331,1.0.332,331,1,1,1,2,1,FALSE
postal-codes,1.0.332,1.0.333,332,1,1,1,2,1,FALSE
postal-codes,1.0.333,1.0.334,333,1,1,1,2,1,FALSE
postal-codes,1.0.334,1.0.335,334,1,1,1,2,1,FALSE
postal-codes,1.0.335,1.0.336,335,1,1,1,2,1,FALSE
postal-codes,1.0.336,1.0.337,336,1,1,1,2,1,FALSE
postal-codes,1.0.337,1.0.338,337,1,1,1,2,1,FALSE
postal-codes,1.0.398,1.0.399,398,1,1,1,2,1,FALSE
postal-codes,1.0.74,1.0.75,74,1,1,1,2,1,FALSE
postal-codes,1.0.75,1.0.76,75,1,1,1,2,1,FALSE
postal-codes,1.0.76,1.0.77,76,1,1,1,2,1,FALSE
postal-codes,1.0.77,1.0.78,77,1,1,1,2,1,FALSE
postal-codes,1.0.70,1.0.71,70,1,1,1,2,1,FALSE
postal-codes,1.0.71,1.0.72,71,1,1,1,2,1,FALSE
postal-codes,1.0.72,1.0.73,72,1,1,1,2,1,FALSE
postal-codes,1.0.73,1.0.74,73,1,1,1,2,1,FALSE
postal-codes,1.0.143,1.0.144,143,1,1,1,2,1,FALSE
postal-codes,1.0.142,1.0.143,142,1,1,1,2,1,FALSE
postal-codes,1.0.141,1.0.142,141,1,1,1,2,1,FALSE
postal-codes,1.0.140,1.0.141,140,1,1,1,2,1,FALSE
postal-codes,1.0.147,1.0.148,147,1,1,1,2,1,FALSE
postal-codes,1.0.79,1.0.80,79,1,1,1,2,1,FALSE
postal-codes,1.0.145,1.0.146,145,1,1,1,2,1,FALSE
postal-codes,1.0.144,1.0.145,144,1,1,1,2,1,FALSE
postal-codes,1.0.419,1.0.420,419,1,1,1,2,1,FALSE
postal-codes,1.0.418,1.0.419,418,1,1,1,2,1,FALSE
postal-codes,1.0.415,1.0.416,415,1,1,1,2,1,FALSE
postal-codes,1.0.414,1.0.415,414,1,1,1,2,1,FALSE
postal-codes,1.0.417,1.0.418,417,1,1,1,2,1,FALSE
postal-codes,1.0.416,1.0.417,416,1,1,1,2,1,FALSE
postal-codes,1.0.411,1.0.412,411,1,1,1,2,1,FALSE
postal-codes,1.0.149,1.0.150,149,1,1,1,2,1,FALSE
postal-codes,1.0.413,1.0.414,413,1,1,1,2,1,FALSE
postal-codes,1.0.412,1.0.413,412,1,1,1,2,1,FALSE
postal-codes,1.0.148,1.0.149,148,1,1,1,2,1,FALSE
postal-codes,1.0.240,1.0.241,240,1,1,1,2,1,FALSE
postal-codes,1.0.241,1.0.242,241,1,1,1,2,1,FALSE
postal-codes,1.0.242,1.0.243,242,1,1,1,2,1,FALSE
postal-codes,1.0.243,1.0.244,243,1,1,1,2,1,FALSE
postal-codes,1.0.244,1.0.245,244,1,1,1,2,1,FALSE
postal-codes,1.0.245,1.0.246,245,1,1,1,2,1,FALSE
postal-codes,1.0.246,1.0.247,246,1,1,1,2,1,FALSE
postal-codes,1.0.247,1.0.248,247,1,1,1,2,1,FALSE
postal-codes,1.0.248,1.0.249,248,1,1,1,2,1,FALSE
postal-codes,1.0.249,1.0.250,249,1,1,1,2,1,FALSE
postal-codes,1.0.146,1.0.147,146,1,1,1,2,1,FALSE
postal-codes,1.0.89,1.0.90,89,1,1,1,2,1,FALSE
postal-codes,1.0.88,1.0.89,88,1,1,1,2,1,FALSE
postal-codes,1.0.378,1.0.379,378,1,1,1,2,1,FALSE
postal-codes,1.0.379,1.0.380,379,1,1,1,2,1,FALSE
postal-codes,1.0.189,1.0.190,189,1,1,1,2,1,FALSE
postal-codes,1.0.188,1.0.189,188,1,1,1,2,1,FALSE
postal-codes,1.0.187,1.0.188,187,1,1,1,2,1,FALSE
postal-codes,1.0.186,1.0.187,186,1,1,1,2,1,FALSE
postal-codes,1.0.185,1.0.186,185,1,1,1,2,1,FALSE
postal-codes,1.0.184,1.0.185,184,1,1,1,2,1,FALSE
postal-codes,1.0.183,1.0.184,183,1,1,1,2,1,FALSE
postal-codes,1.0.182,1.0.183,182,1,1,1,2,1,FALSE
postal-codes,1.0.181,1.0.182,181,1,1,1,2,1,FALSE
postal-codes,1.0.180,1.0.181,180,1,1,1,2,1,FALSE
postal-codes,1.0.341,1.0.342,341,1,1,1,2,1,FALSE
postal-codes,1.0.340,1.0.341,340,1,1,1,2,1,FALSE
postal-codes,1.0.343,1.0.344,343,1,1,1,2,1,FALSE
postal-codes,1.0.342,1.0.343,342,1,1,1,2,1,FALSE
postal-codes,1.0.345,1.0.346,345,1,1,1,2,1,FALSE
postal-codes,1.0.344,1.0.345,344,1,1,1,2,1,FALSE
postal-codes,1.0.347,1.0.348,347,1,1,1,2,1,FALSE
postal-codes,1.0.346,1.0.347,346,1,1,1,2,1,FALSE
postal-codes,1.0.349,1.0.350,349,1,1,1,2,1,FALSE
postal-codes,1.0.348,1.0.349,348,1,1,1,2,1,FALSE
postal-codes,1.0.329,1.0.330,329,1,1,1,2,1,FALSE
postal-codes,1.0.410,1.0.411,410,1,1,1,2,1,FALSE
postal-codes,1.0.287,1.0.288,287,1,1,1,2,1,FALSE
postal-codes,1.0.114,1.0.115,114,1,1,1,2,1,FALSE
postal-codes,1.0.115,1.0.116,115,1,1,1,2,1,FALSE
postal-codes,1.0.116,1.0.117,116,1,1,1,2,1,FALSE
postal-codes,1.0.117,1.0.118,117,1,1,1,2,1,FALSE
postal-codes,1.0.110,1.0.111,110,1,1,1,2,1,FALSE
postal-codes,1.0.111,1.0.112,111,1,1,1,2,1,FALSE
postal-codes,1.0.112,1.0.113,112,1,1,1,2,1,FALSE
postal-codes,1.0.113,1.0.114,113,1,1,1,2,1,FALSE
postal-codes,1.0.118,1.0.119,118,1,1,1,2,1,FALSE
postal-codes,1.0.119,1.0.120,119,1,1,1,2,1,FALSE
postal-codes,1.0.29,1.0.30,29,1,1,1,2,1,FALSE
postal-codes,1.0.28,1.0.29,28,1,1,1,2,1,FALSE
postal-codes,1.0.27,1.0.28,27,1,1,1,2,1,FALSE
postal-codes,1.0.26,1.0.27,26,1,1,1,2,1,FALSE
postal-codes,1.0.25,1.0.26,25,1,1,1,2,1,FALSE
postal-codes,1.0.24,1.0.25,24,1,1,1,2,1,FALSE
postal-codes,1.0.23,1.0.24,23,1,1,1,2,1,FALSE
postal-codes,1.0.22,1.0.23,22,1,1,1,2,1,FALSE
postal-codes,1.0.21,1.0.22,21,1,1,1,2,1,FALSE
postal-codes,1.0.20,1.0.21,20,1,1,1,2,1,FALSE
postal-codes,1.0.446,1.0.447,446,1,1,1,2,1,FALSE
postal-codes,1.0.447,1.0.448,447,1,1,1,2,1,FALSE
postal-codes,1.0.444,1.0.445,444,1,1,1,2,1,FALSE
postal-codes,1.0.445,1.0.446,445,1,1,1,2,1,FALSE
postal-codes,1.0.442,1.0.443,442,1,1,1,2,1,FALSE
postal-codes,1.0.443,1.0.444,443,1,1,1,2,1,FALSE
postal-codes,1.0.440,1.0.441,440,1,1,1,2,1,FALSE
postal-codes,1.0.441,1.0.442,441,1,1,1,2,1,FALSE
postal-codes,1.0.288,1.0.289,288,1,1,1,2,1,FALSE
postal-codes,1.0.448,1.0.449,448,1,1,1,2,1,FALSE
postal-codes,1.0.449,1.0.450,449,1,1,1,2,1,FALSE
postal-codes,1.0.239,1.0.240,239,1,1,1,2,1,FALSE
postal-codes,1.0.238,1.0.239,238,1,1,1,2,1,FALSE
postal-codes,1.0.231,1.0.232,231,1,1,1,2,1,FALSE
postal-codes,1.0.230,1.0.231,230,1,1,1,2,1,FALSE
postal-codes,1.0.233,1.0.234,233,1,1,1,2,1,FALSE
postal-codes,1.0.232,1.0.233,232,1,1,1,2,1,FALSE
postal-codes,1.0.235,1.0.236,235,1,1,1,2,1,FALSE
postal-codes,1.0.234,1.0.235,234,1,1,1,2,1,FALSE
postal-codes,1.0.237,1.0.238,237,1,1,1,2,1,FALSE
postal-codes,1.0.236,1.0.237,236,1,1,1,2,1,FALSE
postal-codes,1.0.305,1.0.306,305,1,1,1,2,1,FALSE
postal-codes,1.0.304,1.0.305,304,1,1,1,2,1,FALSE
postal-codes,1.0.307,1.0.308,307,1,1,1,2,1,FALSE
postal-codes,1.0.306,1.0.307,306,1,1,1,2,1,FALSE
postal-codes,1.0.301,1.0.302,301,1,1,1,2,1,FALSE
postal-codes,1.0.300,1.0.301,300,1,1,1,2,1,FALSE
postal-codes,1.0.303,1.0.304,303,1,1,1,2,1,FALSE
postal-codes,1.0.302,1.0.303,302,1,1,1,2,1,FALSE
postal-codes,1.0.309,1.0.310,309,1,1,1,2,1,FALSE
postal-codes,1.0.308,1.0.309,308,1,1,1,2,1,FALSE
postal-codes,1.0.388,1.0.389,388,1,1,1,2,1,FALSE
postal-codes,1.0.63,1.0.64,63,1,1,1,2,1,FALSE
postal-codes,1.0.62,1.0.63,62,1,1,1,2,1,FALSE
postal-codes,1.0.61,1.0.62,61,1,1,1,2,1,FALSE
postal-codes,1.0.60,1.0.61,60,1,1,1,2,1,FALSE
postal-codes,1.0.67,1.0.68,67,1,1,1,2,1,FALSE
postal-codes,1.0.66,1.0.67,66,1,1,1,2,1,FALSE
postal-codes,1.0.65,1.0.66,65,1,1,1,2,1,FALSE
postal-codes,1.0.64,1.0.65,64,1,1,1,2,1,FALSE
postal-codes,1.0.150,1.0.151,150,1,1,1,2,1,FALSE
postal-codes,1.0.151,1.0.152,151,1,1,1,2,1,FALSE
postal-codes,1.0.69,1.0.70,69,1,1,1,2,1,FALSE
postal-codes,1.0.68,1.0.69,68,1,1,1,2,1,FALSE
postal-codes,1.0.154,1.0.155,154,1,1,1,2,1,FALSE
postal-codes,1.0.155,1.0.156,155,1,1,1,2,1,FALSE
postal-codes,1.0.156,1.0.157,156,1,1,1,2,1,FALSE
postal-codes,1.0.157,1.0.158,157,1,1,1,2,1,FALSE
postal-codes,1.0.4,1.0.5,4,1,1,1,2,1,FALSE
postal-codes,1.0.5,1.0.6,5,2,56,1,57,2,FALSE
postal-codes,1.0.408,1.0.409,408,1,1,1,2,1,FALSE
postal-codes,1.0.409,1.0.410,409,1,1,1,2,1,FALSE
postal-codes,1.0.1,1.0.2,1,3,19,11,30,5,FALSE
postal-codes,1.0.2,1.0.3,2,7,76,13,89,9,FALSE
postal-codes,1.0.3,1.0.4,3,1,1,1,2,1,FALSE
postal-codes,1.0.402,1.0.403,402,1,1,1,2,1,FALSE
postal-codes,1.0.403,1.0.404,403,1,1,1,2,1,FALSE
postal-codes,1.0.400,1.0.401,400,1,1,1,2,1,FALSE
postal-codes,1.0.401,1.0.402,401,1,1,1,2,1,FALSE
postal-codes,1.0.406,1.0.407,406,1,1,1,2,1,FALSE
postal-codes,1.0.407,1.0.408,407,1,1,1,2,1,FALSE
postal-codes,1.0.404,1.0.405,404,1,1,1,2,1,FALSE
postal-codes,1.0.405,1.0.406,405,1,1,1,2,1,FALSE
postal-codes,1.0.152,1.0.153,152,1,1,1,2,1,FALSE
postal-codes,1.0.389,1.0.390,389,1,1,1,2,1,FALSE
postal-codes,1.0.153,1.0.154,153,1,1,1,2,1,FALSE
postal-codes,1.0.16,1.0.17,16,1,1,1,2,1,FALSE
postal-codes,1.0.17,1.0.18,17,1,1,1,2,1,FALSE
postal-codes,1.0.14,1.0.15,14,1,1,1,2,1,FALSE
postal-codes,1.0.15,1.0.16,15,1,1,1,2,1,FALSE
postal-codes,1.0.12,1.0.13,12,1,1,1,2,1,FALSE
postal-codes,1.0.13,1.0.14,13,1,1,1,2,1,FALSE
postal-codes,1.0.10,1.0.11,10,1,1,1,2,1,FALSE
postal-codes,1.0.11,1.0.12,11,1,1,1,2,1,FALSE
postal-codes,1.0.78,1.0.79,78,1,1,1,2,1,FALSE
postal-codes,1.0.18,1.0.19,18,1,1,1,2,1,FALSE
postal-codes,1.0.19,1.0.20,19,1,1,1,2,1,FALSE
postal-codes,1.0.279,1.0.280,279,1,1,1,2,1,FALSE
postal-codes,1.0.278,1.0.279,278,1,1,1,2,1,FALSE
postal-codes,1.0.275,1.0.276,275,1,1,1,2,1,FALSE
postal-codes,1.0.274,1.0.275,274,1,1,1,2,1,FALSE
postal-codes,1.0.277,1.0.278,277,1,1,1,2,1,FALSE
postal-codes,1.0.276,1.0.277,276,1,1,1,2,1,FALSE
postal-codes,1.0.271,1.0.272,271,1,1,1,2,1,FALSE
postal-codes,1.0.270,1.0.271,270,1,1,1,2,1,FALSE
postal-codes,1.0.273,1.0.274,273,1,1,1,2,1,FALSE
postal-codes,1.0.272,1.0.273,272,1,1,1,2,1,FALSE
postal-codes,1.0.198,1.0.199,198,1,1,1,2,1,FALSE
postal-codes,1.0.199,1.0.200,199,1,1,1,2,1,FALSE
postal-codes,1.0.194,1.0.195,194,1,1,1,2,1,FALSE
postal-codes,1.0.195,1.0.196,195,1,1,1,2,1,FALSE
postal-codes,1.0.196,1.0.197,196,2,34,49,83,7,FALSE
postal-codes,1.0.197,1.0.198,197,1,5,0,5,1,FALSE
postal-codes,1.0.190,1.0.191,190,1,1,1,2,1,FALSE
postal-codes,1.0.191,1.0.192,191,1,1,1,2,1,FALSE
postal-codes,1.0.192,1.0.193,192,1,1,1,2,1,FALSE
postal-codes,1.0.193,1.0.194,193,1,1,1,2,1,FALSE
postal-codes,1.0.297,1.0.298,297,1,1,1,2,1,FALSE
postal-codes,1.0.296,1.0.297,296,1,1,1,2,1,FALSE
postal-codes,1.0.295,1.0.296,295,1,1,1,2,1,FALSE
postal-codes,1.0.294,1.0.295,294,1,1,1,2,1,FALSE
postal-codes,1.0.293,1.0.294,293,1,1,1,2,1,FALSE
postal-codes,1.0.98,1.0.99,98,1,1,1,2,1,FALSE
postal-codes,1.0.358,1.0.359,358,1,1,1,2,1,FALSE
postal-codes,1.0.359,1.0.360,359,1,1,1,2,1,FALSE
postal-codes,1.0.356,1.0.357,356,1,1,1,2,1,FALSE
postal-codes,1.0.357,1.0.358,357,1,1,1,2,1,FALSE
postal-codes,1.0.354,1.0.355,354,1,1,1,2,1,FALSE
postal-codes,1.0.99,1.0.100,99,1,1,1,2,1,FALSE
postal-codes,1.0.352,1.0.353,352,1,1,1,2,1,FALSE
postal-codes,1.0.353,1.0.354,353,1,1,1,2,1,FALSE
postal-codes,1.0.299,1.0.300,299,1,1,1,2,1,FALSE
postal-codes,1.0.298,1.0.299,298,1,1,1,2,1,FALSE
postal-codes,1.0.90,1.0.91,90,1,1,1,2,1,FALSE
postal-codes,1.0.91,1.0.92,91,1,1,1,2,1,FALSE
postal-codes,1.0.121,1.0.122,121,1,1,1,2,1,FALSE
postal-codes,1.0.120,1.0.121,120,1,1,1,2,1,FALSE
postal-codes,1.0.123,1.0.124,123,1,1,1,2,1,FALSE
postal-codes,1.0.122,1.0.123,122,1,1,1,2,1,FALSE
postal-codes,1.0.125,1.0.126,125,1,1,1,2,1,FALSE
postal-codes,1.0.124,1.0.125,124,1,1,1,2,1,FALSE
postal-codes,1.0.127,1.0.128,127,1,1,1,2,1,FALSE
postal-codes,1.0.126,1.0.127,126,1,1,1,2,1,FALSE
postal-codes,1.0.129,1.0.130,129,1,1,1,2,1,FALSE
postal-codes,1.0.128,1.0.129,128,1,1,1,2,1,FALSE
postal-codes,1.0.58,1.0.59,58,1,1,1,2,1,FALSE
postal-codes,1.0.59,1.0.60,59,1,1,1,2,1,FALSE
postal-codes,1.0.52,1.0.53,52,1,1,1,2,1,FALSE
postal-codes,1.0.53,1.0.54,53,1,1,1,2,1,FALSE
postal-codes,1.0.50,1.0.51,50,1,1,1,2,1,FALSE
postal-codes,1.0.51,1.0.52,51,1,1,1,2,1,FALSE
postal-codes,1.0.56,1.0.57,56,1,1,1,2,1,FALSE
postal-codes,1.0.57,1.0.58,57,1,1,1,2,1,FALSE
postal-codes,1.0.54,1.0.55,54,1,1,1,2,1,FALSE
postal-codes,1.0.55,1.0.56,55,1,1,1,2,1,FALSE
postal-codes,1.0.433,1.0.434,433,1,1,1,2,1,FALSE
postal-codes,1.0.432,1.0.433,432,1,1,1,2,1,FALSE
postal-codes,1.0.431,1.0.432,431,1,1,1,2,1,FALSE
postal-codes,1.0.430,1.0.431,430,1,1,1,2,1,FALSE
postal-codes,1.0.437,1.0.438,437,1,1,1,2,1,FALSE
postal-codes,1.0.436,1.0.437,436,1,1,1,2,1,FALSE
postal-codes,1.0.435,1.0.436,435,1,1,1,2,1,FALSE
postal-codes,1.0.434,1.0.435,434,1,1,1,2,1,FALSE
postal-codes,1.0.439,1.0.440,439,1,1,1,2,1,FALSE
postal-codes,1.0.438,1.0.439,438,1,1,1,2,1,FALSE
postal-codes,1.0.292,1.0.293,292,1,1,1,2,1,FALSE
postal-codes,1.0.291,1.0.292,291,1,1,1,2,1,FALSE
postal-codes,1.0.290,1.0.291,290,1,1,1,2,1,FALSE
postal-codes,1.0.226,1.0.227,226,1,1,4,5,1,FALSE
postal-codes,1.0.227,1.0.228,227,1,1,1,2,1,FALSE
postal-codes,1.0.224,1.0.225,224,1,1,1,2,1,FALSE
postal-codes,1.0.355,1.0.356,355,1,1,1,2,1,FALSE
postal-codes,1.0.222,1.0.223,222,1,1,1,2,1,FALSE
postal-codes,1.0.223,1.0.224,223,1,1,1,2,1,FALSE
postal-codes,1.0.220,1.0.221,220,1,1,1,2,1,FALSE
postal-codes,1.0.221,1.0.222,221,1,1,1,2,1,FALSE
postal-codes,1.0.385,1.0.386,385,1,1,1,2,1,FALSE
postal-codes,1.0.384,1.0.385,384,1,1,1,2,1,FALSE
postal-codes,1.0.387,1.0.388,387,1,3,0,3,1,TRUE
postal-codes,1.0.386,1.0.387,386,1,1,1,2,1,FALSE
postal-codes,1.0.381,1.0.382,381,1,1,1,2,1,FALSE
postal-codes,1.0.380,1.0.381,380,1,1,1,2,1,FALSE
postal-codes,1.0.383,1.0.384,383,1,1,1,2,1,FALSE
postal-codes,1.0.382,1.0.383,382,1,1,1,2,1,FALSE
postal-codes,1.0.350,1.0.351,350,1,1,1,2,1,FALSE
postal-codes,1.0.351,1.0.352,351,1,1,1,2,1,FALSE
postal-codes,1.0.312,1.0.313,312,1,1,1,2,1,FALSE
postal-codes,1.0.313,1.0.314,313,1,1,1,2,1,FALSE
postal-codes,1.0.310,1.0.311,310,1,1,1,2,1,FALSE
postal-codes,1.0.311,1.0.312,311,1,1,1,2,1,FALSE
postal-codes,1.0.316,1.0.317,316,1,1,1,2,1,FALSE
postal-codes,1.0.317,1.0.318,317,1,1,1,2,1,FALSE
postal-codes,1.0.314,1.0.315,314,1,1,1,2,1,FALSE
postal-codes,1.0.315,1.0.316,315,1,1,1,2,1,FALSE
postal-codes,1.0.318,1.0.319,318,1,1,1,2,1,FALSE
postal-codes,1.0.319,1.0.320,319,1,1,1,2,1,FALSE
postal-codes,1.0.165,1.0.166,165,1,1,1,2,1,FALSE
postal-codes,1.0.164,1.0.165,164,1,1,1,2,1,FALSE
postal-codes,1.0.167,1.0.168,167,1,1,1,2,1,FALSE
postal-codes,1.0.166,1.0.167,166,1,1,1,2,1,FALSE
postal-codes,1.0.161,1.0.162,161,1,1,1,2,1,FALSE
postal-codes,1.0.160,1.0.161,160,1,1,1,2,1,FALSE
postal-codes,1.0.163,1.0.164,163,1,1,1,2,1,FALSE
postal-codes,1.0.162,1.0.163,162,1,1,1,2,1,FALSE
postal-codes,1.0.169,1.0.170,169,1,1,1,2,1,FALSE
postal-codes,1.0.168,1.0.169,168,1,1,1,2,1,FALSE
postal-codes,1.0.367,1.0.368,367,1,1,1,2,1,FALSE
postal-codes,1.0.366,1.0.367,366,1,1,1,2,1,FALSE
postal-codes,1.0.365,1.0.366,365,1,1,1,2,1,FALSE
postal-codes,1.0.364,1.0.365,364,1,1,1,2,1,FALSE
postal-codes,1.0.363,1.0.364,363,1,1,1,2,1,FALSE
postal-codes,1.0.362,1.0.363,362,1,1,1,2,1,FALSE
postal-codes,1.0.361,1.0.362,361,1,1,1,2,1,FALSE
postal-codes,1.0.360,1.0.361,360,1,1,1,2,1,FALSE
postal-codes,1.0.96,1.0.97,96,1,1,1,2,1,FALSE
postal-codes,1.0.97,1.0.98,97,1,1,1,2,1,FALSE
postal-codes,1.0.94,1.0.95,94,1,1,1,2,1,FALSE
postal-codes,1.0.95,1.0.96,95,1,1,1,2,1,FALSE
postal-codes,1.0.92,1.0.93,92,1,1,1,2,1,FALSE
postal-codes,1.0.93,1.0.94,93,1,1,1,2,1,FALSE
postal-codes,1.0.369,1.0.370,369,1,1,1,2,1,FALSE
postal-codes,1.0.368,1.0.369,368,1,1,1,2,1,FALSE
postal-codes,1.0.268,1.0.269,268,1,1,1,2,1,FALSE
postal-codes,1.0.269,1.0.270,269,1,1,1,2,1,FALSE
postal-codes,1.0.262,1.0.263,262,1,1,1,2,1,FALSE
postal-codes,1.0.263,1.0.264,263,1,1,1,2,1,FALSE
postal-codes,1.0.260,1.0.261,260,1,1,1,2,1,FALSE
postal-codes,1.0.261,1.0.262,261,1,1,1,2,1,FALSE
postal-codes,1.0.266,1.0.267,266,1,1,1,2,1,FALSE
postal-codes,1.0.267,1.0.268,267,1,1,1,2,1,FALSE
postal-codes,1.0.264,1.0.265,264,1,1,1,2,1,FALSE
postal-codes,1.0.265,1.0.266,265,1,1,1,2,1,FALSE
postal-codes,1.0.399,1.0.400,399,1,1,1,2,1,FALSE
postal-codes,1.0.390,1.0.391,390,1,1,1,2,1,FALSE
postal-codes,1.0.391,1.0.392,391,1,1,1,2,1,FALSE
postal-codes,1.0.219,1.0.220,219,1,1,1,2,1,FALSE
postal-codes,1.0.218,1.0.219,218,1,1,1,2,1,FALSE
postal-codes,1.0.217,1.0.218,217,1,1,1,2,1,FALSE
postal-codes,1.0.216,1.0.217,216,1,1,1,2,1,FALSE
postal-codes,1.0.215,1.0.216,215,1,1,1,2,1,FALSE
postal-codes,1.0.214,1.0.215,214,1,1,1,2,1,FALSE
postal-codes,1.0.213,1.0.214,213,1,1,1,2,1,FALSE
postal-codes,1.0.212,1.0.213,212,1,1,1,2,1,FALSE
postal-codes,1.0.211,1.0.212,211,1,1,1,2,1,FALSE
postal-codes,1.0.210,1.0.211,210,1,1,1,2,1,FALSE
postal-codes,1.0.284,1.0.285,284,1,1,1,2,1,FALSE
postal-codes,1.0.285,1.0.286,285,1,1,1,2,1,FALSE
postal-codes,1.0.286,1.0.287,286,1,1,1,2,1,FALSE
postal-codes,1.0.328,1.0.329,328,1,1,1,2,1,FALSE
postal-codes,1.0.280,1.0.281,280,1,1,1,2,1,FALSE
postal-codes,1.0.281,1.0.282,281,1,1,1,2,1,FALSE
postal-codes,1.0.282,1.0.283,282,1,1,1,2,1,FALSE
postal-codes,1.0.283,1.0.284,283,1,1,1,2,1,FALSE
postal-codes,1.0.323,1.0.324,323,1,1,1,2,1,FALSE
postal-codes,1.0.322,1.0.323,322,1,1,1,2,1,FALSE
postal-codes,1.0.321,1.0.322,321,1,1,1,2,1,FALSE
postal-codes,1.0.320,1.0.321,320,1,1,1,2,1,FALSE
postal-codes,1.0.327,1.0.328,327,1,1,1,2,1,FALSE
postal-codes,1.0.289,1.0.290,289,1,1,1,2,1,FALSE
postal-codes,1.0.325,1.0.326,325,1,1,1,2,1,FALSE
postal-codes,1.0.324,1.0.325,324,1,1,1,2,1,FALSE
postal-codes,1.0.158,1.0.159,158,1,1,1,2,1,FALSE
postal-codes,1.0.159,1.0.160,159,1,1,1,2,1,FALSE
postal-codes,1.0.138,1.0.139,138,1,1,1,2,1,FALSE
postal-codes,1.0.139,1.0.140,139,1,1,1,2,1,FALSE
postal-codes,1.0.136,1.0.137,136,1,1,1,2,1,FALSE
postal-codes,1.0.137,1.0.138,137,1,1,1,2,1,FALSE
postal-codes,1.0.134,1.0.135,134,1,1,1,2,1,FALSE
postal-codes,1.0.135,1.0.136,135,1,1,1,2,1,FALSE
postal-codes,1.0.132,1.0.133,132,1,1,1,2,1,FALSE
postal-codes,1.0.133,1.0.134,133,1,1,1,2,1,FALSE
postal-codes,1.0.130,1.0.131,130,1,1,1,2,1,FALSE
postal-codes,1.0.131,1.0.132,131,1,1,1,2,1,FALSE
postal-codes,1.0.49,1.0.50,49,1,1,1,2,1,FALSE
postal-codes,1.0.48,1.0.49,48,1,1,1,2,1,FALSE
postal-codes,1.0.41,1.0.42,41,1,1,1,2,1,FALSE
postal-codes,1.0.40,1.0.41,40,1,1,1,2,1,FALSE
postal-codes,1.0.43,1.0.44,43,1,1,1,2,1,FALSE
postal-codes,1.0.42,1.0.43,42,1,1,1,2,1,FALSE
postal-codes,1.0.45,1.0.46,45,1,1,1,2,1,FALSE
postal-codes,1.0.44,1.0.45,44,1,1,1,2,1,FALSE
postal-codes,1.0.47,1.0.48,47,1,1,1,2,1,FALSE
postal-codes,1.0.46,1.0.47,46,1,1,1,2,1,FALSE
postal-codes,1.0.420,1.0.421,420,1,1,1,2,1,FALSE
postal-codes,1.0.421,1.0.422,421,1,1,1,2,1,FALSE
postal-codes,1.0.422,1.0.423,422,1,1,1,2,1,FALSE
postal-codes,1.0.423,1.0.424,423,1,1,1,2,1,FALSE
postal-codes,1.0.424,1.0.425,424,1,1,1,2,1,FALSE
postal-codes,1.0.425,1.0.426,425,1,1,1,2,1,FALSE
postal-codes,1.0.426,1.0.427,426,1,1,1,2,1,FALSE
postal-codes,1.0.427,1.0.428,427,1,1,1,2,1,FALSE
postal-codes,1.0.428,1.0.429,428,1,1,1,2,1,FALSE
postal-codes,1.0.429,1.0.430,429,1,1,1,2,1,FALSE
postal-codes,1.0.253,1.0.254,253,1,1,1,2,1,FALSE
postal-codes,1.0.252,1.0.253,252,1,1,1,2,1,FALSE
postal-codes,1.0.251,1.0.252,251,1,1,1,2,1,FALSE
postal-codes,1.0.250,1.0.251,250,1,1,1,2,1,FALSE
postal-codes,1.0.257,1.0.258,257,1,1,1,2,1,FALSE
postal-codes,1.0.256,1.0.257,256,1,1,1,2,1,FALSE
postal-codes,1.0.255,1.0.256,255,1,1,1,2,1,FALSE
postal-codes,1.0.254,1.0.255,254,1,1,1,2,1,FALSE
postal-codes,1.0.392,1.0.393,392,1,1,1,2,1,FALSE
postal-codes,1.0.393,1.0.394,393,1,1,1,2,1,FALSE
postal-codes,1.0.259,1.0.260,259,1,1,1,2,1,FALSE
postal-codes,1.0.258,1.0.259,258,1,1,1,2,1,FALSE
postal-codes,1.0.396,1.0.397,396,1,1,1,2,1,FALSE
postal-codes,1.0.397,1.0.398,397,1,1,1,2,1,FALSE
postal-codes,1.0.394,1.0.395,394,1,1,1,2,1,FALSE
postal-codes,1.0.395,1.0.396,395,1,1,1,2,1,FALSE
postal-codes,1.0.204,1.0.205,204,1,1,1,2,1,TRUE
postal-codes,1.0.203,1.0.204,203,1,1,1,2,1,TRUE
postal-codes,1.0.245,1.0.246,245,1,1,1,2,1,TRUE
postal-codes,1.0.246,1.0.247,246,1,1,1,2,1,TRUE
postal-codes,1.0.306,1.0.307,306,1,1,1,2,1,TRUE
postal-codes,1.0.299,1.0.300,299,1,1,1,2,1,TRUE
postal-codes,1.0.220,1.0.221,220,1,1,1,2,1,TRUE
postal-codes,1.0.387,1.0.388,387,1,3,0,3,1,FALSE
postal-codes,1.0.260,1.0.261,260,1,1,1,2,1,TRUE
postal-codes,1.0.261,1.0.262,261,1,1,1,2,1,TRUE
postal-codes,1.0.217,1.0.218,217,1,1,1,2,1,TRUE
postal-codes,1.0.210,1.0.211,210,1,1,1,2,1,TRUE
postal-codes,1.0.259,1.0.260,259,1,1,1,2,1,TRUE
postal-codes,1.0.402,1.0.403,402,1,1,1,2,1,TRUE
postal-codes,1.0.215,1.0.216,215,1,1,1,2,1,TRUE
postal-codes,1.0.325,1.0.326,325,1,1,1,2,1,TRUE
postal-codes,1.0.212,1.0.213,212,1,1,1,2,1,TRUE
postal-codes,1.0.238,1.0.239,238,1,1,1,2,1,TRUE
postal-codes,1.0.283,1.0.284,283,1,1,1,2,1,TRUE
postal-codes,1.0.351,1.0.352,351,1,1,1,2,1,TRUE
postal-codes,1.0.350,1.0.351,350,1,1,1,2,1,TRUE
postal-codes,1.0.377,1.0.378,377,1,1,1,2,1,TRUE
postal-codes,1.0.213,1.0.214,213,1,1,1,2,1,TRUE
postal-codes,1.0.25,1.0.26,25,1,1,1,2,1,TRUE
postal-codes,1.0.326,1.0.327,326,1,1,1,2,1,TRUE
postal-codes,1.0.176,1.0.177,176,1,1,1,2,1,TRUE
postal-codes,1.0.79,1.0.80,79,1,1,1,2,1,TRUE
postal-codes,1.0.158,1.0.159,158,1,1,1,2,1,TRUE
postal-codes,1.0.159,1.0.160,159,1,1,1,2,1,TRUE
postal-codes,1.0.85,1.0.86,85,1,1,1,2,1,TRUE
postal-codes,1.0.87,1.0.88,87,1,1,1,2,1,TRUE
postal-codes,1.0.86,1.0.87,86,1,1,1,2,1,TRUE
postal-codes,1.0.41,1.0.42,41,1,1,1,2,1,TRUE
postal-codes,1.0.148,1.0.149,148,1,1,1,2,1,TRUE
angular-drag-drop,2.0.0,2.0.1,1,2,29918,931,30849,7,FALSE
angular-drag-drop,2.0.6,3.0.0,7,3,519,860,1379,10,FALSE
angular-drag-drop,2.0.5,2.0.6,6,2,20,2,22,4,FALSE
angular-drag-drop,2.0.4,2.0.5,5,2,24,2,26,4,FALSE
angular-drag-drop,2.0.3,2.0.4,4,1,1,4,5,1,FALSE
angular-drag-drop,2.0.2,2.0.3,3,2,4,4,8,2,FALSE
angular-drag-drop,2.0.1,2.0.2,2,4,12,6,18,4,FALSE
angular-drag-drop,3.0.1,3.0.2,9,3,3,5,8,3,FALSE
angular-drag-drop,3.0.4,3.0.5,12,3,18,12,30,5,FALSE
angular-drag-drop,3.0.0,3.0.1,8,2,2,2,4,2,FALSE
angular-drag-drop,3.0.5,3.1.0,13,4,575,474,1049,11,FALSE
angular-drag-drop,3.0.2,3.0.3,10,2,4,4,8,4,FALSE
angular-drag-drop,3.0.3,3.0.4,11,4,30,30,60,10,TRUE
angular-drag-drop,3.0.3,3.0.4,11,4,30,30,60,10,FALSE
angular-drag-drop,3.0.2,3.0.3,10,2,4,4,8,4,TRUE
cspace-input,0.0.9,0.0.10,9,2,26,41,67,4,FALSE
cspace-input,0.2.3,0.3.0,17,4,1099,58,1157,32,FALSE
cspace-input,0.0.10,0.0.11,10,18,6000,375,6375,108,FALSE
cspace-input,0.2.1,0.2.2,15,5,1903,493,2396,37,FALSE
cspace-input,0.2.0,0.2.1,14,1,2,2,4,2,FALSE
cspace-input,0.1.0,0.1.1,12,3,1272,642,1914,54,FALSE
cspace-input,0.1.1,0.2.0,13,2,2207,606,2813,60,FALSE
cspace-input,0.6.4,0.6.5,31,1,6,2,8,2,FALSE
cspace-input,0.0.5,0.0.6,5,47,4054,1592,5646,314,FALSE
cspace-input,0.10.0,0.11.0,45,1,19,19,38,5,FALSE
cspace-input,0.0.7,0.0.8,7,2,43,3,46,4,FALSE
cspace-input,0.0.6,0.0.7,6,1,73,5,78,7,FALSE
cspace-input,0.0.1,0.0.2,1,2,8,2,10,3,FALSE
cspace-input,0.0.3,0.0.4,3,1,1,3,4,2,FALSE
cspace-input,0.0.2,0.0.3,2,1,4,2,6,1,FALSE
cspace-input,0.3.2,0.3.3,20,3,2396,150,2546,30,FALSE
cspace-input,0.3.3,0.4.0,21,4,829,259,1088,25,FALSE
cspace-input,0.3.0,0.3.1,18,2,1346,66,1412,14,FALSE
cspace-input,0.3.1,0.3.2,19,1,55,45,100,5,FALSE
cspace-input,0.0.8,0.0.9,8,1,11,7,18,4,TRUE
cspace-input,0.6.5,0.7.0,32,1,329,396,725,12,FALSE
cspace-input,0.7.1,0.8.0,34,2,41,29,70,6,FALSE
cspace-input,0.4.1,0.4.2,23,1,16,3,19,2,FALSE
cspace-input,0.4.0,0.4.1,22,1,2,2,4,2,FALSE
cspace-input,0.4.3,0.4.4,25,1,69,50,119,8,FALSE
cspace-input,0.4.2,0.4.3,24,2,16,7,23,6,FALSE
cspace-input,0.5.0,0.6.1,27,5,1099,492,1591,20,FALSE
cspace-input,0.4.4,0.5.0,26,1,89,87,176,5,FALSE
cspace-input,0.9.0,0.9.1,36,1,6,2,8,2,FALSE
cspace-input,0.9.1,0.9.2,37,2,419,20,439,16,FALSE
cspace-input,0.9.2,0.9.3,38,3,9,15,24,6,FALSE
cspace-input,0.9.3,0.9.4,39,1,13,6,19,2,FALSE
cspace-input,0.9.4,0.9.5,40,1,1,5,6,2,FALSE
cspace-input,0.9.5,0.9.6,41,1,393,2,395,5,FALSE
cspace-input,0.9.6,0.9.7,42,1,16,5,21,3,FALSE
cspace-input,0.0.4,0.0.5,4,3,3,4,7,3,FALSE
cspace-input,0.9.8,0.10.0,44,1,189,131,320,9,FALSE
cspace-input,0.8.0,0.9.0,35,2,634,460,1094,74,FALSE
cspace-input,0.7.0,0.7.1,33,3,57,2,59,5,FALSE
cspace-input,0.9.7,0.9.8,43,1,87,43,130,9,FALSE
cspace-input,0.6.3,0.6.4,30,1,8,3,11,3,FALSE
cspace-input,0.6.2,0.6.3,29,8,313,21,334,19,FALSE
cspace-input,0.0.11,0.1.0,11,6,1145,1001,2146,67,FALSE
cspace-input,0.6.1,0.6.2,28,1,7,5,12,4,FALSE
cspace-input,0.2.2,0.2.3,16,3,1620,10,1630,23,FALSE
cspace-input,0.0.7,0.0.8,7,2,43,3,46,4,TRUE
cspace-input,0.0.8,0.0.9,8,1,11,7,18,4,FALSE
cspace-input,0.0.5,0.0.6,5,47,4054,1592,5646,314,TRUE
cspace-input,0.6.5,0.7.0,32,1,329,396,725,12,TRUE
cspace-input,0.9.3,0.9.4,39,1,13,6,19,2,TRUE
cspace-input,0.8.0,0.9.0,35,2,634,460,1094,74,TRUE
cspace-input,0.0.11,0.1.0,11,6,1145,1001,2146,67,TRUE
cspace-input,0.2.1,0.2.2,15,5,1903,493,2396,37,TRUE
cspace-input,0.0.9,0.0.10,9,2,26,41,67,4,TRUE
cspace-input,0.2.3,0.3.0,17,4,1099,58,1157,32,TRUE
cspace-input,0.4.4,0.5.0,26,1,89,87,176,5,TRUE
cspace-input,0.1.1,0.2.0,13,2,2207,606,2813,60,TRUE
cspace-input,0.0.10,0.0.11,10,18,6000,375,6375,108,TRUE
cspace-input,0.1.0,0.1.1,12,3,1272,642,1914,54,TRUE
cspace-input,0.4.0,0.4.1,22,1,2,2,4,2,TRUE
signavio-i18n,1.1.0,1.2.0,2,5,106,36,142,8,FALSE
signavio-i18n,1.0.0,1.1.0,1,7,92,44,136,10,FALSE
signavio-i18n,1.3.0,1.3.1,5,2,4835,15,4850,9,FALSE
signavio-i18n,1.2.0,1.2.1,3,2,29,7,36,3,FALSE
signavio-i18n,1.2.1,1.3.0,4,4,331,192,523,36,FALSE
signavio-i18n,1.1.0,1.2.0,2,5,106,36,142,8,TRUE
signavio-i18n,1.2.1,1.3.0,4,4,331,192,523,36,TRUE
yo3,3.0.0-alpha0,3.0.0-alpha01,1,16,165,91987,92152,345,FALSE
yo3,3.0.9-dev.1,3.0.9-dev.2,92,1,179,172,351,13,FALSE
yo3,3.0.5-rc.6,3.0.5-rc.7,35,1,179,172,351,13,FALSE
yo3,3.0.5-rc.7,3.0.5,36,1,179,172,351,13,FALSE
yo3,3.0.5-rc.4,3.0.5-rc.5,33,1,179,172,351,13,FALSE
yo3,3.0.5-rc.5,3.0.5-rc.6,34,1,179,172,351,13,FALSE
yo3,3.0.5-rc.2,3.0.5-rc.3,31,1,179,172,351,13,FALSE
yo3,3.0.5-rc.3,3.0.5-rc.4,32,1,179,172,351,13,FALSE
yo3,3.0.5-rc.1,3.0.5-rc.2,30,1,179,172,351,13,FALSE
yo3,3.0.6-beta.2,3.0.6-beta.3,40,1,179,172,351,13,FALSE
yo3,3.0.6-beta.3,3.0.6-beta.4,41,1,179,172,351,13,FALSE
yo3,3.0.6-beta.0,3.0.6-beta.1,38,1,179,172,351,13,FALSE
yo3,3.0.6-beta.1,3.0.6-beta.2,39,1,179,172,351,13,FALSE
yo3,3.0.9-rc.2,3.0.9-rc.3,96,1,179,172,351,13,FALSE
yo3,3.0.9-rc.3,3.0.9-rc.4,97,1,179,172,351,13,FALSE
yo3,3.0.9-rc.1,3.0.9-rc.2,95,1,179,172,351,13,FALSE
yo3,3.0.6-beta.4,3.0.6-beta.5,42,1,179,172,351,13,FALSE
yo3,3.0.9-rc.4,3.0.9,98,1,179,172,351,13,FALSE
yo3,3.0.6-beta.5,3.0.6-beta.6,43,1,179,172,351,13,FALSE
yo3,3.0.4-beta1,3.0.4-beta2,10,1,5745,5861,11606,86,FALSE
yo3,3.0.9-dev.0,3.0.9-dev.1,91,1,179,172,351,13,FALSE
yo3,3.0.4-beta3,3.0.4-beta4,12,1,179,172,351,13,FALSE
yo3,3.0.4-beta2,3.0.4-beta3,11,1,179,172,351,13,FALSE
yo3,3.0.4-beta5,3.0.4-rc1,14,1,179,172,351,13,FALSE
yo3,3.0.4-beta4,3.0.4-beta5,13,1,179,172,351,13,FALSE
yo3,3.0.6,3.0.7-dev.0,71,1,935,420,1355,43,FALSE
yo3,3.0.7,3.0.8-dev.0,81,1,1794,668,2462,73,FALSE
yo3,3.0.4,3.0.5-beta1,19,2,10462,9182,19644,200,FALSE
yo3,3.0.5,3.0.6-beta.0,37,3,10859,4193,15052,214,FALSE
yo3,3.0.2,3.0.3-beta1,6,1,179,172,351,13,FALSE
yo3,3.0.3,3.0.4-beta1,9,2,3282,4164,7446,163,FALSE
yo3,3.0.1,3.0.2-beta1,4,1,294,372,666,52,FALSE
yo3,3.0.8,3.0.9-dev.0,90,1,15220,16016,31236,257,TRUE
yo3,3.0.9,3.0.10-beta-1,99,1,373,208,581,71,FALSE
yo3,3.0.8-dev.0,3.0.8-dev.1,82,1,179,172,351,13,FALSE
yo3,3.0.8-dev.1,3.0.8-dev.2,83,1,179,172,351,13,FALSE
yo3,3.0.8-dev.2,3.0.8-dev.3,84,1,179,172,351,13,FALSE
yo3,3.0.8-dev.3,3.0.8-rc.1,85,1,179,172,351,13,FALSE
yo3,3.0.6-dev.3,3.0.6-dev.4,49,1,179,172,351,13,FALSE
yo3,3.0.6-dev.0,3.0.6-dev.1,47,1,179,172,351,13,FALSE
yo3,3.0.6-dev.1,3.0.6-dev.3,48,1,179,172,351,13,FALSE
yo3,3.0.6-dev.6,3.0.6-dev.7,52,1,179,172,351,13,FALSE
yo3,3.0.6-dev.7,3.0.6-dev.8,53,1,179,172,351,13,FALSE
yo3,3.0.6-dev.4,3.0.6-dev.5,50,1,179,172,351,13,FALSE
yo3,3.0.6-dev.5,3.0.6-dev.6,51,1,179,172,351,13,FALSE
yo3,3.0.6-dev.8,3.0.6-dev.9,54,1,179,172,351,13,FALSE
yo3,3.0.6-dev.9,3.0.6-dev.10,55,1,179,172,351,13,FALSE
yo3,3.0.9-dev.2,3.0.9-rc.0,93,1,179,172,351,13,FALSE
yo3,3.0.7-rc.2,3.0.7,80,1,179,172,351,13,FALSE
yo3,3.0.8-rc.4,3.0.8,89,1,179,172,351,13,FALSE
yo3,3.0.8-rc.1,3.0.8-rc.2,86,1,179,172,351,13,FALSE
yo3,3.0.8-rc.3,3.0.8-rc.4,88,1,179,172,351,13,FALSE
yo3,3.0.8-rc.2,3.0.8-rc.3,87,1,179,172,351,13,FALSE
yo3,3.0.5-beta4,3.0.5-beta5,24,1,179,172,351,13,FALSE
yo3,3.0.5-beta5,3.0.5-beta6,25,3,7847,5255,13102,115,FALSE
yo3,3.0.5-beta6,3.0.5-beta7,26,1,179,172,351,13,FALSE
yo3,3.0.5-beta7,3.0.5-beta8,27,1,179,172,351,13,FALSE
yo3,3.0.5-beta1,3.0.5-beta10,20,3,7847,5255,13102,115,FALSE
yo3,3.0.5-beta2,3.0.5-beta3,22,1,179,172,351,13,FALSE
yo3,3.0.5-beta3,3.0.5-beta4,23,1,179,172,351,13,FALSE
yo3,3.0.5-beta8,3.0.5-beta9,28,1,179,172,351,13,FALSE
yo3,3.0.5-beta9,3.0.5-rc.1,29,1,179,172,351,13,FALSE
yo3,3.0.6-dev.20,3.0.6-dev.21,66,1,179,172,351,13,FALSE
yo3,3.0.0-beta1,3.0.1,3,21,399,267,666,28,FALSE
yo3,3.0.7-rc.0,3.0.7-rc.1,78,1,179,172,351,13,FALSE
yo3,3.0.7-rc.1,3.0.7-rc.2,79,1,179,172,351,13,FALSE
yo3,3.0.2-beta1,3.0.2,5,1,56902,1145,58047,246,FALSE
yo3,3.0.3-beta2,3.0.3,8,1,179,172,351,13,FALSE
yo3,3.0.3-beta1,3.0.3-beta2,7,1,179,172,351,13,FALSE
yo3,3.0.7-dev.6,3.0.7-rc.0,77,1,179,172,351,13,FALSE
yo3,3.0.7-dev.5,3.0.7-dev.6,76,1,179,172,351,13,FALSE
yo3,3.0.7-dev.3,3.0.7-dev.5,75,1,179,172,351,13,FALSE
yo3,3.0.7-dev.2,3.0.7-dev.3,74,1,179,172,351,13,FALSE
yo3,3.0.7-dev.1,3.0.7-dev.2,73,1,179,172,351,13,FALSE
yo3,3.0.7-dev.0,3.0.7-dev.1,72,1,179,172,351,13,FALSE
yo3,3.0.6-beta0,3.0.6-beta11,45,1,179,172,351,13,FALSE
yo3,3.0.4-rc4,3.0.4,18,1,179,172,351,13,FALSE
yo3,3.0.4-rc2,3.0.4-rc3,16,1,179,172,351,13,FALSE
yo3,3.0.4-rc3,3.0.4-rc4,17,1,179,172,351,13,FALSE
yo3,3.0.4-rc1,3.0.4-rc2,15,1,179,172,351,13,FALSE
yo3,3.0.6-dev.14,3.0.6-dev.15,60,1,179,172,351,13,FALSE
yo3,3.0.6-dev.15,3.0.6-dev.16,61,1,179,172,351,13,FALSE
yo3,3.0.6-dev.16,3.0.6-dev.17,62,1,179,172,351,13,FALSE
yo3,3.0.6-dev.17,3.0.6-dev.18,63,1,179,172,351,13,FALSE
yo3,3.0.6-dev.10,3.0.6-dev.11,56,1,179,172,351,13,FALSE
yo3,3.0.6-dev.11,3.0.6-dev.12,57,1,179,172,351,13,FALSE
yo3,3.0.6-dev.12,3.0.6-dev.13,58,1,179,172,351,13,FALSE
yo3,3.0.6-dev.13,3.0.6-dev.14,59,1,179,172,351,13,FALSE
yo3,3.0.6-dev.18,3.0.6-dev.19,64,1,179,172,351,13,FALSE
yo3,3.0.6-dev.19,3.0.6-dev.20,65,1,179,172,351,13,FALSE
yo3,3.0.6-rc.2,3.0.6,70,1,179,172,351,13,FALSE
yo3,3.0.6-rc.1,3.0.6-rc.2,69,1,179,172,351,13,FALSE
yo3,3.0.6-rc.0,3.0.6-rc.1,68,1,179,172,351,13,FALSE
yo3,3.0.8,3.0.9-dev.0,90,1,15220,16016,31236,257,FALSE
yo3,3.0.5-rc.1,3.0.5-rc.2,30,1,179,172,351,13,TRUE
yo3,3.0.4-beta3,3.0.4-beta4,12,1,179,172,351,13,TRUE
yo3,3.0.8-dev.1,3.0.8-dev.2,83,1,179,172,351,13,TRUE
yo3,3.0.8-dev.3,3.0.8-rc.1,85,1,179,172,351,13,TRUE
yo3,3.0.9-dev.0,3.0.9-dev.1,91,1,179,172,351,13,TRUE
yo3,3.0.8-dev.0,3.0.8-dev.1,82,1,179,172,351,13,TRUE
yo3,3.0.5-rc.6,3.0.5-rc.7,35,1,179,172,351,13,TRUE
yo3,3.0.5-rc.5,3.0.5-rc.6,34,1,179,172,351,13,TRUE
yo3,3.0.5-rc.2,3.0.5-rc.3,31,1,179,172,351,13,TRUE
yo3,3.0.0-beta1,3.0.1,3,21,399,267,666,28,TRUE
yo3,3.0.7-dev.6,3.0.7-rc.0,77,1,179,172,351,13,TRUE
yo3,3.0.7-dev.0,3.0.7-dev.1,72,1,179,172,351,13,TRUE
react-nabu,16.0.0,17.0.0,17,3,32,53,85,8,FALSE
react-nabu,17.0.2,17.0.3,20,2,7,7,14,3,FALSE
react-nabu,17.0.3,18.0.0,21,2,9,9,18,4,FALSE
react-nabu,0.2.5,0.3.0,8,6,12,14,26,9,FALSE
react-nabu,17.0.1,17.0.2,19,2,3,6,9,2,FALSE
react-nabu,0.2.3,0.2.4,6,1,2,2,4,1,FALSE
react-nabu,0.2.2,0.2.3,5,2,3,3,6,2,FALSE
react-nabu,0.2.1,0.2.2,4,2,194,752,946,17,FALSE
react-nabu,0.2.0,0.2.1,3,5,85,646,731,16,FALSE
react-nabu,0.1.0,0.1.1,1,12,294,852,1146,38,FALSE
react-nabu,15.4.0,16.0.0,16,17,266,105,371,29,FALSE
react-nabu,0.3.2,14.0.0,11,9,91,87,178,17,FALSE
react-nabu,0.3.0,0.3.1,9,3,20,3,23,3,FALSE
react-nabu,0.3.1,0.3.2,10,3,32,7,39,6,FALSE
react-nabu,18.1.0,18.1.1,23,3,4,5,9,3,FALSE
react-nabu,18.1.1,18.1.2,24,2,4,4,8,2,FALSE
react-nabu,18.1.2,19.0.0,25,2,4,4,8,2,FALSE
react-nabu,18.0.0,18.1.0,22,4,17,6,23,4,FALSE
react-nabu,14.0.0,14.1.0,12,3,42,8,50,3,FALSE
react-nabu,15.3.1,15.4.0,15,4,43,9,52,4,FALSE
react-nabu,15.3.0,15.3.1,14,2,4,2,6,2,FALSE
react-nabu,17.0.0,17.0.1,18,2,2,2,4,2,FALSE
react-nabu,0.2.4,0.2.5,7,2,2,2,4,1,FALSE
react-nabu,0.2.0,0.2.1,3,5,85,646,731,16,TRUE
react-nabu,0.2.1,0.2.2,4,2,194,752,946,17,TRUE
react-nabu,0.1.0,0.1.1,1,12,294,852,1146,38,TRUE
react-nabu,15.3.1,15.4.0,15,4,43,9,52,4,TRUE
shazamjs,0.14.1,0.14.2,11,2,2,1,3,2,FALSE
shazamjs,0.14.0,0.14.1,10,2,3,4,7,3,FALSE
shazamjs,0.15.12,0.15.13,26,3,33,50,83,5,FALSE
shazamjs,0.15.10,0.15.11,24,2,2,2,4,2,FALSE
shazamjs,0.15.11,0.15.12,25,2,2,2,4,2,FALSE
shazamjs,0.14.3,0.15.0,13,4,35,50,85,6,FALSE
shazamjs,0.14.2,0.14.3,12,3,18,3,21,3,FALSE
shazamjs,0.13.6,0.13.7,8,2,2,2,4,2,FALSE
shazamjs,0.13.7,0.14.0,9,3,39,18,57,8,FALSE
shazamjs,0.13.4,0.13.5,6,2,38,32,70,5,FALSE
shazamjs,0.13.5,0.13.6,7,2,10,12,22,4,FALSE
shazamjs,0.13.2,0.13.3,4,2,6,1,7,4,FALSE
shazamjs,0.13.3,0.13.4,5,2,18,5,23,4,FALSE
shazamjs,0.13.0,0.13.1,2,2,2,2,4,2,FALSE
shazamjs,0.13.1,0.13.2,3,2,34,18,52,4,FALSE
shazamjs,0.15.0,0.15.1,14,2,11,6,17,6,FALSE
shazamjs,0.15.1,0.15.2,15,2,3,3,6,3,FALSE
shazamjs,0.15.2,0.15.3,16,2,7,6,13,3,FALSE
shazamjs,0.15.3,0.15.4,17,2,6,2,8,2,FALSE
shazamjs,0.15.4,0.15.5,18,2,14,9,23,4,FALSE
shazamjs,0.15.5,0.15.6,19,2,17,28,45,4,FALSE
shazamjs,0.15.6,0.15.7,20,2,7,7,14,3,FALSE
shazamjs,0.15.7,0.15.8,21,4,6,3,9,5,FALSE
shazamjs,0.15.8,0.15.9,22,2,72,55,127,6,FALSE
shazamjs,0.15.9,0.15.10,23,3,3,3,6,3,FALSE
shazamjs,0.11.0-beta.2,0.13.0,1,2,21,7,28,3,FALSE
shazamjs,0.16.1,0.16.2,29,2,2,5,7,2,FALSE
shazamjs,0.15.13,0.16.0,27,4,35,194,229,8,FALSE
shazamjs,0.17.2,0.17.3,33,1,1,1,2,1,FALSE
shazamjs,0.17.3,0.17.4,34,1,1,1,2,1,FALSE
shazamjs,0.17.0,0.17.1,31,2,5,3,8,2,FALSE
shazamjs,0.17.1,0.17.2,32,2,4,3,7,4,FALSE
shazamjs,0.17.6,0.17.7,37,2,8,7,15,5,FALSE
shazamjs,0.17.7,0.17.8,38,2,10,10,20,5,FALSE
shazamjs,0.17.4,0.17.5,35,6,356,8,364,43,FALSE
shazamjs,0.17.5,0.17.6,36,2,1,24,25,2,FALSE
shazamjs,0.17.8,0.18.0,39,3,52,7,59,5,FALSE
shazamjs,0.15.7,0.15.8,21,4,6,3,9,5,TRUE
shazamjs,0.16.0,0.16.1,28,7,634,768,1402,60,FALSE
shazamjs,0.16.2,0.17.0,30,2,24,3,27,4,FALSE
shazamjs,0.16.1,0.16.2,29,2,2,5,7,2,TRUE
shazamjs,0.15.12,0.15.13,26,3,33,50,83,5,TRUE
shazamjs,0.15.9,0.15.10,23,3,3,3,6,3,TRUE
shazamjs,0.15.8,0.15.9,22,2,72,55,127,6,TRUE
shazamjs,0.17.1,0.17.2,32,2,4,3,7,4,TRUE
shazamjs,0.17.6,0.17.7,37,2,8,7,15,5,TRUE
shazamjs,0.16.2,0.17.0,30,2,24,3,27,4,TRUE
shazamjs,0.15.13,0.16.0,27,4,35,194,229,8,TRUE
shazamjs,0.13.7,0.14.0,9,3,39,18,57,8,TRUE
plugged,1.0.4,1.0.5,5,2,12,1,13,2,FALSE
plugged,1.0.5,1.0.6,6,4,8,3,11,4,FALSE
plugged,1.0.6,1.0.7,7,2,15,3,18,2,FALSE
plugged,1.0.7,1.0.8,8,18,418,263,681,20,FALSE
plugged,1.0.0,1.0.1,1,2,9,1,10,2,FALSE
plugged,1.0.1,1.0.2,2,1,1,1,2,1,FALSE
plugged,1.0.2,1.0.3,3,7,268,104,372,7,FALSE
plugged,1.0.3,1.0.4,4,6,172,25,197,6,FALSE
plugged,1.0.8,1.0.9,9,5,116,125,241,7,FALSE
plugged,1.0.9,1.1.0,10,45,585,533,1118,46,FALSE
plugged,1.0.2,1.0.3,3,7,268,104,372,7,TRUE
plugged,1.1.2,1.1.3,13,12,112,122,234,12,FALSE
plugged,2.2.1,2.3.0,21,3,7,1,8,3,FALSE
plugged,2.2.0,2.2.1,20,2,5,5,10,2,FALSE
plugged,2.1.0,2.1.1,18,1,6,5,11,2,FALSE
plugged,2.1.1,2.2.0,19,6,52,9,61,6,FALSE
plugged,2.4.1,2.5.0,27,37,1273,989,2262,40,FALSE
plugged,2.0.2,2.1.0,17,16,279,143,422,23,FALSE
plugged,2.0.1,2.0.2,16,3,73,27,100,5,FALSE
plugged,2.0.0,2.0.1,15,8,44,13,57,8,FALSE
plugged,1.1.1,1.1.2,12,1,11,10,21,2,FALSE
plugged,2.3.0,2.3.1,22,4,52,15,67,4,FALSE
plugged,2.3.1,2.3.2,23,2,9,3,12,2,FALSE
plugged,2.3.2,2.3.3,24,3,33,9,42,3,FALSE
plugged,2.3.3,2.4.0,25,12,203,119,322,12,FALSE
plugged,2.5.4,2.6.0,32,14,80,31,111,15,FALSE
plugged,2.4.0,2.4.1,26,3,12,38,50,3,FALSE
plugged,2.5.2,2.5.3,30,1,1,1,2,1,FALSE
plugged,2.5.3,2.5.4,31,2,5,4,9,2,FALSE
plugged,2.5.0,2.5.1,28,1,2,2,4,1,FALSE
plugged,2.5.1,2.5.2,29,4,13,7,20,5,FALSE
plugged,1.1.0,1.1.1,11,11,197,130,327,11,FALSE
plugged,2.6.1,2.6.2,34,3,6,3,9,3,FALSE
plugged,2.6.0,2.6.1,33,2,4,4,8,2,FALSE
plugged,2.6.2,2.6.3,35,7,10981,2188,13169,71,FALSE
plugged,1.1.3,2.0.0,14,48,2797,400,3197,55,FALSE
plugged,1.0.7,1.0.8,8,18,418,263,681,20,TRUE
flow-runtime,0.2.1,0.3.0,10,41,83255,6159,89414,539,FALSE
flow-runtime,0.2.0,0.2.1,9,5,105,32,137,16,FALSE
flow-runtime,0.1.0,0.2.0,8,39,19121,1949,21070,496,FALSE
flow-runtime,0.0.5,0.0.6,6,18,4675,378,5053,74,FALSE
flow-runtime,0.10.0,0.11.0,20,31,3640,2476,6116,94,FALSE
flow-runtime,0.0.6,0.1.0,7,23,916,207,1123,64,FALSE
flow-runtime,0.0.1,0.0.2,2,6,45,36,81,25,FALSE
flow-runtime,0.0.0,0.0.1,1,22,37781,2457,40238,680,FALSE
flow-runtime,0.0.3,0.0.4,4,26,4836,840,5676,170,FALSE
flow-runtime,0.0.2,0.0.3,3,1,133,87,220,7,FALSE
flow-runtime,0.3.0,0.4.0,11,11,379,90,469,36,FALSE
flow-runtime,0.6.0,0.6.1,14,3,120,50,170,13,FALSE
flow-runtime,0.11.0,0.11.1,21,2,76,19,95,12,FALSE
flow-runtime,0.11.1,0.12.0,22,3,40,22,62,8,FALSE
flow-runtime,0.7.0,0.8.0,16,3,446,138,584,39,TRUE
flow-runtime,0.4.0,0.5.0,12,3,543,60,603,15,FALSE
flow-runtime,0.5.0,0.6.0,13,12,364,36,400,26,FALSE
flow-runtime,0.9.0,0.9.1,18,2,49,30,79,14,FALSE
flow-runtime,0.9.1,0.10.0,19,6,423,169,592,16,FALSE
flow-runtime,0.0.4,0.0.5,5,9,3960,137,4097,78,FALSE
flow-runtime,0.8.0,0.9.0,17,2,86,30,116,9,FALSE
flow-runtime,0.6.1,0.7.0,15,3,81,27,108,15,FALSE
flow-runtime,0.7.0,0.8.0,16,3,446,138,584,39,FALSE
flow-runtime,0.0.5,0.0.6,6,18,4675,378,5053,74,TRUE
flow-runtime,0.0.3,0.0.4,4,26,4836,840,5676,170,TRUE
flow-runtime,0.5.0,0.6.0,13,12,364,36,400,26,TRUE
flow-runtime,0.6.1,0.7.0,15,3,81,27,108,15,TRUE
flow-runtime,0.3.0,0.4.0,11,11,379,90,469,36,TRUE
flow-runtime,0.9.1,0.10.0,19,6,423,169,592,16,TRUE
flow-runtime,0.0.4,0.0.5,5,9,3960,137,4097,78,TRUE
redux-ddd,1.0.0,1.0.1,1,8,130,82,212,10,FALSE
redux-ddd,1.0.0,1.0.1,1,8,130,82,212,10,TRUE
americons,1.1.0,1.1.2,2,2,81,82,163,2,FALSE
americons,1.1.2,1.2.0,3,7,741,349,1090,475,FALSE
americons,1.0.1,1.1.0,1,1,3,2,5,2,FALSE
americons,1.5.0,1.6.0,6,7,47,39,86,27,FALSE
americons,1.2.0,1.2.1,4,1,43,23,66,20,FALSE
americons,1.2.1,1.5.0,5,7,1117,135,1252,188,FALSE
americons,1.5.0,1.6.0,6,7,47,39,86,27,TRUE
americons,1.2.1,1.5.0,5,7,1117,135,1252,188,TRUE
u200b,0.9.0,0.10.0,28,1,589,154,743,8,FALSE
u200b,0.10.0,0.11.0,29,2,689,867,1556,10,FALSE
u200b,0.6.0,0.7.0,25,1,793,559,1352,9,FALSE
u200b,0.11.0,0.12.0,30,1,94,46,140,6,FALSE
u200b,0.7.0,0.8.0,26,6,2417,4063,6480,13,FALSE
u200b,0.17.0,0.18.0,36,2,348,366,714,5,FALSE
u200b,0.12.0,0.13.0,31,2,137,75,212,5,FALSE
u200b,0.20.0,0.21.0,39,2,74,56,130,5,FALSE
u200b,0.16.0,0.17.0,35,2,243,475,718,5,FALSE
u200b,0.23.0,0.24.0,42,2,114,83,197,5,FALSE
u200b,0.13.0,0.14.0,32,1,14,137,151,3,FALSE
u200b,0.15.0,0.16.0,34,1,644,308,952,10,FALSE
u200b,0.19.0,0.20.0,38,2,346,324,670,5,FALSE
u200b,0.14.0,0.15.0,33,1,36,36,72,4,FALSE
u200b,0.22.0,0.23.0,41,2,42,47,89,5,FALSE
u200b,0.24.0,0.25.0,43,2,238,213,451,5,FALSE
u200b,0.21.0,0.22.0,40,2,228,225,453,5,FALSE
u200b,0.8.0,0.9.0,27,1,766,511,1277,5,FALSE
u200b,0.25.0,0.26.0,44,3,90,78,168,6,FALSE
u200b,0.18.0,0.19.0,37,2,153,153,306,5,FALSE
u200b,0.26.0,0.27.0,45,2,96,98,194,5,FALSE
u200b,0.27.0,0.28.0,46,2,63,46,109,5,FALSE
u200b,0.4.0,0.5.0,23,2,7188,5102,12290,18,FALSE
u200b,0.5.0,0.6.0,24,1,434,7,441,3,FALSE
u200b,0.15.0,0.16.0,34,1,644,308,952,10,TRUE
u200b,0.7.0,0.8.0,26,6,2417,4063,6480,13,TRUE
u200b,0.25.0,0.26.0,44,3,90,78,168,6,TRUE
kibana4-backup,1.1.0,2.0.0,12,3,67,32,99,13,FALSE
kibana4-backup,1.0.0,1.1.0,11,3,161,39,200,17,FALSE
kibana4-backup,0.3.2,0.4.0,7,4,265,143,408,39,FALSE
kibana4-backup,0.3.0,0.3.1,5,2,9,3,12,4,FALSE
kibana4-backup,0.3.1,0.3.2,6,1,14,3,17,4,FALSE
kibana4-backup,0.4.1,0.4.2,9,1,12,6,18,5,FALSE
kibana4-backup,0.2.2,0.3.0,4,2,78,48,126,8,FALSE
kibana4-backup,0.2.1,0.2.2,3,4,87,17,104,13,FALSE
kibana4-backup,0.2.0,0.2.1,2,1,8,2,10,3,FALSE
kibana4-backup,0.1.0,0.2.0,1,5,87,49,136,21,FALSE
kibana4-backup,0.4.0,0.4.1,8,2,8,2,10,2,FALSE
kibana4-backup,0.4.2,1.0.0,10,1,31,9,40,5,FALSE
kibana4-backup,0.2.1,0.2.2,3,4,87,17,104,13,TRUE
kibana4-backup,1.0.0,1.1.0,11,3,161,39,200,17,TRUE
kibana4-backup,0.3.2,0.4.0,7,4,265,143,408,39,TRUE
react-native-newrelic,1.0.4,1.0.5,5,1,12,2,14,1,FALSE
react-native-newrelic,1.0.5,1.0.6,6,2,5,3,8,4,FALSE
react-native-newrelic,1.0.6,1.0.7,7,1,4,2,6,2,FALSE
react-native-newrelic,1.0.7,1.0.8,8,1,3,3,6,3,FALSE
react-native-newrelic,1.0.0,1.0.1,1,1,21,1,22,3,FALSE
react-native-newrelic,1.0.1,1.0.2,2,1,16,10,26,2,FALSE
react-native-newrelic,1.0.2,1.0.3,3,1,76,74,150,8,FALSE
react-native-newrelic,1.0.3,1.0.4,4,1,16,16,32,6,FALSE
react-native-newrelic,1.0.8,1.0.9,9,1,3,3,6,2,FALSE
react-native-newrelic,1.0.9,1.0.10,10,2,316,86,402,10,FALSE
react-native-newrelic,1.0.16,1.0.17,17,1,12,2,14,1,FALSE
react-native-newrelic,1.0.17,1.0.18,18,4,17,7,24,5,FALSE
react-native-newrelic,1.0.14,1.0.15,15,2,228,4,232,3,FALSE
react-native-newrelic,1.0.15,1.0.16,16,2,1466,32,1498,26,FALSE
react-native-newrelic,1.0.12,1.0.13,13,1,1,1,2,1,FALSE
react-native-newrelic,1.0.13,1.0.14,14,1,6,5,11,4,FALSE
react-native-newrelic,1.0.10,1.0.11,11,2,9,7,16,4,TRUE
react-native-newrelic,1.0.11,1.0.12,12,1,63,6,69,4,FALSE
react-native-newrelic,1.0.10,1.0.11,11,2,9,7,16,4,FALSE
react-native-newrelic,1.0.14,1.0.15,15,2,228,4,232,3,TRUE
react-native-newrelic,1.0.11,1.0.12,12,1,63,6,69,4,TRUE
react-native-newrelic,1.0.15,1.0.16,16,2,1466,32,1498,26,TRUE
react-native-newrelic,1.0.7,1.0.8,8,1,3,3,6,3,TRUE
mithril-form,1.1.2,1.2.0,4,1,9,3,12,3,TRUE
mithril-form,1.0.0,1.0.1,1,4,26,23,49,5,FALSE
mithril-form,1.0.1,1.0.2,2,2,47,10,57,3,FALSE
mithril-form,1.0.2,1.1.2,3,1,35,2,37,4,TRUE
mithril-form,1.3.2,1.3.3,8,3,9,9,18,7,FALSE
mithril-form,1.3.1,1.3.2,7,3,5,4,9,3,FALSE
mithril-form,1.3.0,1.3.1,6,1,1,0,1,1,FALSE
mithril-form,1.2.0,1.3.0,5,4,360,264,624,12,FALSE
mithril-form,1.1.2,1.2.0,4,1,9,3,12,3,FALSE
mithril-form,1.0.2,1.1.2,3,1,35,2,37,4,FALSE
chai-snapshots,1.0.4,1.0.5,5,5,15,15,30,9,FALSE
chai-snapshots,1.0.5,1.0.6,6,3,8,4,12,4,FALSE
chai-snapshots,1.0.0,1.0.1,1,5,168,90,258,9,FALSE
chai-snapshots,1.0.1,1.0.2,2,3,24,9,33,6,FALSE
chai-snapshots,1.0.2,1.0.3,3,3,9,9,18,6,FALSE
chai-snapshots,1.0.3,1.0.4,4,4,41,19,60,7,FALSE
chai-snapshots,1.0.4,1.0.5,5,5,15,15,30,9,TRUE
chai-snapshots,1.0.5,1.0.6,6,3,8,4,12,4,TRUE
chai-snapshots,1.0.3,1.0.4,4,4,41,19,60,7,TRUE
itemsense-node,1.0.4,1.0.5,5,1,17,3,20,3,FALSE
itemsense-node,1.0.5,1.0.6,6,2,508,23,531,5,FALSE
itemsense-node,1.0.6,1.0.7,7,3,32,30,62,11,FALSE
itemsense-node,1.0.7,1.0.8,8,4,43,4537,4580,86,FALSE
itemsense-node,1.0.0,1.0.1,1,1,17,3,20,3,FALSE
itemsense-node,1.0.1,1.0.2,2,6,252,23,275,10,FALSE
itemsense-node,1.0.2,1.0.3,3,6,36,6,42,7,FALSE
itemsense-node,1.0.3,1.0.4,4,1,11,11,22,2,FALSE
itemsense-node,1.0.8,1.0.9-a,9,24,763,305,1068,71,FALSE
itemsense-node,1.0.9,1.2.0,11,47,3948,1511,5459,324,FALSE
itemsense-node,1.3.1,1.4.0,15,10,303,76,379,21,FALSE
itemsense-node,1.3.0,1.3.1,14,9,228,64,292,20,FALSE
itemsense-node,1.2.0,1.3.0-a,12,17,671,216,887,59,FALSE
itemsense-node,1.4.0,1.4.1,16,1,12,4,16,3,FALSE
itemsense-node,1.3.0,1.3.1,14,9,228,64,292,20,TRUE
itemsense-node,1.0.0,1.0.1,1,1,17,3,20,3,TRUE
itemsense-node,1.0.6,1.0.7,7,3,32,30,62,11,TRUE
itemsense-node,1.0.9,1.2.0,11,47,3948,1511,5459,324,TRUE
knockout-inview,2.3.0,2.3.1,10,3,7,7,14,4,FALSE
knockout-inview,2.3.1,2.4.0,11,2,53,9,62,3,FALSE
knockout-inview,2.2.1,2.2.2,8,2,5,5,10,3,FALSE
knockout-inview,2.2.0,2.2.1,7,2,3,3,6,3,FALSE
knockout-inview,2.2.2,2.3.0,9,3,33,11,44,4,FALSE
knockout-inview,2.1.0,2.2.0,6,2,90,40,130,3,FALSE
knockout-inview,2.4.0,2.5.0,12,3,89,37,126,3,FALSE
knockout-inview,1.0.0,1.0.1,1,1,18,5,23,4,FALSE
knockout-inview,1.0.1,1.0.2,2,1,60,14,74,2,FALSE
knockout-inview,1.0.2,1.0.3,3,1,66,16,82,3,FALSE
knockout-inview,2.0.0,2.1.0,5,7,115,89,204,12,FALSE
knockout-inview,1.0.3,2.0.0,4,1,33,19,52,3,TRUE
knockout-inview,1.0.3,2.0.0,4,1,33,19,52,3,FALSE
knockout-inview,1.0.1,1.0.2,2,1,60,14,74,2,TRUE
mocker-data-generator,0.6.0,0.7.0,22,2,616,649,1265,13,FALSE
mocker-data-generator,1.0.4,1.0.5,28,1,2,0,2,1,FALSE
mocker-data-generator,1.0.5,1.0.6,29,5,418,275,693,18,FALSE
mocker-data-generator,1.0.6,1.1.0,30,11,610,230,840,28,FALSE
mocker-data-generator,1.0.0,1.0.1,24,1,54,6,60,6,FALSE
mocker-data-generator,1.0.1,1.0.2,25,3,19,10,29,11,FALSE
mocker-data-generator,1.0.2,1.0.3,26,5,69,67,136,12,FALSE
mocker-data-generator,1.0.3,1.0.4,27,2,85,13,98,8,FALSE
mocker-data-generator,0.7.0,1.0.0,23,2,1407,2968,4375,41,FALSE
mocker-data-generator,0.4.2,0.4.4,16,2,72,14,86,9,FALSE
mocker-data-generator,0.5.0,0.6.0,21,3,464,300,764,9,FALSE
mocker-data-generator,0.4.4,0.4.5,17,4,762,232,994,20,FALSE
mocker-data-generator,0.4.7,0.5.0,20,1,178,17,195,6,FALSE
mocker-data-generator,0.4.6,0.4.7,19,1,29,6,35,7,FALSE
mocker-data-generator,1.2.4,1.2.5,36,1,6,20,26,3,FALSE
mocker-data-generator,1.2.5,1.2.7,37,8,128,94,222,20,FALSE
mocker-data-generator,1.2.2,1.2.3,34,5,26,14,40,7,FALSE
mocker-data-generator,1.2.3,1.2.4,35,2,22,22,44,12,FALSE
mocker-data-generator,1.2.0,1.2.1,32,21,180,86,266,29,FALSE
mocker-data-generator,1.2.1,1.2.2,33,2,211,122,333,20,FALSE
mocker-data-generator,1.1.0,1.2.0,31,8,707,443,1150,38,FALSE
mocker-data-generator,0.4.5,0.4.6,18,2,438,36,474,10,FALSE
mocker-data-generator,2.0.1,2.0.2,40,3,31,21,52,6,FALSE
mocker-data-generator,0.2.2,0.3.0,12,7,1152,787,1939,24,FALSE
mocker-data-generator,0.2.1,0.2.2,11,1,12,15,27,6,FALSE
mocker-data-generator,0.2.0,0.2.1,10,1,9,5,14,5,FALSE
mocker-data-generator,0.1.1,0.1.2,5,2,143,38,181,6,FALSE
mocker-data-generator,0.1.5,0.1.6,7,3,27,15,42,6,FALSE
mocker-data-generator,0.1.2,0.1.5,6,3,94,46,140,9,FALSE
mocker-data-generator,0.1.7,0.2.0,9,1,1,1,2,1,FALSE
mocker-data-generator,0.0.4,0.1.1,4,13,780,318,1098,21,FALSE
mocker-data-generator,0.0.1,0.0.2,1,2,996,33,1029,19,FALSE
mocker-data-generator,0.0.3,0.0.4,3,1,27,7,34,2,FALSE
mocker-data-generator,0.0.2,0.0.3,2,1,22,2,24,2,FALSE
mocker-data-generator,0.3.0,0.4.0,13,6,820,130,950,22,FALSE
mocker-data-generator,2.0.0,2.0.1,39,16,462,299,761,21,FALSE
mocker-data-generator,2.0.2,2.1.0,41,7,176,14,190,18,FALSE
mocker-data-generator,0.1.6,0.1.7,8,5,342,133,475,9,FALSE
mocker-data-generator,0.4.1,0.4.2,15,1,344,354,698,14,FALSE
mocker-data-generator,0.4.0,0.4.1,14,1,95,82,177,6,FALSE
mocker-data-generator,1.2.7,2.0.0,38,24,6284,3509,9793,131,FALSE
mocker-data-generator,1.0.5,1.0.6,29,5,418,275,693,18,TRUE
mocker-data-generator,0.4.4,0.4.5,17,4,762,232,994,20,TRUE
mocker-data-generator,1.0.2,1.0.3,26,5,69,67,136,12,TRUE
mocker-data-generator,0.2.2,0.3.0,12,7,1152,787,1939,24,TRUE
mocker-data-generator,0.3.0,0.4.0,13,6,820,130,950,22,TRUE
mocker-data-generator,0.4.5,0.4.6,18,2,438,36,474,10,TRUE
mocker-data-generator,2.0.2,2.1.0,41,7,176,14,190,18,TRUE
mocker-data-generator,0.1.1,0.1.2,5,2,143,38,181,6,TRUE
mocker-data-generator,0.1.6,0.1.7,8,5,342,133,475,9,TRUE
mocker-data-generator,0.0.4,0.1.1,4,13,780,318,1098,21,TRUE
mocker-data-generator,0.0.2,0.0.3,2,1,22,2,24,2,TRUE
mocker-data-generator,0.6.0,0.7.0,22,2,616,649,1265,13,TRUE
mocker-data-generator,0.4.1,0.4.2,15,1,344,354,698,14,TRUE
mocker-data-generator,0.4.0,0.4.1,14,1,95,82,177,6,TRUE
mocker-data-generator,0.4.6,0.4.7,19,1,29,6,35,7,TRUE
mocker-data-generator,0.5.0,0.6.0,21,3,464,300,764,9,TRUE
node-msbuild,0.1.2,0.1.3,1,4,73,8,81,5,FALSE
node-msbuild,0.1.3,0.1.4,2,3,5,9,14,3,TRUE
node-msbuild,0.1.3,0.1.4,2,3,5,9,14,3,FALSE
node-msbuild,0.1.4,0.1.5,3,6,58,7,65,9,FALSE
node-msbuild,0.1.5,0.1.6,4,1,14,2,16,1,FALSE
relay-subscriptions,0.3.0,1.0.0,4,12,1894,1216,3110,101,FALSE
relay-subscriptions,1.0.0,1.0.1,5,5,4668,6,4674,7,FALSE
relay-subscriptions,0.2.1,0.3.0,3,3,452,617,1069,36,FALSE
relay-subscriptions,0.2.0,0.2.1,2,5,45,34,79,6,FALSE
relay-subscriptions,1.0.0,1.0.1,5,5,4668,6,4674,7,TRUE
relay-subscriptions,0.3.0,1.0.0,4,12,1894,1216,3110,101,TRUE
gulp-stylelint-console-reporter,0.1.0,0.1.1,3,3,8,8,16,3,FALSE
gulp-stylelint-console-reporter,0.0.1,0.0.2,1,5,12,6,18,6,FALSE
gulp-stylelint-console-reporter,0.0.2,0.1.0,2,4,89,10,99,5,FALSE
gulp-stylelint-console-reporter,0.0.2,0.1.0,2,4,89,10,99,5,TRUE
uxcore-form,1.2.25,1.2.26,33,2,16,5,21,4,FALSE
uxcore-form,1.2.24,1.2.25,32,10,496,415,911,41,FALSE
uxcore-form,1.2.21,1.2.22,29,2,6,2,8,3,FALSE
uxcore-form,1.2.20,1.2.21,28,3,27,20,47,6,FALSE
uxcore-form,1.2.23,1.2.24,31,1,29,27,56,6,FALSE
uxcore-form,1.2.22,1.2.23,30,5,143,85,228,17,FALSE
uxcore-form,1.3.4,1.3.5,39,1,10,6,16,4,FALSE
uxcore-form,1.2.12,1.2.13,20,3,2662,23,2685,26,FALSE
uxcore-form,1.2.13,1.2.14,21,4,17,2630,2647,24,FALSE
uxcore-form,1.3.5,1.3.6,40,1,18,1,19,4,FALSE
uxcore-form,1.2.14,1.2.15,22,1,1,1,2,1,FALSE
uxcore-form,1.2.15,1.2.16,23,1,1,1,2,1,FALSE
uxcore-form,1.2.10,1.2.11,18,4,61,25,86,13,FALSE
uxcore-form,1.6.2,1.6.3,61,1,6,1,7,3,FALSE
uxcore-form,1.6.3,1.7.0,62,1,9,4,13,3,FALSE
uxcore-form,1.6.0,1.6.1,59,5,37,82,119,17,FALSE
uxcore-form,1.6.1,1.6.2,60,1,23,4,27,8,FALSE
uxcore-form,1.4.1,1.4.2,52,1,3,3,6,2,FALSE
uxcore-form,1.7.5,1.8.0,68,1,9,5,14,3,FALSE
uxcore-form,1.7.4,1.7.5,67,7,25,17,42,15,FALSE
uxcore-form,1.7.3,1.7.4,66,1,9,1,10,5,FALSE
uxcore-form,1.7.2,1.7.3,65,1,1,1,2,1,FALSE
uxcore-form,1.7.1,1.7.2,64,1,26,16,42,4,FALSE
uxcore-form,1.7.0,1.7.1,63,1,7,3,10,3,FALSE
uxcore-form,1.4.0,1.4.1,51,1,10,2,12,2,FALSE
uxcore-form,1.2.11,1.2.12,19,2,34,124,158,10,FALSE
uxcore-form,1.4.2,1.4.3,53,1,4,3,7,2,FALSE
uxcore-form,1.4.3,1.4.4,54,1,10,3,13,2,FALSE
uxcore-form,1.4.4,1.4.5,55,1,5,5,10,2,FALSE
uxcore-form,1.4.5,1.5.0,56,6,254,479,733,17,FALSE
uxcore-form,1.2.16,1.2.17,24,3,227,74,301,17,FALSE
uxcore-form,1.2.17,1.2.18,25,1,4,3,7,3,FALSE
uxcore-form,1.2.18,1.2.19,26,1,7,4,11,4,FALSE
uxcore-form,1.2.19,1.2.20,27,1,6,3,9,3,FALSE
uxcore-form,1.5.1,1.6.0,58,1,63,36,99,20,FALSE
uxcore-form,1.5.0,1.5.1,57,2,6862,422,7284,35,FALSE
uxcore-form,1.3.3,1.3.4,38,2,148,146,294,10,FALSE
uxcore-form,1.3.2,1.3.3,37,3,238,158,396,13,FALSE
uxcore-form,1.3.1,1.3.2,36,4,118,116,234,21,FALSE
uxcore-form,1.3.0,1.3.1,35,1,11,13,24,7,FALSE
uxcore-form,1.3.7,1.3.8,42,1,7,2,9,3,FALSE
uxcore-form,1.3.6,1.3.7,41,1,7,2,9,3,FALSE
uxcore-form,1.2.0,1.2.1,9,5,81,394,475,18,FALSE
uxcore-form,1.2.1,1.2.2,10,8,169,521,690,14,FALSE
uxcore-form,1.3.9,1.3.10,44,4,166,866,1032,23,FALSE
uxcore-form,1.3.8,1.3.9,43,2,141,136,277,4,FALSE
uxcore-form,1.2.8,1.2.9,16,3,14,6,20,7,FALSE
uxcore-form,1.2.9,1.2.10,17,6,89,35,124,14,FALSE
uxcore-form,1.2.6,1.2.7,14,1,1,3,4,2,FALSE
uxcore-form,1.2.7,1.2.8,15,3,70,30,100,9,FALSE
uxcore-form,1.8.0,1.8.1,69,1,45,2,47,6,FALSE
uxcore-form,1.2.4,1.2.6,13,7,34,85,119,12,FALSE
uxcore-form,1.8.1,1.8.2,70,1,17,2,19,3,FALSE
uxcore-form,1.3.13,1.3.14,48,1,10,5,15,4,FALSE
uxcore-form,1.3.12,1.3.13,47,2,154,150,304,4,FALSE
uxcore-form,1.3.11,1.3.12,46,5,300,218,518,16,FALSE
uxcore-form,1.3.10,1.3.11,45,1,10,134,144,5,FALSE
uxcore-form,1.3.14,1.3.15,49,2,13,5,18,4,FALSE
uxcore-form,1.2.2,1.2.3,11,7,89,49,138,17,FALSE
uxcore-form,1.2.3,1.2.4,12,3,47,33,80,8,FALSE
uxcore-form,3.1.1,3.2.0,101,3,22,10,32,6,FALSE
uxcore-form,3.1.0,3.1.1,100,1,5,5,10,3,FALSE
uxcore-form,3.0.0,3.1.0,99,2,10,4,14,3,FALSE
uxcore-form,2.0.0,2.1.0,96,6,227,207,434,18,FALSE
uxcore-form,1.8.12,1.8.13,81,1,9,1,10,3,FALSE
uxcore-form,1.8.13,1.8.14,82,2,1822,5559,7381,40,FALSE
uxcore-form,1.8.10,1.8.11,79,1,7,2,9,3,FALSE
uxcore-form,1.8.11,1.8.12,80,1,22,3,25,6,FALSE
uxcore-form,1.8.8,1.8.9,77,1,13,1,14,4,FALSE
uxcore-form,1.8.9,1.8.10,78,2,8,1,9,3,FALSE
uxcore-form,1.8.4,1.8.5,73,2,11,5,16,5,FALSE
uxcore-form,1.8.5,1.8.6,74,1,28,17,45,6,FALSE
uxcore-form,1.8.6,1.8.7,75,1,12,4,16,5,FALSE
uxcore-form,1.9.2,1.10.0,86,1,6,2,8,2,FALSE
uxcore-form,2.1.0,2.1.1,97,1,9,5,14,2,FALSE
uxcore-form,1.8.3,1.8.4,72,1,86,18,104,7,FALSE
uxcore-form,1.9.1,1.9.2,85,1,89,632,721,14,FALSE
uxcore-form,1.9.0,1.9.1,84,1,9,4,13,5,FALSE
uxcore-form,1.8.7,1.8.8,76,1,39,5,44,6,FALSE
uxcore-form,1.10.8,2.0.0,95,1,8,4,12,3,FALSE
uxcore-form,1.10.6,1.10.7,93,1,18,1,19,3,FALSE
uxcore-form,1.10.7,1.10.8,94,1,19,4,23,4,FALSE
uxcore-form,1.10.4,1.10.5,91,1,9,3,12,4,FALSE
uxcore-form,1.10.5,1.10.6,92,1,20,9,29,3,FALSE
uxcore-form,1.10.2,1.10.3,89,1,274,259,533,3,FALSE
uxcore-form,1.10.3,1.10.4,90,1,7,4,11,2,FALSE
uxcore-form,1.10.0,1.10.1,87,1,12,2,14,4,FALSE
uxcore-form,1.10.1,1.10.2,88,1,13,1,14,5,FALSE
uxcore-form,3.2.0,3.3.0,102,2,36,3,39,6,FALSE
uxcore-form,1.0.4,1.0.5,5,1,29,17,46,6,FALSE
uxcore-form,1.0.5,1.0.6,6,21,1536,565,2101,101,FALSE
uxcore-form,1.0.6,1.1.0,7,10,1144,1128,2272,71,FALSE
uxcore-form,1.0.0,1.0.1,1,10,4336,2760,7096,126,FALSE
uxcore-form,1.0.1,1.0.2,2,9,2802,14231,17033,137,FALSE
uxcore-form,1.0.2,1.0.3,3,1,186,110,296,12,FALSE
uxcore-form,1.0.3,1.0.4,4,1,16,3,19,6,FALSE
uxcore-form,1.1.0,1.2.0,8,33,1828,803,2631,176,FALSE
uxcore-form,1.8.2,1.8.3,71,2,1761,2063,3824,33,FALSE
uxcore-form,1.3.8,1.3.9,43,2,141,136,277,4,TRUE
uxcore-form,1.3.3,1.3.4,38,2,148,146,294,10,TRUE
uxcore-form,1.3.4,1.3.5,39,1,10,6,16,4,TRUE
uxcore-form,1.2.1,1.2.2,10,8,169,521,690,14,TRUE
uxcore-form,1.4.5,1.5.0,56,6,254,479,733,17,TRUE
uxcore-form,1.4.3,1.4.4,54,1,10,3,13,2,TRUE
uxcore-form,1.2.9,1.2.10,17,6,89,35,124,14,TRUE
uxcore-form,1.2.7,1.2.8,15,3,70,30,100,9,TRUE
uxcore-form,1.2.2,1.2.3,11,7,89,49,138,17,TRUE
uxcore-form,1.1.0,1.2.0,8,33,1828,803,2631,176,TRUE
uxcore-form,1.2.0,1.2.1,9,5,81,394,475,18,TRUE
eslint-config-trustpilot,1.0.0-beta3,1.0.0,7,4,310,315,625,18,FALSE
eslint-config-trustpilot,1.0.0-beta2,1.0.0-beta3,6,6,296,296,592,18,FALSE
eslint-config-trustpilot,1.0.0-beta,1.0.0-beta2,5,1,15,15,30,1,FALSE
eslint-config-trustpilot,1.0.0,1.1.0,8,4,7,22,29,5,FALSE
eslint-config-trustpilot,1.1.0,1.2.0,9,5,29,42,71,10,FALSE
eslint-config-trustpilot,1.5.0,1.6.0,14,4,80,80,160,29,FALSE
eslint-config-trustpilot,1.4.0,1.5.0,13,6,32,26,58,13,FALSE
eslint-config-trustpilot,1.3.0,1.4.0,12,4,23,9,32,9,FALSE
eslint-config-trustpilot,1.2.0,1.2.1,10,3,7,7,14,3,FALSE
eslint-config-trustpilot,1.2.1,1.3.0,11,8,129,105,234,38,FALSE
eslint-config-trustpilot,0.1.0,0.1.1,1,2,6,6,12,2,FALSE
eslint-config-trustpilot,0.1.1,0.1.2,2,3,4,7,11,4,FALSE
eslint-config-trustpilot,0.1.2,0.1.3,3,4,5,5,10,4,FALSE
eslint-config-trustpilot,0.1.3,1.0.0-beta,4,11,46,48,94,18,FALSE
eslint-config-trustpilot,1.6.0,1.7.0,15,11,2064,98,2162,17,FALSE
eslint-config-trustpilot,1.2.0,1.2.1,10,3,7,7,14,3,TRUE
eslint-config-trustpilot,1.3.0,1.4.0,12,4,23,9,32,9,TRUE
nexus-parser,1.0.4,1.0.5,4,1,2,2,4,2,FALSE
nexus-parser,1.0.5,1.0.6,5,2,1032,6,1038,7,FALSE
nexus-parser,1.0.6,1.0.8,6,1,1029,6,1035,6,FALSE
nexus-parser,1.0.1,1.0.2,1,3,104,142,246,9,FALSE
nexus-parser,1.0.2,1.0.3,2,1,2,1,3,1,FALSE
nexus-parser,1.0.3,1.0.4,3,1,2,1,3,1,FALSE
nexus-parser,1.0.5,1.0.6,5,2,1032,6,1038,7,TRUE
nexus-parser,1.0.6,1.0.8,6,1,1029,6,1035,6,TRUE
steamcommunity,1.0.4,1.0.5,6,2,5,1,6,2,FALSE
steamcommunity,1.0.5,1.0.6,7,2,2,2,4,2,FALSE
steamcommunity,1.0.6,1.0.7,8,3,50,1,51,3,FALSE
steamcommunity,1.0.7,1.0.8,9,2,4,2,6,2,FALSE
steamcommunity,1.0.0,1.0.1,2,2,2,2,4,2,FALSE
steamcommunity,1.0.1,1.0.2,3,5,234,5,239,6,FALSE
steamcommunity,1.0.2,1.0.3,4,2,34,1,35,2,FALSE
steamcommunity,1.0.3,1.0.4,5,2,24,1,25,2,FALSE
steamcommunity,1.0.8,2.0.0,10,2,5,4,9,2,FALSE
steamcommunity,3.1.1,3.2.0,23,4,190,16,206,5,FALSE
steamcommunity,3.1.0,3.1.1,22,2,2,2,4,2,FALSE
steamcommunity,3.9.0,3.9.1,39,2,3,3,6,2,FALSE
steamcommunity,3.10.0,3.11.0,50,2,109,3,112,3,FALSE
steamcommunity,3.12.2,3.13.0,53,3,9,2,11,3,FALSE
steamcommunity,3.18.0,3.18.1,64,2,3,3,6,2,FALSE
steamcommunity,3.18.1,3.18.2,65,3,10,10,20,4,FALSE
steamcommunity,3.18.2,3.18.3,66,2,2,7,9,2,FALSE
steamcommunity,3.18.3,3.18.4,67,3,9,12,21,3,FALSE
steamcommunity,3.18.4,3.18.5,68,2,2,2,4,2,FALSE
steamcommunity,3.18.5,3.18.6,69,7,32,43,75,7,FALSE
steamcommunity,3.18.6,3.18.7,70,5,106,37,143,5,FALSE
steamcommunity,3.18.7,3.19.0-beta1,71,3,164,83,247,17,FALSE
steamcommunity,3.5.2,3.6.0,33,4,179,3,182,4,FALSE
steamcommunity,3.5.1,3.5.2,32,2,5,2,7,3,TRUE
steamcommunity,3.5.0,3.5.1,31,2,5,5,10,2,FALSE
steamcommunity,3.7.1,3.7.2,36,2,9,4,13,2,FALSE
steamcommunity,3.7.0,3.7.1,35,2,13,10,23,2,FALSE
steamcommunity,3.7.2,3.8.0,37,5,168,4,172,7,FALSE
steamcommunity,3.0.0,3.1.0,21,2,6,2,8,2,FALSE
steamcommunity,3.23.2,3.23.3,96,2,3,3,6,2,FALSE
steamcommunity,3.23.3,3.24.0,97,4,96,56,152,4,FALSE
steamcommunity,3.23.0,3.23.1,94,2,18,2,20,2,FALSE
steamcommunity,3.23.1,3.23.2,95,2,11,5,16,2,FALSE
steamcommunity,3.14.0,3.14.1,55,3,3,3,6,3,FALSE
steamcommunity,3.14.1,3.14.159,56,2,23,7,30,2,FALSE
steamcommunity,3.17.2,3.18.0,63,7,550,78,628,17,FALSE
steamcommunity,3.17.1,3.17.2,62,3,7,3,10,3,FALSE
steamcommunity,3.17.0,3.17.1,61,4,6,17,23,4,FALSE
steamcommunity,3.16.0,3.17.0,60,8,145,52,197,8,FALSE
steamcommunity,3.11.1,3.12.2,52,13,441,64,505,19,FALSE
steamcommunity,3.11.0,3.11.1,51,2,8,1,9,2,FALSE
steamcommunity,3.13.0,3.14.0,54,5,62,8,70,5,FALSE
steamcommunity,3.19.10,3.20.0,88,4,144,20,164,6,FALSE
steamcommunity,3.19.5,3.19.6,83,3,71,2,73,3,FALSE
steamcommunity,3.19.4,3.19.5,82,2,2,2,4,2,FALSE
steamcommunity,3.19.7,3.19.8,85,2,2,2,4,2,FALSE
steamcommunity,3.19.6,3.19.7,84,3,34,15,49,4,FALSE
steamcommunity,3.19.1,3.19.2,79,4,13,10,23,4,FALSE
steamcommunity,3.19.0,3.19.1,78,2,7,6,13,2,FALSE
steamcommunity,3.19.3,3.19.4,81,3,3,3,6,3,FALSE
steamcommunity,3.19.2,3.19.3,80,4,63,14,77,5,FALSE
steamcommunity,3.30.6,3.30.7,112,5,23,11,34,5,FALSE
steamcommunity,3.30.4,3.30.5,110,3,3,3,6,3,FALSE
steamcommunity,3.30.5,3.30.6,111,2,2,2,4,2,FALSE
steamcommunity,3.30.2,3.30.3,108,4,10,4,14,4,FALSE
steamcommunity,3.19.8,3.19.9,86,2,2,2,4,2,FALSE
steamcommunity,3.30.0,3.30.1,106,2,7,1,8,2,FALSE
steamcommunity,3.30.1,3.30.2,107,3,11,1,12,3,FALSE
steamcommunity,3.4.0,3.5.0,30,5,424,220,644,10,FALSE
steamcommunity,3.14.1593,3.15.0,58,3,11,2,13,3,FALSE
steamcommunity,3.6.0,3.7.0,34,3,213,107,320,6,FALSE
steamcommunity,2.0.0,2.1.0,11,2,24,24,48,4,FALSE
steamcommunity,3.25.0,3.26.0,99,4,44,39,83,4,FALSE
steamcommunity,2.2.1,2.3.0,14,4,139,6,145,5,FALSE
steamcommunity,2.2.0,2.2.1,13,2,12,16,28,2,FALSE
steamcommunity,3.22.0,3.23.0,93,4,41,8,49,4,FALSE
steamcommunity,3.27.2,3.28.0,104,4,5,47,52,4,FALSE
steamcommunity,3.27.0,3.27.1,102,3,7,1,8,3,FALSE
steamcommunity,3.27.1,3.27.2,103,2,2,2,4,2,FALSE
steamcommunity,3.21.0,3.21.1,90,2,10,4,14,2,FALSE
steamcommunity,3.21.1,3.21.2,91,3,6,5,11,3,FALSE
steamcommunity,3.21.2,3.22.0,92,4,79,8,87,7,FALSE
steamcommunity,3.15.0,3.16.0,59,6,48,10,58,6,FALSE
steamcommunity,3.30.3,3.30.4,109,3,20,2,22,3,FALSE
steamcommunity,2.5.0,2.5.1,17,2,4,1,5,2,FALSE
steamcommunity,3.19.0-beta2,3.19.0-beta3,73,3,79,141,220,14,FALSE
steamcommunity,3.19.0-beta3,3.19.0-beta4,74,3,37,21,58,3,FALSE
steamcommunity,3.9.9,3.9.10,48,3,3,1,4,3,FALSE
steamcommunity,3.9.8,3.9.9,47,3,3,3,6,3,FALSE
steamcommunity,3.19.0-beta6,3.19.0,77,5,34,4,38,7,FALSE
steamcommunity,3.19.0-beta4,3.19.0-beta5,75,2,6,2,8,2,FALSE
steamcommunity,3.19.0-beta5,3.19.0-beta6,76,2,10,2,12,2,FALSE
steamcommunity,3.9.3,3.9.4,42,2,28,16,44,2,FALSE
steamcommunity,3.9.2,3.9.3,41,2,2,1,3,2,FALSE
steamcommunity,3.9.1,3.9.2,40,2,5,1,6,2,FALSE
steamcommunity,2.4.0,2.5.0,16,2,85,1,86,3,FALSE
steamcommunity,3.9.7,3.9.8,46,2,2,2,4,2,FALSE
steamcommunity,3.9.6,3.9.7,45,2,4,4,8,2,FALSE
steamcommunity,3.9.5,3.9.6,44,2,2,2,4,2,FALSE
steamcommunity,3.9.4,3.9.5,43,5,20,20,40,5,FALSE
steamcommunity,2.6.0,3.0.0,20,4,89,74,163,9,FALSE
steamcommunity,3.3.1,3.3.2,27,2,5,1,6,2,FALSE
steamcommunity,3.3.0,3.3.1,26,2,9,8,17,5,FALSE
steamcommunity,3.3.3,3.4.0,29,5,57,5,62,8,FALSE
steamcommunity,3.3.2,3.3.3,28,2,2,1,3,2,FALSE
steamcommunity,3.28.0,3.30.0,105,15,259,92,351,17,FALSE
steamcommunity,3.24.0,3.25.0,98,3,32,20,52,5,FALSE
steamcommunity,3.26.1,3.27.0,101,4,61,6,67,4,FALSE
steamcommunity,3.26.0,3.26.1,100,2,4,1,5,2,FALSE
steamcommunity,2.1.0,2.2.0,12,7,264,6,270,8,FALSE
steamcommunity,3.20.0,3.21.0,89,3,76,46,122,4,FALSE
steamcommunity,2.3.0,2.4.0,15,2,4,3,7,2,FALSE
steamcommunity,3.14.159,3.14.1593,57,3,99,2,101,3,FALSE
steamcommunity,2.5.2,2.6.0,19,3,19,3,22,3,FALSE
steamcommunity,3.8.0,3.9.0,38,3,153,8,161,5,FALSE
steamcommunity,2.5.1,2.5.2,18,2,3,1,4,2,FALSE
steamcommunity,3.9.10,3.10.0,49,4,79,17,96,7,FALSE
steamcommunity,3.19.0-beta1,3.19.0-beta2,72,2,61,56,117,16,FALSE
steamcommunity,3.2.0,3.2.1,24,2,35,10,45,2,FALSE
steamcommunity,3.2.1,3.3.0,25,2,16,1,17,2,FALSE
steamcommunity,3.19.9,3.19.10,87,3,17,7,24,3,FALSE
steamcommunity,3.5.1,3.5.2,32,2,5,2,7,3,FALSE
steamcommunity,3.21.2,3.22.0,92,4,79,8,87,7,TRUE
steamcommunity,0.1.0,1.0.0,1,18,398,113,511,20,FALSE
steamcommunity,3.9.7,3.9.8,46,2,2,2,4,2,TRUE
node-red-contrib-pubnub,4.0.1,4.0.2,5,1,32,36,68,3,FALSE
node-red-contrib-pubnub,4.0.0,4.0.1,4,2,2270,3,2273,3,FALSE
node-red-contrib-pubnub,4.0.1,4.0.2,5,1,32,36,68,3,TRUE
react-state-validation-stlk,0.1.0,0.1.1,1,1,36,5,41,3,FALSE
react-state-validation-stlk,0.1.1,0.1.2,2,1,31,18,49,4,FALSE
react-state-validation-stlk,0.1.2,0.1.3,3,1,31,18,49,4,TRUE
react-state-validation-stlk,0.1.3,0.1.4,4,1,31,18,49,4,FALSE
react-state-validation-stlk,0.1.4,0.1.5,5,6,46,11,57,8,FALSE
react-state-validation-stlk,0.1.5,0.1.6,6,1,31,18,49,4,FALSE
react-state-validation-stlk,0.1.2,0.1.3,3,1,31,18,49,4,FALSE
br-bid,0.0.15,0.0.16,15,2,55,29,84,4,FALSE
br-bid,0.0.14,0.0.15,14,1,58,21,79,6,FALSE
br-bid,0.0.17,0.1.0,17,1,69,2,71,2,FALSE
br-bid,0.0.16,0.0.17,16,2,2,2,4,2,FALSE
br-bid,0.0.11,0.0.12,11,1,494,126,620,8,FALSE
br-bid,0.0.10,0.0.11,10,3,6,4,10,4,FALSE
br-bid,0.0.13,0.0.14,13,1,32,10,42,2,FALSE
br-bid,0.0.12,0.0.13,12,1,15,9,24,35,FALSE
br-bid,0.1.0,0.1.1,18,1,3,2,5,1,FALSE
br-bid,0.1.1,0.1.2,19,2,159,75,234,6,FALSE
br-bid,0.1.2,0.1.3,20,2,201,288,489,5,FALSE
br-bid,0.1.3,0.1.4,21,3,553,235,788,14,FALSE
br-bid,0.1.4,0.1.5,22,2,52,44,96,5,FALSE
br-bid,0.1.5,0.1.6,23,1,293,138,431,2,FALSE
br-bid,0.1.6,0.1.7,24,1,20,8,28,2,FALSE
br-bid,0.1.7,0.1.8,25,1,7,2,9,2,FALSE
br-bid,0.0.5,0.0.6,5,3,78,74,152,15,FALSE
br-bid,0.0.4,0.0.5,4,6,126,74,200,25,FALSE
br-bid,0.0.7,0.0.8,7,1,59,193,252,10,FALSE
br-bid,0.0.6,0.0.7,6,3,737,69,806,40,FALSE
br-bid,0.0.3,0.0.4,3,1,101,39,140,11,FALSE
br-bid,0.0.9,0.0.10,9,1,825,172,997,8,FALSE
br-bid,0.0.8,0.0.9,8,2,155,5,160,4,FALSE
br-bid,0.1.12,0.1.13,30,1,89,21,110,4,FALSE
br-bid,0.1.13,1.0.0,31,4,855,869,1724,27,FALSE
br-bid,0.1.10,0.1.11,28,1,490,372,862,7,FALSE
br-bid,0.1.11,0.1.12,29,1,134,263,397,3,FALSE
br-bid,0.1.9,0.1.10,27,1,10,2,12,2,FALSE
br-bid,0.1.8,0.1.9,26,1,8,4,12,2,FALSE
br-bid,0.0.1,0.0.2,1,1,28,70,98,10,FALSE
br-bid,0.0.2,0.0.3,2,3,442,244,686,36,FALSE
br-bid,0.1.0,0.1.1,18,1,3,2,5,1,TRUE
br-bid,0.1.1,0.1.2,19,2,159,75,234,6,TRUE
br-bid,0.1.12,0.1.13,30,1,89,21,110,4,TRUE
br-bid,0.0.6,0.0.7,6,3,737,69,806,40,TRUE
graphql-tracer,0.2.4,0.2.5,7,4,91,29,120,5,FALSE
graphql-tracer,0.2.3,0.2.4,6,2,2,2,4,2,FALSE
graphql-tracer,0.2.2,0.2.3,5,2,29,2,31,3,FALSE
graphql-tracer,0.2.1,0.2.2,4,2,2,1,3,2,FALSE
graphql-tracer,0.2.0,0.2.1,3,1,1,1,2,1,FALSE
graphql-tracer,0.1.4,0.1.5,1,3,13,2,15,3,FALSE
graphql-tracer,0.1.5,0.2.0,2,2,22,4,26,3,FALSE
graphql-tracer,0.2.3,0.2.4,6,2,2,2,4,2,TRUE
graphql-tracer,0.2.4,0.2.5,7,4,91,29,120,5,TRUE
graphql-tracer,0.1.4,0.1.5,1,3,13,2,15,3,TRUE
react-swipeable-views,0.3.2,0.3.3,14,5,107,71,178,12,FALSE
react-swipeable-views,0.3.3,0.3.4,15,4,23,23,46,5,FALSE
react-swipeable-views,0.3.0,0.3.1,12,17,267,103,370,30,FALSE
react-swipeable-views,0.3.1,0.3.2,13,3,3,1,4,3,FALSE
react-swipeable-views,0.3.4,0.3.5,16,10,94,44,138,14,FALSE
react-swipeable-views,0.2.3,0.3.0,11,12,98,59,157,19,FALSE
react-swipeable-views,0.2.2,0.2.3,10,3,3,3,6,3,FALSE
react-swipeable-views,0.2.1,0.2.2,9,2,58,13,71,5,FALSE
react-swipeable-views,0.2.0,0.2.1,8,2,3,1,4,2,FALSE
react-swipeable-views,0.1.5,0.1.6,6,4,43,10,53,5,FALSE
react-swipeable-views,0.1.6,0.2.0,7,2,11,10,21,3,FALSE
react-swipeable-views,0.10.1,0.10.2,58,5,17,7,24,7,FALSE
react-swipeable-views,0.10.0,0.10.1,57,1,9,9,18,5,FALSE
react-swipeable-views,0.10.3,0.10.4,60,7,13,15,28,8,FALSE
react-swipeable-views,0.10.2,0.10.3,59,3,139,155,294,12,FALSE
react-swipeable-views,0.10.5,0.10.6,62,5,116,62,178,12,FALSE
react-swipeable-views,0.10.4,0.10.5,61,6,783,92,875,32,FALSE
react-swipeable-views,0.10.7,0.10.8,64,11,249,53,302,27,FALSE
react-swipeable-views,0.7.9,0.7.10,47,3,90,53,143,6,FALSE
react-swipeable-views,0.7.6,0.7.7,44,9,459,75,534,23,FALSE
react-swipeable-views,0.10.8,0.11.0,65,9,188,143,331,26,FALSE
react-swipeable-views,0.11.0,0.11.1,66,5,107,83,190,31,FALSE
react-swipeable-views,0.11.1,0.11.2,67,5,260,106,366,12,FALSE
react-swipeable-views,0.11.2,0.12.0,68,8,6838,84,6922,43,FALSE
react-swipeable-views,0.12.2,0.12.3,71,3,12,12,24,4,FALSE
react-swipeable-views,0.12.1,0.12.2,70,7,503,375,878,17,FALSE
react-swipeable-views,0.12.0,0.12.1,69,6,1674,385,2059,21,FALSE
react-swipeable-views,0.9.0,0.9.1,53,5,512,373,885,81,FALSE
react-swipeable-views,0.9.1,0.9.2,54,2,19,11,30,11,FALSE
react-swipeable-views,0.9.2,0.9.3,55,3,78,17,95,13,FALSE
react-swipeable-views,0.9.3,0.10.0,56,11,527,416,943,47,FALSE
react-swipeable-views,0.7.10,0.7.11,48,7,332,337,669,64,FALSE
react-swipeable-views,0.7.11,0.8.0,49,12,394,376,770,39,FALSE
react-swipeable-views,0.8.1,0.8.3,51,16,325,136,461,46,FALSE
react-swipeable-views,0.8.0,0.8.1,50,7,195,85,280,28,FALSE
react-swipeable-views,0.8.3,0.9.0,52,6,308,178,486,70,FALSE
react-swipeable-views,0.7.8,0.7.9,46,3,37,25,62,5,FALSE
react-swipeable-views,0.10.6,0.10.7,63,4,24,4,28,5,FALSE
react-swipeable-views,0.7.7,0.7.8,45,2,11,7,18,2,FALSE
react-swipeable-views,0.7.2,0.7.3,40,5,401,99,500,19,FALSE
react-swipeable-views,0.7.4,0.7.5,42,2,1,2,3,2,FALSE
react-swipeable-views,0.7.5,0.7.6,43,2,2,1,3,2,FALSE
react-swipeable-views,0.7.3,0.7.4,41,11,1018,162,1180,56,FALSE
react-swipeable-views,0.7.1,0.7.2,39,6,235,67,302,12,FALSE
react-swipeable-views,0.12.1,0.12.2,70,7,503,375,878,17,TRUE
react-swipeable-views,0.4.1,0.4.2,20,2,5,6,11,3,FALSE
react-swipeable-views,0.4.0,0.4.1,19,6,129,114,243,12,FALSE
react-swipeable-views,0.4.3,0.4.4,22,1,30,21,51,1,FALSE
react-swipeable-views,0.4.2,0.4.3,21,5,31,25,56,7,FALSE
react-swipeable-views,0.4.5,0.4.6,24,5,50,33,83,8,FALSE
react-swipeable-views,0.4.4,0.4.5,23,3,10,11,21,3,FALSE
react-swipeable-views,0.7.0,0.7.1,38,3,345,145,490,23,TRUE
react-swipeable-views,0.7.10,0.7.11,48,7,332,337,669,64,TRUE
react-swipeable-views,0.7.5,0.7.6,43,2,2,1,3,2,TRUE
react-swipeable-views,0.8.0,0.8.1,50,7,195,85,280,28,TRUE
react-swipeable-views,0.6.5,0.7.0,37,5,247,106,353,27,TRUE
react-swipeable-views,0.3.6,0.4.0,18,12,262,205,467,26,FALSE
react-swipeable-views,0.6.4,0.6.5,36,2,167,22,189,48,FALSE
react-swipeable-views,0.1.4,0.1.5,5,6,12,7,19,8,FALSE
react-swipeable-views,0.6.3,0.6.4,35,11,313,200,513,35,FALSE
react-swipeable-views,0.6.0,0.6.1,32,8,48,46,94,10,FALSE
react-swipeable-views,0.6.5,0.7.0,37,5,247,106,353,27,FALSE
react-swipeable-views,0.3.5,0.3.6,17,12,61,80,141,21,FALSE
react-swipeable-views,0.5.4,0.6.0,31,18,354,286,640,36,FALSE
react-swipeable-views,0.5.0,0.5.1,27,3,11,3,14,3,FALSE
react-swipeable-views,0.5.1,0.5.2,28,5,1246,524,1770,29,FALSE
react-swipeable-views,0.5.2,0.5.3,29,2,3,3,6,2,FALSE
react-swipeable-views,0.4.6,0.4.7,25,9,6688,1221,7909,128,FALSE
react-swipeable-views,0.7.0,0.7.1,38,3,345,145,490,23,FALSE
react-swipeable-views,0.4.7,0.5.0,26,16,1105,697,1802,68,FALSE
react-swipeable-views,0.6.2,0.6.3,34,20,469,340,809,70,FALSE
react-swipeable-views,0.5.3,0.5.4,30,9,316,84,400,24,FALSE
react-swipeable-views,0.6.1,0.6.2,33,2,11,16,27,3,FALSE
react-swipeable-views,0.5.3,0.5.4,30,9,316,84,400,24,TRUE
react-swipeable-views,0.4.5,0.4.6,24,5,50,33,83,8,TRUE
react-swipeable-views,0.7.11,0.8.0,49,12,394,376,770,39,TRUE
react-swipeable-views,0.7.8,0.7.9,46,3,37,25,62,5,TRUE
react-swipeable-views,0.3.6,0.4.0,18,12,262,205,467,26,TRUE
react-swipeable-views,0.8.1,0.8.3,51,16,325,136,461,46,TRUE
react-swipeable-views,0.7.7,0.7.8,45,2,11,7,18,2,TRUE
react-swipeable-views,0.4.2,0.4.3,21,5,31,25,56,7,TRUE
react-swipeable-views,0.3.2,0.3.3,14,5,107,71,178,12,TRUE
react-swipeable-views,0.7.3,0.7.4,41,11,1018,162,1180,56,TRUE
react-swipeable-views,0.1.5,0.1.6,6,4,43,10,53,5,TRUE
react-swipeable-views,0.4.6,0.4.7,25,9,6688,1221,7909,128,TRUE
react-swipeable-views,0.2.1,0.2.2,9,2,58,13,71,5,TRUE
react-swipeable-views,0.7.9,0.7.10,47,3,90,53,143,6,TRUE
react-swipeable-views,0.1.1,0.1.2,2,1,3,2,5,1,FALSE
react-swipeable-views,0.1.2,0.1.3,3,1,4,1,5,2,FALSE
react-swipeable-views,0.1.3,0.1.4,4,14,678,70,748,32,FALSE
react-swipeable-views,0.6.3,0.6.4,35,11,313,200,513,35,TRUE
react-swipeable-views,0.6.2,0.6.3,34,20,469,340,809,70,TRUE
react-swipeable-views,0.2.3,0.3.0,11,12,98,59,157,19,TRUE
react-swipeable-views,0.6.4,0.6.5,36,2,167,22,189,48,TRUE
react-swipeable-views,0.7.6,0.7.7,44,9,459,75,534,23,TRUE
react-swipeable-views,0.7.1,0.7.2,39,6,235,67,302,12,TRUE
react-swipeable-views,0.1.4,0.1.5,5,6,12,7,19,8,TRUE
bip-pod,0.4.11,0.4.12,94,1,38,1,39,2,FALSE
bip-pod,0.3.8,0.3.9,72,1,29,27,56,2,FALSE
bip-pod,0.3.9,0.3.10,73,2,6,10,16,2,FALSE
bip-pod,0.3.2,0.3.3,66,3,14,3,17,4,FALSE
bip-pod,0.3.3,0.3.4,67,1,18,5,23,2,FALSE
bip-pod,0.3.0,0.3.1,64,1,5,5,10,2,FALSE
bip-pod,0.3.1,0.3.2,65,1,5,1,6,2,FALSE
bip-pod,0.3.6,0.3.7,70,1,2,2,4,2,FALSE
bip-pod,0.3.7,0.3.8,71,1,3,3,6,2,FALSE
bip-pod,0.3.4,0.3.5,68,1,2,2,4,2,FALSE
bip-pod,0.3.5,0.3.6,69,1,2,2,4,2,FALSE
bip-pod,0.3.18,0.3.19,81,1,3,3,6,2,FALSE
bip-pod,0.3.19,0.3.20,82,1,2,2,4,2,FALSE
bip-pod,0.3.14,0.3.15,78,1,25,16,41,3,FALSE
bip-pod,0.3.15,0.3.16,79,3,99,28,127,4,FALSE
bip-pod,0.3.16,0.3.18,80,11,91,78,169,14,FALSE
bip-pod,0.3.10,0.3.11,74,1,3,3,6,2,FALSE
bip-pod,0.3.11,0.3.12,75,3,51,80,131,4,FALSE
bip-pod,0.3.12,0.3.13,76,1,5,1,6,2,FALSE
bip-pod,0.3.13,0.3.14,77,1,134,6,140,3,FALSE
bip-pod,0.2.45,0.2.46,61,1,24,85,109,2,FALSE
bip-pod,0.2.46,0.2.47,62,1,7,1,8,2,FALSE
bip-pod,0.2.47,0.3.0,63,57,2281,1596,3877,88,FALSE
bip-pod,0.2.40,0.2.41,58,1,56,30,86,2,FALSE
bip-pod,0.2.41,0.2.42,59,1,27,7,34,2,FALSE
bip-pod,0.2.42,0.2.45,60,4,64,15,79,7,FALSE
bip-pod,0.2.26,0.2.27,45,1,15,14,29,6,FALSE
bip-pod,0.2.27,0.2.29,46,2,12,12,24,5,FALSE
bip-pod,0.2.25,0.2.26,44,1,37,17,54,2,FALSE
bip-pod,0.2.22,0.2.23,42,1,8,4,12,2,FALSE
bip-pod,0.2.23,0.2.25,43,2,51,8,59,4,FALSE
bip-pod,0.2.20,0.2.21,40,1,3,5,8,2,FALSE
bip-pod,0.2.21,0.2.22,41,1,42,13,55,2,FALSE
bip-pod,0.2.37,0.2.38,55,1,1,1,2,1,FALSE
bip-pod,0.2.29,0.2.30,47,1,15,2,17,2,FALSE
bip-pod,0.2.36,0.2.37,54,1,38,3,41,2,FALSE
bip-pod,0.2.31,0.2.32,49,2,7,7,14,4,FALSE
bip-pod,0.2.30,0.2.31,48,1,29,22,51,2,FALSE
bip-pod,0.2.33,0.2.34,51,3,175,7,182,4,FALSE
bip-pod,0.2.32,0.2.33,50,4,45,38,83,5,FALSE
bip-pod,0.2.35,0.2.36,53,3,19,10,29,4,FALSE
bip-pod,0.4.10,0.4.11,93,1,8,3,11,2,FALSE
bip-pod,0.4.13,0.4.14,96,1,8,7,15,2,FALSE
bip-pod,0.4.12,0.4.13,95,5,48,9,57,5,FALSE
bip-pod,0.4.15,0.4.16,98,1,33,21,54,2,FALSE
bip-pod,0.4.14,0.4.15,97,1,3,3,6,2,FALSE
bip-pod,0.4.17,0.4.18,100,1,8,4,12,2,FALSE
bip-pod,0.4.16,0.4.17,99,1,16,5,21,2,FALSE
bip-pod,0.4.19,0.4.20,102,1,2,2,4,2,FALSE
bip-pod,0.4.18,0.4.19,101,1,38,2,40,2,FALSE
bip-pod,0.2.39,0.2.40,57,2,25,22,47,3,FALSE
bip-pod,0.2.38,0.2.39,56,2,66,4,70,4,FALSE
bip-pod,0.4.20,0.4.21,103,1,21,32,53,2,FALSE
bip-pod,0.4.21,0.5.0,104,2,452,1406,1858,14,FALSE
bip-pod,0.0.10,0.1.0,10,1,70,28,98,2,FALSE
bip-pod,0.4.9,0.4.10,92,1,33,22,55,2,FALSE
bip-pod,0.4.8,0.4.9,91,1,1,1,2,1,FALSE
bip-pod,0.4.1,0.4.2,85,1,13,5,18,2,FALSE
bip-pod,0.4.0,0.4.1,84,2,13,4,17,2,FALSE
bip-pod,0.4.3,0.4.4,87,1,2,2,4,2,FALSE
bip-pod,0.4.2,0.4.3,86,2,28,2,30,2,FALSE
bip-pod,0.4.4,0.4.6,88,6,60,49,109,7,FALSE
bip-pod,0.4.7,0.4.8,90,1,266,131,397,5,FALSE
bip-pod,0.4.6,0.4.7,89,1,8,6,14,2,FALSE
bip-pod,0.2.19,0.2.20,39,1,6,7,13,5,FALSE
bip-pod,0.2.18,0.2.19,38,1,14,6,20,2,FALSE
bip-pod,0.2.17,0.2.18,37,1,10,10,20,2,FALSE
bip-pod,0.2.16,0.2.17,36,1,1,1,2,1,FALSE
bip-pod,0.2.15,0.2.16,35,1,69,23,92,2,FALSE
bip-pod,0.2.14,0.2.15,34,1,41,12,53,2,FALSE
bip-pod,0.2.13,0.2.14,33,2,16,6,22,3,FALSE
bip-pod,0.2.12,0.2.13,32,1,3,3,6,2,FALSE
bip-pod,0.2.11,0.2.12,31,1,7,2,9,2,FALSE
bip-pod,0.2.10,0.2.11,30,1,1,1,2,1,FALSE
bip-pod,0.2.6,0.2.8,27,1,26,3,29,2,FALSE
bip-pod,0.1.8,0.1.9,19,1,15,5,20,2,FALSE
bip-pod,0.1.9,0.2.0,20,1,69,30,99,2,FALSE
bip-pod,0.2.5,0.2.6,26,1,73,16,89,2,FALSE
bip-pod,0.2.4,0.2.5,25,1,40,39,79,2,FALSE
bip-pod,0.2.3,0.2.4,24,1,9,2,11,2,TRUE
bip-pod,0.2.2,0.2.3,23,1,53,20,73,4,FALSE
bip-pod,0.2.1,0.2.2,22,5,21,15,36,7,FALSE
bip-pod,0.2.0,0.2.1,21,1,107,82,189,5,FALSE
bip-pod,0.1.0,0.1.1,11,1,36,77,113,2,FALSE
bip-pod,0.1.1,0.1.2,12,1,2,2,4,2,FALSE
bip-pod,0.1.2,0.1.3,13,1,33,24,57,2,FALSE
bip-pod,0.1.3,0.1.4,14,1,17,4,21,3,FALSE
bip-pod,0.1.4,0.1.5,15,1,2,4,6,3,FALSE
bip-pod,0.1.5,0.1.6,16,1,762,743,1505,2,FALSE
bip-pod,0.1.6,0.1.7,17,1,10,1,11,2,FALSE
bip-pod,0.2.8,0.2.9,28,1,13,3,16,2,FALSE
bip-pod,0.0.5,0.0.6,5,2,851,2,853,8,FALSE
bip-pod,0.0.4,0.0.5,4,1,12,7,19,2,FALSE
bip-pod,0.0.7,0.0.8,7,1,1,1,2,1,FALSE
bip-pod,0.0.6,0.0.7,6,1,29,24,53,2,FALSE
bip-pod,0.0.1,0.0.2,1,1,6,6,12,1,FALSE
bip-pod,0.0.3,0.0.4,3,1,4,5,9,1,FALSE
bip-pod,0.0.2,0.0.3,2,6,71,59,130,7,FALSE
bip-pod,0.0.9,0.0.10,9,1,85,13,98,2,FALSE
bip-pod,0.0.8,0.0.9,8,1,12,7,19,2,FALSE
bip-pod,0.2.9,0.2.10,29,1,3,3,6,2,FALSE
bip-pod,0.1.7,0.1.8,18,1,101,32,133,3,FALSE
bip-pod,0.2.34,0.2.35,52,1,10,2,12,2,FALSE
bip-pod,0.3.20,0.4.0,83,12,474,219,693,13,FALSE
bip-pod,0.2.3,0.2.4,24,1,9,2,11,2,FALSE
bip-pod,0.0.9,0.0.10,9,1,85,13,98,2,TRUE
bip-pod,0.3.20,0.4.0,83,12,474,219,693,13,TRUE
bip-pod,0.2.21,0.2.22,41,1,42,13,55,2,TRUE
bip-pod,0.4.14,0.4.15,97,1,3,3,6,2,TRUE
bip-pod,0.4.3,0.4.4,87,1,2,2,4,2,TRUE
bip-pod,0.3.5,0.3.6,69,1,2,2,4,2,TRUE
bip-pod,0.4.10,0.4.11,93,1,8,3,11,2,TRUE
google-trends-api,1.0.4,1.1.0,5,17,1145,384,1529,65,FALSE
google-trends-api,1.1.0,1.1.1,6,10,106,98,204,55,FALSE
google-trends-api,1.1.3,1.1.4,8,3,5,5,10,3,FALSE
google-trends-api,1.0.0,1.0.1,1,2,11,3,14,3,FALSE
google-trends-api,1.0.1,1.0.2,2,2,4,4,8,2,FALSE
google-trends-api,1.0.2,1.0.3,3,2,8,5,13,3,FALSE
google-trends-api,1.0.3,1.0.4,4,3,21,5,26,4,FALSE
google-trends-api,2.1.0,3.0.0,21,10,480,138,618,32,FALSE
google-trends-api,1.1.4,1.1.5,9,7,21,21,42,9,FALSE
google-trends-api,3.0.0,3.0.1,22,8,1013,332,1345,19,FALSE
google-trends-api,3.0.1,3.0.2,23,12,46045,1111,47156,96,FALSE
google-trends-api,1.1.5,1.2.0,10,25,413,69,482,62,FALSE
google-trends-api,1.1.1,1.1.3,7,8,1483,1467,2950,76,FALSE
google-trends-api,1.2.6,1.2.7,17,2,2,2,4,2,FALSE
google-trends-api,1.2.7,1.3.0,18,7,910,40,950,27,FALSE
google-trends-api,1.2.4,1.2.5,15,2,3,2,5,2,FALSE
google-trends-api,1.2.5,1.2.6,16,2,20,1,21,2,FALSE
google-trends-api,1.2.2,1.2.3,13,4,4,4,8,4,FALSE
google-trends-api,1.2.3,1.2.4,14,2,11,7,18,2,FALSE
google-trends-api,1.2.0,1.2.1,11,8,1799,13,1812,16,FALSE
google-trends-api,1.2.1,1.2.2,12,2,2,2,4,2,FALSE
google-trends-api,2.0.0,2.1.0,20,11,556,212,768,46,FALSE
google-trends-api,1.3.0,2.0.0,19,23,3278,3732,7010,79,FALSE
google-trends-api,1.1.0,1.1.1,6,10,106,98,204,55,TRUE
google-trends-api,4.0.1,4.0.2,26,3,63,73,136,13,FALSE
google-trends-api,4.0.0,4.0.1,25,3,11,230,241,6,FALSE
google-trends-api,4.0.3,4.1.0,28,36,891,2125,3016,134,FALSE
google-trends-api,4.0.2,4.0.3,27,1,1,1,2,1,FALSE
google-trends-api,3.0.2,4.0.0,24,27,4947,53135,58082,207,FALSE
google-trends-api,1.1.3,1.1.4,8,3,5,5,10,3,TRUE
google-trends-api,1.2.3,1.2.4,14,2,11,7,18,2,TRUE
fade-props,0.1.0,0.2.0,1,4,23,3,26,6,FALSE
fade-props,0.2.0,1.0.0,2,4,160,50,210,8,FALSE
fade-props,0.1.0,0.2.0,1,4,23,3,26,6,TRUE
flarej,0.1.4-rc.6,0.1.4-rc.7,104,1,1,1,2,1,FALSE
flarej,0.1.4-rc.5,0.1.4-rc.6,103,1,1,1,2,1,FALSE
flarej,0.1.4-rc.4,0.1.4-rc.5,102,1,681,1389,2070,6,FALSE
flarej,0.1.4-rc.3,0.1.4-rc.4,101,1,1573,810,2383,8,FALSE
flarej,0.1.4-rc.2,0.1.4-rc.3,100,1,7,7,14,5,FALSE
flarej,0.1.4-rc.1,0.1.4-rc.2,99,1,66,50,116,5,FALSE
flarej,0.1.3-rc.48,0.1.3,97,1,1,1,2,1,FALSE
flarej,0.1.3,0.1.4-rc.1,98,1,22,21,43,6,FALSE
flarej,0.1.3-rc.47,0.1.3-rc.48,96,1,1,1,2,1,FALSE
flarej,0.1.3-rc.46,0.1.3-rc.47,95,1,664,459,1123,12,FALSE
flarej,0.1.3-rc.5,0.1.3-rc.6,55,1,6,6,12,3,FALSE
flarej,0.1.2-rc.19,0.1.2-rc.20,41,1,7,7,14,5,FALSE
flarej,0.1.2-rc.18,0.1.2-rc.19,40,1,237,99,336,6,FALSE
flarej,0.1.3-rc.38,0.1.3-rc.39,88,1,149,151,300,5,FALSE
flarej,0.1.3-rc.39,0.1.3-rc.40,89,1,10,10,20,5,FALSE
flarej,0.1.3-rc.36,0.1.3-rc.37,86,1,1,1,2,1,FALSE
flarej,0.1.3-rc.37,0.1.3-rc.38,87,3,47,152,199,6,FALSE
flarej,0.1.3-rc.34,0.1.3-rc.35,84,1,150,150,300,5,TRUE
flarej,0.1.3-rc.35,0.1.3-rc.36,85,1,151,48,199,5,FALSE
flarej,0.1.2-rc.11,0.1.2-rc.12,33,1,148,118,266,8,FALSE
flarej,0.1.3-rc.33,0.1.3-rc.34,83,1,43,146,189,4,FALSE
flarej,0.1.3-rc.30,0.1.3-rc.31,80,1,1,1,2,1,FALSE
flarej,0.1.3-rc.31,0.1.3-rc.32,81,1,274,247,521,5,FALSE
flarej,0.1.3-rc.14,0.1.3-rc.15,64,1,27,34,61,5,FALSE
flarej,0.1.3-rc.15,0.1.3-rc.16,65,3,1909,510,2419,19,FALSE
flarej,0.1.3-rc.16,0.1.3-rc.17,66,1,238,135,373,5,FALSE
flarej,0.1.3-rc.17,0.1.3-rc.18,67,1,7,7,14,5,FALSE
flarej,0.1.3-rc.10,0.1.3-rc.11,60,4,1980,1486,3466,53,FALSE
flarej,0.1.3-rc.11,0.1.3-rc.12,61,1,180,177,357,8,FALSE
flarej,0.1.3-rc.12,0.1.3-rc.13,62,1,1,1,2,1,FALSE
flarej,0.1.3-rc.13,0.1.3-rc.14,63,5,199,148,347,13,FALSE
flarej,0.1.2,0.1.3-rc.1,50,3,193,182,375,25,TRUE
flarej,0.1.3-rc.18,0.1.3-rc.19,68,1,30,30,60,2,FALSE
flarej,0.1.3-rc.19,0.1.3-rc.20,69,1,51,115,166,4,FALSE
flarej,0.1.2-rc.27,0.1.2,49,3,1286,77,1363,15,FALSE
flarej,0.1.3-rc.4,0.1.3-rc.5,54,1,1,1,2,1,FALSE
flarej,0.1.3-rc.2,0.1.3-rc.3,52,1,1,1,2,1,FALSE
flarej,0.1.3-rc.3,0.1.3-rc.4,53,1,4,4,8,3,FALSE
flarej,0.1.3-rc.1,0.1.3-rc.2,51,1,2,2,4,1,FALSE
flarej,0.1.2-rc.15,0.1.2-rc.16,37,1,6,6,12,5,FALSE
flarej,0.1.3-rc.20,0.1.3-rc.21,70,2,363,444,807,17,FALSE
flarej,0.1.2-rc.17,0.1.2-rc.18,39,1,115,51,166,11,FALSE
flarej,0.1.3-rc.29,0.1.3-rc.30,79,2,276,811,1087,21,FALSE
flarej,0.1.3-rc.28,0.1.3-rc.29,78,1,160,85,245,5,FALSE
flarej,0.1.2-rc.16,0.1.2-rc.17,38,1,18,18,36,6,FALSE
flarej,0.1.3-rc.21,0.1.3-rc.22,71,1,572,535,1107,6,FALSE
flarej,0.1.2-rc.21,0.1.2-rc.22,43,1,1,1,2,1,FALSE
flarej,0.1.2-rc.22,0.1.2-rc.23,44,1,41,12,53,5,FALSE
flarej,0.1.2-rc.23,0.1.2-rc.24,45,1,36,12,48,7,FALSE
flarej,0.1.2-rc.24,0.1.2-rc.25,46,2,89,218,307,10,FALSE
flarej,0.1.3-rc.24,0.1.3-rc.25,74,1,18,39,57,6,FALSE
flarej,0.1.2-rc.26,0.1.2-rc.27,48,1,17,17,34,6,FALSE
flarej,0.1.2-rc.25,0.1.2-rc.26,47,1,239,158,397,8,FALSE
flarej,0.1.2-rc.12,0.1.2-rc.13,34,2,189,186,375,12,FALSE
flarej,0.1.3-rc.48,0.1.3,97,1,1,1,2,1,TRUE
flarej,0.1.3-rc.41,0.1.3-rc.42,91,1,151,48,199,5,FALSE
flarej,0.1.2-rc.13,0.1.2-rc.14,35,8,2513,358,2871,24,FALSE
flarej,0.1.3-rc.43,0.1.3-rc.45,93,6,6820,17857,24677,106,FALSE
flarej,0.1.3-rc.42,0.1.3-rc.43,92,1,152,249,401,6,FALSE
flarej,0.1.2-rc.20,0.1.2-rc.21,42,1,23,9,32,6,FALSE
flarej,0.1.3-rc.40,0.1.3-rc.41,90,4,580,575,1155,17,FALSE
flarej,0.1.3-rc.45,0.1.3-rc.46,94,2,932,730,1662,27,FALSE
flarej,0.1.3-rc.23,0.1.3-rc.24,73,1,497,431,928,4,FALSE
flarej,0.1.3-rc.25,0.1.3-rc.26,75,1,1,1,2,1,FALSE
flarej,0.1.3-rc.27,0.1.3-rc.28,77,2,93,156,249,14,FALSE
flarej,0.1.3-rc.32,0.1.3-rc.33,82,1,146,44,190,4,FALSE
flarej,0.1.2-rc.10,0.1.2-rc.11,32,1,1,1,2,1,FALSE
flarej,0.1.3-rc.6,0.1.3-rc.7,56,1,2,2,4,1,FALSE
flarej,0.1.3-rc.26,0.1.3-rc.27,76,1,425,427,852,11,FALSE
flarej,0.1.3-rc.7,0.1.3-rc.8,57,1,14,14,28,6,FALSE
flarej,0.1.2-rc.14,0.1.2-rc.15,36,1,360,101,461,7,FALSE
flarej,0.1.3-rc.22,0.1.3-rc.23,72,1,3,3,6,1,FALSE
flarej,0.1.3-rc.34,0.1.3-rc.35,84,1,150,150,300,5,FALSE
flarej,0.1.2-rc.9,0.1.2-rc.10,31,2,2207,2445,4652,17,FALSE
flarej,0.1.2-rc.8,0.1.2-rc.9,30,2,172,56,228,6,FALSE
flarej,0.1.2-rc.1,0.1.2-rc.2,23,1,353,72,425,7,FALSE
flarej,0.1.2-rc.3,0.1.2-rc.4,25,1,1,1,2,1,FALSE
flarej,0.1.2-rc.2,0.1.2-rc.3,24,5,112,202,314,14,FALSE
flarej,0.1.2-rc.5,0.1.2-rc.6,27,1,1,1,2,1,FALSE
flarej,0.1.2-rc.4,0.1.2-rc.5,26,1,70,37,107,11,FALSE
flarej,0.1.2-rc.7,0.1.2-rc.8,29,1,1,1,2,1,FALSE
flarej,0.1.2-rc.6,0.1.2-rc.7,28,1,10,20,30,4,FALSE
flarej,0.1.1-rc11,0.1.1-rc12,5,1,1,1,2,1,FALSE
flarej,0.1.1-rc10,0.1.1-rc11,4,1,1,1,2,1,FALSE
flarej,0.1.1-rc13,0.1.1-rc14,7,1,1,1,2,1,FALSE
flarej,0.1.1-rc12,0.1.1-rc13,6,1,1,1,2,1,FALSE
flarej,0.1.1-rc15,0.1.1-rc16,9,1,1,1,2,1,FALSE
flarej,0.1.1-rc14,0.1.1-rc15,8,1,152,79,231,6,FALSE
flarej,0.1.1-rc17,0.1.1-rc18,11,2,54,50,104,6,FALSE
flarej,0.1.1-rc16,0.1.1-rc17,10,4,420,126,546,19,FALSE
flarej,0.1.1-rc18,0.1.1-rc19,12,1,166,12,178,5,FALSE
flarej,0.1.1-rc20,0.1.1-rc21,15,1,158,130,288,8,FALSE
flarej,0.1.3-rc.8,0.1.3-rc.9,58,2,351,277,628,8,FALSE
flarej,0.1.3-rc.9,0.1.3-rc.10,59,1,2,2,4,1,FALSE
flarej,0.1.1-rc1,0.1.1-rc10,3,11,499,454,953,36,FALSE
flarej,0.1.1-rc3,0.1.1-rc5,17,6,312,297,609,25,FALSE
flarej,0.1.1-rc2,0.1.1-rc20,14,20,1796,964,2760,81,FALSE
flarej,0.1.1-rc5,0.1.1-rc6,18,1,1,1,2,1,FALSE
flarej,0.1.1-rc7,0.1.1-rc8,20,1,1,1,2,1,FALSE
flarej,0.1.1-rc6,0.1.1-rc7,19,5,187,157,344,11,FALSE
flarej,0.1.1-rc9,0.1.2-rc.1,22,12,2039,791,2830,69,FALSE
flarej,0.1.1-rc8,0.1.1-rc9,21,1,1,1,2,1,FALSE
flarej,0.1.0,0.1.1-rc1,2,16,3651,1054,4705,102,FALSE
flarej,0.1.2,0.1.3-rc.1,50,3,193,182,375,25,FALSE
flarej,0.1.3-rc.2,0.1.3-rc.3,52,1,1,1,2,1,TRUE
flarej,0.1.3-rc.47,0.1.3-rc.48,96,1,1,1,2,1,TRUE
flarej,0.1.1-rc20,0.1.1-rc21,15,1,158,130,288,8,TRUE
flarej,0.1.2-rc.18,0.1.2-rc.19,40,1,237,99,336,6,TRUE
flarej,0.1.3-rc.14,0.1.3-rc.15,64,1,27,34,61,5,TRUE
flarej,0.1.3-rc.13,0.1.3-rc.14,63,5,199,148,347,13,TRUE
flarej,0.1.0,0.1.1-rc1,2,16,3651,1054,4705,102,TRUE
flarej,0.0.1,0.1.0,1,34,16940,999,17939,218,FALSE
flarej,0.1.3-rc.5,0.1.3-rc.6,55,1,6,6,12,3,TRUE
flarej,0.1.3-rc.42,0.1.3-rc.43,92,1,152,249,401,6,TRUE
flarej,0.1.2-rc.3,0.1.2-rc.4,25,1,1,1,2,1,TRUE
flarej,0.1.2-rc.24,0.1.2-rc.25,46,2,89,218,307,10,TRUE
flarej,0.1.4-rc.2,0.1.4-rc.3,100,1,7,7,14,5,TRUE
flarej,0.1.3-rc.43,0.1.3-rc.45,93,6,6820,17857,24677,106,TRUE
flarej,0.1.3-rc.45,0.1.3-rc.46,94,2,932,730,1662,27,TRUE
flarej,0.1.1-rc9,0.1.2-rc.1,22,12,2039,791,2830,69,TRUE
flarej,0.1.3-rc.38,0.1.3-rc.39,88,1,149,151,300,5,TRUE
flarej,0.1.2-rc.9,0.1.2-rc.10,31,2,2207,2445,4652,17,TRUE
flarej,0.1.3-rc.32,0.1.3-rc.33,82,1,146,44,190,4,TRUE
flarej,0.1.3-rc.7,0.1.3-rc.8,57,1,14,14,28,6,TRUE
flarej,0.1.2-rc.26,0.1.2-rc.27,48,1,17,17,34,6,TRUE
metacdn.hls.js,0.5.41,0.6.2-71,3,134,14540,11968,26508,273,FALSE
metacdn.hls.js,0.5.40,0.5.41,2,68,1373,949,2322,112,FALSE
metacdn.hls.js,0.6.2,0.6.3,5,1,12,14,26,3,FALSE
metacdn.hls.js,0.5.39,0.5.40,1,7,153,59,212,12,FALSE
metacdn.hls.js,0.5.40,0.5.41,2,68,1373,949,2322,112,TRUE
react-log,2.0.1,2.1.0,10,13,8050,5664,13714,63,FALSE
react-log,2.0.0,2.0.1,9,1,1,3,4,2,FALSE
react-log,2.3.0,2.3.1,14,4,54,89,143,6,FALSE
react-log,2.2.1,2.3.0,13,2,28,9,37,6,FALSE
react-log,2.2.0,2.2.1,12,1,2,6,8,2,FALSE
react-log,2.1.0,2.2.0,11,5,3737,8,3745,13,FALSE
react-log,1.1.1,1.2.0,4,3,1299,419,1718,50,FALSE
react-log,1.1.0,1.1.1,3,1,2,2,4,1,FALSE
react-log,1.0.0,1.0.1,1,3,67,24,91,6,FALSE
react-log,1.0.1,1.1.0,2,5,25,19,44,13,FALSE
react-log,1.4.0,2.0.0,8,8,473,1453,1926,99,FALSE
react-log,1.3.0,1.4.0,7,4,85,24,109,7,FALSE
react-log,1.2.0,1.2.1,5,3,18,8,26,5,FALSE
react-log,1.2.1,1.3.0,6,3,165,43,208,23,FALSE
react-log,1.0.1,1.1.0,2,5,25,19,44,13,TRUE
react-log,1.1.1,1.2.0,4,3,1299,419,1718,50,TRUE
react-native-extended-cli,1.0.147,1.0.148,148,1,2,2,4,1,FALSE
react-native-extended-cli,1.0.146,1.0.147,147,1,2,1,3,2,FALSE
react-native-extended-cli,1.0.98,1.0.99,99,1,10,8,18,2,FALSE
react-native-extended-cli,1.0.99,1.0.100,100,1,10,3,13,1,FALSE
react-native-extended-cli,1.0.96,1.0.97,97,2,5,3,8,3,FALSE
react-native-extended-cli,1.0.97,1.0.98,98,1,1,1,2,1,FALSE
react-native-extended-cli,1.0.94,1.0.95,95,1,1,1,2,1,FALSE
react-native-extended-cli,1.0.95,1.0.96,96,1,1,1,2,1,FALSE
react-native-extended-cli,1.0.92,1.0.93,93,1,1,1,2,1,FALSE
react-native-extended-cli,1.0.93,1.0.94,94,1,1,1,2,1,FALSE
react-native-extended-cli,1.0.90,1.0.91,91,1,1,1,2,1,FALSE
react-native-extended-cli,1.0.91,1.0.92,92,1,1,1,2,1,FALSE
react-native-extended-cli,1.0.89,1.0.90,90,1,1,1,2,1,FALSE
react-native-extended-cli,1.0.88,1.0.89,89,1,1,1,2,1,FALSE
react-native-extended-cli,1.0.85,1.0.86,86,1,1,1,2,1,FALSE
react-native-extended-cli,1.0.84,1.0.85,85,1,1,1,2,1,FALSE
react-native-extended-cli,1.0.87,1.0.88,88,1,1,1,2,1,FALSE
react-native-extended-cli,1.0.86,1.0.87,87,1,1,1,2,1,FALSE
react-native-extended-cli,1.0.81,1.0.82,82,1,10,1,11,1,FALSE
react-native-extended-cli,1.0.80,1.0.81,81,1,1,1,2,1,FALSE
react-native-extended-cli,1.0.83,1.0.84,84,1,1,1,2,1,FALSE
react-native-extended-cli,1.0.82,1.0.83,83,1,1,1,2,1,FALSE
react-native-extended-cli,1.0.107,1.0.108,108,1,3,2,5,1,FALSE
react-native-extended-cli,1.0.106,1.0.107,107,1,4,11,15,1,FALSE
react-native-extended-cli,1.0.105,1.0.106,106,2,7,2,9,3,FALSE
react-native-extended-cli,1.0.104,1.0.105,105,3,50,23,73,3,FALSE
react-native-extended-cli,1.0.103,1.0.104,104,1,1,0,1,1,FALSE
react-native-extended-cli,1.0.102,1.0.103,103,1,2,2,4,1,FALSE
react-native-extended-cli,1.0.101,1.0.102,102,1,3,3,6,1,TRUE
react-native-extended-cli,1.0.100,1.0.101,101,1,7,6,13,1,FALSE
react-native-extended-cli,1.0.109,1.0.110,110,1,3,6,9,1,FALSE
react-native-extended-cli,1.0.108,1.0.109,109,1,1,1,2,1,FALSE
react-native-extended-cli,1.0.114,1.0.115,115,1,1,1,2,1,FALSE
react-native-extended-cli,1.0.115,1.0.116,116,1,1,1,2,1,FALSE
react-native-extended-cli,1.0.116,1.0.117,117,1,0,1,1,1,FALSE
react-native-extended-cli,1.0.117,1.0.118,118,2,5,5,10,4,FALSE
react-native-extended-cli,1.0.110,1.0.111,111,1,1,1,2,1,FALSE
react-native-extended-cli,1.0.111,1.0.112,112,1,4,1,5,1,FALSE
react-native-extended-cli,1.0.112,1.0.113,113,1,4,14,18,1,FALSE
react-native-extended-cli,1.0.113,1.0.114,114,1,14,4,18,1,FALSE
react-native-extended-cli,1.0.118,1.0.119,119,1,1,0,1,1,FALSE
react-native-extended-cli,1.0.119,1.0.120,120,1,4,12,16,3,FALSE
react-native-extended-cli,1.0.121,1.0.122,122,1,1,1,2,1,FALSE
react-native-extended-cli,1.0.120,1.0.121,121,1,1,1,2,1,FALSE
react-native-extended-cli,1.0.123,1.0.124,124,1,1,1,2,1,FALSE
react-native-extended-cli,1.0.122,1.0.123,123,1,2,2,4,1,FALSE
react-native-extended-cli,1.0.125,1.0.126,126,1,1,1,2,1,FALSE
react-native-extended-cli,1.0.124,1.0.125,125,1,2,1,3,1,FALSE
react-native-extended-cli,1.0.127,1.0.128,128,1,2,2,4,1,FALSE
react-native-extended-cli,1.0.126,1.0.127,127,1,20,9,29,4,FALSE
react-native-extended-cli,1.0.129,1.0.130,130,1,2052,1,2053,5,FALSE
react-native-extended-cli,1.0.128,1.0.129,129,1,15,1,16,1,FALSE
react-native-extended-cli,1.0.58,1.0.59,59,1,7,4,11,2,FALSE
react-native-extended-cli,1.0.59,1.0.60,60,1,0,5,5,2,FALSE
react-native-extended-cli,1.0.52,1.0.53,53,1,1,1,2,1,FALSE
react-native-extended-cli,1.0.53,1.0.54,54,1,9,11,20,1,FALSE
react-native-extended-cli,1.0.50,1.0.51,51,1,1,1,2,1,FALSE
react-native-extended-cli,1.0.51,1.0.52,52,1,1,1,2,1,FALSE
react-native-extended-cli,1.0.56,1.0.57,57,1,1,1,2,1,FALSE
react-native-extended-cli,1.0.57,1.0.58,58,1,1,1,2,1,FALSE
react-native-extended-cli,1.0.54,1.0.55,55,1,1,1,2,1,FALSE
react-native-extended-cli,1.0.55,1.0.56,56,1,1,1,2,1,FALSE
react-native-extended-cli,1.0.138,1.0.139,139,1,9,0,9,1,FALSE
react-native-extended-cli,1.0.139,1.0.140,140,1,3,5,8,1,FALSE
react-native-extended-cli,1.0.136,1.0.137,137,1,0,4,4,1,FALSE
react-native-extended-cli,1.0.137,1.0.138,138,1,1,1,2,1,FALSE
react-native-extended-cli,1.0.134,1.0.135,135,1,3,2,5,1,FALSE
react-native-extended-cli,1.0.135,1.0.136,136,1,4,4,8,1,FALSE
react-native-extended-cli,1.0.132,1.0.133,133,1,6,6,12,1,FALSE
react-native-extended-cli,1.0.133,1.0.134,134,1,44,63,107,7,FALSE
react-native-extended-cli,1.0.130,1.0.131,131,3,59,12,71,5,FALSE
react-native-extended-cli,1.0.131,1.0.132,132,1,1,1,2,1,FALSE
react-native-extended-cli,1.0.49,1.0.50,50,2,64,51,115,12,FALSE
react-native-extended-cli,1.0.48,1.0.49,49,1,1,1,2,1,FALSE
react-native-extended-cli,1.0.41,1.0.42,42,1,4,1,5,1,FALSE
react-native-extended-cli,1.0.43,1.0.44,44,1,22,12,34,2,FALSE
react-native-extended-cli,1.0.42,1.0.43,43,1,5,5,10,1,FALSE
react-native-extended-cli,1.0.45,1.0.46,46,1,18,2,20,1,FALSE
react-native-extended-cli,1.0.44,1.0.45,45,1,1,1,2,1,FALSE
react-native-extended-cli,1.0.47,1.0.48,48,2,22,16,38,4,TRUE
react-native-extended-cli,1.0.46,1.0.47,47,1,2,0,2,1,FALSE
react-native-extended-cli,1.0.74,1.0.75,75,1,1,1,2,1,FALSE
react-native-extended-cli,1.0.75,1.0.76,76,1,1,1,2,1,FALSE
react-native-extended-cli,1.0.149,1.0.150,150,1,1,1,2,1,FALSE
react-native-extended-cli,1.0.148,1.0.149,149,1,1,1,2,1,FALSE
react-native-extended-cli,1.0.70,1.0.71,71,1,1,1,2,1,FALSE
react-native-extended-cli,1.0.71,1.0.72,72,1,1,1,2,1,FALSE
react-native-extended-cli,1.0.72,1.0.73,73,1,1,1,2,1,FALSE
react-native-extended-cli,1.0.73,1.0.74,74,1,1,1,2,1,FALSE
react-native-extended-cli,1.0.143,1.0.144,144,1,6,10,16,2,FALSE
react-native-extended-cli,1.0.142,1.0.143,143,1,24,3,27,1,FALSE
react-native-extended-cli,1.0.141,1.0.142,142,1,2,1,3,2,FALSE
react-native-extended-cli,1.0.140,1.0.141,141,1,2,1,3,1,FALSE
react-native-extended-cli,1.0.78,1.0.79,79,1,1,1,2,1,FALSE
react-native-extended-cli,1.0.79,1.0.80,80,1,1,1,2,1,FALSE
react-native-extended-cli,1.0.145,1.0.146,146,1,7,3,10,1,FALSE
react-native-extended-cli,1.0.144,1.0.145,145,1,188,103,291,7,FALSE
react-native-extended-cli,1.0.76,1.0.77,77,1,1,1,2,1,FALSE
react-native-extended-cli,1.0.77,1.0.78,78,1,1,1,2,1,FALSE
react-native-extended-cli,1.0.63,1.0.64,64,1,1,1,2,1,FALSE
react-native-extended-cli,1.0.62,1.0.63,63,1,10,10,20,2,FALSE
react-native-extended-cli,1.0.61,1.0.62,62,1,4,4,8,2,TRUE
react-native-extended-cli,1.0.60,1.0.61,61,1,5,0,5,1,FALSE
react-native-extended-cli,1.0.67,1.0.68,68,1,1,1,2,1,FALSE
react-native-extended-cli,1.0.66,1.0.67,67,1,1,1,2,1,TRUE
react-native-extended-cli,1.0.65,1.0.66,66,1,3,1,4,1,FALSE
react-native-extended-cli,1.0.64,1.0.65,65,2,10,1,11,3,FALSE
react-native-extended-cli,1.0.69,1.0.70,70,1,1,1,2,1,FALSE
react-native-extended-cli,1.0.68,1.0.69,69,1,1,0,1,1,FALSE
react-native-extended-cli,1.0.4,1.0.5,5,1,1,1,2,1,FALSE
react-native-extended-cli,1.0.5,1.0.6,6,1,1,1,2,1,FALSE
react-native-extended-cli,1.0.6,1.0.7,7,1,1,1,2,1,FALSE
react-native-extended-cli,1.0.7,1.0.8,8,1,1,1,2,1,FALSE
react-native-extended-cli,1.0.1,1.0.2,2,1,0,14,14,1,FALSE
react-native-extended-cli,1.0.2,1.0.3,3,1,1,1,2,1,FALSE
react-native-extended-cli,1.0.3,1.0.4,4,1,1,1,2,1,FALSE
react-native-extended-cli,1.0.8,1.0.9,9,1,1,1,2,1,FALSE
react-native-extended-cli,1.0.9,1.0.10,10,1,1,1,2,1,FALSE
react-native-extended-cli,1.0.16,1.0.17,17,1,1,1,2,1,FALSE
react-native-extended-cli,1.0.17,1.0.18,18,1,7,41,48,3,FALSE
react-native-extended-cli,1.0.14,1.0.15,15,1,44,3,47,3,FALSE
react-native-extended-cli,1.0.15,1.0.16,16,1,2,1,3,1,FALSE
react-native-extended-cli,1.0.12,1.0.13,13,1,11,1,12,3,FALSE
react-native-extended-cli,1.0.13,1.0.14,14,1,3,3,6,3,FALSE
react-native-extended-cli,1.0.10,1.0.11,11,1,3,0,3,1,FALSE
react-native-extended-cli,1.0.11,1.0.12,12,2,13,3,16,2,FALSE
react-native-extended-cli,1.0.18,1.0.19,19,1,13,9,22,1,FALSE
react-native-extended-cli,1.0.19,1.0.20,20,1,63,9,72,5,FALSE
react-native-extended-cli,1.0.101,1.0.102,102,1,3,3,6,1,FALSE
react-native-extended-cli,1.0.30,1.0.31,31,1,83,48,131,10,FALSE
react-native-extended-cli,1.0.31,1.0.32,32,1,4,4,8,2,FALSE
react-native-extended-cli,1.0.32,1.0.33,33,1,4,5,9,3,FALSE
react-native-extended-cli,1.0.33,1.0.34,34,1,1,2,3,1,FALSE
react-native-extended-cli,1.0.34,1.0.35,35,1,2,2,4,1,FALSE
react-native-extended-cli,1.0.35,1.0.36,36,1,25,6,31,2,FALSE
react-native-extended-cli,1.0.36,1.0.37,37,1,2,2,4,1,FALSE
react-native-extended-cli,1.0.37,1.0.38,38,1,5,5,10,1,FALSE
react-native-extended-cli,1.0.38,1.0.39,39,1,48,2,50,2,FALSE
react-native-extended-cli,1.0.39,1.0.40,40,1,2,0,2,1,FALSE
react-native-extended-cli,1.0.29,1.0.30,30,1,12,5,17,11,FALSE
react-native-extended-cli,1.0.28,1.0.29,29,1,9,1,10,2,FALSE
react-native-extended-cli,1.0.27,1.0.28,28,1,8,8,16,5,FALSE
react-native-extended-cli,1.0.26,1.0.27,27,1,18,24,42,1,FALSE
react-native-extended-cli,1.0.25,1.0.26,26,1,65,7,72,4,FALSE
react-native-extended-cli,1.0.24,1.0.25,25,1,102,3,105,7,FALSE
react-native-extended-cli,1.0.23,1.0.24,24,1,1,1,2,1,FALSE
react-native-extended-cli,1.0.22,1.0.23,23,1,13,11,24,3,FALSE
react-native-extended-cli,1.0.21,1.0.22,22,1,34,2,36,6,FALSE
react-native-extended-cli,1.0.20,1.0.21,21,1,8,7,15,1,FALSE
react-native-extended-cli,1.0.40,1.0.41,41,1,2,1,3,1,FALSE
react-native-extended-cli,1.0.47,1.0.48,48,2,22,16,38,4,FALSE
react-native-extended-cli,1.0.61,1.0.62,62,1,4,4,8,2,FALSE
react-native-extended-cli,1.0.66,1.0.67,67,1,1,1,2,1,FALSE
react-native-extended-cli,1.0.75,1.0.76,76,1,1,1,2,1,TRUE
react-redux-grid,1.0.4,1.0.5,5,1,0,309,309,6,FALSE
react-redux-grid,1.0.5,1.0.6,6,2,25,15,40,4,FALSE
react-redux-grid,1.0.6,1.1.0-1,7,12,20242,21588,41830,99,FALSE
react-redux-grid,2.0.4,2.1.0,25,3,5131,721,5852,105,FALSE
react-redux-grid,1.0.0,1.0.1,1,1,12,2,14,3,FALSE
react-redux-grid,1.0.1,1.0.2,2,1,7200,7175,14375,10,FALSE
react-redux-grid,1.0.2,1.0.3,3,1,94,79,173,5,FALSE
react-redux-grid,1.0.3,1.0.4,4,1,165,101,266,11,FALSE
react-redux-grid,5.1.1,5.1.2,72,6,697,708,1405,92,FALSE
react-redux-grid,3.1.1,3.1.2,43,2,7,7,14,7,FALSE
react-redux-grid,5.1.0,5.1.1,71,9,100834,1829,102663,19,FALSE
react-redux-grid,2.2.5,2.2.6,32,2,6,3,9,4,FALSE
react-redux-grid,2.2.4,2.2.5,31,3,615,184,799,22,FALSE
react-redux-grid,2.2.6,2.3.0,33,4,339,109,448,21,FALSE
react-redux-grid,2.2.1,2.2.2,28,2,140,119,259,4,FALSE
react-redux-grid,2.2.3,2.2.4,30,4,546,22,568,17,FALSE
react-redux-grid,2.2.2,2.2.3,29,2,9,1,10,3,FALSE
react-redux-grid,2.0.3,2.0.4,24,2,84,4,88,4,FALSE
react-redux-grid,2.1.0,2.2.0,26,3,1171,253,1424,51,FALSE
react-redux-grid,5.1.2,5.1.3,73,4,252,241,493,10,FALSE
react-redux-grid,2.0.2,2.0.3,23,3,67,17,84,13,FALSE
react-redux-grid,5.1.3,5.1.4,74,2,10,10,20,2,FALSE
react-redux-grid,4.0.0,4.1.0,48,7,1364,1234,2598,48,FALSE
react-redux-grid,4.1.0,4.2.0,49,6,1371,782,2153,32,FALSE
react-redux-grid,3.1.5,4.0.0,47,2,829,300,1129,45,FALSE
react-redux-grid,4.3.2,4.4.0,53,3,1196,971,2167,76,FALSE
react-redux-grid,3.1.2,3.1.3,44,2,5,12,17,3,FALSE
react-redux-grid,3.1.4,3.1.5,46,13,1384,573,1957,90,FALSE
react-redux-grid,3.0.0,3.0.1,40,2,10,2,12,3,FALSE
react-redux-grid,4.4.6,4.4.7,60,5,144,25,169,11,FALSE
react-redux-grid,3.1.0,3.1.1,42,2,43,53,96,26,FALSE
react-redux-grid,1.6.0,1.7.0,14,11,2979,1168,4147,108,FALSE
react-redux-grid,4.4.4,4.4.5,58,2,55,16,71,8,FALSE
react-redux-grid,5.1.12,5.1.13,82,8,378,195,573,30,FALSE
react-redux-grid,2.3.1,2.3.2,35,5,57,51,108,22,FALSE
react-redux-grid,1.9.1,1.9.2,18,2,7,6,13,3,FALSE
react-redux-grid,1.9.0,1.9.1,17,2,14,2,16,2,FALSE
react-redux-grid,1.9.3,2.0.0,20,3,14435,1541,15976,223,FALSE
react-redux-grid,1.9.2,1.9.3,19,5,1242,7039,8281,18,FALSE
react-redux-grid,1.8.0,1.9.0,16,29,3378,8408,11786,133,FALSE
react-redux-grid,2.3.2,2.3.3,36,4,34,12,46,9,FALSE
react-redux-grid,1.7.0,1.8.0,15,12,8353,1245,9598,51,FALSE
react-redux-grid,1.4.0,1.5.0,12,11,15246,71008,86254,65,FALSE
react-redux-grid,5.0.0,5.0.1,68,2,9,3,12,2,FALSE
react-redux-grid,2.0.1,2.0.2,22,2,112,32,144,15,FALSE
react-redux-grid,2.3.0,2.3.1,34,2,114,35,149,11,FALSE
react-redux-grid,1.1.0,1.2.0,9,59,25017,24118,49135,374,FALSE
react-redux-grid,2.3.3,2.4.0,37,5,2905,1375,4280,112,FALSE
react-redux-grid,4.4.11,4.4.12,65,2,10,2,12,3,FALSE
react-redux-grid,1.5.0,1.6.0,13,19,5223,529,5752,99,FALSE
react-redux-grid,5.1.13,5.1.14,83,6,179,21,200,13,FALSE
react-redux-grid,4.4.12,4.4.13,66,6,144,33,177,8,FALSE
react-redux-grid,1.3.0,1.4.0,11,5,3077,1489,4566,134,FALSE
react-redux-grid,4.4.10,4.4.11,64,5,177,246,423,20,FALSE
react-redux-grid,4.4.13,5.0.0,67,9,493,178,671,24,FALSE
react-redux-grid,1.2.0,1.3.0,10,39,7162,3984,11146,128,FALSE
react-redux-grid,3.0.1,3.1.0,41,4,2062,240,2302,52,FALSE
react-redux-grid,5.1.9,5.1.10,80,13,274,87,361,35,FALSE
react-redux-grid,2.4.1,3.0.0,39,4,2767,1441,4208,116,FALSE
react-redux-grid,2.4.0,2.4.1,38,2,6,4,10,3,FALSE
react-redux-grid,5.1.8,5.1.9,79,21,356,100951,101307,40,FALSE
react-redux-grid,2.0.0,2.0.1,21,2,1,1,2,2,FALSE
react-redux-grid,5.0.1,5.0.2,69,7,433,127,560,16,FALSE
react-redux-grid,5.0.2,5.1.0,70,15,3960,1747,5707,92,FALSE
react-redux-grid,4.4.9,4.4.10,63,6,220,279,499,12,FALSE
react-redux-grid,4.4.8,4.4.9,62,2,7,3,10,2,FALSE
react-redux-grid,4.4.5,4.4.6,59,3,33,7,40,7,FALSE
react-redux-grid,5.1.4,5.1.5,75,2,2,2,4,2,FALSE
react-redux-grid,4.4.7,4.4.8,61,4,16,16,32,5,FALSE
react-redux-grid,5.1.6,5.1.7,77,3,45,24,69,6,FALSE
react-redux-grid,4.4.1,4.4.2,55,4,283,127,410,41,FALSE
react-redux-grid,4.4.0,4.4.1,54,2,13,10,23,2,FALSE
react-redux-grid,4.4.3,4.4.4,57,2,5,4,9,4,FALSE
react-redux-grid,4.4.2,4.4.3,56,6,109,13,122,11,TRUE
react-redux-grid,5.1.5,5.1.6,76,7,602,185,787,24,FALSE
react-redux-grid,4.2.0,4.3.0,50,3,1815,1621,3436,111,FALSE
react-redux-grid,3.1.3,3.1.4,45,2,117,19,136,14,FALSE
react-redux-grid,4.3.0,4.3.1,51,4,276,20640,20916,214,FALSE
react-redux-grid,4.3.1,4.3.2,52,4,134,2,136,4,FALSE
react-redux-grid,5.1.10,5.1.12,81,14,598,204,802,29,FALSE
react-redux-grid,5.1.7,5.1.8,78,2,4,2,6,2,FALSE
react-redux-grid,2.2.0,2.2.1,27,3,39,43,82,8,FALSE
react-redux-grid,1.9.3,2.0.0,20,3,14435,1541,15976,223,TRUE
react-redux-grid,4.4.2,4.4.3,56,6,109,13,122,11,FALSE
react-redux-grid,2.0.4,2.1.0,25,3,5131,721,5852,105,TRUE
react-redux-grid,2.1.0,2.2.0,26,3,1171,253,1424,51,TRUE
react-redux-grid,5.1.12,5.1.13,82,8,378,195,573,30,TRUE
react-redux-grid,2.0.3,2.0.4,24,2,84,4,88,4,TRUE
react-redux-grid,3.1.1,3.1.2,43,2,7,7,14,7,TRUE
react-redux-grid,1.7.0,1.8.0,15,12,8353,1245,9598,51,TRUE
react-redux-grid,1.5.0,1.6.0,13,19,5223,529,5752,99,TRUE
react-redux-grid,1.2.0,1.3.0,10,39,7162,3984,11146,128,TRUE
react-redux-grid,3.1.3,3.1.4,45,2,117,19,136,14,TRUE
react-redux-grid,2.3.0,2.3.1,34,2,114,35,149,11,TRUE
react-redux-grid,5.1.1,5.1.2,72,6,697,708,1405,92,TRUE
react-redux-grid,1.8.0,1.9.0,16,29,3378,8408,11786,133,TRUE
react-redux-grid,1.3.0,1.4.0,11,5,3077,1489,4566,134,TRUE
react-redux-grid,4.4.13,5.0.0,67,9,493,178,671,24,TRUE
react-redux-grid,4.4.5,4.4.6,59,3,33,7,40,7,TRUE
react-redux-grid,5.1.10,5.1.12,81,14,598,204,802,29,TRUE
react-redux-grid,5.1.5,5.1.6,76,7,602,185,787,24,TRUE
react-redux-grid,5.1.2,5.1.3,73,4,252,241,493,10,TRUE
react-redux-grid,5.0.1,5.0.2,69,7,433,127,560,16,TRUE
react-redux-grid,4.2.0,4.3.0,50,3,1815,1621,3436,111,TRUE
react-redux-grid,5.1.9,5.1.10,80,13,274,87,361,35,TRUE
react-redux-grid,1.9.1,1.9.2,18,2,7,6,13,3,TRUE
react-redux-grid,2.2.4,2.2.5,31,3,615,184,799,22,TRUE
react-redux-grid,1.6.0,1.7.0,14,11,2979,1168,4147,108,TRUE
react-redux-grid,2.0.1,2.0.2,22,2,112,32,144,15,TRUE
react-redux-grid,4.4.9,4.4.10,63,6,220,279,499,12,TRUE
react-redux-grid,4.1.0,4.2.0,49,6,1371,782,2153,32,TRUE
react-redux-grid,3.0.0,3.0.1,40,2,10,2,12,3,TRUE
react-redux-grid,1.4.0,1.5.0,12,11,15246,71008,86254,65,TRUE
react-redux-grid,2.3.3,2.4.0,37,5,2905,1375,4280,112,TRUE
react-redux-grid,3.0.1,3.1.0,41,4,2062,240,2302,52,TRUE
metalsmith-relative-links,1.1.0,1.1.1,2,3,21,7,28,6,FALSE
metalsmith-relative-links,1.0.0,1.1.0,1,5,52,17,69,8,FALSE
metalsmith-relative-links,1.0.0,1.1.0,1,5,52,17,69,8,TRUE
mservice-calendar,1.1.0,1.2.0,3,1,27,1,28,1,FALSE
mservice-calendar,1.0.0,1.0.1,1,1,48,0,48,1,FALSE
mservice-calendar,1.0.1,1.1.0,2,2,1001,1340,2341,54,FALSE
mservice-calendar,2.0.1,2.1.0,15,4,23,16,39,7,FALSE
mservice-calendar,2.0.0,2.0.1,14,3,5,4,9,4,FALSE
mservice-calendar,2.7.1,2.7.2,24,1,1,1,2,1,FALSE
mservice-calendar,2.2.1,2.3.0,18,1,7555,28,7583,44,FALSE
mservice-calendar,2.2.0,2.2.1,17,1,7,9,16,1,FALSE
mservice-calendar,2.1.0,2.2.0,16,1,128,26,154,10,FALSE
mservice-calendar,2.7.3,2.7.4,26,1,188,248,436,8,FALSE
mservice-calendar,2.3.0,2.4.0,19,1,66,7542,7608,44,FALSE
mservice-calendar,1.2.6,1.3.0,10,1,16,1,17,3,FALSE
mservice-calendar,1.3.2,2.0.0,13,1,1212,945,2157,51,FALSE
mservice-calendar,1.3.1,1.3.2,12,2,23,14,37,6,FALSE
mservice-calendar,1.2.5,1.2.6,9,3,2,1,3,3,FALSE
mservice-calendar,1.2.2,1.2.3,6,1,1,1,2,1,FALSE
mservice-calendar,1.2.3,1.2.4,7,1,2,1,3,1,FALSE
mservice-calendar,1.2.0,1.2.1,4,1,2,0,2,1,FALSE
mservice-calendar,1.2.1,1.2.2,5,1,1,1,2,1,FALSE
mservice-calendar,2.4.0,2.5.0,20,1,3778,14,3792,8,FALSE
mservice-calendar,2.5.0,2.6.0,21,1,383,61,444,7,FALSE
mservice-calendar,2.9.0,2.10.0,29,1,9,3,12,1,FALSE
mservice-calendar,2.7.4,2.8.0,27,1,1288,378,1666,20,FALSE
mservice-calendar,2.6.0,2.7.0,22,1,604,187,791,21,FALSE
mservice-calendar,2.7.0,2.7.1,23,1,17,21,38,6,FALSE
mservice-calendar,1.2.4,1.2.5,8,1,1,1,2,1,FALSE
mservice-calendar,2.7.2,2.7.3,25,1,36,46,82,3,FALSE
mservice-calendar,2.8.0,2.9.0,28,1,74,0,74,3,FALSE
mservice-calendar,1.3.0,1.3.1,11,3,275,80,355,12,FALSE
mservice-calendar,1.2.6,1.3.0,10,1,16,1,17,3,TRUE
mservice-calendar,1.3.2,2.0.0,13,1,1212,945,2157,51,TRUE
mservice-calendar,1.2.5,1.2.6,9,3,2,1,3,3,TRUE
mservice-calendar,2.0.0,2.0.1,14,3,5,4,9,4,TRUE
mservice-calendar,2.8.0,2.9.0,28,1,74,0,74,3,TRUE
mservice-calendar,1.0.1,1.1.0,2,2,1001,1340,2341,54,TRUE
mservice-calendar,2.7.3,2.7.4,26,1,188,248,436,8,TRUE
mservice-calendar,2.4.0,2.5.0,20,1,3778,14,3792,8,TRUE
mservice-calendar,2.9.0,2.10.0,29,1,9,3,12,1,TRUE
mservice-calendar,2.6.0,2.7.0,22,1,604,187,791,21,TRUE
mservice-calendar,2.1.0,2.2.0,16,1,128,26,154,10,TRUE
postcss-functions,2.1.0,2.1.1,3,5,344,221,565,16,FALSE
postcss-functions,1.0.0,2.0.0,1,6,38,16,54,7,FALSE
postcss-functions,2.0.0,2.1.0,2,16,286,113,399,26,FALSE
postcss-functions,2.0.0,2.1.0,2,16,286,113,399,26,TRUE
babel-plugin-insert-css-module,1.0.0,1.0.1,1,3,6,5,11,3,FALSE
babel-plugin-insert-css-module,1.0.1,1.0.2,2,2,5,2,7,2,FALSE
babel-plugin-insert-css-module,1.0.2,1.0.3,3,2,2,2,4,2,FALSE
babel-plugin-insert-css-module,1.0.3,1.0.4,4,2,5,5,10,4,FALSE
babel-plugin-insert-css-module,1.0.3,1.0.4,4,2,5,5,10,4,TRUE
proto.js,0.1.0,0.1.1,1,1,45,45,90,2,FALSE
proto.js,0.1.1,0.1.2,2,3,138,119,257,12,FALSE
proto.js,0.1.1,0.1.2,2,3,138,119,257,12,TRUE
m3d-capture,0.0.4,0.1.0,4,4,11,9,20,5,FALSE
m3d-capture,0.0.1,0.0.2,1,1,1,1,2,1,FALSE
m3d-capture,0.0.3,0.0.4,3,3,9,7,16,4,FALSE
m3d-capture,0.0.2,0.0.3,2,2,3,3,6,3,FALSE
m3d-capture,0.0.4,0.1.0,4,4,11,9,20,5,TRUE
brat-frontend-editor,0.3.9,0.3.10,3,1,1,1,2,1,FALSE
brat-frontend-editor,0.0.19,0.2.7,1,3,257,53,310,14,FALSE
brat-frontend-editor,0.2.7,0.3.9,2,6,1061,259,1320,51,FALSE
brat-frontend-editor,0.3.10,0.3.12,4,2,30,301,331,29,FALSE
brat-frontend-editor,0.3.12,0.3.36,5,21,1933,2575,4508,156,FALSE
brat-frontend-editor,0.3.10,0.3.12,4,2,30,301,331,29,TRUE
griddle-react-bootstrap,0.3.0,0.3.1,2,4,103,11342,11445,27,FALSE
griddle-react-bootstrap,0.3.1,0.4.0,3,4,193,32,225,12,FALSE
griddle-react-bootstrap,0.2.0,0.3.0,1,11,357,80,437,24,FALSE
griddle-react-bootstrap,0.4.1,0.4.2,5,2,35,6,41,3,FALSE
griddle-react-bootstrap,0.4.0,0.4.1,4,2,4,2,6,2,FALSE
griddle-react-bootstrap,0.4.3,0.4.4,7,2,5,5,10,3,FALSE
griddle-react-bootstrap,0.4.2,0.4.3,6,7,20,18,38,10,FALSE
griddle-react-bootstrap,0.3.0,0.3.1,2,4,103,11342,11445,27,TRUE
griddle-react-bootstrap,0.3.1,0.4.0,3,4,193,32,225,12,TRUE
griddle-react-bootstrap,0.2.0,0.3.0,1,11,357,80,437,24,TRUE
griddle-react-bootstrap,0.4.1,0.4.2,5,2,35,6,41,3,TRUE
griddle-react-bootstrap,0.4.0,0.4.1,4,2,4,2,6,2,TRUE
ethereumjs-connect,1.0.4,1.0.5,125,1,220,383,603,3,FALSE
ethereumjs-connect,1.0.5,1.0.6,126,1,96,52,148,3,FALSE
ethereumjs-connect,1.0.6,1.0.7,127,1,462,290,752,3,FALSE
ethereumjs-connect,1.0.7,1.0.8,128,1,220,392,612,3,FALSE
ethereumjs-connect,1.0.0,1.0.1,121,1,7,5,12,3,FALSE
ethereumjs-connect,1.0.1,1.0.2,122,1,58,47,105,3,FALSE
ethereumjs-connect,1.0.2,1.0.3,123,1,15,11,26,3,FALSE
ethereumjs-connect,1.0.3,1.0.4,124,1,382,219,601,3,FALSE
ethereumjs-connect,1.0.8,1.0.9,129,1,388,228,616,4,FALSE
ethereumjs-connect,1.0.9,1.0.10,130,1,4,4,8,3,FALSE
ethereumjs-connect,4.0.1,4.0.2,251,7,26962,27230,54192,17,FALSE
ethereumjs-connect,4.0.0,4.0.1,250,2,30974,93081,124055,8,FALSE
ethereumjs-connect,0.3.8,0.3.9,27,1,129,23,152,5,FALSE
ethereumjs-connect,0.3.9,0.4.0,28,1,6,7,13,3,FALSE
ethereumjs-connect,4.0.5,4.0.6,255,1,1509,1264,2773,4,FALSE
ethereumjs-connect,4.0.4,4.0.5,254,1,16,14,30,4,FALSE
ethereumjs-connect,0.3.2,0.3.3,21,1,211,68,279,3,FALSE
ethereumjs-connect,0.3.3,0.3.4,22,1,36,9,45,3,FALSE
ethereumjs-connect,0.3.0,0.3.1,19,1,21,11,32,3,FALSE
ethereumjs-connect,0.3.1,0.3.2,20,1,3614,10676,14290,3,FALSE
ethereumjs-connect,0.3.6,0.3.7,25,2,150,395,545,5,FALSE
ethereumjs-connect,0.8.10,0.8.11,93,1,39,39,78,3,FALSE
ethereumjs-connect,0.3.4,0.3.5,23,1,10,15,25,3,FALSE
ethereumjs-connect,0.3.5,0.3.6,24,1,8,7,15,3,FALSE
ethereumjs-connect,1.0.16,1.0.17,137,1,10,8,18,3,FALSE
ethereumjs-connect,1.0.17,1.0.18,138,1,39,39,78,3,FALSE
ethereumjs-connect,1.0.14,1.0.15,135,1,39,39,78,3,FALSE
ethereumjs-connect,1.0.15,1.0.16,136,1,222,387,609,3,FALSE
ethereumjs-connect,1.0.12,1.0.13,133,1,4,4,8,3,FALSE
ethereumjs-connect,1.0.13,1.0.14,134,1,11,11,22,3,FALSE
ethereumjs-connect,1.0.10,1.0.11,131,1,4,4,8,3,FALSE
ethereumjs-connect,1.0.11,1.0.12,132,1,5,5,10,3,FALSE
ethereumjs-connect,1.0.18,1.0.19,139,1,14,10,24,3,FALSE
ethereumjs-connect,1.0.19,1.0.20,140,1,391,226,617,3,FALSE
ethereumjs-connect,1.4.1,2.0.0,229,29,12704,3189,15893,48,FALSE
ethereumjs-connect,0.5.9,0.5.10,49,1,4,4,8,3,FALSE
ethereumjs-connect,0.5.7,0.5.8,47,1,83,189,272,3,FALSE
ethereumjs-connect,2.3.0,2.3.1,238,1,10,12,22,4,FALSE
ethereumjs-connect,0.8.9,0.8.10,92,1,37,36,73,3,FALSE
ethereumjs-connect,0.7.12,0.7.13,77,1,11,21,32,3,FALSE
ethereumjs-connect,0.9.18,0.9.19,113,1,39,39,78,3,FALSE
ethereumjs-connect,0.9.19,0.9.20,114,1,23,15,38,3,FALSE
ethereumjs-connect,0.9.12,0.9.13,107,1,17,5,22,3,FALSE
ethereumjs-connect,0.9.13,0.9.14,108,1,50,92,142,3,FALSE
ethereumjs-connect,0.9.10,0.9.11,105,1,316,17,333,3,FALSE
ethereumjs-connect,0.9.11,0.9.12,106,1,19538,24588,44126,3,FALSE
ethereumjs-connect,0.9.16,0.9.17,111,1,3,3,6,1,FALSE
ethereumjs-connect,0.9.17,0.9.18,112,1,12,8,20,3,FALSE
ethereumjs-connect,0.9.14,0.9.15,109,1,55,47,102,3,FALSE
ethereumjs-connect,0.9.15,0.9.16,110,1,14,22,36,3,FALSE
ethereumjs-connect,3.0.6,3.0.7,247,1,26,21,47,4,FALSE
ethereumjs-connect,3.0.7,3.0.8,248,1,3,3,6,2,FALSE
ethereumjs-connect,3.0.4,3.0.5,245,1,25,26,51,4,FALSE
ethereumjs-connect,3.0.5,3.0.6,246,1,6386,321,6707,4,FALSE
ethereumjs-connect,3.0.2,3.0.3,243,1,85,67,152,4,FALSE
ethereumjs-connect,3.0.3,3.0.4,244,1,160,269,429,4,FALSE
ethereumjs-connect,3.0.0,3.0.1,241,1,30,16,46,4,FALSE
ethereumjs-connect,3.0.1,3.0.2,242,1,7576,7554,15130,4,FALSE
ethereumjs-connect,3.0.8,4.0.0,249,9,293354,139998,433352,98,FALSE
ethereumjs-connect,1.2.13,1.2.15,164,1,78,77,155,3,FALSE
ethereumjs-connect,1.2.15,1.2.16,165,1,74,54,128,3,FALSE
ethereumjs-connect,0.8.8,0.8.9,91,1,10,10,20,3,FALSE
ethereumjs-connect,1.2.16,1.2.17,166,1,4,4,8,3,FALSE
ethereumjs-connect,1.2.17,1.2.18,167,1,252,150,402,3,FALSE
ethereumjs-connect,0.9.8,0.9.9,103,1,30969,26147,57116,3,FALSE
ethereumjs-connect,1.2.19,1.2.20,169,1,54,25,79,3,FALSE
ethereumjs-connect,0.4.10,0.5.0,39,1,301,125,426,5,FALSE
ethereumjs-connect,1.3.28,1.3.29,225,1,7,7,14,3,FALSE
ethereumjs-connect,1.3.29,1.3.30,226,1,2132,2169,4301,3,FALSE
ethereumjs-connect,1.3.22,1.3.23,219,1,62,55,117,3,FALSE
ethereumjs-connect,1.3.23,1.3.24,220,1,100,56,156,3,FALSE
ethereumjs-connect,1.3.20,1.3.21,217,1,4,4,8,3,FALSE
ethereumjs-connect,1.3.21,1.3.22,218,1,73,58,131,3,FALSE
ethereumjs-connect,1.3.26,1.3.27,223,1,53,28,81,3,FALSE
ethereumjs-connect,4.0.3,4.0.4,253,1,50,60,110,4,FALSE
ethereumjs-connect,1.3.24,1.3.25,221,1,39,21,60,3,FALSE
ethereumjs-connect,1.3.25,1.3.26,222,1,38,38,76,3,FALSE
ethereumjs-connect,4.0.2,4.0.3,252,2,1160,1167,2327,6,FALSE
ethereumjs-connect,1.2.20,1.2.21,170,1,46,8,54,3,FALSE
ethereumjs-connect,1.4.0,1.4.1,228,1,115,116,231,3,FALSE
ethereumjs-connect,0.7.13,0.7.14,78,1,26797,26796,53593,4,FALSE
ethereumjs-connect,1.0.26,1.1.0,146,1,395,220,615,3,FALSE
ethereumjs-connect,1.0.25,1.0.26,145,1,4,4,8,3,FALSE
ethereumjs-connect,1.0.24,1.0.25,144,1,222,387,609,3,FALSE
ethereumjs-connect,1.0.23,1.0.24,143,1,5,5,10,3,FALSE
ethereumjs-connect,1.0.22,1.0.23,142,1,37,17,54,3,FALSE
ethereumjs-connect,0.8.4,0.8.5,87,1,18,26,44,3,FALSE
ethereumjs-connect,1.0.20,1.0.22,141,3,697,657,1354,8,FALSE
ethereumjs-connect,1.2.25,1.2.26,175,1,30,11,41,3,FALSE
ethereumjs-connect,2.3.1,2.3.2,239,1,2411,34,2445,4,FALSE
ethereumjs-connect,2.0.3,2.1.0,233,1,22,13,35,3,FALSE
ethereumjs-connect,2.0.2,2.0.3,232,2,41,16,57,5,FALSE
ethereumjs-connect,2.0.1,2.0.2,231,1,60,19,79,3,FALSE
ethereumjs-connect,1.2.24,1.2.25,174,1,35,28,63,3,FALSE
ethereumjs-connect,1.3.30,1.4.0,227,1,4,4,8,4,FALSE
ethereumjs-connect,1.2.27,1.2.28,177,1,70,70,140,3,FALSE
ethereumjs-connect,0.3.7,0.3.8,26,1,273,442,715,6,FALSE
ethereumjs-connect,1.2.26,1.2.27,176,1,91,58,149,3,FALSE
ethereumjs-connect,2.2.0,2.3.0,237,1,296,139,435,5,FALSE
ethereumjs-connect,1.2.21,1.2.22,171,1,43,42,85,3,FALSE
ethereumjs-connect,0.5.12,0.5.13,52,1,5,5,10,3,FALSE
ethereumjs-connect,0.5.13,0.6.0,53,1,52,19,71,3,FALSE
ethereumjs-connect,0.5.10,0.5.11,50,1,4,4,8,3,FALSE
ethereumjs-connect,0.5.11,0.5.12,51,1,11,7,18,3,FALSE
ethereumjs-connect,0.9.23,0.9.24,118,1,4,4,8,3,FALSE
ethereumjs-connect,0.9.22,0.9.23,117,1,6,6,12,3,FALSE
ethereumjs-connect,0.9.21,0.9.22,116,1,4,4,8,3,FALSE
ethereumjs-connect,0.6.8,0.6.9,62,1,6,6,12,3,FALSE
ethereumjs-connect,1.2.10,1.2.11,162,1,76,61,137,3,FALSE
ethereumjs-connect,0.9.25,1.0.0,120,1,3,3,6,1,FALSE
ethereumjs-connect,0.9.24,0.9.25,119,1,5,5,10,3,FALSE
ethereumjs-connect,0.6.3,0.6.4,57,1,22,17,39,3,FALSE
ethereumjs-connect,0.6.2,0.6.3,56,1,41,41,82,3,FALSE
ethereumjs-connect,0.6.1,0.6.2,55,1,49,47,96,3,FALSE
ethereumjs-connect,0.6.0,0.6.1,54,1,6,4,10,3,FALSE
ethereumjs-connect,0.6.7,0.6.8,61,1,47,48,95,3,FALSE
ethereumjs-connect,0.6.6,0.6.7,60,1,122,172,294,3,FALSE
ethereumjs-connect,0.6.5,0.6.6,59,1,151,140,291,3,FALSE
ethereumjs-connect,0.6.4,0.6.5,58,1,37,32,69,3,FALSE
ethereumjs-connect,0.4.9,0.4.10,38,1,5,5,10,3,FALSE
ethereumjs-connect,0.4.8,0.4.9,37,1,34,15,49,3,FALSE
ethereumjs-connect,0.4.1,0.4.2,30,1,45,21,66,3,FALSE
ethereumjs-connect,0.4.0,0.4.1,29,1,113,86,199,3,FALSE
ethereumjs-connect,0.4.3,0.4.4,32,1,29,22,51,3,FALSE
ethereumjs-connect,0.4.2,0.4.3,31,1,56,26,82,4,FALSE
ethereumjs-connect,0.4.5,0.4.6,34,1,14,14,28,3,FALSE
ethereumjs-connect,0.4.4,0.4.5,33,1,45,63,108,3,FALSE
ethereumjs-connect,0.4.7,0.4.8,36,1,15,10,25,3,FALSE
ethereumjs-connect,0.4.6,0.4.7,35,1,10,12,22,3,FALSE
ethereumjs-connect,1.2.36,1.2.37,186,1,80,11,91,3,FALSE
ethereumjs-connect,1.2.37,1.2.38,187,1,6,6,12,3,FALSE
ethereumjs-connect,1.2.34,1.2.35,184,1,20,16,36,3,FALSE
ethereumjs-connect,1.2.35,1.2.36,185,1,4,4,8,3,FALSE
ethereumjs-connect,1.2.32,1.2.33,182,1,12,11,23,3,FALSE
ethereumjs-connect,1.2.33,1.2.34,183,1,30,15,45,3,FALSE
ethereumjs-connect,1.2.30,1.2.31,180,2,44,31,75,4,FALSE
ethereumjs-connect,1.2.31,1.2.32,181,1,5,5,10,3,FALSE
ethereumjs-connect,0.7.10,0.7.11,75,1,10672,10516,21188,3,FALSE
ethereumjs-connect,0.9.20,0.9.21,115,1,5,5,10,3,FALSE
ethereumjs-connect,0.8.7,0.8.8,90,1,162,136,298,3,FALSE
ethereumjs-connect,0.8.6,0.8.7,89,1,25006,25001,50007,3,FALSE
ethereumjs-connect,0.7.14,0.7.15,79,2,32,21,53,4,FALSE
ethereumjs-connect,0.7.15,0.7.16,80,1,4,4,8,3,FALSE
ethereumjs-connect,0.7.16,0.7.17,81,1,5,5,10,3,FALSE
ethereumjs-connect,1.2.39,1.2.40,189,1,39,39,78,3,FALSE
ethereumjs-connect,1.3.3,1.3.4,200,1,4,4,8,4,FALSE
ethereumjs-connect,1.3.2,1.3.3,199,1,5,5,10,3,FALSE
ethereumjs-connect,1.3.1,1.3.2,198,1,48,10,58,3,FALSE
ethereumjs-connect,1.3.0,1.3.1,197,1,413,21,434,3,FALSE
ethereumjs-connect,1.3.7,1.3.8,204,1,156,136,292,3,FALSE
ethereumjs-connect,1.3.6,1.3.7,203,1,30,31,61,3,FALSE
ethereumjs-connect,1.3.5,1.3.6,202,1,5,5,10,3,FALSE
ethereumjs-connect,1.3.4,1.3.5,201,2,7,7,14,4,FALSE
ethereumjs-connect,0.8.1,0.8.2,84,1,129,73,202,3,FALSE
ethereumjs-connect,1.3.9,1.3.10,206,1,479,279,758,3,FALSE
ethereumjs-connect,1.3.8,1.3.9,205,1,42,42,84,3,FALSE
ethereumjs-connect,2.1.2,2.2.0,236,1,180,24,204,5,FALSE
ethereumjs-connect,0.6.9,0.6.10,63,1,7,7,14,3,FALSE
ethereumjs-connect,1.2.43,1.2.44,193,1,21,11,32,3,FALSE
ethereumjs-connect,1.2.42,1.2.43,192,1,16,6,22,4,FALSE
ethereumjs-connect,1.2.41,1.2.42,191,1,57,47,104,3,FALSE
ethereumjs-connect,1.2.40,1.2.41,190,1,37,11,48,3,FALSE
ethereumjs-connect,1.2.46,1.3.0,196,1,30,15,45,3,FALSE
ethereumjs-connect,1.2.45,1.2.46,195,1,38,12,50,3,FALSE
ethereumjs-connect,1.2.44,1.2.45,194,1,2,2,4,1,FALSE
ethereumjs-connect,0.1.5,0.1.6,6,1,23,43,66,3,FALSE
ethereumjs-connect,0.6.10,0.7.0,64,1,27,17,44,3,FALSE
ethereumjs-connect,1.1.1,1.1.2,148,1,220,383,603,3,FALSE
ethereumjs-connect,1.1.0,1.1.1,147,1,4,4,8,3,FALSE
ethereumjs-connect,1.1.3,1.1.4,150,1,18,13,31,3,FALSE
ethereumjs-connect,1.1.2,1.1.3,149,1,385,218,603,3,FALSE
ethereumjs-connect,1.1.5,1.2.0,152,1,229,382,611,4,FALSE
ethereumjs-connect,1.1.4,1.1.5,151,1,44,40,84,3,FALSE
ethereumjs-connect,1.2.23,1.2.24,173,1,28,12,40,3,FALSE
ethereumjs-connect,1.2.22,1.2.23,172,1,6,6,12,3,FALSE
ethereumjs-connect,1.2.29,1.2.30,179,1,6,6,12,3,FALSE
ethereumjs-connect,1.2.28,1.2.29,178,1,2,2,4,1,FALSE
ethereumjs-connect,0.8.11,0.9.0,94,1,92,95,187,3,FALSE
ethereumjs-connect,0.2.7,0.2.8,16,2,11,41,52,4,FALSE
ethereumjs-connect,0.1.9,0.2.0,9,1,6990,5327,12317,4,FALSE
ethereumjs-connect,0.2.5,0.2.7,15,3,300,275,575,7,FALSE
ethereumjs-connect,0.2.4,0.2.5,14,2,300,220,520,7,FALSE
ethereumjs-connect,0.2.3,0.2.4,13,4,43799,8104,51903,10,FALSE
ethereumjs-connect,0.2.2,0.2.3,12,1,9,3,12,2,FALSE
ethereumjs-connect,0.2.1,0.2.2,11,1,21,9,30,3,FALSE
ethereumjs-connect,0.2.0,0.2.1,10,2,63,283,346,5,FALSE
ethereumjs-connect,0.1.0,0.1.1,1,2,2650,2630,5280,5,FALSE
ethereumjs-connect,0.1.1,0.1.2,2,1,2,2,4,1,FALSE
ethereumjs-connect,2.1.0,2.1.1,234,1,24,24,48,5,FALSE
ethereumjs-connect,0.1.3,0.1.4,4,1,167,482,649,3,FALSE
ethereumjs-connect,0.1.4,0.1.5,5,2,99,65,164,4,FALSE
ethereumjs-connect,0.1.2,0.1.3,3,5,1012,524,1536,13,FALSE
ethereumjs-connect,0.1.6,0.1.7,7,1,109,83,192,5,FALSE
ethereumjs-connect,0.2.8,0.2.9,17,2,6262,13063,19325,4,FALSE
ethereumjs-connect,2.1.1,2.1.2,235,1,5,5,10,5,FALSE
ethereumjs-connect,0.7.8,0.7.9,73,1,12,11,23,3,FALSE
ethereumjs-connect,0.7.9,0.7.10,74,1,98,130,228,3,FALSE
ethereumjs-connect,0.7.6,0.7.7,71,1,37,77,114,5,FALSE
ethereumjs-connect,0.7.7,0.7.8,72,1,48,35,83,3,FALSE
ethereumjs-connect,0.7.4,0.7.5,69,1,302,307,609,3,FALSE
ethereumjs-connect,0.7.5,0.7.6,70,1,120,10,130,3,FALSE
ethereumjs-connect,0.7.2,0.7.3,67,1,4789,4244,9033,4,FALSE
ethereumjs-connect,0.7.3,0.7.4,68,1,10,16,26,4,FALSE
ethereumjs-connect,0.7.0,0.7.1,65,1,5,5,10,3,FALSE
ethereumjs-connect,0.7.1,0.7.2,66,1,14,11,25,3,FALSE
ethereumjs-connect,0.8.5,0.8.6,88,1,3,6,9,3,FALSE
ethereumjs-connect,0.9.1,0.9.2,96,1,14,17,31,3,FALSE
ethereumjs-connect,0.5.8,0.5.9,48,1,40,40,80,3,FALSE
ethereumjs-connect,0.2.9,0.3.0,18,1,11000,3761,14761,3,FALSE
ethereumjs-connect,0.7.11,0.7.12,76,1,68,55,123,3,FALSE
ethereumjs-connect,0.5.4,0.5.5,44,1,307,310,617,3,FALSE
ethereumjs-connect,0.5.5,0.5.6,45,1,4085,20394,24479,3,FALSE
ethereumjs-connect,0.5.6,0.5.7,46,1,22,12,34,3,FALSE
ethereumjs-connect,0.1.7,0.1.9,8,3,10251,68111,78362,10,FALSE
ethereumjs-connect,0.5.0,0.5.1,40,1,15824,11028,26852,4,FALSE
ethereumjs-connect,0.5.1,0.5.2,41,2,42,42,84,4,FALSE
ethereumjs-connect,0.5.2,0.5.3,42,1,69,57,126,4,FALSE
ethereumjs-connect,0.5.3,0.5.4,43,1,20,15,35,3,FALSE
ethereumjs-connect,0.9.0,0.9.1,95,1,150,76,226,3,FALSE
ethereumjs-connect,1.2.11,1.2.13,163,1,43,43,86,3,FALSE
ethereumjs-connect,0.9.2,0.9.3,97,1,138,166,304,3,FALSE
ethereumjs-connect,0.9.3,0.9.4,98,1,22,18,40,5,FALSE
ethereumjs-connect,0.9.4,0.9.5,99,2,4,4,8,2,FALSE
ethereumjs-connect,0.9.5,0.9.6,100,1,119,115,234,3,FALSE
ethereumjs-connect,0.9.6,0.9.7,101,1,19,14,33,3,FALSE
ethereumjs-connect,0.9.7,0.9.8,102,1,82,81,163,3,FALSE
ethereumjs-connect,1.2.18,1.2.19,168,1,4,3,7,3,FALSE
ethereumjs-connect,0.9.9,0.9.10,104,1,4,4,8,3,FALSE
ethereumjs-connect,2.3.2,3.0.0,240,4,11975,5151,17126,21,FALSE
ethereumjs-connect,0.8.2,0.8.3,85,1,50,18,68,3,FALSE
ethereumjs-connect,0.8.0,0.8.1,83,1,5,5,10,3,FALSE
ethereumjs-connect,1.2.6,1.2.7,158,1,12,8,20,3,FALSE
ethereumjs-connect,1.2.7,1.2.8,159,1,83,77,160,3,FALSE
ethereumjs-connect,1.2.4,1.2.5,156,1,4,5,9,3,FALSE
ethereumjs-connect,1.2.5,1.2.6,157,1,19,14,33,3,FALSE
ethereumjs-connect,1.2.2,1.2.4,155,4,324,439,763,9,FALSE
ethereumjs-connect,1.2.38,1.2.39,188,1,41,41,82,3,FALSE
ethereumjs-connect,1.2.0,1.2.1,153,1,27,11,38,3,FALSE
ethereumjs-connect,1.2.1,1.2.2,154,1,440,220,660,3,FALSE
ethereumjs-connect,0.7.17,0.8.0,82,1,65,54,119,3,FALSE
ethereumjs-connect,1.2.8,1.2.9,160,1,6,5,11,3,FALSE
ethereumjs-connect,1.2.9,1.2.10,161,1,19,14,33,3,FALSE
ethereumjs-connect,2.0.0,2.0.1,230,1,20972,27232,48204,4,FALSE
ethereumjs-connect,1.3.27,1.3.28,224,1,47,42,89,3,FALSE
ethereumjs-connect,0.8.3,0.8.4,86,1,16,11,27,3,FALSE
ethereumjs-connect,1.3.13,1.3.14,210,1,18,17,35,3,FALSE
ethereumjs-connect,1.3.12,1.3.13,209,1,73,58,131,3,FALSE
ethereumjs-connect,1.3.11,1.3.12,208,1,101,91,192,3,FALSE
ethereumjs-connect,1.3.10,1.3.11,207,1,28827,28297,57124,3,FALSE
ethereumjs-connect,1.3.17,1.3.18,214,1,39,39,78,3,FALSE
ethereumjs-connect,1.3.16,1.3.17,213,1,120,19,139,3,FALSE
ethereumjs-connect,1.3.15,1.3.16,212,1,57,64,121,3,FALSE
ethereumjs-connect,1.3.14,1.3.15,211,1,24,18,42,3,FALSE
ethereumjs-connect,1.3.19,1.3.20,216,1,81,51,132,3,FALSE
ethereumjs-connect,1.3.18,1.3.19,215,1,44,18,62,3,FALSE
ethereumjs-connect,4.0.3,4.0.4,253,1,50,60,110,4,TRUE
ethereumjs-connect,2.0.3,2.1.0,233,1,22,13,35,3,TRUE
ethereumjs-connect,1.2.34,1.2.35,184,1,20,16,36,3,TRUE
ethereumjs-connect,0.7.2,0.7.3,67,1,4789,4244,9033,4,TRUE
ethereumjs-connect,0.1.7,0.1.9,8,3,10251,68111,78362,10,TRUE
ethereumjs-connect,1.2.6,1.2.7,158,1,12,8,20,3,TRUE
ethereumjs-connect,1.2.2,1.2.4,155,4,324,439,763,9,TRUE
ethereumjs-connect,0.9.19,0.9.20,114,1,23,15,38,3,TRUE
ethereumjs-connect,0.4.8,0.4.9,37,1,34,15,49,3,TRUE
ethereumjs-connect,2.3.2,3.0.0,240,4,11975,5151,17126,21,TRUE
ethereumjs-connect,0.2.3,0.2.4,13,4,43799,8104,51903,10,TRUE
ethereumjs-connect,1.0.1,1.0.2,122,1,58,47,105,3,TRUE
ethereumjs-connect,4.0.5,4.0.6,255,1,1509,1264,2773,4,TRUE
ethereumjs-connect,3.0.3,3.0.4,244,1,160,269,429,4,TRUE
ethereumjs-connect,2.3.1,2.3.2,239,1,2411,34,2445,4,TRUE
ethereumjs-connect,0.5.13,0.6.0,53,1,52,19,71,3,TRUE
ethereumjs-connect,0.9.25,1.0.0,120,1,3,3,6,1,TRUE
ethereumjs-connect,0.4.9,0.4.10,38,1,5,5,10,3,TRUE
ethereumjs-connect,1.2.46,1.3.0,196,1,30,15,45,3,TRUE
ethereumjs-connect,0.1.2,0.1.3,3,5,1012,524,1536,13,TRUE
react-router,1.0.0-beta2,1.0.0-beta3,45,78,1437,755,2192,190,FALSE
react-router,1.0.0-beta1,1.0.0-beta2,44,30,1268,817,2085,49,FALSE
react-router,1.0.0-alpha2,1.0.0-beta1,43,33,1175,962,2137,61,FALSE
react-router,1.0.0-alpha1,1.0.0-alpha2,42,9,22,1241,1263,10,FALSE
react-router,3.0.4,3.0.5,89,1,1,1,2,1,FALSE
react-router,3.0.0-alpha.3,3.0.0-beta.1,83,236,12047,21098,33145,985,FALSE
react-router,1.0.1,1.0.2,53,36,1671,752,2423,88,FALSE
react-router,1.0.2,1.0.3,54,62,5163,2122,7285,265,FALSE
react-router,1.0.3,2.0.0-rc1,55,8,784,963,1747,19,FALSE
react-router,3.0.0-beta.1,3.0.0,84,68,2556,917,3473,168,FALSE
react-router,2.0.0-rc6,2.0.0,61,7,44,14,58,20,FALSE
react-router,2.0.0-rc5,2.0.0-rc6,60,60,1136,560,1696,117,FALSE
react-router,2.0.0-rc4,2.0.0-rc5,59,78,738,374,1112,128,FALSE
react-router,2.2.1,2.2.2,67,4,30,13,43,5,FALSE
react-router,2.2.0,2.2.1,66,4,22,8,30,6,FALSE
react-router,2.0.0-rc1,2.0.0-rc2,56,8,135,38,173,23,FALSE
react-router,2.2.2,2.2.4,68,9,107,77,184,10,FALSE
react-router,1.0.0-rc1,1.0.0-rc2,48,174,7068,5788,12856,542,FALSE
react-router,1.0.0-rc2,1.0.0-rc3,49,9,142,34,176,17,FALSE
react-router,1.0.0-rc3,1.0.0-rc4,50,174,4663,1383,6046,451,FALSE
react-router,1.0.0-rc4,1.0.0,51,33,1136,2279,3415,56,FALSE
react-router,2.1.0,2.1.1,64,3,49,144,193,7,FALSE
react-router,3.0.3,3.0.4,88,9,124,80,204,58,FALSE
react-router,1.0.0-beta3,1.0.0-beta4,46,101,9312,5456,14768,323,FALSE
react-router,2.1.1,2.2.0,65,16,719,207,926,65,FALSE
react-router,4.1.0,4.1.1,107,4,749,51,800,7,FALSE
react-router,3.0.0-alpha.1,3.0.0-alpha.2,81,173,10143,6103,16246,701,FALSE
react-router,1.0.0-beta4,1.0.0-rc1,47,122,7032,12903,19935,498,FALSE
react-router,2.0.0,2.0.1,62,54,901,454,1355,92,FALSE
react-router,3.0.0,3.0.1,85,103,11692,7753,19445,425,FALSE
react-router,4.0.0-beta.8,4.0.0,105,26,38817,31357,70174,612,FALSE
react-router,2.5.0,2.5.1,73,8,183,26,209,17,FALSE
react-router,4.0.0-beta.1,4.0.0-beta.2,98,4,34,109,143,13,FALSE
react-router,4.0.0-beta.3,4.0.0-beta.4,100,22,281,55,336,37,FALSE
react-router,4.0.0-beta.2,4.0.0-beta.3,99,9,73,46,119,14,FALSE
react-router,4.0.0-beta.4,4.0.0-beta.5,101,20,450,114,564,55,FALSE
react-router,4.0.0-beta.7,4.0.0-beta.8,104,42,12636,2035,14671,272,FALSE
react-router,2.0.1,2.1.0,63,55,1174,621,1795,138,FALSE
react-router,4.0.0,4.1.0,106,69,2275,884,3159,162,FALSE
react-router,2.3.0,2.4.0,70,40,1043,3773,4816,137,FALSE
react-router,3.0.1,3.0.2,86,24,930,687,1617,61,FALSE
react-router,2.4.1,2.5.0,72,85,6856,3823,10679,312,FALSE
react-router,2.4.0,2.4.1,71,49,1441,1205,2646,132,FALSE
react-router,2.5.2,2.6.0,75,52,1876,1705,3581,284,FALSE
react-router,1.0.0,1.0.1,52,73,1311,1059,2370,153,FALSE
react-router,2.2.4,2.3.0,69,13,445,116,561,40,FALSE
react-router,2.6.1,2.7.0,77,89,3355,2909,6264,323,FALSE
react-router,2.6.0,2.6.1,76,41,936,793,1729,107,FALSE
react-router,2.7.0,2.8.0,78,61,7406,17307,24713,494,FALSE
react-router,2.5.1,2.5.2,74,22,1006,349,1355,70,FALSE
react-router,2.8.0,2.8.1,79,36,680,657,1337,78,FALSE
react-router,3.0.2,3.0.3,87,335,69794,39586,109380,1886,FALSE
react-router,3.0.0-alpha.2,3.0.0-alpha.3,82,41,932,772,1704,122,FALSE
react-router,2.0.0-rc3,2.0.0-rc4,58,3,13,2,15,3,FALSE
react-router,2.0.0-rc2,2.0.0-rc3,57,18,137,97,234,18,FALSE
react-router,0.10.1,0.10.2,21,4,99,183,282,17,FALSE
react-router,0.10.0,0.10.1,20,4,51,48,99,8,FALSE
react-router,0.9.2,0.9.3,16,3,30,12,42,9,FALSE
react-router,0.10.2,0.11.0,22,122,8393,13035,21428,478,FALSE
react-router,0.9.4,0.9.5,18,10,209,91,300,21,FALSE
react-router,0.9.5,0.10.0,19,2,1080,1054,2134,8,FALSE
react-router,0.9.1,0.9.2,15,18,645,800,1445,59,FALSE
react-router,0.11.4,0.11.5,27,32,755,321,1076,83,FALSE
react-router,0.11.5,0.11.6,28,8,128,93,221,17,FALSE
react-router,0.11.0,0.11.1,23,4,106,28,134,11,FALSE
react-router,0.11.1,0.11.2,24,24,359,87,446,38,FALSE
react-router,0.11.2,0.11.3,25,19,1892,385,2277,42,FALSE
react-router,0.8.0,0.9.0,13,29,3164,3340,6504,107,FALSE
react-router,0.9.3,0.9.4,17,59,5564,1221,6785,125,FALSE
react-router,0.9.0,0.9.1,14,5,43,24,67,10,FALSE
react-router,0.7.0,0.8.0,12,64,8997,6825,15822,269,FALSE
react-router,0.11.3,0.11.4,26,9,166,75,241,18,FALSE
react-router,0.6.1,0.7.0,11,17,1368,1042,2410,109,FALSE
react-router,0.0.0,0.0.1,1,296,202475,198777,401252,792,FALSE
react-router,0.4.1,0.4.2,4,8,158,34,192,20,FALSE
react-router,0.4.0,0.4.1,3,7,35,10,45,9,FALSE
react-router,0.4.2,0.5.0,5,2,16,9,25,6,FALSE
react-router,0.5.0,0.5.1,6,50,2521,1274,3795,175,FALSE
react-router,0.5.1,0.5.2,7,14,607,144,751,62,FALSE
react-router,2.0.0,2.0.1,62,54,901,454,1355,92,TRUE
react-router,0.13.5,0.13.6,40,801,28163,20782,48945,2207,FALSE
react-router,4.0.0-beta.5,4.0.0-beta.6,102,17,163,95,258,37,FALSE
react-router,4.0.0-beta.6,4.0.0-beta.7,103,53,2444,859,3303,188,FALSE
react-router,0.6.0,0.6.1,10,8,1634,953,2587,16,FALSE
react-router,0.5.3,0.6.0,9,32,2792,1346,4138,120,FALSE
react-router,4.0.0-alpha.4,4.0.0-alpha.5,95,27,943,144,1087,59,FALSE
react-router,4.0.0-alpha.5,4.0.0-alpha.6,96,34,1249,646,1895,61,FALSE
react-router,4.0.0-alpha.3,4.0.0-alpha.4,94,24,766,553,1319,77,FALSE
react-router,4.0.0-0,4.0.0-1,91,3,21,17,38,4,FALSE
react-router,4.0.0-1,4.0.0-2,92,3,14,7,21,4,FALSE
react-router,4.0.0-2,4.0.0-alpha.3,93,68,1030,421,1451,145,FALSE
react-router,4.0.0-alpha.6,4.0.0-beta.1,97,193,25029,12152,37181,1017,FALSE
react-router,0.13.4,0.13.5,39,208,5289,1728,7017,529,FALSE
react-router,0.13.2,0.13.3,37,29,4243,2498,6741,152,FALSE
react-router,0.13.3,0.13.4,38,794,55492,63487,118979,2767,FALSE
react-router,0.5.2,0.5.3,8,55,2526,1725,4251,149,FALSE
react-router,0.12.3,0.12.4,33,3,118,84,202,16,FALSE
react-router,0.12.2,0.12.3,32,11,1632,1589,3221,52,FALSE
react-router,0.12.1,0.12.2,31,2,296,433,729,13,FALSE
react-router,0.12.0,0.12.1,30,46,5398,1766,7164,150,FALSE
react-router,0.12.4,0.13.0,34,49,2173,2158,4331,122,FALSE
react-router,0.13.0,0.13.1,35,2,91,85,176,8,FALSE
react-router,0.13.1,0.13.2,36,33,711,426,1137,74,FALSE
react-router,0.11.6,0.12.0,29,122,11960,11445,23405,312,FALSE
react-router,4.1.0,4.1.1,107,4,749,51,800,7,TRUE
react-router,2.2.2,2.2.4,68,9,107,77,184,10,TRUE
react-router,1.0.0-rc2,1.0.0-rc3,49,9,142,34,176,17,TRUE
react-router,1.0.0-beta4,1.0.0-rc1,47,122,7032,12903,19935,498,TRUE
react-router,4.0.0-beta.7,4.0.0-beta.8,104,42,12636,2035,14671,272,TRUE
react-router,3.0.0-beta.1,3.0.0,84,68,2556,917,3473,168,TRUE
react-router,1.0.0-beta3,1.0.0-beta4,46,101,9312,5456,14768,323,TRUE
react-router,0.0.1,0.4.0,2,65,9993,6908,16901,157,TRUE
react-router,1.0.3,2.0.0-rc1,55,8,784,963,1747,19,TRUE
react-router,0.4.1,0.4.2,4,8,158,34,192,20,TRUE
react-router,3.0.0-alpha.3,3.0.0-beta.1,83,236,12047,21098,33145,985,TRUE
react-router,1.0.0-rc3,1.0.0-rc4,50,174,4663,1383,6046,451,TRUE
react-router,0.0.1,0.4.0,2,65,9993,6908,16901,157,FALSE
react-router,2.3.0,2.4.0,70,40,1043,3773,4816,137,TRUE
react-router,2.5.1,2.5.2,74,22,1006,349,1355,70,TRUE
react-router,3.0.2,3.0.3,87,335,69794,39586,109380,1886,TRUE
react-router,2.0.1,2.1.0,63,55,1174,621,1795,138,TRUE
react-router,1.0.0-alpha2,1.0.0-beta1,43,33,1175,962,2137,61,TRUE
react-router,2.0.0-rc4,2.0.0-rc5,59,78,738,374,1112,128,TRUE
react-router,4.0.0-beta.5,4.0.0-beta.6,102,17,163,95,258,37,TRUE
react-router,2.0.0-rc1,2.0.0-rc2,56,8,135,38,173,23,TRUE
react-router,3.0.0-alpha.1,3.0.0-alpha.2,81,173,10143,6103,16246,701,TRUE
react-router,3.0.0-alpha.2,3.0.0-alpha.3,82,41,932,772,1704,122,TRUE
react-router,2.5.2,2.6.0,75,52,1876,1705,3581,284,TRUE
react-router,2.6.0,2.6.1,76,41,936,793,1729,107,TRUE
react-router,2.7.0,2.8.0,78,61,7406,17307,24713,494,TRUE
react-router,4.0.0-alpha.6,4.0.0-beta.1,97,193,25029,12152,37181,1017,TRUE
react-router,1.0.2,1.0.3,54,62,5163,2122,7285,265,TRUE
react-router,4.0.0-beta.3,4.0.0-beta.4,100,22,281,55,336,37,TRUE
react-router,0.9.4,0.9.5,18,10,209,91,300,21,TRUE
react-router,0.9.5,0.10.0,19,2,1080,1054,2134,8,TRUE
react-router,1.0.0-rc1,1.0.0-rc2,48,174,7068,5788,12856,542,TRUE
image-steam,0.1.1,0.1.2,2,1,24,15,39,7,FALSE
image-steam,0.15.0,0.16.0,30,3,13,7,20,5,FALSE
image-steam,0.6.0,0.7.0,14,1,161,58,219,11,FALSE
image-steam,0.31.2,0.31.3,70,14,185,26,211,18,FALSE
image-steam,0.31.3,0.32.0,71,18,308,229,537,34,FALSE
image-steam,0.31.0,0.31.1,68,3,4,20,24,10,FALSE
image-steam,0.31.1,0.31.2,69,3,929,101,1030,19,FALSE
image-steam,0.32.0,0.33.0,72,8,194,21,215,21,FALSE
image-steam,0.26.1,0.26.2,54,4,238,7,245,7,FALSE
image-steam,0.24.1-alpha.1,0.24.1,47,1,26,9,35,6,FALSE
image-steam,0.7.1,0.7.2,16,2,4,5,9,3,FALSE
image-steam,0.2.0,0.3.0,7,2,36,3,39,6,FALSE
image-steam,0.1.0,0.1.1,1,1,1606,0,1606,45,FALSE
image-steam,0.34.6,0.34.7,80,3,9,5,14,5,FALSE
image-steam,0.1.2,0.1.3,3,1,16,1,17,2,FALSE
image-steam,0.34.4,0.34.5,78,2,5,1,6,2,FALSE
image-steam,0.1.4,0.1.5,5,3,20,5,25,4,FALSE
image-steam,0.1.5,0.2.0,6,10,246,61,307,24,FALSE
image-steam,0.34.1,0.34.2,75,3,7,3,10,3,FALSE
image-steam,0.34.0,0.34.1,74,4,6,6,12,4,FALSE
image-steam,0.10.0,0.11.0,20,1,31,1,32,6,FALSE
image-steam,0.1.3,0.1.4,4,1,23,21,44,2,FALSE
image-steam,0.34.3,0.34.4,77,2,4,4,8,2,FALSE
image-steam,0.3.0,0.3.1,8,1,9,2,11,2,FALSE
image-steam,0.3.1,0.4.0,9,1,16,1,17,4,FALSE
image-steam,0.11.0,0.12.0,21,3,160,23,183,20,FALSE
image-steam,0.12.1,0.12.2,23,1,7,1,8,2,FALSE
image-steam,0.7.0,0.7.1,15,3,17,6,23,3,FALSE
image-steam,0.34.2,0.34.3,76,3,87,30,117,4,FALSE
image-steam,0.12.3,0.12.4,25,1,2,2,4,2,FALSE
image-steam,0.12.2,0.12.3,24,4,18,1,19,8,FALSE
image-steam,0.17.0,0.18.0,32,2,16,4,20,3,FALSE
image-steam,0.12.0,0.12.1,22,1,48,18,66,4,FALSE
image-steam,0.20.0,0.20.1,39,2,386,380,766,10,FALSE
image-steam,0.20.1,0.21.0,40,3,17,3,20,5,FALSE
image-steam,0.34.5,0.34.6,79,2,8,5,13,2,FALSE
image-steam,0.12.4,0.13.0,26,2,39,21,60,10,FALSE
image-steam,0.4.0,0.5.0-alpha1,10,1,23,0,23,2,FALSE
image-steam,0.23.1,0.24.0,45,1,39,2,41,3,FALSE
image-steam,0.7.2,0.8.0,17,6,241,96,337,6,FALSE
image-steam,0.5.0,0.6.0,13,1,169,6,175,5,FALSE
image-steam,0.13.0,0.14.0,27,1,26,7,33,3,FALSE
image-steam,0.9.0,0.10.0,19,1,113,23,136,10,FALSE
image-steam,0.14.1,0.15.0,29,1,41,12,53,7,FALSE
image-steam,0.14.0,0.14.1,28,1,3,1,4,2,FALSE
image-steam,0.22.0,0.22.1,42,1,2,2,4,2,FALSE
image-steam,0.22.1,0.23.0,43,1,48,31,79,4,FALSE
image-steam,0.24.0,0.24.1-alpha.1,46,1,3,3,6,2,FALSE
image-steam,0.21.0,0.22.0,41,1,5,1,6,2,FALSE
image-steam,0.25.2,0.25.3,51,4,40,40,80,6,FALSE
image-steam,0.16.0,0.17.0,31,3,100,17,117,8,TRUE
image-steam,0.25.1,0.25.2,50,1,8,3,11,2,FALSE
image-steam,0.25.0,0.25.1,49,1,10,10,20,2,FALSE
image-steam,0.25.3,0.26.0,52,1,59,2,61,13,FALSE
image-steam,0.8.0,0.9.0,18,2,81,37,118,11,FALSE
image-steam,0.29.1,0.30.0,62,1,10,4,14,2,FALSE
image-steam,0.29.0,0.29.1,61,1,2,2,4,2,FALSE
image-steam,0.26.3,0.27.0,56,3,27,19,46,7,FALSE
image-steam,0.5.0-alpha2,0.5.0,12,1,81,9,90,7,FALSE
image-steam,0.5.0-alpha1,0.5.0-alpha2,11,1,3,3,6,2,FALSE
image-steam,0.18.1,0.18.2,34,1,28,18,46,2,FALSE
image-steam,0.18.0,0.18.1,33,2,3,3,6,2,FALSE
image-steam,0.18.3,0.18.4,36,1,10,6,16,3,TRUE
image-steam,0.18.2,0.18.3,35,1,51,34,85,4,FALSE
image-steam,0.28.0,0.29.0,60,1,164,89,253,4,FALSE
image-steam,0.27.2,0.28.0,59,6,81,4,85,17,FALSE
image-steam,0.27.1,0.27.2,58,2,6,2,8,2,FALSE
image-steam,0.27.0,0.27.1,57,3,3,3,6,3,FALSE
image-steam,0.23.0,0.23.1,44,1,9,2,11,2,FALSE
image-steam,0.18.4,0.19.0,37,4,187,119,306,7,FALSE
image-steam,0.19.0,0.20.0,38,2,509,444,953,7,FALSE
image-steam,0.26.0,0.26.1,53,1,11,3,14,3,FALSE
image-steam,0.26.2,0.26.3,55,3,57,17,74,5,FALSE
image-steam,0.24.1,0.25.0,48,2,58,56,114,3,FALSE
image-steam,0.33.0,0.34.0,73,6,755,328,1083,29,FALSE
image-steam,0.30.3,0.30.4,66,2,9,11,20,4,FALSE
image-steam,0.30.2,0.30.3,65,1,11,7,18,2,FALSE
image-steam,0.30.1,0.30.2,64,1,2,2,4,2,FALSE
image-steam,0.30.0,0.30.1,63,1,3,2,5,2,FALSE
image-steam,0.30.4,0.31.0,67,2,123,98,221,17,TRUE
image-steam,0.5.0,0.6.0,13,1,169,6,175,5,TRUE
image-steam,0.16.0,0.17.0,31,3,100,17,117,8,FALSE
image-steam,0.18.3,0.18.4,36,1,10,6,16,3,FALSE
image-steam,0.30.4,0.31.0,67,2,123,98,221,17,FALSE
image-steam,0.12.2,0.12.3,24,4,18,1,19,8,TRUE
image-steam,0.26.2,0.26.3,55,3,57,17,74,5,TRUE
image-steam,0.20.0,0.20.1,39,2,386,380,766,10,TRUE
image-steam,0.13.0,0.14.0,27,1,26,7,33,3,TRUE
react-tween,0.4.0-alpha.4,0.4.0-alpha.5,38,6,4884,243,5127,19,FALSE
react-tween,0.4.0-alpha.14,0.4.0-alpha.15,48,5,58,127,185,11,FALSE
react-tween,0.4.0-alpha.16,0.4.0-alpha.17,50,3,29,1,30,3,FALSE
react-tween,0.4.0-alpha.5,0.4.0-alpha.6,39,1,1,1,2,1,FALSE
react-tween,0.4.0-alpha.6,0.4.0-alpha.7,40,1,1,1,2,1,FALSE
react-tween,0.4.0-alpha.15,0.4.0-alpha.16,49,2,5,28,33,4,FALSE
react-tween,0.4.0-alpha.12,0.4.0-alpha.13,46,3,50,12,62,5,FALSE
react-tween,0.4.0-alpha.13,0.4.0-alpha.14,47,1,1,0,1,1,FALSE
react-tween,0.4.0-alpha.10,0.4.0-alpha.11,44,2,3,1,4,2,FALSE
react-tween,0.4.0-alpha.11,0.4.0-alpha.12,45,3,15,17,32,6,FALSE
react-tween,0.4.0-alpha.7,0.4.0-alpha.8,41,1,58,16,74,7,FALSE
react-tween,0.4.0-alpha.8,0.4.0-alpha.9,42,4,141,207,348,10,FALSE
react-tween,0.4.0-alpha.9,0.4.0-alpha.10,43,3,16,5,21,5,FALSE
react-tween,0.1.10,0.1.11,15,7,410,411,821,32,FALSE
react-tween,0.1.9,0.1.10-1,10,2,102,17,119,4,FALSE
react-tween,0.1.10-3,0.1.10-4,13,3,288,285,573,20,FALSE
react-tween,0.1.10-2,0.1.10-3,12,2,11,17,28,3,FALSE
react-tween,0.1.10-1,0.1.10-2,11,1,42,98,140,5,FALSE
react-tween,0.4.0-alpha.2,0.4.0-alpha.3,36,3,238,14,252,9,FALSE
react-tween,0.4.0-alpha.1,0.4.0-alpha.2,35,1,1,1,2,1,FALSE
react-tween,0.4.0-alpha.3,0.4.0-alpha.4,37,2,65,65,130,2,FALSE
react-tween,0.1.1,0.1.2,2,4,359,23,382,12,FALSE
react-tween,0.1.2,0.1.3,3,1,1,1,2,1,FALSE
react-tween,0.1.3,0.1.4,4,3,32,32,64,6,FALSE
react-tween,0.1.4,0.1.5,5,1,1,1,2,1,FALSE
react-tween,0.1.5,0.1.6,6,2,25,15,40,5,FALSE
react-tween,0.1.6,0.1.7,7,1,66,10,76,5,FALSE
react-tween,0.3.3-alpha.1,0.3.3-alpha.2,31,1,1,1,2,1,FALSE
react-tween,0.3.3-alpha.2,0.3.3-alpha.3,32,1,1,1,2,1,FALSE
react-tween,0.3.3-alpha.3,0.3.3,33,1,1,1,2,1,FALSE
react-tween,0.3.2,0.3.3-alpha.1,30,2,25,23,48,5,FALSE
react-tween,0.3.1,0.3.2,29,1,1,1,2,1,FALSE
react-tween,0.2.1,0.3.0-alpha.1,24,2,154,83,237,7,FALSE
react-tween,0.2.0,0.2.1,23,7,8,40,48,7,FALSE
react-tween,0.1.8,0.1.9,9,1,9,6,15,3,FALSE
react-tween,0.1.7,0.1.8,8,2,221,367,588,14,FALSE
react-tween,0.2.0-alpha.2,0.2.0,22,2,40,37,77,8,FALSE
react-tween,0.3.3,0.4.0-alpha.1,34,4,468,1364,1832,38,FALSE
react-tween,0.3.0,0.3.1,28,3,175,73,248,10,FALSE
react-tween,0.1.12,0.1.13,17,4,55,26,81,6,FALSE
react-tween,0.1.13,0.1.14,18,2,39,11,50,3,FALSE
react-tween,0.1.11,0.1.12,16,3,160,115,275,10,FALSE
react-tween,0.1.14,0.1.15,19,2,36,75,111,6,FALSE
react-tween,0.1.15,0.2.0-alpha.1,20,18,1365,592,1957,57,FALSE
react-tween,0.2.0-alpha.1,0.2.0-alpha.2,21,1,1,1,2,1,FALSE
react-tween,0.3.0-alpha.3,0.3.0,27,1,1,1,2,1,FALSE
react-tween,0.3.0-alpha.2,0.3.0-alpha.3,26,1,12,11,23,3,FALSE
react-tween,0.3.0-alpha.1,0.3.0-alpha.2,25,1,1,1,2,1,FALSE
react-tween,0.1.6,0.1.7,7,1,66,10,76,5,TRUE
react-tween,0.4.0-alpha.3,0.4.0-alpha.4,37,2,65,65,130,2,TRUE
react-tween,0.2.0,0.2.1,23,7,8,40,48,7,TRUE
react-tween,0.3.2,0.3.3-alpha.1,30,2,25,23,48,5,TRUE
react-tween,0.3.0-alpha.2,0.3.0-alpha.3,26,1,12,11,23,3,TRUE
react-tween,0.3.3,0.4.0-alpha.1,34,4,468,1364,1832,38,TRUE
react-tween,0.1.10-2,0.1.10-3,12,2,11,17,28,3,TRUE
react-tween,0.4.0-alpha.12,0.4.0-alpha.13,46,3,50,12,62,5,TRUE
ho-iter,0.1.0,0.2.0,1,12,838,200,1038,57,FALSE
ho-iter,0.2.0,0.3.0,2,9,395,39,434,17,FALSE
ho-iter,0.2.0,0.3.0,2,9,395,39,434,17,TRUE
phaethon,0.1.0,0.1.1,1,10,172,49,221,16,FALSE
phaethon,0.1.1,0.2.0,2,21,370,260,630,53,FALSE
phaethon,0.1.1,0.2.0,2,21,370,260,630,53,TRUE
ng2-bs-dialogs-creator,4.1.1-beta.10,4.1.1-beta.11,11,1,28,28,56,5,FALSE
ng2-bs-dialogs-creator,4.1.1-beta.9,4.1.1-beta.10,10,1,206,181,387,3,FALSE
ng2-bs-dialogs-creator,1.0.0-beta.8,1.0.0-beta.9,8,1,206,181,387,3,FALSE
ng2-bs-dialogs-creator,1.0.0-beta.9,4.1.1-beta.9,9,2,14,14,28,2,FALSE
ng2-bs-dialogs-creator,1.0.0-beta.6,1.0.0-beta.7,6,1,206,181,387,3,FALSE
ng2-bs-dialogs-creator,1.0.0-beta.7,1.0.0-beta.8,7,2,496,30,526,34,FALSE
ng2-bs-dialogs-creator,1.0.0-beta.4,1.0.0-beta.5,4,1,1,1,2,1,FALSE
ng2-bs-dialogs-creator,1.0.0-beta.5,1.0.0-beta.6,5,2,488,27,515,31,FALSE
ng2-bs-dialogs-creator,1.0.0-beta.2,1.0.0-beta.3,2,1,257,0,257,10,FALSE
ng2-bs-dialogs-creator,1.0.0-beta.3,1.0.0-beta.4,3,3,157,5,162,7,FALSE
ng2-bs-dialogs-creator,1.0.0-beta.1,1.0.0-beta.2,1,1,206,181,387,3,FALSE
ng2-bs-dialogs-creator,1.0.0-beta.9,4.1.1-beta.9,9,2,14,14,28,2,TRUE
ng2-bs-dialogs-creator,1.0.0-beta.7,1.0.0-beta.8,7,2,496,30,526,34,TRUE
reaction-cli,0.1.6,0.1.7,4,1,2,2,4,2,FALSE
reaction-cli,0.1.7,0.1.8,5,1,37,36,73,5,FALSE
reaction-cli,0.6.0,0.6.2,59,2,2,2,4,2,FALSE
reaction-cli,0.7.2,0.7.3,79,2,8,3,11,3,FALSE
reaction-cli,0.6.6,0.6.7,63,2,11,2,13,2,FALSE
reaction-cli,0.6.5,0.6.6,62,1,22,7,29,4,FALSE
reaction-cli,0.6.4,0.6.5,61,2,13,11,24,2,FALSE
reaction-cli,0.6.9,0.6.10,66,1,6,3,9,2,FALSE
reaction-cli,0.6.8,0.6.9,65,3,13,5,18,3,FALSE
reaction-cli,0.7.8,0.7.9,85,2,18,4,22,3,FALSE
reaction-cli,0.7.9,0.7.10,86,3,4,4,8,3,FALSE
reaction-cli,0.7.6,0.7.7,83,4,81,15,96,12,FALSE
reaction-cli,0.7.7,0.7.8,84,3,53,31,84,3,FALSE
reaction-cli,0.7.4,0.7.5,81,9,246,18,264,16,FALSE
reaction-cli,0.7.5,0.7.6,82,1,4,4,8,3,FALSE
reaction-cli,0.6.7,0.6.8,64,2,2,2,4,2,FALSE
reaction-cli,0.7.3,0.7.4,80,1,19,1,20,2,FALSE
reaction-cli,0.7.0,0.7.1,77,9,174,57,231,19,FALSE
reaction-cli,0.7.1,0.7.2,78,1,4,4,8,3,FALSE
reaction-cli,0.6.20,0.6.21,75,3,206,173,379,9,FALSE
reaction-cli,0.6.21,0.7.0,76,4,233,8,241,10,FALSE
reaction-cli,0.5.9,0.6.0,58,5,84,16,100,11,FALSE
reaction-cli,0.8.4,0.9.0,95,2,30,29,59,4,FALSE
reaction-cli,0.5.7,0.5.9,57,3,38,14,52,11,FALSE
reaction-cli,0.9.0,0.9.1,96,2,12,1,13,2,FALSE
reaction-cli,0.9.1,0.9.2,97,2,8,2,10,2,FALSE
reaction-cli,0.7.10,0.7.11,87,3,22,3,25,4,FALSE
reaction-cli,0.7.11,0.7.12,88,5,14,8,22,6,FALSE
reaction-cli,0.7.12,0.7.13,89,4,32,9,41,5,FALSE
reaction-cli,0.7.13,0.8.0,90,5,149,9,158,14,FALSE
reaction-cli,0.8.1,0.8.2,92,2,30,3,33,3,FALSE
reaction-cli,0.8.0,0.8.1,91,3,28,15,43,4,FALSE
reaction-cli,0.8.3,0.8.4,94,2,5,2,7,2,FALSE
reaction-cli,0.8.2,0.8.3,93,3,3010,1,3011,3,FALSE
reaction-cli,0.6.19,0.6.20,74,16,615,78,693,34,FALSE
reaction-cli,0.6.18,0.6.19,73,3,12,9,21,3,FALSE
reaction-cli,0.6.2,0.6.4,60,5,374,26,400,19,FALSE
reaction-cli,0.6.13,0.6.14,69,1,10,2,12,2,FALSE
reaction-cli,0.6.12,0.6.13,68,3,116,48,164,10,FALSE
reaction-cli,0.6.10,0.6.12,67,6,58,42,100,9,FALSE
reaction-cli,0.6.16,0.6.18,72,2,62,37,99,9,FALSE
reaction-cli,0.6.15,0.6.16,71,1,22,6,28,5,FALSE
reaction-cli,0.6.14,0.6.15,70,1,7,7,14,6,FALSE
reaction-cli,0.1.3,0.1.4,1,1,2,2,4,2,FALSE
reaction-cli,0.1.4,0.1.5,2,1,3,3,6,2,FALSE
reaction-cli,0.1.5,0.1.6,3,3,46,7,53,5,FALSE
reaction-cli,0.3.8,0.3.9,25,2,38,37,75,7,FALSE
reaction-cli,0.3.9,0.3.10,26,3,9,1,10,3,FALSE
reaction-cli,0.3.2,0.3.3,19,2,13,8,21,2,FALSE
reaction-cli,0.3.3,0.3.4,20,2,2,2,4,2,FALSE
reaction-cli,0.3.0,0.3.1,17,1,2,2,4,1,FALSE
reaction-cli,0.3.1,0.3.2,18,2,6,4,10,4,FALSE
reaction-cli,0.3.6,0.3.7,23,1,2,1,3,2,FALSE
reaction-cli,0.3.7,0.3.8,24,1,2,2,4,2,FALSE
reaction-cli,0.3.4,0.3.5,21,1,2,2,4,2,FALSE
reaction-cli,0.3.5,0.3.6,22,1,2,2,4,2,FALSE
reaction-cli,0.3.10,0.3.11,27,3,41,36,77,7,FALSE
reaction-cli,0.3.11,0.3.12,28,1,2,2,4,2,FALSE
reaction-cli,0.3.12,0.4.0,29,1,2,2,4,1,FALSE
reaction-cli,0.4.11,0.4.12,40,2,31,10,41,4,FALSE
reaction-cli,0.4.10,0.4.11,39,2,42,15,57,5,FALSE
reaction-cli,0.4.13,0.4.14,42,1,7,2,9,2,FALSE
reaction-cli,0.4.12,0.4.13,41,1,10,10,20,1,FALSE
reaction-cli,0.4.15,0.4.16,44,2,4,4,8,2,FALSE
reaction-cli,0.4.14,0.4.15,43,1,5,5,10,1,FALSE
reaction-cli,0.4.17,0.4.18,46,1,2,2,4,2,FALSE
reaction-cli,0.4.16,0.4.17,45,1,2,2,4,2,FALSE
reaction-cli,0.4.19,0.4.20,48,1,2,2,4,2,FALSE
reaction-cli,0.4.18,0.4.19,47,2,8,4,12,4,FALSE
reaction-cli,0.4.20,0.4.21,49,4,20,15,35,4,FALSE
reaction-cli,0.4.21,0.5.0,50,5,25,29,54,8,FALSE
reaction-cli,0.4.9,0.4.10,38,1,2,2,4,2,FALSE
reaction-cli,0.4.8,0.4.9,37,5,58,18,76,8,FALSE
reaction-cli,0.4.1,0.4.2,31,2,43,26,69,5,FALSE
reaction-cli,0.4.0,0.4.1,30,1,154,6,160,5,FALSE
reaction-cli,0.4.3,0.4.4,33,5,23,5,28,6,FALSE
reaction-cli,0.4.2,0.4.3,32,1,5,1,6,1,FALSE
reaction-cli,0.4.4,0.4.6,34,14,414,97,511,30,FALSE
reaction-cli,0.4.7,0.4.8,36,1,4,6,10,2,FALSE
reaction-cli,0.4.6,0.4.7,35,1,24,5,29,2,FALSE
reaction-cli,0.7.12,0.7.13,89,4,32,9,41,5,TRUE
reaction-cli,0.2.7,0.2.8,14,1,2,2,4,1,FALSE
reaction-cli,0.2.6,0.2.7,13,1,4,1,5,1,FALSE
reaction-cli,0.2.5,0.2.6,12,1,2,2,4,2,FALSE
reaction-cli,0.2.4,0.2.5,11,2,9,7,16,3,FALSE
reaction-cli,0.2.3,0.2.4,10,1,2,2,4,2,FALSE
reaction-cli,0.2.2,0.2.3,9,1,4,6,10,2,FALSE
reaction-cli,0.2.1,0.2.2,8,3,51,9,60,7,FALSE
reaction-cli,0.2.0,0.2.1,7,2,10,12,22,3,FALSE
reaction-cli,0.2.9,0.3.0,16,5,76,38,114,14,FALSE
reaction-cli,0.2.8,0.2.9,15,2,22,11,33,5,FALSE
reaction-cli,0.5.5,0.5.6,55,1,2,2,4,2,FALSE
reaction-cli,0.5.6,0.5.7,56,3,92,15,107,8,FALSE
reaction-cli,0.5.0,0.5.1,51,1,2,2,4,2,FALSE
reaction-cli,0.5.1,0.5.2,52,3,17,11,28,5,FALSE
reaction-cli,0.5.2,0.5.3,53,4,17,9,26,4,FALSE
reaction-cli,0.5.3,0.5.5,54,5,8,9,17,6,FALSE
reaction-cli,0.1.8,0.2.0,6,9,141,51,192,12,FALSE
reaction-cli,0.6.18,0.6.19,73,3,12,9,21,3,TRUE
reaction-cli,0.6.21,0.7.0,76,4,233,8,241,10,TRUE
reaction-cli,0.6.4,0.6.5,61,2,13,11,24,2,TRUE
reaction-cli,0.6.19,0.6.20,74,16,615,78,693,34,TRUE
reaction-cli,0.6.10,0.6.12,67,6,58,42,100,9,TRUE
reaction-cli,0.4.1,0.4.2,31,2,43,26,69,5,TRUE
reaction-cli,0.4.2,0.4.3,32,1,5,1,6,1,TRUE
reaction-cli,0.8.3,0.8.4,94,2,5,2,7,2,TRUE
reaction-cli,0.3.9,0.3.10,26,3,9,1,10,3,TRUE
reaction-cli,0.3.10,0.3.11,27,3,41,36,77,7,TRUE
reaction-cli,0.4.14,0.4.15,43,1,5,5,10,1,TRUE
reaction-cli,0.5.6,0.5.7,56,3,92,15,107,8,TRUE
reaction-cli,0.8.0,0.8.1,91,3,28,15,43,4,TRUE
reaction-cli,0.7.7,0.7.8,84,3,53,31,84,3,TRUE
reaction-cli,0.4.11,0.4.12,40,2,31,10,41,4,TRUE
reaction-cli,0.3.2,0.3.3,19,2,13,8,21,2,TRUE
reaction-cli,0.7.4,0.7.5,81,9,246,18,264,16,TRUE
reaction-cli,0.3.12,0.4.0,29,1,2,2,4,1,TRUE
reaction-cli,0.5.7,0.5.9,57,3,38,14,52,11,TRUE
buntpapier,0.9.0,0.10.0,19,3,65,102,167,7,FALSE
buntpapier,0.6.0,0.6.1,9,3,386,306,692,18,FALSE
buntpapier,0.14.4,0.14.5,32,1,1,1,2,1,FALSE
buntpapier,0.11.0,0.12.0,21,3,391,12,403,12,FALSE
buntpapier,0.14.7,0.15.0,35,2,69,14,83,4,FALSE
buntpapier,0.14.6,0.14.7,34,2,2,1,3,2,FALSE
buntpapier,0.14.1,0.14.2,29,2,4,4,8,4,FALSE
buntpapier,0.14.0,0.14.1,28,2,7,5,12,3,FALSE
buntpapier,0.10.0,0.11.0,20,3,105,29,134,12,FALSE
buntpapier,0.3.0,0.3.1,5,1,14,6,20,2,FALSE
buntpapier,0.3.1,0.4.0,6,2,44,4,48,6,FALSE
buntpapier,0.7.2,0.8.0,13,3,171,146,317,10,FALSE
buntpapier,0.12.1,0.12.2,23,2,4,4,8,3,FALSE
buntpapier,0.7.0,0.7.1,11,2,4,5,9,2,FALSE
buntpapier,0.7.1,0.7.2,12,1,2,2,4,2,FALSE
buntpapier,0.12.2,0.13.0,24,3,417,5,422,15,FALSE
buntpapier,0.12.0,0.12.1,22,2,2,2,4,2,FALSE
buntpapier,0.16.0,0.17.0,42,2,12,2,14,4,FALSE
buntpapier,0.4.0,0.5.0,7,1,537,308,845,16,FALSE
buntpapier,0.13.2,0.14.0,27,2,6,6,12,3,FALSE
buntpapier,0.13.0,0.13.1,25,3,3,3,6,3,FALSE
buntpapier,0.13.1,0.13.2,26,2,8,4,12,8,FALSE
buntpapier,0.14.5,0.14.6,33,1,1,1,2,1,FALSE
buntpapier,0.15.1,0.15.2,37,2,18,4,22,3,FALSE
buntpapier,0.15.2,0.15.3,38,2,3,2,5,2,FALSE
buntpapier,0.15.3,0.15.4,39,2,7,5,12,2,FALSE
buntpapier,0.15.4,0.15.5,40,2,2,2,4,2,FALSE
buntpapier,0.15.5,0.16.0,41,2,5,3,8,4,FALSE
buntpapier,0.14.3,0.14.4,31,2,2,1,3,2,FALSE
buntpapier,0.14.2,0.14.3,30,2,24,1,25,2,FALSE
buntpapier,0.8.4,0.9.0,18,1,51,112,163,3,FALSE
buntpapier,0.8.1,0.8.2,15,1,2,2,4,2,FALSE
buntpapier,0.8.0,0.8.1,14,1,4,4,8,3,FALSE
buntpapier,0.8.3,0.8.4,17,1,15,40,55,3,FALSE
buntpapier,0.8.2,0.8.3,16,1,3,3,6,2,FALSE
buntpapier,0.5.0,0.6.0,8,2,83,99,182,7,FALSE
buntpapier,0.15.0,0.15.1,36,2,2,2,4,2,FALSE
buntpapier,0.6.1,0.7.0,10,1,682,8,690,20,FALSE
buntpapier,0.11.0,0.12.0,21,3,391,12,403,12,TRUE
buntpapier,0.2.1,0.3.0,4,2,659,25,684,8,TRUE
buntpapier,0.2.0,0.2.1,3,2,2,1,3,2,FALSE
buntpapier,0.1.0,0.2.0,2,1,1,2,3,2,FALSE
buntpapier,0.0.0,0.1.0,1,3,2056,1030,3086,34,FALSE
buntpapier,0.8.4,0.9.0,18,1,51,112,163,3,TRUE
buntpapier,0.2.1,0.3.0,4,2,659,25,684,8,FALSE
buntpapier,0.3.1,0.4.0,6,2,44,4,48,6,TRUE
buntpapier,0.13.2,0.14.0,27,2,6,6,12,3,TRUE
buntpapier,0.9.0,0.10.0,19,3,65,102,167,7,TRUE
buntpapier,0.14.0,0.14.1,28,2,7,5,12,3,TRUE
buntpapier,0.7.2,0.8.0,13,3,171,146,317,10,TRUE
buntpapier,0.8.0,0.8.1,14,1,4,4,8,3,TRUE
buntpapier,0.13.0,0.13.1,25,3,3,3,6,3,TRUE
buntpapier,0.0.0,0.1.0,1,3,2056,1030,3086,34,TRUE
buntpapier,0.14.2,0.14.3,30,2,24,1,25,2,TRUE
laravel-elixir-webpack-official,1.0.4,1.0.5,5,3,8,5,13,4,FALSE
laravel-elixir-webpack-official,1.0.5,1.0.6,6,5,21,11,32,5,TRUE
laravel-elixir-webpack-official,1.0.6,1.0.8,7,5,10,9,19,5,TRUE
laravel-elixir-webpack-official,1.0.3,1.0.4,4,1,2,2,4,2,FALSE
laravel-elixir-webpack-official,1.0.8,1.0.9,8,4,8,3,11,5,FALSE
laravel-elixir-webpack-official,1.0.9,1.0.10,9,2,6,1,7,3,FALSE
laravel-elixir-webpack-official,1.0.5,1.0.6,6,5,21,11,32,5,FALSE
laravel-elixir-webpack-official,1.0.0,1.0.1,1,1,11,2,13,2,FALSE
laravel-elixir-webpack-official,1.0.1,1.0.2,2,6,14,12,26,6,FALSE
laravel-elixir-webpack-official,1.0.2,1.0.3,3,9,150,25,175,14,FALSE
laravel-elixir-webpack-official,1.0.6,1.0.8,7,5,10,9,19,5,FALSE
loco-metrics,0.1.0,0.1.1,1,2,4,4,8,4,FALSE
loco-metrics,0.1.1,0.1.2,2,1,6,4,10,3,FALSE
loco-metrics,0.1.2,0.2.0,3,2,16,16,32,8,FALSE
loco-metrics,0.1.0,0.1.1,1,2,4,4,8,4,TRUE
knotisapi,1.4.0,1.4.1,8,4,152,8,160,4,FALSE
knotisapi,1.1.0,1.2.0,4,6,434,212,646,10,FALSE
knotisapi,1.0.0,1.0.1,1,10,3106,176,3282,42,FALSE
knotisapi,1.0.1,1.0.2,2,2,4,4,8,2,FALSE
knotisapi,1.0.2,1.1.0,3,8,1236,198,1434,16,FALSE
knotisapi,1.3.0,1.4.0,7,4,118,36,154,8,FALSE
knotisapi,1.2.0,1.2.1,5,2,116,110,226,4,FALSE
knotisapi,1.2.1,1.3.0,6,2,214,2,216,6,FALSE
knotisapi,1.1.0,1.2.0,4,6,434,212,646,10,TRUE
knotisapi,1.0.2,1.1.0,3,8,1236,198,1434,16,TRUE
knotisapi,1.0.0,1.0.1,1,10,3106,176,3282,42,TRUE
particle-api-js,6.0.3,6.0.4,20,3,73,70,143,7,FALSE
particle-api-js,6.0.2,6.0.3,19,4,81,57,138,11,FALSE
particle-api-js,6.0.1,6.0.2,18,6,61,41,102,12,FALSE
particle-api-js,6.0.0,6.0.1,17,3,26,10,36,9,FALSE
particle-api-js,6.0.7,6.0.8,24,6,2337,1391,3728,29,FALSE
particle-api-js,6.0.6,6.0.7,23,5,568,85,653,19,FALSE
particle-api-js,6.0.5,6.0.6,22,2,109,47,156,10,FALSE
particle-api-js,6.0.4,6.0.5,21,4,121,83,204,10,FALSE
particle-api-js,6.1.0,6.2.0,26,12,1904,1672,3576,38,FALSE
particle-api-js,6.0.8,6.1.0,25,4,250,68,318,17,FALSE
particle-api-js,6.4.3,6.5.0,33,30,6312,1419,7731,64,FALSE
particle-api-js,6.4.2,6.4.3,32,6,315,127,442,23,TRUE
particle-api-js,6.4.1,6.4.2,31,6,84,1608,1692,28,FALSE
particle-api-js,6.4.0,6.4.1,30,5,296,253,549,9,FALSE
particle-api-js,6.2.0,6.3.0,27,6,907,93,1000,19,FALSE
particle-api-js,6.3.0,6.3.1,28,1,108,91,199,5,FALSE
particle-api-js,6.3.1,6.4.0,29,2,258,236,494,7,FALSE
particle-api-js,5.0.0,5.0.1,1,4,15,3,18,7,FALSE
particle-api-js,5.0.1,5.0.2,2,5,1001,32,1033,14,FALSE
particle-api-js,5.0.2,5.1.0,3,12,579,232,811,19,FALSE
particle-api-js,5.1.1,5.2.0,5,2,79,36,115,8,FALSE
particle-api-js,5.1.0,5.1.1,4,4,50,34,84,10,FALSE
particle-api-js,5.2.2,5.2.3,8,2,32,32,64,6,TRUE
particle-api-js,5.2.3,5.2.4,9,3,34,30,64,7,FALSE
particle-api-js,5.2.0,5.2.1,6,2,43,34,77,7,FALSE
particle-api-js,5.2.1,5.2.2,7,5,45,41,86,11,FALSE
particle-api-js,5.2.6,5.2.7,12,3,70,31,101,8,FALSE
particle-api-js,5.2.4,5.2.5,10,2,43,35,78,6,FALSE
particle-api-js,5.2.5,5.2.6,11,2,35,29,64,6,FALSE
particle-api-js,5.3.0,5.3.1,15,19,9838,9308,19146,88,FALSE
particle-api-js,6.4.2,6.4.3,32,6,315,127,442,23,FALSE
particle-api-js,5.2.2,5.2.3,8,2,32,32,64,6,FALSE
particle-api-js,5.2.3,5.2.4,9,3,34,30,64,7,TRUE
particle-api-js,5.2.7,5.3.0-develop.1,13,25,10549,9334,19883,107,FALSE
particle-api-js,5.3.1,6.0.0,16,6,1186,1143,2329,21,FALSE
particle-api-js,6.4.3,6.5.0,33,30,6312,1419,7731,64,TRUE
particle-api-js,5.2.5,5.2.6,11,2,35,29,64,6,TRUE
particle-api-js,6.0.2,6.0.3,19,4,81,57,138,11,TRUE
particle-api-js,6.3.0,6.3.1,28,1,108,91,199,5,TRUE
particle-api-js,6.0.5,6.0.6,22,2,109,47,156,10,TRUE
particle-api-js,5.2.6,5.2.7,12,3,70,31,101,8,TRUE
particle-api-js,5.0.2,5.1.0,3,12,579,232,811,19,TRUE
starspot,0.3.2,0.3.3,7,3,38,45,83,3,FALSE
starspot,0.3.3,0.3.5,8,8,36,15,51,8,FALSE
starspot,0.3.0,0.3.1,5,6,191,127,318,11,FALSE
starspot,0.3.1,0.3.2,6,2,14,2,16,2,FALSE
starspot,0.3.6,0.3.7,10,9,785,309,1094,35,FALSE
starspot,0.3.5,0.3.6,9,4,236,24,260,8,FALSE
starspot,0.2.2,0.3.0,4,9,584,35,619,14,FALSE
starspot,0.2.1,0.2.2,3,11,589,266,855,33,FALSE
starspot,0.2.0,0.2.1,2,1,2,2,4,2,FALSE
starspot,0.2.2,0.3.0,4,9,584,35,619,14,TRUE
starspot,0.2.1,0.2.2,3,11,589,266,855,33,TRUE
starspot,0.3.2,0.3.3,7,3,38,45,83,3,TRUE
starspot,0.3.3,0.3.5,8,8,36,15,51,8,TRUE
starspot,0.3.0,0.3.1,5,6,191,127,318,11,TRUE
starspot,0.3.6,0.3.7,10,9,785,309,1094,35,TRUE
starspot,0.3.5,0.3.6,9,4,236,24,260,8,TRUE
babel-dts-generator,0.6.2,0.6.3,35,5,2893,18,2911,12,FALSE
babel-dts-generator,0.6.1,0.6.2,34,10,125,4,129,21,FALSE
babel-dts-generator,0.6.0,0.6.1,33,8,126,25,151,22,FALSE
babel-dts-generator,0.4.4,0.4.5,27,6,102,6,108,20,FALSE
babel-dts-generator,0.4.5,0.4.6,28,1,2,3,5,1,FALSE
babel-dts-generator,0.4.1,0.4.2,24,13,571,64,635,51,FALSE
babel-dts-generator,0.4.0,0.4.1,23,1,77,0,77,14,FALSE
babel-dts-generator,0.4.3,0.4.4,26,9,160,22,182,25,FALSE
babel-dts-generator,0.4.2,0.4.3,25,3,434,220,654,46,FALSE
babel-dts-generator,0.5.0,0.5.1,31,5,56,28,84,11,FALSE
babel-dts-generator,0.5.1,0.6.0,32,6,120,22,142,15,FALSE
babel-dts-generator,0.4.7,0.5.0,30,7,289,73,362,40,FALSE
babel-dts-generator,0.4.6,0.4.7,29,1,2,3,5,1,FALSE
babel-dts-generator,0.3.1,0.4.0,22,5,257,215,472,28,FALSE
babel-dts-generator,0.3.0,0.3.1,21,4,95,237,332,19,FALSE
babel-dts-generator,0.6.0,0.6.1,33,8,126,25,151,22,TRUE
babel-dts-generator,0.4.4,0.4.5,27,6,102,6,108,20,TRUE
babel-dts-generator,0.3.1,0.4.0,22,5,257,215,472,28,TRUE
babel-dts-generator,0.3.0,0.3.1,21,4,95,237,332,19,TRUE
babel-dts-generator,0.4.2,0.4.3,25,3,434,220,654,46,TRUE
babel-dts-generator,0.4.5,0.4.6,28,1,2,3,5,1,TRUE
babel-dts-generator,0.4.1,0.4.2,24,13,571,64,635,51,TRUE
babel-dts-generator,0.4.0,0.4.1,23,1,77,0,77,14,TRUE
babel-dts-generator,0.4.3,0.4.4,26,9,160,22,182,25,TRUE
babel-dts-generator,0.5.1,0.6.0,32,6,120,22,142,15,TRUE
babel-dts-generator,0.2.17,0.2.18,19,1,2,3,5,1,FALSE
babel-dts-generator,0.2.16,0.2.17,18,1,2,3,5,1,TRUE
babel-dts-generator,0.2.15,0.2.16,17,13,3257,1639,4896,106,FALSE
babel-dts-generator,0.2.14,0.2.15,16,8,173,75,248,83,FALSE
babel-dts-generator,0.2.13,0.2.14,15,3,25,15,40,11,FALSE
babel-dts-generator,0.2.12,0.2.13,14,4,67,10,77,10,FALSE
babel-dts-generator,0.2.16,0.2.17,18,1,2,3,5,1,FALSE
do-translate,0.1.12,0.1.13,18,1,2099,147,2246,6,FALSE
do-translate,0.1.13,0.1.14,19,1,34,19,53,4,FALSE
do-translate,0.1.16,0.1.17,21,1,8,4,12,2,FALSE
do-translate,1.0.1,1.0.2,25,2,5,7,12,3,FALSE
do-translate,0.1.18,1.0.0,23,5,29,22,51,6,FALSE
do-translate,1.0.0,1.0.1,24,2,4,4,8,3,FALSE
do-translate,0.1.14,0.1.16,20,6,265,2121,2386,19,FALSE
do-translate,0.1.17,0.1.18,22,1,341,587,928,8,FALSE
do-translate,0.0.5,0.1.0,5,1,20,20,40,9,FALSE
do-translate,0.0.4,0.0.5,4,1,5,6,11,2,FALSE
do-translate,0.0.1,0.0.2,1,1,5,6,11,2,FALSE
do-translate,0.0.3,0.0.4,3,1,5,6,11,2,FALSE
do-translate,0.0.2,0.0.3,2,1,674,0,674,22,FALSE
do-translate,0.1.8,0.1.9,14,5,312,366,678,16,FALSE
do-translate,0.1.9,0.1.10,15,2,1258,17797,19055,21,FALSE
do-translate,0.1.0,0.1.1,6,1,371,6,377,11,FALSE
do-translate,0.1.1,0.1.2,7,6,85,11,96,6,FALSE
do-translate,0.1.2,0.1.3,8,5,17844,66,17910,21,FALSE
do-translate,0.1.3,0.1.4,9,6,66,18143,18209,20,FALSE
do-translate,0.1.4,0.1.5,10,1,10,7,17,2,FALSE
do-translate,0.1.5,0.1.6,11,1,3,3,6,2,FALSE
do-translate,0.1.6,0.1.7,12,7,17807,39,17846,12,FALSE
do-translate,0.1.7,0.1.8,13,1,46,8,54,2,FALSE
do-translate,0.1.10,0.1.11,16,1,2,2,4,1,FALSE
do-translate,0.1.11,0.1.12,17,1,2,2,4,1,FALSE
do-translate,0.1.16,0.1.17,21,1,8,4,12,2,TRUE
do-translate,0.1.8,0.1.9,14,5,312,366,678,16,TRUE
do-translate,0.1.9,0.1.10,15,2,1258,17797,19055,21,TRUE
do-translate,0.1.2,0.1.3,8,5,17844,66,17910,21,TRUE
ngx-webstorage,0.0.5,0.0.6,5,1,78,78,156,1,FALSE
ngx-webstorage,0.0.4,0.0.5,4,1,78,78,156,1,FALSE
ngx-webstorage,0.0.7,0.0.8,7,1,78,78,156,1,FALSE
ngx-webstorage,0.0.6,0.0.7,6,1,78,78,156,1,FALSE
ngx-webstorage,0.0.1,0.0.2,1,1,78,78,156,1,FALSE
ngx-webstorage,0.0.3,0.0.4,3,1,78,78,156,1,FALSE
ngx-webstorage,0.0.2,0.0.3,2,1,78,78,156,1,FALSE
ngx-webstorage,0.0.8,1.8.0,8,37,3044,5902,8946,216,FALSE
ngx-webstorage,0.0.7,0.0.8,7,1,78,78,156,1,TRUE
native-toast,1.0.0,1.1.0,5,3,112,26,138,7,FALSE
native-toast,0.1.0,0.1.1,1,3,6,6,12,3,FALSE
native-toast,0.1.1,0.1.2,2,2,6,5,11,2,FALSE
native-toast,0.1.2,0.2.0,3,4,42,6,48,8,FALSE
native-toast,0.2.0,1.0.0,4,11,2839,248,3087,25,FALSE
native-toast,1.0.0,1.1.0,5,3,112,26,138,7,TRUE
vernal,0.0.5,0.0.6,6,1,2,2,4,2,FALSE
vernal,0.0.4,0.0.5,5,1,7,4,11,2,FALSE
vernal,0.0.6,0.1.0,7,2,2,2,4,2,FALSE
vernal,0.0.1,0.0.2,2,1,43,3,46,2,FALSE
vernal,0.0.3,0.0.4,4,1,2,2,4,2,FALSE
vernal,1.0.2,1.0.3,13,1,5,5,10,2,FALSE
vernal,0.0.2,0.0.3,3,1,2,2,4,1,FALSE
vernal,1.1.0,1.2.0,15,1,109,34,143,3,TRUE
vernal,1.0.3,1.1.0,14,1,199,204,403,4,FALSE
vernal,1.3.1,1.3.2,19,1,1,26,27,2,FALSE
vernal,1.3.0,1.3.1,18,1,36,1,37,2,TRUE
vernal,1.2.1,1.3.0,17,1,8,6,14,3,FALSE
vernal,1.2.0,1.2.1,16,1,7,1,8,2,FALSE
vernal,0.2.0,1.0.0,10,1,150,52,202,4,FALSE
vernal,0.1.0,0.1.1,8,1,1,1,2,1,FALSE
vernal,0.1.1,0.2.0,9,2,5,2,7,2,FALSE
vernal,1.0.0,1.0.1,11,1,4,7,11,2,FALSE
vernal,1.0.1,1.0.2,12,1,9,3,12,2,FALSE
vernal,1.1.0,1.2.0,15,1,109,34,143,3,FALSE
vernal,1.0.3,1.1.0,14,1,199,204,403,4,TRUE
vernal,1.3.0,1.3.1,18,1,36,1,37,2,FALSE
sidebarjs,1.1.0,1.1.5,4,1,3,8,11,4,FALSE
sidebarjs,1.1.5,1.2.0,5,8,295,215,510,19,FALSE
sidebarjs,1.0.1,1.0.2,2,2,8,8,16,5,FALSE
sidebarjs,1.0.2,1.1.0,3,3,22,14,36,8,FALSE
sidebarjs,1.5.0,1.6.0,7,2,42,19,61,6,FALSE
sidebarjs,1.6.0,1.6.1,8,2,5,5,10,5,FALSE
sidebarjs,1.6.1,1.7.0,9,9,299,211,510,26,FALSE
sidebarjs,1.2.0,1.5.0,6,8,236,228,464,26,FALSE
sidebarjs,1.0.0,1.0.1,1,1,12,9,21,3,FALSE
sidebarjs,1.7.1,1.8.0,11,2,24,18,42,4,FALSE
sidebarjs,1.7.0,1.7.1,10,1,8,8,16,4,FALSE
sidebarjs,2.0.1,2.1.0,17,2,27,31,58,7,FALSE
sidebarjs,2.0.0,2.0.1,16,2,17,13,30,8,FALSE
sidebarjs,1.10.0,1.10.1,14,4,122,17,139,13,FALSE
sidebarjs,1.10.1,2.0.0,15,1,4,4,8,4,FALSE
sidebarjs,1.9.0,1.10.0,13,6,321,135,456,23,FALSE
sidebarjs,1.8.0,1.9.0,12,32,1332,965,2297,90,FALSE
sidebarjs,2.0.1,2.1.0,17,2,27,31,58,7,TRUE
sidebarjs,1.8.0,1.9.0,12,32,1332,965,2297,90,TRUE
sidebarjs,1.7.0,1.7.1,10,1,8,8,16,4,TRUE
ngadapter,1.1.0,1.2.0,8,4,64,28,92,8,FALSE
ngadapter,1.0.0,1.0.1,5,1,3,3,6,1,FALSE
ngadapter,1.0.1,1.0.2,6,2,30,6,36,3,FALSE
ngadapter,1.0.2,1.1.0,7,2,125,21,146,4,FALSE
ngadapter,1.2.0,1.2.1,9,1,2,2,4,1,FALSE
ngadapter,0.1.1,0.1.2,3,3,34,10,44,4,FALSE
ngadapter,0.1.2,1.0.0,4,3,431,165,596,9,FALSE
ngadapter,0.0.1,0.1.0,1,13,671,212,883,47,FALSE
ngadapter,0.1.0,0.1.1,2,4,84,26,110,7,FALSE
ngadapter,1.1.0,1.2.0,8,4,64,28,92,8,TRUE
ngadapter,1.0.1,1.0.2,6,2,30,6,36,3,TRUE
ngadapter,1.0.2,1.1.0,7,2,125,21,146,4,TRUE
react-pagify-preset-bootstrap,1.0.0,1.0.1,1,2,4,1,5,2,FALSE
react-pagify-preset-bootstrap,1.0.1,1.0.2,2,10,50,37,87,10,FALSE
react-pagify-preset-bootstrap,1.0.1,1.0.2,2,10,50,37,87,10,TRUE
fetch-mock,3.1.3,3.2.0,39,3,51,27,78,7,FALSE
fetch-mock,3.1.2,3.1.3,38,2,10,10,20,3,FALSE
fetch-mock,3.1.1,3.1.2,37,1,28,29,57,1,FALSE
fetch-mock,3.1.0,3.1.1,36,4,322,218,540,15,FALSE
fetch-mock,1.0.0,1.0.1,1,7,173,147,320,16,TRUE
fetch-mock,1.0.1,1.1.0,2,6,86,10,96,14,FALSE
fetch-mock,5.9.4,5.10.0,84,4,215,74,289,5,FALSE
fetch-mock,4.0.1,4.1.0,43,7,95,51,146,11,FALSE
fetch-mock,5.5.0,5.6.0,73,5,369,238,607,9,FALSE
fetch-mock,5.10.0,5.10.1,85,4,108,16,124,7,FALSE
fetch-mock,5.10.1,5.11.0,86,2,74,8,82,4,FALSE
fetch-mock,5.0.0,5.0.1,57,2,12,4,16,3,FALSE
fetch-mock,5.0.1,5.0.2,58,3,7,3,10,3,FALSE
fetch-mock,4.5.2,4.5.3,52,2,9,9,18,2,FALSE
fetch-mock,5.2.0,5.3.0,69,2,205,35,240,5,FALSE
fetch-mock,5.0.3,5.0.4,60,2,4,2,6,2,FALSE
fetch-mock,5.0.4,5.0.5,61,2,6,4,10,3,FALSE
fetch-mock,4.5.0,4.5.1,50,4,19,2,21,4,FALSE
fetch-mock,4.5.1,4.5.2,51,2,5,1,6,2,FALSE
fetch-mock,5.0.2,5.0.3,59,2,16,2,18,3,FALSE
fetch-mock,4.5.3,4.5.4,53,2,6,4,10,2,FALSE
fetch-mock,4.5.4,4.6.0,54,6,86,10,96,14,FALSE
fetch-mock,5.0.5,5.1.0,62,4,309,220,529,7,FALSE
fetch-mock,5.6.2,5.7.0,76,2,122,11,133,5,FALSE
fetch-mock,4.3.0,4.3.1,47,2,2,2,4,2,FALSE
fetch-mock,5.6.1,5.6.2,75,2,3,3,6,2,FALSE
fetch-mock,3.0.4,3.1.0,35,6,38,18,56,13,FALSE
fetch-mock,3.0.2,3.0.3,33,4,54,19,73,4,FALSE
fetch-mock,3.0.3,3.0.4,34,6,53,17,70,11,FALSE
fetch-mock,3.0.0,3.0.1,31,1,1,1,2,1,FALSE
fetch-mock,3.0.1,3.0.2,32,3,58,38,96,8,FALSE
fetch-mock,4.1.0,4.1.1,44,3,13,7,20,5,FALSE
fetch-mock,4.1.1,4.2.0,45,17,674,432,1106,38,FALSE
fetch-mock,5.6.0,5.6.1,74,3,24,66,90,6,FALSE
fetch-mock,4.0.0,4.0.1,42,2,29,5,34,6,FALSE
fetch-mock,4.3.1,4.4.0,48,2,7,2,9,3,FALSE
fetch-mock,2.0.1,2.1.0,13,2,88,12,100,4,FALSE
fetch-mock,2.2.7,2.2.8,19,4,11,4,15,6,FALSE
fetch-mock,2.2.6,2.2.7,18,1,22,25,47,1,FALSE
fetch-mock,2.2.1,2.2.3,16,1,26,16,42,3,FALSE
fetch-mock,2.2.0,2.2.1,15,1,9,8,17,1,FALSE
fetch-mock,2.2.3,2.2.6,17,3,53,70,123,3,FALSE
fetch-mock,2.2.9,2.2.10,21,1,1,1,2,1,FALSE
fetch-mock,2.2.8,2.2.9,20,6,83,121,204,33,FALSE
fetch-mock,4.6.1,5.0.0,56,2,535,500,1035,7,FALSE
fetch-mock,4.6.0,4.6.1,55,3,6,9,15,4,FALSE
fetch-mock,2.2.15,2.3.0,27,2,7,3,10,2,FALSE
fetch-mock,2.2.14,2.2.15,26,2,3,4,7,2,FALSE
fetch-mock,2.2.11,2.2.12,23,2,3,15,18,3,FALSE
fetch-mock,2.2.10,2.2.11,22,1,1,1,2,1,FALSE
fetch-mock,2.2.13,2.2.14,25,4,48,39,87,4,FALSE
fetch-mock,2.2.12,2.2.13,24,1,1,1,2,1,FALSE
fetch-mock,1.5.0,1.5.2,11,3,11,9,20,5,FALSE
fetch-mock,1.5.2,2.0.1,12,5,660,730,1390,27,FALSE
fetch-mock,1.3.0,1.4.0,8,5,290,60,350,10,FALSE
fetch-mock,2.4.0,3.0.0,30,5,332,126,458,12,FALSE
fetch-mock,1.1.1,1.1.2,4,1,28,28,56,1,FALSE
fetch-mock,1.1.0,1.1.1,3,1,75,0,75,1,FALSE
fetch-mock,1.1.3,1.2.0,6,2,58,22,80,6,FALSE
fetch-mock,1.1.2,1.1.3,5,1,3,2,5,1,FALSE
fetch-mock,4.4.0,4.5.0,49,4,115,79,194,8,FALSE
fetch-mock,2.1.0,2.2.0,14,4,438,218,656,11,FALSE
fetch-mock,5.7.0,5.8.0,77,2,79,6,85,5,FALSE
fetch-mock,5.8.0,5.8.1,78,2,37,11,48,3,FALSE
fetch-mock,5.8.1,5.9.0,79,2,82,15,97,6,FALSE
fetch-mock,1.4.0,1.4.1,9,1,2,2,4,1,FALSE
fetch-mock,1.4.1,1.5.0,10,2,64,4,68,6,FALSE
fetch-mock,5.9.1,5.9.2,81,3,4,222,226,3,FALSE
fetch-mock,5.9.0,5.9.1,80,8,366,291,657,22,FALSE
fetch-mock,5.9.3,5.9.4,83,4,4,4,8,4,FALSE
fetch-mock,5.9.2,5.9.3,82,1,1,1,2,1,FALSE
fetch-mock,2.3.0,2.3.1,28,5,9,9,18,6,FALSE
fetch-mock,2.3.1,2.4.0,29,3,9,15,24,7,FALSE
fetch-mock,1.2.0,1.3.0,7,2,136,28,164,8,FALSE
fetch-mock,5.4.0,5.5.0,72,3,38,21,59,6,FALSE
fetch-mock,5.3.1,5.4.0,71,3,180,216,396,7,FALSE
fetch-mock,5.3.0,5.3.1,70,2,1,21,22,2,FALSE
fetch-mock,5.1.5,5.2.0,68,4,87,20,107,11,FALSE
fetch-mock,5.1.4,5.1.5,67,2,53,3,56,4,FALSE
fetch-mock,5.1.1,5.1.2,64,3,38,3,41,3,FALSE
fetch-mock,5.1.0,5.1.1,63,2,18,17,35,4,FALSE
fetch-mock,5.1.3,5.1.4,66,2,53,3,56,4,FALSE
fetch-mock,5.1.2,5.1.3,65,2,2,2,4,2,FALSE
fetch-mock,4.2.0,4.3.0,46,3,275,148,423,13,TRUE
fetch-mock,3.2.0,3.2.1,40,5,729,435,1164,25,FALSE
fetch-mock,3.2.1,4.0.0,41,5,278,1214,1492,14,FALSE
fetch-mock,1.0.0,1.0.1,1,7,173,147,320,16,FALSE
fetch-mock,4.2.0,4.3.0,46,3,275,148,423,13,FALSE
fetch-mock,4.0.1,4.1.0,43,7,95,51,146,11,TRUE
fetch-mock,2.1.0,2.2.0,14,4,438,218,656,11,TRUE
fetch-mock,5.9.0,5.9.1,80,8,366,291,657,22,TRUE
fetch-mock,5.0.1,5.0.2,58,3,7,3,10,3,TRUE
fetch-mock,5.1.3,5.1.4,66,2,53,3,56,4,TRUE
fetch-mock,1.0.1,1.1.0,2,6,86,10,96,14,TRUE
fetch-mock,5.8.0,5.8.1,78,2,37,11,48,3,TRUE
fetch-mock,3.0.4,3.1.0,35,6,38,18,56,13,TRUE
fetch-mock,1.1.3,1.2.0,6,2,58,22,80,6,TRUE
fetch-mock,3.0.1,3.0.2,32,3,58,38,96,8,TRUE
cookie-wrapper,0.0.5,0.0.6,5,1,18,2,20,3,FALSE
cookie-wrapper,0.0.4,0.0.5,4,1,8,49,57,3,FALSE
cookie-wrapper,0.0.7,0.0.8,7,2,4,2,6,3,FALSE
cookie-wrapper,0.0.6,0.0.7,6,2,15,9,24,3,FALSE
cookie-wrapper,0.0.1,0.0.2,1,6,73,26,99,11,FALSE
cookie-wrapper,0.0.3,0.0.4,3,2,8,4,12,12,FALSE
cookie-wrapper,0.0.2,0.0.3,2,3,50,3,53,4,FALSE
cookie-wrapper,0.0.9,0.1.0,9,4,22,7,29,5,FALSE
cookie-wrapper,0.0.8,0.0.9,8,1,24,8,32,5,FALSE
cookie-wrapper,0.1.0,0.1.1,10,3,29,6,35,4,FALSE
cookie-wrapper,0.1.1,0.1.2,11,1,14,9,23,3,FALSE
cookie-wrapper,0.1.2,0.1.3,12,3,108,42,150,7,FALSE
cookie-wrapper,0.0.5,0.0.6,5,1,18,2,20,3,TRUE
cookie-wrapper,0.0.2,0.0.3,2,3,50,3,53,4,TRUE
cookie-wrapper,0.0.1,0.0.2,1,6,73,26,99,11,TRUE
basalplatten,1.2.2,1.2.3,11,2,5,1,6,2,FALSE
basalplatten,1.2.3,1.3.0,12,1,22,19,41,2,FALSE
basalplatten,1.2.1,1.2.2,10,4,38,40,78,9,FALSE
basalplatten,1.1.1,1.1.2,3,1,2,2,4,2,TRUE
basalplatten,1.1.0,1.1.1,2,1,1,0,1,1,FALSE
basalplatten,1.1.3,1.1.4,5,1,0,1,1,1,FALSE
basalplatten,1.1.2,1.1.3,4,3,6,2,8,4,TRUE
basalplatten,1.0.0,1.1.0,1,3,1002,284,1286,30,TRUE
basalplatten,1.1.4,1.1.5,6,1,4,4,8,4,FALSE
basalplatten,1.1.6,1.2.0,8,2,32,33,65,2,FALSE
basalplatten,1.2.0,1.2.1,9,1,1,0,1,1,FALSE
basalplatten,1.1.5,1.1.6,7,2,1,0,1,2,FALSE
basalplatten,1.1.1,1.1.2,3,1,2,2,4,2,FALSE
basalplatten,1.1.2,1.1.3,4,3,6,2,8,4,FALSE
basalplatten,1.2.2,1.2.3,11,2,5,1,6,2,TRUE
basalplatten,1.0.0,1.1.0,1,3,1002,284,1286,30,FALSE
basalplatten,1.1.4,1.1.5,6,1,4,4,8,4,TRUE
basalplatten,1.1.3,1.1.4,5,1,0,1,1,1,TRUE
basalplatten,1.2.1,1.2.2,10,4,38,40,78,9,TRUE
subscriptions-transport-ws,0.2.5,0.2.6,13,5,235,77,312,8,FALSE
subscriptions-transport-ws,0.2.4,0.2.5,12,9,595,200,795,28,FALSE
subscriptions-transport-ws,0.2.3,0.2.4,11,14,534,182,716,26,FALSE
subscriptions-transport-ws,0.2.2,0.2.3,10,25,445,224,669,65,FALSE
subscriptions-transport-ws,0.2.1,0.2.2,9,2,2,1,3,2,FALSE
subscriptions-transport-ws,0.2.0,0.2.1,8,3,46,9,55,6,TRUE
subscriptions-transport-ws,0.1.0,0.1.1,1,2,42,4,46,3,FALSE
subscriptions-transport-ws,0.1.1,0.1.2,2,2,9,11,20,4,FALSE
subscriptions-transport-ws,0.1.2,0.1.3,3,3,22,6,28,4,FALSE
subscriptions-transport-ws,0.1.3,0.1.4,4,2,7,2,9,2,FALSE
subscriptions-transport-ws,0.1.4,0.1.5,5,5,89,53,142,7,FALSE
subscriptions-transport-ws,0.1.5,0.1.6,6,2,18,2,20,2,FALSE
subscriptions-transport-ws,0.1.6,0.2.0,7,4,177,66,243,10,FALSE
subscriptions-transport-ws,0.6.0,0.7.0,25,92,8289,3613,11902,262,FALSE
subscriptions-transport-ws,0.5.5-alpha.0,0.5.5,23,25,396,171,567,41,FALSE
subscriptions-transport-ws,0.5.4,0.5.5-alpha.0,22,1,5,1,6,2,FALSE
subscriptions-transport-ws,0.5.5,0.6.0,24,19,1197,715,1912,60,FALSE
subscriptions-transport-ws,0.5.0,0.5.1,18,7,21,11,32,9,FALSE
subscriptions-transport-ws,0.5.1,0.5.2,19,8,72,31,103,16,FALSE
subscriptions-transport-ws,0.5.2,0.5.3,20,5,19,3,22,6,FALSE
subscriptions-transport-ws,0.5.3,0.5.4,21,22,662,59,721,41,FALSE
subscriptions-transport-ws,0.3.0,0.3.1,15,5,90,8,98,8,FALSE
subscriptions-transport-ws,0.3.1,0.4.0,16,39,1719,820,2539,88,FALSE
subscriptions-transport-ws,0.2.6,0.3.0,14,8,107,43,150,18,FALSE
subscriptions-transport-ws,0.2.0,0.2.1,8,3,46,9,55,6,FALSE
subscriptions-transport-ws,0.4.0,0.5.0,17,17,1534,417,1951,41,FALSE
subscriptions-transport-ws,0.2.2,0.2.3,10,25,445,224,669,65,TRUE
subscriptions-transport-ws,0.6.0,0.7.0,25,92,8289,3613,11902,262,TRUE
subscriptions-transport-ws,0.2.6,0.3.0,14,8,107,43,150,18,TRUE
subscriptions-transport-ws,0.2.5,0.2.6,13,5,235,77,312,8,TRUE
subscriptions-transport-ws,0.2.4,0.2.5,12,9,595,200,795,28,TRUE
subscriptions-transport-ws,0.2.3,0.2.4,11,14,534,182,716,26,TRUE
subscriptions-transport-ws,0.3.0,0.3.1,15,5,90,8,98,8,TRUE
subscriptions-transport-ws,0.3.1,0.4.0,16,39,1719,820,2539,88,TRUE
subscriptions-transport-ws,0.5.5-alpha.0,0.5.5,23,25,396,171,567,41,TRUE
subscriptions-transport-ws,0.4.0,0.5.0,17,17,1534,417,1951,41,TRUE
subscriptions-transport-ws,0.5.0,0.5.1,18,7,21,11,32,9,TRUE
subscriptions-transport-ws,0.5.1,0.5.2,19,8,72,31,103,16,TRUE
subscriptions-transport-ws,0.5.2,0.5.3,20,5,19,3,22,6,TRUE
subscriptions-transport-ws,0.5.3,0.5.4,21,22,662,59,721,41,TRUE
subscriptions-transport-ws,0.5.5,0.6.0,24,19,1197,715,1912,60,TRUE
fizzy,0.2.0,0.2.1,26,1,3,3,6,2,FALSE
fizzy,0.1.8,0.1.9,20,1,10,3,13,2,FALSE
fizzy,0.1.9,0.1.10,21,2,2,2,4,2,FALSE
fizzy,0.0.11,0.0.12,11,1,51,32,83,3,FALSE
fizzy,0.0.10,0.0.11,10,2,74,3,77,5,FALSE
fizzy,0.2.1,0.2.2,27,1,2,1,3,1,FALSE
fizzy,0.0.12,0.1.0,12,1,11,6,17,3,FALSE
fizzy,0.1.0,0.1.1,13,1,3,1,4,2,FALSE
fizzy,0.1.1,0.1.2,14,1,3,2,5,2,FALSE
fizzy,0.1.2,0.1.3,15,3,53,27,80,11,FALSE
fizzy,0.1.3,0.1.4,16,2,2,13,15,3,FALSE
fizzy,0.1.4,0.1.6,17,2,15,4,19,4,FALSE
fizzy,0.1.6,0.1.7,18,1,7,2,9,2,FALSE
fizzy,0.1.7,0.1.8,19,2,2,2,4,2,FALSE
fizzy,0.0.5,0.0.6,5,1,39,39,78,5,FALSE
fizzy,0.0.4,0.0.5,4,1,4,6,10,2,FALSE
fizzy,0.0.7,0.0.8,7,1,9,5,14,2,FALSE
fizzy,0.0.6,0.0.7,6,4,4,9,13,4,FALSE
fizzy,0.0.1,0.0.2,1,4,192,4,196,15,FALSE
fizzy,0.0.3,0.0.4,3,2,3,3,6,2,FALSE
fizzy,0.0.2,0.0.3,2,2,4,4,8,2,FALSE
fizzy,0.3.2,0.3.3,31,1,2,1,3,1,FALSE
fizzy,0.3.0,0.3.1,29,1,3,2,5,1,FALSE
fizzy,0.3.1,0.3.2,30,1,10,4,14,2,FALSE
fizzy,0.0.9,0.0.10,9,1,39,25,64,5,FALSE
fizzy,0.0.8,0.0.9,8,1,4,4,8,2,FALSE
fizzy,0.4.1,0.4.2,34,1,6,2,8,2,FALSE
fizzy,0.1.12,0.1.13,24,1,2,2,4,2,FALSE
fizzy,0.1.13,0.2.0,25,1,9,4,13,2,FALSE
fizzy,0.1.10,0.1.11,22,2,19,1,20,3,FALSE
fizzy,0.1.11,0.1.12,23,1,3,2,5,2,FALSE
fizzy,0.2.2,0.3.0,28,2,9,1,10,3,FALSE
fizzy,0.0.2,0.0.3,2,2,4,4,8,2,TRUE
fizzy,0.1.6,0.1.7,18,1,7,2,9,2,TRUE
fizzy,0.3.3,0.4.0,32,2,6,8,14,2,FALSE
fizzy,0.4.0,0.4.1,33,1,5,15,20,2,FALSE
harvey,0.3.16,0.3.17,35,4,89,12,101,6,FALSE
harvey,0.3.10,0.3.11,29,2,14,12,26,2,FALSE
harvey,0.5.10,0.5.11,63,3,154,15,169,6,FALSE
harvey,0.5.11,0.5.12,64,3,17,3,20,3,FALSE
harvey,0.3.17,0.3.18,36,6,603,146,749,12,FALSE
harvey,0.3.8,0.3.9,27,2,5,2,7,2,FALSE
harvey,0.3.9,0.3.10,28,2,2,5,7,3,FALSE
harvey,0.3.6,0.3.7,25,3,5,5,10,3,FALSE
harvey,0.3.7,0.3.8,26,8,206,52,258,19,FALSE
harvey,0.4.9,0.4.10,51,3,271,41,312,5,FALSE
harvey,0.4.8,0.4.9,50,11,60,28,88,12,FALSE
harvey,0.5.8,0.5.9,61,2,4,2,6,2,FALSE
harvey,0.5.9,0.5.10,62,2,68,2,70,3,FALSE
harvey,0.4.1,0.4.2,43,1,3,3,6,2,FALSE
harvey,0.4.0,0.4.1,42,1,17,1,18,2,FALSE
harvey,0.4.3,0.4.4,45,4,6,4,10,4,FALSE
harvey,0.4.2,0.4.3,44,3,617,80,697,15,FALSE
harvey,0.5.0,0.5.1,53,3,51,13,64,3,FALSE
harvey,0.4.4,0.4.5,46,2,236,27,263,6,FALSE
harvey,0.4.7,0.4.8,49,2,2,2,4,2,FALSE
harvey,0.5.3,0.5.4,56,3,1297,1255,2552,57,FALSE
harvey,0.4.10,0.5.0,52,3,84,9,93,8,FALSE
harvey,0.3.11,0.3.12,30,4,19,10,29,5,FALSE
harvey,0.3.14,0.3.15,33,1,3,2,5,1,FALSE
harvey,0.4.6,0.4.7,48,6,676,68,744,12,FALSE
harvey,0.3.18,0.3.19,37,4,432,4,436,7,FALSE
harvey,0.5.4,0.5.5,57,2,4,4,8,4,FALSE
harvey,0.3.12,0.3.13,31,2,18,7,25,2,FALSE
harvey,0.5.5,0.5.6,58,7,24,15,39,13,FALSE
harvey,0.5.6,0.5.7,59,9,433,425,858,21,FALSE
harvey,0.5.7,0.5.8,60,2,38,8,46,5,FALSE
harvey,0.3.15,0.3.16,34,6,319,16,335,6,FALSE
harvey,0.4.5,0.4.6,47,1,20,15,35,4,FALSE
harvey,0.3.19,0.3.20,38,2,15,2,17,4,FALSE
harvey,0.5.1,0.5.2,54,5,347,32,379,11,FALSE
harvey,0.3.21,0.3.22,40,1,91,5,96,7,FALSE
harvey,0.3.20,0.3.21,39,1,20,20,40,2,FALSE
harvey,0.3.22,0.4.0,41,10,3954,1469,5423,74,FALSE
harvey,0.5.2,0.5.3,55,9,598,212,810,32,FALSE
harvey,0.3.13,0.3.14,32,5,31,11,42,8,FALSE
harvey,0.3.2,0.3.3,21,10,753,374,1127,22,FALSE
harvey,0.3.3,0.3.4,22,1,19,8,27,3,FALSE
harvey,0.3.1,0.3.2,20,3,6,4,10,3,FALSE
harvey,0.3.4,0.3.5,23,4,4,4,8,4,FALSE
harvey,0.2.20,0.3.0,18,24,1079,913,1992,66,FALSE
harvey,0.2.7,0.2.8,5,4,81,3,84,6,FALSE
harvey,0.2.6,0.2.7,4,4,615,11,626,6,FALSE
harvey,0.2.5,0.2.6,3,7,1053,350,1403,41,FALSE
harvey,0.2.4,0.2.5,2,3,486,341,827,23,FALSE
harvey,0.2.3,0.2.4,1,11,64,91,155,15,FALSE
harvey,0.2.9,0.2.10,7,2,274,105,379,9,FALSE
harvey,0.2.8,0.2.9,6,6,868,26,894,19,FALSE
harvey,0.3.0,0.3.1,19,13,824,108,932,17,FALSE
harvey,0.3.5,0.3.6,24,6,174,48,222,16,FALSE
harvey,0.2.19,0.2.20,17,29,1647,759,2406,107,FALSE
harvey,0.2.18,0.2.19,16,4,33,31,64,6,FALSE
harvey,0.2.17,0.2.18,15,8,441,205,646,21,FALSE
harvey,0.2.16,0.2.17,14,5,145,7,152,9,FALSE
harvey,0.2.15,0.2.16,13,12,192,52,244,21,FALSE
harvey,0.2.14,0.2.15,12,4,64,65,129,18,FALSE
harvey,0.2.13,0.2.14,11,4,63,64,127,18,FALSE
harvey,0.2.12,0.2.13,10,8,417,71,488,17,FALSE
harvey,0.2.11,0.2.12,9,8,80,30,110,8,FALSE
harvey,0.2.10,0.2.11,8,8,672,22,694,16,FALSE
harvey,0.3.15,0.3.16,34,6,319,16,335,6,TRUE
harvey,0.3.16,0.3.17,35,4,89,12,101,6,TRUE
harvey,0.2.20,0.3.0,18,24,1079,913,1992,66,TRUE
harvey,0.2.6,0.2.7,4,4,615,11,626,6,TRUE
harvey,0.2.5,0.2.6,3,7,1053,350,1403,41,TRUE
harvey,0.3.3,0.3.4,22,1,19,8,27,3,TRUE
harvey,0.3.10,0.3.11,29,2,14,12,26,2,TRUE
harvey,0.2.19,0.2.20,17,29,1647,759,2406,107,TRUE
harvey,0.3.7,0.3.8,26,8,206,52,258,19,TRUE
harvey,0.2.8,0.2.9,6,6,868,26,894,19,TRUE
harvey,0.2.13,0.2.14,11,4,63,64,127,18,TRUE
harvey,0.2.10,0.2.11,8,8,672,22,694,16,TRUE
harvey,0.2.15,0.2.16,13,12,192,52,244,21,TRUE
redux-tooltip,0.6.0,0.6.1,20,3,34,39,73,5,FALSE
redux-tooltip,0.2.1,0.3.0,5,15,755,238,993,48,FALSE
redux-tooltip,0.2.0,0.2.1,4,9,420,194,614,36,FALSE
redux-tooltip,0.1.1,0.1.2,1,5,274,91,365,23,FALSE
redux-tooltip,0.1.2,0.1.3,2,3,253,13,266,20,FALSE
redux-tooltip,0.1.3,0.2.0,3,6,377,54,431,26,FALSE
redux-tooltip,0.6.2,0.7.0,22,8,210,23,233,19,FALSE
redux-tooltip,0.3.0,0.3.1,6,9,319,164,483,24,FALSE
redux-tooltip,0.3.1,0.4.0,7,7,674,69,743,22,FALSE
redux-tooltip,0.4.1,0.4.2,9,5,182,56,238,12,FALSE
redux-tooltip,0.4.0,0.4.1,8,2,42,15,57,5,FALSE
redux-tooltip,0.4.3,0.4.4,11,2,82,25,107,7,FALSE
redux-tooltip,0.4.2,0.4.3,10,3,17,20,37,7,FALSE
redux-tooltip,0.4.5,0.4.6,13,6,320,48,368,12,FALSE
redux-tooltip,0.4.4,0.4.5,12,12,267,197,464,23,FALSE
redux-tooltip,0.5.2,0.5.3,17,5,128,50,178,10,FALSE
redux-tooltip,0.4.6,0.5.0,14,11,1087,230,1317,62,FALSE
redux-tooltip,0.5.4,0.6.0,19,8,104,54,158,16,FALSE
redux-tooltip,0.5.0,0.5.1,15,4,80,38,118,11,FALSE
redux-tooltip,0.5.1,0.5.2,16,4,74,91,165,12,FALSE
redux-tooltip,0.5.3,0.5.4,18,4,94,11,105,8,FALSE
redux-tooltip,0.6.1,0.6.2,21,4,105,98,203,13,FALSE
redux-tooltip,0.7.0,0.7.1,23,14,106,1105,1211,49,FALSE
redux-tooltip,0.7.1,0.7.2,24,4,10,10,20,4,FALSE
redux-tooltip,0.4.4,0.4.5,12,12,267,197,464,23,TRUE
redux-tooltip,0.4.1,0.4.2,9,5,182,56,238,12,TRUE
redux-tooltip,0.4.3,0.4.4,11,2,82,25,107,7,TRUE
redux-tooltip,0.2.0,0.2.1,4,9,420,194,614,36,TRUE
redux-tooltip,0.5.0,0.5.1,15,4,80,38,118,11,TRUE
redux-tooltip,0.1.2,0.1.3,2,3,253,13,266,20,TRUE
redux-tooltip,0.5.3,0.5.4,18,4,94,11,105,8,TRUE
redux-tooltip,0.6.0,0.6.1,20,3,34,39,73,5,TRUE
redux-tooltip,0.1.3,0.2.0,3,6,377,54,431,26,TRUE
redux-tooltip,0.6.1,0.6.2,21,4,105,98,203,13,TRUE
url-io,3.1.0,3.2.0,12,2,245,165,410,14,FALSE
url-io,2.0.3,2.0.4,5,2,2,2,4,2,FALSE
url-io,2.0.2,2.0.3,4,2,72,20,92,5,FALSE
url-io,2.0.1,2.0.2,3,2,3,2,5,2,FALSE
url-io,2.0.0,2.0.1,2,2,3,1,4,2,FALSE
url-io,2.0.4,2.1.0,6,2,106,36,142,7,FALSE
url-io,2.2.0,3.0.0,10,2,279,320,599,22,TRUE
url-io,2.1.2,2.2.0,9,2,32,3,35,4,FALSE
url-io,1.0.0,2.0.0,1,2,22,40,62,7,FALSE
url-io,2.1.0,2.1.1,7,2,10,2,12,2,FALSE
url-io,2.1.1,2.1.2,8,2,7,2,9,3,FALSE
url-io,4.0.0,4.0.2,27,4,17,23,40,4,FALSE
url-io,3.0.0,3.1.0,11,2,47,48,95,8,FALSE
url-io,3.10.0,3.10.1,21,2,2,2,4,2,FALSE
url-io,3.10.1,3.10.2,22,2,2,2,4,2,TRUE
url-io,3.10.2,3.10.3,23,2,5,1,6,2,FALSE
url-io,3.10.3,3.10.4,24,2,14,4,18,2,FALSE
url-io,3.10.4,3.10.5,25,2,3,3,6,2,FALSE
url-io,3.10.5,4.0.0,26,3,2604,295,2899,25,FALSE
url-io,3.9.0,3.10.0,20,3,145,101,246,5,FALSE
url-io,3.8.0,3.9.0,19,2,43,1,44,3,FALSE
url-io,3.4.0,3.5.0,15,2,4,1,5,2,FALSE
url-io,3.5.0,3.6.0,16,2,65,30,95,2,FALSE
url-io,3.6.0,3.7.0,17,2,5,1,6,2,FALSE
url-io,3.3.0,3.4.0,14,2,82,89,171,12,FALSE
url-io,3.2.0,3.3.0,13,2,44,35,79,10,TRUE
url-io,3.7.0,3.8.0,18,2,6,2,8,2,FALSE
url-io,2.2.0,3.0.0,10,2,279,320,599,22,FALSE
url-io,3.4.0,3.5.0,15,2,4,1,5,2,TRUE
url-io,3.2.0,3.3.0,13,2,44,35,79,10,FALSE
url-io,3.10.1,3.10.2,22,2,2,2,4,2,FALSE
url-io,2.0.3,2.0.4,5,2,2,2,4,2,TRUE
url-io,2.0.2,2.0.3,4,2,72,20,92,5,TRUE
Templ8,0.9.23,0.9.24,35,1,22,1,23,2,FALSE
Templ8,0.9.22,0.9.23,34,1,22,1,23,2,FALSE
Templ8,0.9.21,0.9.22,33,1,22,1,23,2,FALSE
Templ8,0.10.2,0.10.3,41,1,22,1,23,2,FALSE
Templ8,0.9.26,0.10.0,38,1,22,1,23,2,FALSE
Templ8,0.9.25,0.9.26,37,1,22,1,23,2,FALSE
Templ8,0.9.24,0.9.25,36,1,22,1,23,2,FALSE
Templ8,0.9.7,0.9.8,20,1,22,1,23,2,FALSE
Templ8,0.9.0,0.9.1,13,1,22,1,23,2,TRUE
Templ8,0.9.1,0.9.2,14,1,22,1,23,2,FALSE
Templ8,0.9.2,0.9.3,15,1,22,1,23,2,FALSE
Templ8,0.9.3,0.9.4,16,1,22,1,23,2,FALSE
Templ8,0.9.4,0.9.5,17,1,22,1,23,2,FALSE
Templ8,0.9.5,0.9.6,18,1,22,1,23,2,FALSE
Templ8,0.9.6,0.9.7,19,1,22,1,23,2,FALSE
Templ8,0.10.0,0.10.1,39,1,22,1,23,2,FALSE
Templ8,0.9.8,0.9.9,21,1,22,1,23,2,TRUE
Templ8,0.9.9,0.9.11,22,1,22,1,23,2,FALSE
Templ8,0.10.3,0.10.4,42,1,22,1,23,2,FALSE
Templ8,0.9.20,0.9.21,32,1,22,1,23,2,FALSE
Templ8,0.10.4,0.10.5,43,1,22,1,23,2,FALSE
Templ8,0.10.1,0.10.2,40,1,22,1,23,2,FALSE
Templ8,0.9.18,0.9.19,30,1,22,1,23,2,FALSE
Templ8,0.9.19,0.9.20,31,1,22,1,23,2,FALSE
Templ8,0.9.12,0.9.13,24,1,22,1,23,2,FALSE
Templ8,0.9.13,0.9.14,25,1,22,1,23,2,FALSE
Templ8,0.9.11,0.9.12,23,1,22,1,23,2,FALSE
Templ8,0.9.16,0.9.17,28,1,22,1,23,2,FALSE
Templ8,0.9.17,0.9.18,29,1,22,1,23,2,FALSE
Templ8,0.9.14,0.9.15,26,1,22,1,23,2,FALSE
Templ8,0.9.15,0.9.16,27,1,22,1,23,2,FALSE
Templ8,0.9.0,0.9.1,13,1,22,1,23,2,FALSE
Templ8,0.9.8,0.9.9,21,1,22,1,23,2,FALSE
Templ8,0.9.21,0.9.22,33,1,22,1,23,2,TRUE
Templ8,0.9.19,0.9.20,31,1,22,1,23,2,TRUE
calcify,0.4.0,0.5.0,4,3,295,279,574,11,FALSE
calcify,0.3.0,0.4.0,3,1,53,50,103,7,FALSE
calcify,0.6.0,0.7.0,6,2,97,117,214,5,FALSE
calcify,0.5.0,0.6.0,5,2,178,174,352,5,FALSE
calcify,0.6.0,0.7.0,6,2,97,117,214,5,TRUE
d3-cluster,1.0.0-alpha.1,1.0.0-alpha.2,1,2,1,2,3,2,FALSE
d3-cluster,1.0.0-alpha.3,1.0.0-alpha.4,3,1,1,2,3,2,FALSE
d3-cluster,1.0.0-alpha.2,1.0.0-alpha.3,2,1,2,2,4,2,FALSE
d3-cluster,1.0.0-alpha.5,1.0.0-alpha.6,5,2,2,4,6,2,FALSE
d3-cluster,1.0.0-alpha.4,1.0.0-alpha.5,4,2,33,125,158,9,FALSE
d3-cluster,1.0.0-alpha.7,1.0.0-alpha.8,7,3,32,28,60,3,FALSE
d3-cluster,1.0.0-alpha.6,1.0.0-alpha.7,6,1,104,75,179,6,TRUE
d3-cluster,1.0.0-alpha.6,1.0.0-alpha.7,6,1,104,75,179,6,FALSE
rematch,0.1.0,0.1.1,1,4,6,4,10,5,FALSE
rematch,0.1.1,0.1.2,2,7,21,10,31,8,FALSE
rematch,0.1.2,0.1.3,3,3,16,12,28,3,FALSE
rematch,0.1.1,0.1.2,2,7,21,10,31,8,TRUE
rematch,0.1.2,0.1.3,3,3,16,12,28,3,TRUE
barejs,0.3.0,0.3.1,3,1,2,2,4,1,FALSE
barejs,0.2.2,0.3.0,2,1,30,24,54,5,FALSE
barejs,0.2.0,0.2.2,1,2,3,2,5,2,FALSE
barejs,0.6.0,0.7.0,7,1,335,245,580,4,FALSE
barejs,0.3.1,0.4.0,4,1,26,59,85,7,FALSE
barejs,0.4.0,0.5.0,5,1,89,27,116,10,FALSE
barejs,0.5.0,0.6.0,6,1,3037,10,3047,6,FALSE
barejs,0.4.0,0.5.0,5,1,89,27,116,10,TRUE
barejs,0.5.0,0.6.0,6,1,3037,10,3047,6,TRUE
prefixed-reflexbox,1.1.3,1.1.4,1,1,1,1,2,1,FALSE
prefixed-reflexbox,1.1.5,1.1.6,3,6,492,611,1103,48,FALSE
prefixed-reflexbox,1.1.4,1.1.5,2,1,1,1,2,1,FALSE
prefixed-reflexbox,1.1.6,1.1.7,4,1,1,1,2,1,FALSE
prefixed-reflexbox,1.1.6,1.1.7,4,1,1,1,2,1,TRUE
librato-api,1.1.1,1.1.2,10,2,3,3,6,3,FALSE
librato-api,1.1.0,1.1.1,9,2,6,327,333,3,FALSE
librato-api,1.1.3,1.1.4,12,4,5,6,11,5,FALSE
librato-api,1.1.2,1.1.3,11,2,6,2,8,3,FALSE
librato-api,1.0.1,1.0.2,6,9,2349,221,2570,28,FALSE
librato-api,1.0.2,1.0.3,7,2,6,7,13,3,FALSE
librato-api,1.0.3,1.1.0,8,15,2841,2608,5449,38,FALSE
librato-api,0.2.2,1.0.1,5,12,2328,228,2556,28,FALSE
librato-api,0.2.1,0.2.2,4,2,4,3,7,2,FALSE
librato-api,0.2.0,0.2.1,3,3,4,3,7,3,FALSE
librato-api,0.1.0,0.1.1,1,2,18,2,20,2,FALSE
librato-api,0.1.1,0.2.0,2,3,317,5,322,5,FALSE
librato-api,1.1.4,1.1.5,13,7,85,83,168,11,FALSE
librato-api,1.1.0,1.1.1,9,2,6,327,333,3,TRUE
librato-api,1.1.2,1.1.3,11,2,6,2,8,3,TRUE
librato-api,0.2.0,0.2.1,3,3,4,3,7,3,TRUE
librato-api,1.0.2,1.0.3,7,2,6,7,13,3,TRUE
librato-api,0.2.2,1.0.1,5,12,2328,228,2556,28,TRUE
gulp-zkflow-angular,1.1.0,1.1.1,46,3,45,35,80,7,FALSE
gulp-zkflow-angular,0.6.0-0,1.0.0-0,28,4,524,263,787,21,FALSE
gulp-zkflow-angular,1.0.0,1.0.1,44,3,4,4,8,3,FALSE
gulp-zkflow-angular,1.0.1,1.1.0,45,5,206,196,402,31,FALSE
gulp-zkflow-angular,1.0.0-11,1.0.0-12,40,11,1620,658,2278,72,FALSE
gulp-zkflow-angular,1.0.0-10,1.0.0-11,39,2,53,27,80,9,FALSE
gulp-zkflow-angular,1.0.0-13,1.0.0-14,42,3,34,14,48,8,FALSE
gulp-zkflow-angular,1.0.0-12,1.0.0-13,41,4,92,114,206,14,FALSE
gulp-zkflow-angular,1.0.0-14,1.0.0,43,5,186,68,254,9,FALSE
gulp-zkflow-angular,0.2.7,0.2.8,11,2,2,2,4,2,FALSE
gulp-zkflow-angular,0.2.6,0.2.7,10,2,5,5,10,3,FALSE
gulp-zkflow-angular,0.2.5,0.2.6,9,2,13,8,21,3,FALSE
gulp-zkflow-angular,0.2.4,0.2.5,8,3,7,7,14,3,FALSE
gulp-zkflow-angular,0.2.3,0.2.4,7,4,62,12,74,9,FALSE
gulp-zkflow-angular,0.2.2,0.2.3,6,2,20,12,32,4,FALSE
gulp-zkflow-angular,0.2.1,0.2.2,5,2,426,510,936,42,FALSE
gulp-zkflow-angular,0.2.0,0.2.1,4,4,11,33,44,7,FALSE
gulp-zkflow-angular,0.1.0,0.1.1,2,3,18,4,22,4,FALSE
gulp-zkflow-angular,0.1.1,0.2.0,3,3,99,87,186,11,FALSE
gulp-zkflow-angular,0.2.8,0.3.0,12,5,121,11,132,11,FALSE
gulp-zkflow-angular,0.3.2,0.4.0,15,4,604,256,860,48,FALSE
gulp-zkflow-angular,0.3.0,0.3.1,13,3,25,145,170,27,FALSE
gulp-zkflow-angular,0.3.1,0.3.2,14,2,11,3,14,3,FALSE
gulp-zkflow-angular,0.4.0,0.5.0-alpha.0,16,3,58,51,109,7,FALSE
gulp-zkflow-angular,0.5.0,0.5.1,25,2,10,39,49,14,FALSE
gulp-zkflow-angular,0.5.1,0.5.2,26,2,3,2,5,2,FALSE
gulp-zkflow-angular,0.5.2,0.6.0-0,27,2,385,272,657,12,FALSE
gulp-zkflow-angular,1.0.0-8,1.0.0-9,37,2,22,9,31,4,FALSE
gulp-zkflow-angular,0.5.0-alpha.5,0.5.0-alpha.6,22,2,5,5,10,5,FALSE
gulp-zkflow-angular,0.5.0-alpha.1,0.5.0-alpha.2,18,2,28,7,35,3,FALSE
gulp-zkflow-angular,0.5.0-alpha.0,0.5.0-alpha.1,17,1,1,1,2,1,FALSE
gulp-zkflow-angular,0.5.0-alpha.3,0.5.0-alpha.4,20,2,86,42,128,13,FALSE
gulp-zkflow-angular,0.5.0-alpha.2,0.5.0-alpha.3,19,2,18,3,21,6,FALSE
gulp-zkflow-angular,1.0.0-9,1.0.0-10,38,2,84,18,102,7,FALSE
gulp-zkflow-angular,0.5.0-alpha.4,0.5.0-alpha.5,21,2,308,99,407,11,FALSE
gulp-zkflow-angular,0.5.0-alpha.7,0.5.0,24,5,989,262,1251,39,FALSE
gulp-zkflow-angular,0.5.0-alpha.6,0.5.0-alpha.7,23,2,48,43,91,2,FALSE
gulp-zkflow-angular,1.0.0-5,1.0.0-6,34,2,39,52,91,4,FALSE
gulp-zkflow-angular,1.0.0-4,1.0.0-5,33,2,68,25,93,10,FALSE
gulp-zkflow-angular,1.0.0-7,1.0.0-8,36,2,68,34,102,4,FALSE
gulp-zkflow-angular,1.0.0-6,1.0.0-7,35,2,6,3,9,2,FALSE
gulp-zkflow-angular,1.0.0-1,1.0.0-2,30,2,58,28,86,5,FALSE
gulp-zkflow-angular,1.0.0-0,1.0.0-1,29,2,3,3,6,3,FALSE
gulp-zkflow-angular,1.0.0-3,1.0.0-4,32,1,1,1,2,1,FALSE
gulp-zkflow-angular,1.0.0-2,1.0.0-3,31,2,160,124,284,16,FALSE
gulp-zkflow-angular,0.0.8,0.1.0,1,12,1038,568,1606,67,FALSE
gulp-zkflow-angular,0.2.6,0.2.7,10,2,5,5,10,3,TRUE
gulp-zkflow-angular,0.2.4,0.2.5,8,3,7,7,14,3,TRUE
gulp-zkflow-angular,0.4.0,0.5.0-alpha.0,16,3,58,51,109,7,TRUE
gulp-zkflow-angular,0.3.2,0.4.0,15,4,604,256,860,48,TRUE
gulp-zkflow-angular,0.5.0-alpha.5,0.5.0-alpha.6,22,2,5,5,10,5,TRUE
gulp-zkflow-angular,0.1.0,0.1.1,2,3,18,4,22,4,TRUE
gulp-zkflow-angular,0.1.1,0.2.0,3,3,99,87,186,11,TRUE
gulp-zkflow-angular,1.0.0-9,1.0.0-10,38,2,84,18,102,7,TRUE
gulp-zkflow-angular,0.5.0,0.5.1,25,2,10,39,49,14,TRUE
gulp-zkflow-angular,1.0.0-7,1.0.0-8,36,2,68,34,102,4,TRUE
gulp-zkflow-angular,1.0.0-2,1.0.0-3,31,2,160,124,284,16,TRUE
openshare,1.4.6,1.4.7,9,2,4,3,7,2,TRUE
openshare,1.4.7,1.4.8,10,1,1,1,2,1,FALSE
openshare,1.4.8,1.4.9-1,11,14,154,5907,6061,27,FALSE
openshare,1.4.9,1.4.10,13,10,3385,4011,7396,20,FALSE
openshare,1.4.5,1.4.6,8,8,13473,5453,18926,86,FALSE
openshare,1.4.6,1.4.7,9,2,4,3,7,2,FALSE
openshare,1.4.0,1.4.1,3,5,14,8,22,10,FALSE
openshare,1.4.1,1.4.2,4,4,34,26,60,13,FALSE
openshare,1.4.2,1.4.3,5,2,14,8,22,8,FALSE
openshare,1.4.3,1.4.4,6,2,8,8,16,8,FALSE
openshare,1.4.4,1.4.5,7,9,568,64,632,22,FALSE
openshare,1.3.0,1.4.0,2,13,3905,3809,7714,36,FALSE
openshare,1.2.2,1.3.0,1,12,3764,3854,7618,36,FALSE
openshare,1.4.0,1.4.1,3,5,14,8,22,10,TRUE
openshare,1.4.8,1.4.9-1,11,14,154,5907,6061,27,TRUE
openshare,1.4.9,1.4.10,13,10,3385,4011,7396,20,TRUE
jadelint,0.3.2,0.3.3,24,4,18,10,28,6,FALSE
jadelint,0.3.0,0.3.1,21,1,3,2,5,2,FALSE
jadelint,0.3.1,0.3.2-beta,22,8,15,11,26,10,FALSE
jadelint,0.3.0-beta3,0.3.0,20,2,3,3,6,3,FALSE
jadelint,0.3.0-beta2,0.3.0-beta3,19,2,2,2,4,2,FALSE
jadelint,0.3.0-beta,0.3.0-beta2,18,2,15,11,26,4,FALSE
jadelint,0.3.2-beta,0.3.2,23,2,15,12,27,3,FALSE
jadelint,0.2.7,0.2.8,11,1,2,1,3,2,FALSE
jadelint,0.2.6,0.2.7,10,4,15,7,22,5,FALSE
jadelint,0.2.5,0.2.6,9,2,5,4,9,2,FALSE
jadelint,0.2.4,0.2.5,8,1,2,2,4,2,FALSE
jadelint,0.2.3,0.2.4,7,2,22,8,30,4,FALSE
jadelint,0.2.2,0.2.3,6,1,2,0,2,1,FALSE
jadelint,0.2.1,0.2.2,5,1,2,0,2,1,FALSE
jadelint,0.2.0,0.2.1,4,1,2,0,2,1,FALSE
jadelint,0.1.1,0.2.0,3,60,1597,297,1894,143,FALSE
jadelint,0.2.9,0.2.10,13,4,154,144,298,6,FALSE
jadelint,0.2.8,0.2.9,12,6,184,16,200,13,FALSE
jadelint,0.2.13,0.3.0-beta,17,20,383,181,564,49,FALSE
jadelint,0.2.12,0.2.13,16,3,18,5,23,5,FALSE
jadelint,0.2.11,0.2.12,15,1,1,2,3,2,FALSE
jadelint,0.2.10,0.2.11,14,7,66,13,79,8,FALSE
jadelint,0.1.0,0.1.1,2,24,592,267,859,84,FALSE
jadelint,0.2.10,0.2.11,14,7,66,13,79,8,TRUE
jadelint,0.3.0-beta,0.3.0-beta2,18,2,15,11,26,4,TRUE
jadelint,0.2.13,0.3.0-beta,17,20,383,181,564,49,TRUE
turbo-commit,0.0.1,0.1.0,1,3,34,12,46,3,FALSE
turbo-commit,0.3.0,0.4.0,6,43,1213,571,1784,93,FALSE
turbo-commit,0.6.0,0.7.0,9,56,656,248,904,82,FALSE
turbo-commit,0.7.0,0.8.0,10,57,1035,552,1587,97,FALSE
turbo-commit,0.2.0,0.3.0,5,11,171,142,313,16,FALSE
turbo-commit,0.1.0,0.1.1,2,7,12,15,27,7,FALSE
turbo-commit,0.1.1,0.1.3,3,25,183,128,311,32,FALSE
turbo-commit,0.1.3,0.2.0,4,5,207,88,295,13,FALSE
turbo-commit,0.5.0,0.6.0,8,14,137,53,190,23,FALSE
turbo-commit,0.4.0,0.5.0,7,22,285,190,475,37,FALSE
turbo-commit,0.3.0,0.4.0,6,43,1213,571,1784,93,TRUE
turbo-commit,0.7.0,0.8.0,10,57,1035,552,1587,97,TRUE
glob-uglifyjs,0.1.1,0.2.0,6,1,241,168,409,7,FALSE
glob-uglifyjs,0.0.4,0.1.0,4,2,130,13,143,9,FALSE
glob-uglifyjs,0.0.1,0.0.2,1,2,3,2,5,2,FALSE
glob-uglifyjs,0.0.3,0.0.4,3,1,2,2,4,2,FALSE
glob-uglifyjs,0.0.2,0.0.3,2,2,2,1,3,2,FALSE
glob-uglifyjs,0.3.0,0.4.0,8,5,31,671,702,7,FALSE
glob-uglifyjs,0.1.0,0.1.1,5,1,25,11,36,4,FALSE
glob-uglifyjs,0.2.0,0.3.0,7,18,424,262,686,49,FALSE
glob-uglifyjs,0.4.1,0.4.2,10,2,5,5,10,2,FALSE
glob-uglifyjs,0.4.0,0.4.1,9,4,11,10,21,4,FALSE
glob-uglifyjs,1.0.0-alpha-1,1.0.0-beta.1,13,1,2,2,4,2,FALSE
glob-uglifyjs,0.4.2,0.4.3,11,3,8,8,16,6,FALSE
glob-uglifyjs,0.4.3,1.0.0-alpha-1,12,1,2,2,4,2,TRUE
glob-uglifyjs,0.4.3,1.0.0-alpha-1,12,1,2,2,4,2,FALSE
glob-uglifyjs,0.0.3,0.0.4,3,1,2,2,4,2,TRUE
glob-uglifyjs,0.2.0,0.3.0,7,18,424,262,686,49,TRUE
glob-uglifyjs,0.4.0,0.4.1,9,4,11,10,21,4,TRUE
credentials-io,0.2.3,0.2.4,5,5,47,10,57,5,FALSE
credentials-io,0.2.2,0.2.3,4,2,7,2,9,2,FALSE
credentials-io,0.2.1,0.2.2,3,2,6,6,12,2,TRUE
credentials-io,0.2.0,0.2.1,2,5,95,43,138,5,FALSE
credentials-io,0.2.1,0.2.2,3,2,6,6,12,2,FALSE
fenix-ui-metadata-editor,2.0.0-beta.24,2.0.0-beta.25,22,1,883,459,1342,17,FALSE
fenix-ui-metadata-editor,2.0.0-beta.25,2.0.0-beta.26,23,1,883,459,1342,17,FALSE
fenix-ui-metadata-editor,2.0.0-beta.22,2.0.0-beta.23,20,1,883,459,1342,17,FALSE
fenix-ui-metadata-editor,2.0.0-beta.23,2.0.0-beta.24,21,1,883,459,1342,17,FALSE
fenix-ui-metadata-editor,2.0.0-beta.46,2.0.0-beta.47,44,1,883,459,1342,17,FALSE
fenix-ui-metadata-editor,2.0.0-beta.47,2.0.0-beta.48,45,1,883,459,1342,17,FALSE
fenix-ui-metadata-editor,2.0.0-beta.26,2.0.0-beta.27,24,1,883,459,1342,17,FALSE
fenix-ui-metadata-editor,2.0.0-beta.27,2.0.0-beta.28,25,1,883,459,1342,17,FALSE
fenix-ui-metadata-editor,2.0.0-beta.42,2.0.0-beta.43,40,1,883,459,1342,17,FALSE
fenix-ui-metadata-editor,2.0.0-beta.43,2.0.0-beta.44,41,1,883,459,1342,17,FALSE
fenix-ui-metadata-editor,2.0.0-beta.53,2.0.0-beta.54,50,1,883,459,1342,17,FALSE
fenix-ui-metadata-editor,2.0.0-beta.28,2.0.0-beta.29,26,1,883,459,1342,17,FALSE
fenix-ui-metadata-editor,2.0.0-beta.29,2.0.0-beta.30,27,1,883,459,1342,17,FALSE
fenix-ui-metadata-editor,2.0.0-beta.48,2.0.0-beta.49,46,1,883,459,1342,17,FALSE
fenix-ui-metadata-editor,2.0.0-beta.49,2.0.0-beta.50,47,1,883,459,1342,17,FALSE
fenix-ui-metadata-editor,2.0.0-beta.9,2.0.0-beta.10,9,1,883,459,1342,17,FALSE
fenix-ui-metadata-editor,2.0.0-beta.8,2.0.0-beta.9,8,1,883,459,1342,17,FALSE
fenix-ui-metadata-editor,2.0.0-beta.3,2.0.0-beta.5,4,1,883,459,1342,17,FALSE
fenix-ui-metadata-editor,2.0.0-beta.2,2.0.0-beta.3,3,1,883,459,1342,17,FALSE
fenix-ui-metadata-editor,2.0.0-beta.1,2.0.0-beta.2,2,1,883,459,1342,17,FALSE
fenix-ui-metadata-editor,2.0.0-beta.0,2.0.0-beta.1,1,1,883,459,1342,17,FALSE
fenix-ui-metadata-editor,2.0.0-beta.7,2.0.0-beta.8,7,1,883,459,1342,17,FALSE
fenix-ui-metadata-editor,2.0.0-beta.6,2.0.0-beta.7,6,1,883,459,1342,17,FALSE
fenix-ui-metadata-editor,2.0.0-beta.5,2.0.0-beta.6,5,1,883,459,1342,17,FALSE
fenix-ui-metadata-editor,2.0.0-beta.19,2.0.0-beta.22,19,1,883,459,1342,17,FALSE
fenix-ui-metadata-editor,2.0.0-beta.18,2.0.0-beta.19,18,1,883,459,1342,17,FALSE
fenix-ui-metadata-editor,2.0.0-beta.17,2.0.0-beta.18,17,1,883,459,1342,17,FALSE
fenix-ui-metadata-editor,2.0.0-beta.16,2.0.0-beta.17,16,1,883,459,1342,17,FALSE
fenix-ui-metadata-editor,2.0.0-beta.15,2.0.0-beta.16,15,1,883,459,1342,17,FALSE
fenix-ui-metadata-editor,2.0.0-beta.14,2.0.0-beta.15,14,1,883,459,1342,17,FALSE
fenix-ui-metadata-editor,2.0.0-beta.13,2.0.0-beta.14,13,1,883,459,1342,17,FALSE
fenix-ui-metadata-editor,2.0.0-beta.12,2.0.0-beta.13,12,1,883,459,1342,17,FALSE
fenix-ui-metadata-editor,2.0.0-beta.11,2.0.0-beta.12,11,1,883,459,1342,17,FALSE
fenix-ui-metadata-editor,2.0.0-beta.10,2.0.0-beta.11,10,1,883,459,1342,17,FALSE
fenix-ui-metadata-editor,2.0.0-beta.31,2.0.0-beta.32,29,1,883,459,1342,17,FALSE
fenix-ui-metadata-editor,2.0.0-beta.30,2.0.0-beta.31,28,1,883,459,1342,17,FALSE
fenix-ui-metadata-editor,2.0.0-beta.33,2.0.0-beta.34,31,1,883,459,1342,17,FALSE
fenix-ui-metadata-editor,2.0.0-beta.32,2.0.0-beta.33,30,1,883,459,1342,17,FALSE
fenix-ui-metadata-editor,2.0.0-beta.35,2.0.0-beta.36,33,1,883,459,1342,17,FALSE
fenix-ui-metadata-editor,2.0.0-beta.34,2.0.0-beta.35,32,1,883,459,1342,17,FALSE
fenix-ui-metadata-editor,2.0.0-beta.37,2.0.0-beta.38,35,1,883,459,1342,17,FALSE
fenix-ui-metadata-editor,2.0.0-beta.36,2.0.0-beta.37,34,1,883,459,1342,17,FALSE
fenix-ui-metadata-editor,2.0.0-beta.39,2.0.0-beta.40,37,1,883,459,1342,17,FALSE
fenix-ui-metadata-editor,2.0.0-beta.52,2.0.0-beta.53,49,1,883,459,1342,17,FALSE
fenix-ui-metadata-editor,2.0.0-beta.38,2.0.0-beta.39,36,1,883,459,1342,17,FALSE
fenix-ui-metadata-editor,2.0.0-beta.50,2.0.0-beta.52,48,1,883,459,1342,17,FALSE
fenix-ui-metadata-editor,2.0.0-beta.56,2.0.0-beta.57,53,1,883,459,1342,17,FALSE
fenix-ui-metadata-editor,2.0.0-beta.55,2.0.0-beta.56,52,1,883,459,1342,17,FALSE
fenix-ui-metadata-editor,2.0.0-beta.54,2.0.0-beta.55,51,1,883,459,1342,17,FALSE
fenix-ui-metadata-editor,2.0.0-beta.44,2.0.0-beta.45,42,1,883,459,1342,17,FALSE
fenix-ui-metadata-editor,2.0.0-beta.45,2.0.0-beta.46,43,1,883,459,1342,17,FALSE
fenix-ui-metadata-editor,2.0.0-beta.40,2.0.0-beta.41,38,1,883,459,1342,17,FALSE
fenix-ui-metadata-editor,2.0.0-beta.41,2.0.0-beta.42,39,1,883,459,1342,17,FALSE
fenix-ui-metadata-editor,2.0.0-beta.12,2.0.0-beta.13,12,1,883,459,1342,17,TRUE
fenix-ui-metadata-editor,2.0.0-beta.25,2.0.0-beta.26,23,1,883,459,1342,17,TRUE
fenix-ui-metadata-editor,2.0.0-beta.37,2.0.0-beta.38,35,1,883,459,1342,17,TRUE
fenix-ui-metadata-editor,2.0.0-beta.43,2.0.0-beta.44,41,1,883,459,1342,17,TRUE
fenix-ui-metadata-editor,2.0.0-beta.45,2.0.0-beta.46,43,1,883,459,1342,17,TRUE
fenix-ui-metadata-editor,2.0.0-beta.49,2.0.0-beta.50,47,1,883,459,1342,17,TRUE
nblue-core,1.0.0,1.0.1,51,1,809,624,1433,15,FALSE
nblue-core,0.0.13,0.0.14,13,1,809,624,1433,15,FALSE
nblue-core,0.0.12,0.0.13,12,1,809,624,1433,15,FALSE
nblue-core,0.0.59,1.0.0,50,1,8,2,10,2,FALSE
nblue-core,0.0.14,0.0.16,14,1,809,624,1433,15,FALSE
nblue-core,0.0.17,0.0.18,16,1,809,624,1433,15,FALSE
nblue-core,0.0.16,0.0.17,15,1,809,624,1433,15,FALSE
nblue-core,0.0.11,0.0.12,11,1,809,624,1433,15,FALSE
nblue-core,0.0.10,0.0.11,10,1,809,624,1433,15,FALSE
nblue-core,0.0.39,0.0.41,35,1,809,624,1433,15,FALSE
nblue-core,0.0.38,0.0.39,34,1,809,624,1433,15,FALSE
nblue-core,0.0.37,0.0.38,33,1,809,624,1433,15,FALSE
nblue-core,0.0.36,0.0.37,32,1,809,624,1433,15,FALSE
nblue-core,0.0.35,0.0.36,31,1,809,624,1433,15,FALSE
nblue-core,0.0.34,0.0.35,30,1,809,624,1433,15,FALSE
nblue-core,0.0.33,0.0.34,29,1,809,624,1433,15,FALSE
nblue-core,0.0.18,0.0.20,17,1,809,624,1433,15,FALSE
nblue-core,0.0.31,0.0.32,27,1,809,624,1433,15,FALSE
nblue-core,0.0.30,0.0.31,26,1,809,624,1433,15,FALSE
nblue-core,0.0.5,0.0.6,5,1,809,624,1433,15,FALSE
nblue-core,0.0.4,0.0.5,4,1,809,624,1433,15,FALSE
nblue-core,0.0.7,0.0.8,7,1,809,624,1433,15,FALSE
nblue-core,0.0.6,0.0.7,6,1,809,624,1433,15,FALSE
nblue-core,0.0.1,0.0.2,1,1,809,624,1433,15,FALSE
nblue-core,0.0.3,0.0.4,3,1,809,624,1433,15,FALSE
nblue-core,0.0.2,0.0.3,2,1,809,624,1433,15,TRUE
nblue-core,0.0.55,0.0.56,46,1,9,8,17,2,FALSE
nblue-core,0.0.9,0.0.10,9,1,809,624,1433,15,FALSE
nblue-core,0.0.8,0.0.9,8,1,809,624,1433,15,FALSE
nblue-core,0.0.32,0.0.33,28,1,809,624,1433,15,FALSE
nblue-core,0.0.53,0.0.55,45,1,2,2,4,1,FALSE
nblue-core,0.0.57,0.0.58,48,1,3,3,6,2,FALSE
nblue-core,0.0.56,0.0.57,47,1,21,5,26,3,FALSE
nblue-core,0.0.50,0.0.51,42,2,87,42,129,2,FALSE
nblue-core,0.0.29,0.0.30,25,1,809,624,1433,15,FALSE
nblue-core,0.0.20,0.0.21,18,1,809,624,1433,15,FALSE
nblue-core,0.0.21,0.0.22,19,1,809,624,1433,15,FALSE
nblue-core,0.0.22,0.0.23,20,1,809,624,1433,15,FALSE
nblue-core,0.0.23,0.0.25,21,1,809,624,1433,15,FALSE
nblue-core,0.0.25,0.0.26,22,1,809,624,1433,15,FALSE
nblue-core,0.0.26,0.0.27,23,1,809,624,1433,15,FALSE
nblue-core,0.0.27,0.0.29,24,1,809,624,1433,15,FALSE
nblue-core,0.0.42,0.0.43,37,1,809,624,1433,15,FALSE
nblue-core,0.0.43,0.0.44,38,1,809,624,1433,15,FALSE
nblue-core,0.0.41,0.0.42,36,1,809,624,1433,15,FALSE
nblue-core,0.0.46,0.0.50,41,39,8849,3697,12546,258,FALSE
nblue-core,0.0.44,0.0.45,39,1,809,624,1433,15,FALSE
nblue-core,0.0.45,0.0.46,40,1,809,624,1433,15,FALSE
nblue-core,0.0.58,0.0.59,49,1,373,208,581,12,FALSE
nblue-core,0.0.52,0.0.53,44,1,809,624,1433,15,FALSE
nblue-core,0.0.51,0.0.52,43,2,8,250,258,8,FALSE
nblue-core,1.0.1,1.0.2,52,1,2925,1195,4120,29,FALSE
nblue-core,0.0.2,0.0.3,2,1,809,624,1433,15,FALSE
nblue-core,0.0.41,0.0.42,36,1,809,624,1433,15,TRUE
nblue-core,1.0.1,1.0.2,52,1,2925,1195,4120,29,TRUE
nblue-core,0.0.6,0.0.7,6,1,809,624,1433,15,TRUE
nblue-core,0.0.8,0.0.9,8,1,809,624,1433,15,TRUE
react-entanglement-web-storage-adapter,0.1.0,1.0.0,2,2,5530,66,5596,7,TRUE
react-entanglement-web-storage-adapter,0.0.1,0.1.0,1,2,7,11,18,13,FALSE
rock-js,1.0.4,1.0.5,13,2,473,75,548,8,FALSE
rock-js,1.0.5,1.0.6,14,1,1,1,2,1,FALSE
rock-js,1.0.6,1.0.7,15,5,245,230,475,15,FALSE
rock-js,1.0.7,1.0.8,16,1,38,69,107,4,FALSE
rock-js,1.0.0,1.0.1,9,1,38,69,107,4,FALSE
rock-js,1.0.1,1.0.2,10,1,3,3,6,3,FALSE
rock-js,1.0.2,1.0.3,11,2,161,98,259,5,FALSE
rock-js,1.0.3,1.0.4,12,1,1,1,2,1,FALSE
rock-js,1.0.8,1.0.9,17,1,52,1,53,4,FALSE
rock-js,1.0.9,1.0.10,18,2,152,24,176,12,FALSE
rock-js,1.0.16,1.0.17,25,4,295,280,575,15,FALSE
rock-js,1.6.3,1.6.4,108,1,13,9,22,4,FALSE
rock-js,1.6.0,1.6.1,105,1,1784,2344,4128,12,FALSE
rock-js,1.0.15,1.0.16,24,1,38,69,107,4,FALSE
rock-js,1.0.12,1.0.13,21,4,47,102,149,13,FALSE
rock-js,1.0.13,1.0.14,22,3,7,5,12,5,FALSE
rock-js,1.6.4,1.6.5,109,1,9,2,11,5,FALSE
rock-js,1.6.5,1.6.6,110,1,8,3,11,3,FALSE
rock-js,1.6.8,1.6.9,113,2,66,60,126,13,FALSE
rock-js,1.6.9,1.7.0,114,1,38,69,107,4,FALSE
rock-js,1.0.18,1.0.19,27,5,29,47,76,8,FALSE
rock-js,1.0.19,1.0.20,28,2,145,208,353,5,FALSE
rock-js,1.8.4,1.8.5,130,1,132,126,258,4,FALSE
rock-js,1.7.6,1.7.7,121,1,38,69,107,4,FALSE
rock-js,1.8.6,1.8.7,132,1,14,2,16,3,FALSE
rock-js,1.8.7,1.8.8,133,1,288,310,598,4,FALSE
rock-js,1.8.0,1.8.1,126,1,997,951,1948,8,FALSE
rock-js,1.8.1,1.8.2,127,1,371,702,1073,7,FALSE
rock-js,1.8.2,1.8.3,128,1,138,152,290,4,FALSE
rock-js,1.7.10,1.8.0,125,1,127,144,271,4,FALSE
rock-js,1.4.12,1.5.0,101,1,18,8,26,3,FALSE
rock-js,1.4.10,1.4.11,99,1,543,709,1252,8,FALSE
rock-js,1.4.11,1.4.12,100,1,175,578,753,5,FALSE
rock-js,1.4.0,1.4.1,89,1,766,411,1177,11,FALSE
rock-js,1.4.1,1.4.2,90,2,27,10,37,3,FALSE
rock-js,1.4.2,1.4.3,91,1,1,1,2,1,FALSE
rock-js,1.4.3,1.4.4,92,1,431,798,1229,5,FALSE
rock-js,1.4.4,1.4.5,93,2,524,386,910,8,FALSE
rock-js,1.4.5,1.4.6,94,1,38,69,107,4,FALSE
rock-js,1.4.6,1.4.7,95,1,23,23,46,3,FALSE
rock-js,1.2.17,1.2.18,75,1,34,34,68,4,FALSE
rock-js,1.0.30,1.0.31,39,2,248,111,359,6,FALSE
rock-js,1.0.31,1.1.0,40,1,38,69,107,4,FALSE
rock-js,1.2.19,1.3.0,77,1,13,13,26,4,FALSE
rock-js,1.0.29,1.0.30,38,2,22,22,44,4,FALSE
rock-js,1.0.28,1.0.29,37,3,1043,986,2029,6,FALSE
rock-js,1.0.27,1.0.28,36,4,258,254,512,10,FALSE
rock-js,1.0.26,1.0.27,35,2,3,2,5,2,FALSE
rock-js,1.0.25,1.0.26,34,1,19,13,32,4,FALSE
rock-js,1.0.24,1.0.25,33,1,140,42,182,5,FALSE
rock-js,1.0.23,1.0.24,32,1,38,69,107,4,FALSE
rock-js,1.0.22,1.0.23,31,2,83,2,85,5,FALSE
rock-js,1.0.21,1.0.22,30,1,1,1,2,1,FALSE
rock-js,1.0.20,1.0.21,29,1,231,228,459,3,FALSE
rock-js,1.4.8,1.4.9,97,1,578,496,1074,4,FALSE
rock-js,1.6.2,1.6.3,107,1,75,82,157,6,FALSE
rock-js,1.0.17,1.0.18,26,3,70,48,118,8,FALSE
rock-js,1.0.14,1.0.15,23,4,203,160,363,13,FALSE
rock-js,1.6.1,1.6.2,106,1,66,74,140,6,FALSE
rock-js,1.6.6,1.6.7,111,1,430,519,949,5,FALSE
rock-js,1.6.7,1.6.8,112,1,38,69,107,4,FALSE
rock-js,1.0.10,1.0.11,19,1,118,146,264,9,FALSE
rock-js,1.0.11,1.0.12,20,1,10,19,29,4,FALSE
rock-js,1.5.1,1.5.2,103,1,371,393,764,5,FALSE
rock-js,1.5.0,1.5.1,102,1,3085,1908,4993,12,FALSE
rock-js,1.5.2,1.6.0,104,1,6,27,33,3,FALSE
rock-js,1.3.3,1.3.4,81,1,5,5,10,3,FALSE
rock-js,1.3.2,1.3.3,80,1,1,1,2,1,FALSE
rock-js,1.3.1,1.3.2,79,2,726,1088,1814,11,FALSE
rock-js,1.3.0,1.3.1,78,1,1487,2240,3727,19,FALSE
rock-js,1.3.7,1.3.8,85,1,38,69,107,4,FALSE
rock-js,1.3.6,1.3.7,84,2,34,34,68,18,FALSE
rock-js,1.3.5,1.3.6,83,1,37,21,58,3,FALSE
rock-js,1.3.4,1.3.5,82,2,42,26,68,6,FALSE
rock-js,1.3.9,1.3.10,87,3,114,152,266,6,FALSE
rock-js,1.3.8,1.3.9,86,1,76,125,201,8,FALSE
rock-js,1.8.3,1.8.4,129,1,14,4,18,3,FALSE
rock-js,1.1.1,1.1.2,42,1,49,222,271,5,FALSE
rock-js,1.1.0,1.1.1,41,2,1366,334,1700,10,FALSE
rock-js,1.1.3,1.1.4,44,4,95,80,175,13,FALSE
rock-js,1.1.2,1.1.3,43,1,3,3,6,3,FALSE
rock-js,1.1.5,1.1.6,46,2,10,7,17,4,FALSE
rock-js,1.1.4,1.1.5,45,4,28,24,52,5,FALSE
rock-js,1.1.7,1.1.8,48,2,454,715,1169,7,FALSE
rock-js,1.1.6,1.1.7,47,1,38,69,107,4,FALSE
rock-js,1.1.9,1.1.10,50,1,214,214,428,4,FALSE
rock-js,1.1.8,1.1.9,49,1,38,69,107,4,FALSE
rock-js,0.0.5,0.0.6,5,1,25,25,50,2,FALSE
rock-js,0.0.4,0.0.5,4,1,3,187,190,2,FALSE
rock-js,0.0.7,0.0.8,7,2,739,718,1457,10,FALSE
rock-js,0.0.6,0.0.7,6,1,3,3,6,2,FALSE
rock-js,0.0.1,0.0.2,1,1,16,1,17,2,FALSE
rock-js,0.0.3,0.0.4,3,1,1,2,3,2,FALSE
rock-js,0.0.2,0.0.3,2,1,38,69,107,4,FALSE
rock-js,0.0.8,1.0.0,8,16,4578,3446,8024,65,FALSE
rock-js,1.7.9,1.7.10,124,1,12,11,23,3,FALSE
rock-js,1.7.8,1.7.9,123,2,70,69,139,6,FALSE
rock-js,1.7.7,1.7.8,122,1,486,28,514,4,FALSE
rock-js,1.8.5,1.8.6,131,1,66,263,329,14,FALSE
rock-js,1.7.5,1.7.6,120,1,10,10,20,3,FALSE
rock-js,1.7.4,1.7.5,119,1,90,76,166,4,FALSE
rock-js,1.7.3,1.7.4,118,2,751,625,1376,8,FALSE
rock-js,1.7.2,1.7.3,117,1,2,7,9,4,FALSE
rock-js,1.7.1,1.7.2,116,1,2,7,9,4,FALSE
rock-js,1.7.0,1.7.1,115,2,406,1269,1675,12,FALSE
rock-js,1.2.10,1.2.11,68,1,38,69,107,4,FALSE
rock-js,1.2.11,1.2.12,69,1,16,13,29,4,FALSE
rock-js,1.2.12,1.2.13,70,1,109,109,218,6,FALSE
rock-js,1.2.13,1.2.14,71,1,151,151,302,6,FALSE
rock-js,1.2.14,1.2.15,72,2,432,192,624,10,FALSE
rock-js,1.2.15,1.2.16,73,1,19,1,20,5,FALSE
rock-js,1.2.16,1.2.17,74,1,31,31,62,4,FALSE
rock-js,1.4.7,1.4.8,96,1,812,621,1433,9,FALSE
rock-js,1.2.18,1.2.19,76,1,15,13,28,5,FALSE
rock-js,1.4.9,1.4.10,98,1,4,4,8,3,FALSE
rock-js,1.2.6,1.2.7,64,1,13,25,38,5,FALSE
rock-js,1.2.7,1.2.8,65,1,38,69,107,4,FALSE
rock-js,1.2.5,1.2.6,63,2,696,16,712,7,FALSE
rock-js,1.2.2,1.2.3,61,1,10,10,20,4,FALSE
rock-js,1.2.3,1.2.5,62,1,10,7,17,4,FALSE
rock-js,1.2.0,1.2.1,59,2,1128,1422,2550,19,FALSE
rock-js,1.2.1,1.2.2,60,1,38,69,107,4,FALSE
rock-js,1.2.8,1.2.9,66,1,7,7,14,5,FALSE
rock-js,1.2.9,1.2.10,67,1,61,61,122,5,FALSE
rock-js,1.3.10,1.4.0,88,1,38,69,107,4,FALSE
rock-js,1.1.11,1.1.12,52,2,8,8,16,6,FALSE
rock-js,1.1.10,1.1.11,51,1,568,715,1283,8,FALSE
rock-js,1.1.13,1.1.14,54,1,13,7,20,5,FALSE
rock-js,1.1.12,1.1.13,53,1,38,69,107,4,FALSE
rock-js,1.1.15,1.1.16,56,1,307,223,530,4,FALSE
rock-js,1.1.14,1.1.15,55,1,198,243,441,6,FALSE
rock-js,1.1.17,1.2.0,58,1,20,28,48,8,FALSE
rock-js,1.1.16,1.1.17,57,1,3,3,6,3,FALSE
rock-js,1.6.6,1.6.7,111,1,430,519,949,5,TRUE
rock-js,1.8.8,1.8.9,134,1,36,14,50,4,FALSE
rock-js,1.0.8,1.0.9,17,1,52,1,53,4,TRUE
rock-js,1.8.0,1.8.1,126,1,997,951,1948,8,TRUE
rock-js,1.1.17,1.2.0,58,1,20,28,48,8,TRUE
react-console-component,0.6.0,0.6.1,13,33,522,210,732,51,FALSE
react-console-component,0.1.1,0.2.0,2,9,324,29,353,24,FALSE
react-console-component,0.3.0,0.4.0,6,3,26,4,30,3,FALSE
react-console-component,0.1.0,0.1.1,1,3,27,5,32,3,FALSE
react-console-component,0.2.2,0.3.0,5,13,51,31,82,19,FALSE
react-console-component,0.2.1,0.2.2,4,5,6,6,12,5,FALSE
react-console-component,0.2.0,0.2.1,3,4,17,3,20,4,FALSE
react-console-component,0.4.1,0.4.2,8,7,23,16,39,10,FALSE
react-console-component,0.4.0,0.4.1,7,24,393,223,616,28,FALSE
react-console-component,0.4.2,0.5.0,9,8,180,67,247,9,FALSE
react-console-component,0.5.0,0.5.1,10,3,40,19,59,6,FALSE
react-console-component,0.5.1,0.5.2,11,7,68,65,133,7,FALSE
react-console-component,0.5.2,0.6.0,12,22,564,209,773,26,FALSE
react-console-component,0.1.1,0.2.0,2,9,324,29,353,24,TRUE
react-console-component,0.2.2,0.3.0,5,13,51,31,82,19,TRUE
react-scripts-ts,1.0.4,1.0.5,8,27,1908,132,2040,117,FALSE
react-scripts-ts,1.0.5,1.0.6,9,2,2,1,3,2,FALSE
react-scripts-ts,1.0.6,1.1.6-prerelease.0,10,57,5968,1155,7123,344,FALSE
react-scripts-ts,1.0.0,1.0.1,4,7,127,53,180,24,FALSE
react-scripts-ts,1.0.1,1.0.2,5,5,10,235,245,7,FALSE
react-scripts-ts,1.0.2,1.0.3,6,6,9,6,15,6,FALSE
react-scripts-ts,1.0.3,1.0.4,7,7,32,75,107,14,FALSE
react-scripts-ts,1.1.9,1.2.0,15,2,21,8,29,3,FALSE
react-scripts-ts,1.1.8,1.1.9,14,16,104,29,133,19,FALSE
react-scripts-ts,0.8.6,1.0.0,3,2,4,15,19,3,FALSE
react-scripts-ts,0.8.5,0.8.6,2,5,181,87,268,14,FALSE
react-scripts-ts,1.3.0,1.4.0,17,43,87720,1936,89656,182,FALSE
react-scripts-ts,1.1.6,1.1.7,12,256,10210,3818,14028,771,FALSE
react-scripts-ts,1.1.6-prerelease.0,1.1.6,11,1,2,2,4,1,FALSE
react-scripts-ts,1.2.0,1.3.0,16,16,273,92,365,25,FALSE
react-scripts-ts,0.8.4,0.8.5,1,4,33,34,67,8,FALSE
react-scripts-ts,1.1.7,1.1.8,13,4,28,15,43,4,FALSE
react-scripts-ts,2.0.1,2.1.0,21,29,93727,3499,97226,210,FALSE
react-scripts-ts,2.0.0-alpha.3,2.0.0,19,4,93678,3678,97356,179,FALSE
react-scripts-ts,2.1.0,2.2.0,22,2,166,34,200,18,FALSE
react-scripts-ts,1.4.0,2.0.0-alpha.3,18,128,99606,6889,106495,502,FALSE
react-scripts-ts,2.0.0,2.0.1,20,3,26,27,53,8,FALSE
react-scripts-ts,1.4.0,2.0.0-alpha.3,18,128,99606,6889,106495,502,TRUE
react-scripts-ts,1.0.4,1.0.5,8,27,1908,132,2040,117,TRUE
react-scripts-ts,1.0.0,1.0.1,4,7,127,53,180,24,TRUE
react-scripts-ts,1.0.1,1.0.2,5,5,10,235,245,7,TRUE
react-scripts-ts,2.0.1,2.1.0,21,29,93727,3499,97226,210,TRUE
react-scripts-ts,1.0.3,1.0.4,7,7,32,75,107,14,TRUE
react-scripts-ts,1.1.8,1.1.9,14,16,104,29,133,19,TRUE
react-scripts-ts,1.0.2,1.0.3,6,6,9,6,15,6,TRUE
react-scripts-ts,1.1.6,1.1.7,12,256,10210,3818,14028,771,TRUE
react-scripts-ts,0.8.4,0.8.5,1,4,33,34,67,8,TRUE
react-scripts-ts,1.3.0,1.4.0,17,43,87720,1936,89656,182,TRUE
react-scripts-ts,1.1.7,1.1.8,13,4,28,15,43,4,TRUE
react-scripts-ts,1.2.0,1.3.0,16,16,273,92,365,25,TRUE
react-scripts-ts,1.0.5,1.0.6,9,2,2,1,3,2,TRUE
gyrejs,0.4.0,0.4.1,33,2,17,4,21,2,FALSE
gyrejs,0.3.0,0.4.0,32,3,6,5,11,4,FALSE
gyrejs,0.0.15,0.0.16,13,1,1,1,2,1,FALSE
gyrejs,0.0.14,0.0.15,12,7,226,865,1091,32,FALSE
gyrejs,0.0.17,0.0.18,15,2,7,23,30,3,FALSE
gyrejs,0.0.16,0.0.17,14,2,19,25,44,5,FALSE
gyrejs,0.0.11,0.0.12,9,3,251,116,367,21,FALSE
gyrejs,0.0.10,0.0.11,8,2,122,59,181,11,FALSE
gyrejs,0.0.13,0.0.14,11,7,1001,577,1578,49,FALSE
gyrejs,0.0.12,0.0.13,10,2,50,33,83,7,FALSE
gyrejs,0.0.19,0.0.20,17,2,342,93,435,14,FALSE
gyrejs,0.0.18,0.0.19,16,2,3,3,6,2,FALSE
gyrejs,0.0.5,0.0.7,5,8,103,898,1001,27,FALSE
gyrejs,0.0.4,0.0.5,4,1,1025,125,1150,26,FALSE
gyrejs,0.0.7,0.0.8,6,1,1,1,2,1,FALSE
gyrejs,0.0.1,0.0.2,1,1,1,1,2,1,FALSE
gyrejs,0.0.3,0.0.4,3,1,1,1,2,1,FALSE
gyrejs,0.0.2,0.0.3,2,1,1,1,2,1,FALSE
gyrejs,0.0.8,0.0.10,7,3,7,4,11,3,FALSE
gyrejs,0.0.20,0.0.21,18,2,155,66,221,8,FALSE
gyrejs,0.0.21,0.0.22,19,2,6,4,10,3,FALSE
gyrejs,0.0.22,0.0.23,20,4,65,38,103,10,FALSE
gyrejs,0.0.23,0.0.24,21,7,206,46,252,21,FALSE
gyrejs,0.0.24,0.0.25,22,2,30,13,43,3,FALSE
gyrejs,0.0.25,0.0.26,23,5,155,79,234,10,FALSE
gyrejs,0.1.0,0.2.0,25,17,123,115,238,29,FALSE
gyrejs,0.2.5,0.3.0,31,15,3538,1617,5155,167,FALSE
gyrejs,0.2.4,0.2.5,30,1,1,1,2,1,FALSE
gyrejs,0.2.3,0.2.4,29,1,1,1,2,1,FALSE
gyrejs,0.2.2,0.2.3,28,1,1,1,2,1,FALSE
gyrejs,0.2.1,0.2.2,27,1,1,1,2,1,FALSE
gyrejs,0.2.0,0.2.1,26,1,1,1,2,1,FALSE
gyrejs,0.0.26,0.1.0,24,2,1352,881,2233,33,FALSE
gyrejs,0.0.11,0.0.12,9,3,251,116,367,21,TRUE
gyrejs,0.0.12,0.0.13,10,2,50,33,83,7,TRUE
gyrejs,0.0.25,0.0.26,23,5,155,79,234,10,TRUE
gyrejs,0.2.5,0.3.0,31,15,3538,1617,5155,167,TRUE
gyrejs,0.0.14,0.0.15,12,7,226,865,1091,32,TRUE
backup-mongodb-restorer,1.0.4,1.0.5,4,3,53,28,81,5,FALSE
backup-mongodb-restorer,1.0.5,1.0.6,5,2,6,5,11,2,FALSE
backup-mongodb-restorer,1.0.6,1.1.0,6,1,102,41,143,5,FALSE
backup-mongodb-restorer,1.0.0,1.0.2,1,3,3,5,8,5,FALSE
backup-mongodb-restorer,1.0.2,1.0.3,2,3,13,3,16,5,FALSE
backup-mongodb-restorer,1.0.3,1.0.4,3,2,5,3,8,2,FALSE
backup-mongodb-restorer,1.0.5,1.0.6,5,2,6,5,11,2,TRUE
elparser,0.0.5,0.0.6,5,2,152,32,184,8,FALSE
elparser,0.0.4,0.0.5,4,1,7,5,12,6,FALSE
elparser,0.0.7,0.0.8,7,1,3,4,7,2,FALSE
elparser,0.0.6,0.0.7,6,1,7,5,12,6,FALSE
elparser,0.0.1,0.0.2,1,1,7,5,12,6,FALSE
elparser,0.0.3,0.0.4,3,2,1902,4,1906,11,FALSE
elparser,0.0.2,0.0.3,2,1,7,5,12,6,FALSE
elparser,0.0.8,0.0.9,8,1,7,5,12,6,FALSE
elparser,0.0.3,0.0.4,3,2,1902,4,1906,11,TRUE
react-umeditor,0.6.0,0.6.1,63,1,6,906,912,7,FALSE
react-umeditor,0.8.0-rc1,0.8.0,73,1,4,29,33,5,FALSE
react-umeditor,0.5.18,0.5.19,53,1,23,7,30,6,FALSE
react-umeditor,0.5.19,0.5.20,54,1,2,2,4,2,FALSE
react-umeditor,0.5.16,0.5.17,51,1,15,6,21,5,FALSE
react-umeditor,0.5.17,0.5.18,52,1,6,16,22,6,FALSE
react-umeditor,0.5.14,0.5.15,49,1,66,13,79,10,FALSE
react-umeditor,0.5.15,0.5.16,50,2,2,1,3,2,FALSE
react-umeditor,0.5.12,0.5.13,47,2,1290,1307,2597,8,FALSE
react-umeditor,0.5.13,0.5.14,48,2,6,4,10,3,FALSE
react-umeditor,0.5.11,0.5.12,46,2,278,249,527,34,FALSE
react-umeditor,0.7.6,0.7.7,71,2,791,482,1273,8,FALSE
react-umeditor,0.7.7,0.8.0-rc1,72,4,6862,6875,13737,30,FALSE
react-umeditor,0.6.1,0.7.0,64,2,407,32,439,17,FALSE
react-umeditor,0.7.5,0.7.6,70,1,6,6,12,6,FALSE
react-umeditor,0.7.2,0.7.3,67,2,4,4,8,3,FALSE
react-umeditor,0.7.3,0.7.4,68,1,1339,1300,2639,12,FALSE
react-umeditor,0.7.0,0.7.1,65,1,17,17,34,9,FALSE
react-umeditor,0.7.1,0.7.2,66,1,3,3,6,2,FALSE
react-umeditor,0.5.9,0.5.11,45,9,2002,1601,3603,52,FALSE
react-umeditor,0.5.27,0.6.0,62,1,177,97,274,8,FALSE
react-umeditor,0.5.26,0.5.27,61,1,72,2,74,4,FALSE
react-umeditor,0.5.25,0.5.26,60,2,445,81,526,16,FALSE
react-umeditor,0.5.24,0.5.25,59,2,51,11,62,6,FALSE
react-umeditor,0.5.23,0.5.24,58,2,47,35,82,6,FALSE
react-umeditor,0.5.22,0.5.23,57,2,206,116,322,16,FALSE
react-umeditor,0.5.21,0.5.22,56,1,8,8,16,6,FALSE
react-umeditor,0.5.20,0.5.21,55,1,5,5,10,5,FALSE
react-umeditor,0.8.0,0.8.1,74,1,19,16,35,4,FALSE
react-umeditor,0.7.4,0.7.5,69,2,57,37,94,19,FALSE
react-umeditor,0.0.1,0.1.0,1,7,24560,125,24685,139,FALSE
react-umeditor,0.2.26,0.2.27,28,3,59,136,195,11,FALSE
react-umeditor,0.2.27,0.2.28,29,4,838,50,888,18,FALSE
react-umeditor,0.2.24,0.2.25,26,2,42,10,52,12,FALSE
react-umeditor,0.2.25,0.2.26,27,10,2011,719,2730,39,FALSE
react-umeditor,0.2.22,0.2.23,24,2,368,12,380,13,FALSE
react-umeditor,0.2.23,0.2.24,25,2,549,69,618,22,FALSE
react-umeditor,0.2.20,0.2.21,22,1,19,7,26,6,FALSE
react-umeditor,0.2.21,0.2.22,23,1,6,34,40,6,FALSE
react-umeditor,0.2.0,0.2.1,3,4,5,5,10,4,FALSE
react-umeditor,0.2.28,0.3.1,30,12,6926,2674,9600,171,FALSE
react-umeditor,0.2.7,0.2.8,9,1,18,129,147,7,FALSE
react-umeditor,0.2.5,0.2.7,8,14,324,209,533,51,FALSE
react-umeditor,0.2.4,0.2.5,7,2,117,6,123,7,FALSE
react-umeditor,0.2.3,0.2.4,6,2,56,12,68,7,FALSE
react-umeditor,0.2.2,0.2.3,5,1,324,306,630,5,FALSE
react-umeditor,0.2.1,0.2.2,4,2,10,4,14,3,FALSE
react-umeditor,0.1.0,0.2.0,2,15,50486,24141,74627,252,FALSE
react-umeditor,0.2.9,0.2.10,11,1,13,7,20,6,FALSE
react-umeditor,0.2.8,0.2.9,10,2,10,6,16,2,FALSE
react-umeditor,0.3.2,0.3.3,32,1,14,14,28,10,FALSE
react-umeditor,0.3.3,0.4.1,33,3,14389,410,14799,27,FALSE
react-umeditor,0.5.8,0.5.9,44,6,19,15,34,7,FALSE
react-umeditor,0.4.1,0.4.2,34,2,6298,4980,11278,10,FALSE
react-umeditor,0.5.5,0.5.6,41,1,541,434,975,9,FALSE
react-umeditor,0.5.6,0.5.7,42,2,480,575,1055,11,FALSE
react-umeditor,0.4.2,0.5.0,35,11,8824,5809,14633,46,FALSE
react-umeditor,0.5.0,0.5.1,36,1,16,7,23,3,FALSE
react-umeditor,0.5.1,0.5.2,37,1,44,8,52,5,FALSE
react-umeditor,0.5.2,0.5.3,38,3,24,12,36,8,FALSE
react-umeditor,0.5.3,0.5.4,39,1,19,16,35,4,FALSE
react-umeditor,0.2.19,0.2.20,21,3,155,37,192,12,FALSE
react-umeditor,0.2.17,0.2.18,19,2,2423,1921,4344,39,FALSE
react-umeditor,0.2.16,0.2.17,18,1,8,4,12,6,FALSE
react-umeditor,0.2.15,0.2.16,17,1,12,4,16,6,FALSE
react-umeditor,0.2.14,0.2.15,16,1,6,6,12,6,FALSE
react-umeditor,0.2.13,0.2.14,15,1,10,6,16,6,FALSE
react-umeditor,0.2.12,0.2.13,14,1,46,34,80,6,FALSE
react-umeditor,0.2.11,0.2.12,13,1,18,18,36,6,FALSE
react-umeditor,0.2.10,0.2.11,12,1,147,83,230,6,FALSE
react-umeditor,0.5.4,0.5.5,40,1,19,16,35,4,FALSE
react-umeditor,0.2.18,0.2.19,20,3,613,294,907,26,FALSE
react-umeditor,0.3.1,0.3.2,31,1,39,39,78,6,FALSE
react-umeditor,0.5.7,0.5.8,43,2,264,13244,13508,11,FALSE
react-umeditor,1.0.0-rc2,1.0.0-rc3,77,2,3,3,6,3,FALSE
react-umeditor,1.0.0-rc3,1.0.0-rc4,78,4,160,77,237,10,FALSE
react-umeditor,1.0.0-rc4,1.0.0-rc5,79,2,23,9,32,5,FALSE
react-umeditor,1.0.0-rc1,1.0.0-rc2,76,15,508,282,790,49,FALSE
react-umeditor,1.0.0-rc1,1.0.0-rc2,76,15,508,282,790,49,TRUE
react-umeditor,0.5.2,0.5.3,38,3,24,12,36,8,TRUE
react-umeditor,0.8.1,1.0.0-rc1,75,5,5062,34585,39647,83,FALSE
es6-error,1.0.0,2.0.0,1,6,103,19,122,9,FALSE
es6-error,2.0.2,2.1.0,4,3,5,3,8,3,FALSE
es6-error,2.0.1,2.0.2,3,6,30,7,37,6,FALSE
es6-error,2.0.0,2.0.1,2,5,38,8,46,7,FALSE
es6-error,2.1.0,2.1.1,5,5,49,1,50,5,FALSE
es6-error,4.0.1,4.0.2,12,3,109,2,111,5,FALSE
es6-error,4.0.0,4.0.1,11,3,125,109,234,13,FALSE
es6-error,3.1.0,3.2.0,9,3,5,1,6,5,FALSE
es6-error,3.0.1,3.1.0,8,3,3,3,6,3,FALSE
es6-error,3.0.0,3.0.1,7,5,41,39,80,8,FALSE
es6-error,3.2.0,4.0.0,10,6,185,23,208,12,FALSE
es6-error,2.1.1,3.0.0,6,5,229,43,272,13,FALSE
es6-error,3.1.0,3.2.0,9,3,5,1,6,5,TRUE
node-intlb,0.1.10,0.1.11,9,1,3,2,5,2,FALSE
node-intlb,0.1.11,0.2.2,10,2,208,130,338,14,FALSE
node-intlb,0.6.1,0.6.2,20,2,2,2,4,2,FALSE
node-intlb,0.6.0,0.6.1,19,1,3,3,6,2,FALSE
node-intlb,0.2.13,0.4.0,16,4,29,33,62,5,FALSE
node-intlb,0.2.12,0.2.13,15,1,23,16,39,2,FALSE
node-intlb,0.2.11,0.2.12,14,2,7,20,27,3,FALSE
node-intlb,0.2.10,0.2.11,13,1,3,1,4,2,FALSE
node-intlb,0.1.9,0.1.10,8,1,27,5,32,3,FALSE
node-intlb,0.2.2,0.2.8,11,6,15,24,39,13,FALSE
node-intlb,0.5.1,0.6.0,18,1,7,2,9,2,FALSE
node-intlb,0.4.0,0.5.1,17,4,33,12,45,5,FALSE
node-intlb,0.1.0,0.1.1,1,2,16,10,26,4,TRUE
node-intlb,0.1.1,0.1.2,2,1,3,3,6,2,FALSE
node-intlb,0.1.2,0.1.3,3,1,9,4,13,3,FALSE
node-intlb,0.1.3,0.1.4,4,3,56,26,82,8,TRUE
node-intlb,0.1.4,0.1.5,5,1,137,26,163,6,FALSE
node-intlb,0.1.5,0.1.6,6,2,43,23,66,5,FALSE
node-intlb,0.1.6,0.1.9,7,3,17,18,35,5,FALSE
node-intlb,0.2.8,0.2.10,12,3,17,23,40,9,FALSE
node-intlb,0.1.0,0.1.1,1,2,16,10,26,4,FALSE
node-intlb,0.1.3,0.1.4,4,3,56,26,82,8,FALSE
node-intlb,0.2.10,0.2.11,13,1,3,1,4,2,TRUE
graphology-generators,0.0.1,0.1.0,1,1,163,6,169,6,TRUE
graphology-generators,0.3.0,0.4.0,4,1,38,29,67,4,FALSE
graphology-generators,0.4.1,0.4.2,6,3,8,3,11,3,FALSE
graphology-generators,0.2.0,0.3.0,3,2,123,9,132,8,FALSE
graphology-generators,0.1.0,0.2.0,2,2,157,10,167,10,FALSE
graphology-generators,0.4.0,0.4.1,5,2,6,7,13,4,FALSE
graphology-generators,0.4.3,0.5.0,8,4,218,7,225,8,FALSE
graphology-generators,0.4.2,0.4.3,7,1,36,63,99,3,FALSE
graphology-generators,0.5.0,0.6.0,9,1,131,2,133,4,FALSE
graphology-generators,0.0.1,0.1.0,1,1,163,6,169,6,FALSE
graphology-generators,0.4.3,0.5.0,8,4,218,7,225,8,TRUE
roi,0.14.1,0.15.0,18,11,459,339,798,31,FALSE
roi,0.14.0,0.14.1,17,7,485,301,786,25,FALSE
roi,0.11.0,0.12.0,13,7,114,50,164,12,FALSE
roi,0.12.1,0.13.0,15,15,248,93,341,30,FALSE
roi,0.12.0,0.12.1,14,3,121,9,130,6,FALSE
roi,0.13.0,0.14.0,16,9,191,31,222,13,TRUE
roi,0.9.0,0.10.0,11,14,334,213,547,27,FALSE
roi,0.10.0,0.11.0,12,6,22,22,44,10,FALSE
roi,0.6.0,0.7.0,8,4,5,211,216,4,FALSE
roi,0.8.0,0.9.0,10,2,46,41,87,4,FALSE
roi,0.7.0,0.8.0,9,3,64,19,83,3,FALSE
roi,0.5.0,0.6.0,7,13,637,274,911,29,FALSE
roi,0.13.0,0.14.0,16,9,191,31,222,13,FALSE
roi,0.9.0,0.10.0,11,14,334,213,547,27,TRUE
roi,0.3.1,0.3.2,4,2,3,3,6,3,FALSE
roi,0.3.2,0.4.0,5,2,33,1,34,4,FALSE
roi,0.3.0,0.3.1,3,2,6,11,17,2,FALSE
roi,0.2.0,0.3.0,2,8,125,91,216,16,FALSE
roi,0.1.0,0.2.0,1,5,51,73,124,10,FALSE
roi,0.4.0,0.5.0,6,14,588,96,684,24,FALSE
roi,0.4.0,0.5.0,6,14,588,96,684,24,TRUE
roi,0.14.1,0.15.0,18,11,459,339,798,31,TRUE
graphql-document-collector,0.1.0,0.1.1,1,1,7,4,11,3,FALSE
graphql-document-collector,0.1.1,0.1.2,2,4,13,13,26,4,FALSE
graphql-document-collector,0.1.2,0.1.3,3,3,10,6,16,3,FALSE
graphql-document-collector,0.1.0,0.1.1,1,1,7,4,11,3,TRUE
rxjs-aws,0.1.9,0.1.10,12,2,3,3,6,3,FALSE
rxjs-aws,0.1.0,0.1.1,4,1,72,168,240,2,FALSE
rxjs-aws,0.1.1,0.1.2,5,1,23,2,25,2,FALSE
rxjs-aws,0.1.2,0.1.3,6,1,4,2,6,2,FALSE
rxjs-aws,0.1.3,0.1.4,7,2,119,87,206,2,FALSE
rxjs-aws,0.1.4,0.1.5,8,2,2,3,5,2,FALSE
rxjs-aws,0.1.5,0.1.6,9,2,1,2,3,2,FALSE
rxjs-aws,0.1.6,0.1.7,10,2,5,6,11,2,FALSE
rxjs-aws,0.1.7,0.1.9,11,4,89,83,172,5,FALSE
rxjs-aws,0.1.28,0.1.29,28,2,21,210,231,4,FALSE
rxjs-aws,0.0.3,0.1.0,3,8,233,47,280,16,FALSE
rxjs-aws,0.1.23,0.1.24,24,2,4,4,8,3,FALSE
rxjs-aws,0.1.22,0.1.23,23,2,381,214,595,9,FALSE
rxjs-aws,0.1.21,0.1.22,22,2,26,1,27,3,FALSE
rxjs-aws,0.1.20,0.1.21,21,2,3,3,6,2,FALSE
rxjs-aws,0.1.27,0.1.28,27,2,217,31,248,4,FALSE
rxjs-aws,0.1.26,0.1.27,26,2,11,10,21,4,FALSE
rxjs-aws,0.1.24,0.1.26,25,4,9,8,17,5,FALSE
rxjs-aws,0.1.12,0.1.13,15,2,13,1,14,2,FALSE
rxjs-aws,0.1.13,0.1.16,16,6,18,5,23,6,FALSE
rxjs-aws,0.1.10,0.1.11,13,2,1,2,3,2,FALSE
rxjs-aws,0.1.11,0.1.12,14,2,2,1,3,2,FALSE
rxjs-aws,0.1.16,0.1.17,17,2,16,4,20,2,FALSE
rxjs-aws,0.1.17,0.1.18,18,3,8,3,11,3,FALSE
rxjs-aws,0.1.18,0.1.19,19,2,2,2,4,2,FALSE
rxjs-aws,0.1.19,0.1.20,20,2,2,3,5,2,FALSE
rxjs-aws,0.1.9,0.1.10,12,2,3,3,6,3,TRUE
rxjs-aws,0.1.1,0.1.2,5,1,23,2,25,2,TRUE
rxjs-aws,0.1.3,0.1.4,7,2,119,87,206,2,TRUE
rxjs-aws,0.1.6,0.1.7,10,2,5,6,11,2,TRUE
rxjs-aws,0.1.28,0.1.29,28,2,21,210,231,4,TRUE
rxjs-aws,0.1.21,0.1.22,22,2,26,1,27,3,TRUE
rxjs-aws,0.1.27,0.1.28,27,2,217,31,248,4,TRUE
rxjs-aws,0.1.24,0.1.26,25,4,9,8,17,5,TRUE
text-model,0.3.0,1.0.0,5,3,5,1,6,3,FALSE
text-model,0.2.1,0.3.0,4,17,326,72,398,29,FALSE
text-model,0.2.0,0.2.1,3,4,43,7,50,7,FALSE
text-model,0.1.0,0.1.1,1,3,3,3,6,3,FALSE
text-model,0.1.1,0.2.0,2,12,679,232,911,18,FALSE
text-model,0.3.0,1.0.0,5,3,5,1,6,3,TRUE
uri-change-observer,0.0.1,0.0.2,1,3,128,54,182,10,FALSE
uri-change-observer,0.0.1,0.0.2,1,3,128,54,182,10,TRUE
js-validate,0.4.1,0.4.2,10,1,3,3,6,3,FALSE
js-validate,0.4.0,0.4.1,9,1,2,2,4,2,FALSE
js-validate,0.5.1,0.6.0,12,1,52,4,56,5,TRUE
js-validate,0.4.2,0.5.1,11,2,53,43,96,7,FALSE
js-validate,0.3.1,0.4.0,8,2,174,97,271,13,TRUE
js-validate,0.3.0,0.3.1,7,1,3,3,6,2,FALSE
js-validate,0.1.0,0.1.1,3,1,62,40,102,3,FALSE
js-validate,0.2.2,0.3.0,6,7,131,19,150,8,FALSE
js-validate,0.2.1,0.2.2,5,8,180,72,252,10,FALSE
js-validate,0.1.1,0.2.1,4,16,166,54,220,20,FALSE
js-validate,0.5.1,0.6.0,12,1,52,4,56,5,FALSE
js-validate,0.3.1,0.4.0,8,2,174,97,271,13,FALSE
js-validate,0.0.3,0.1.0,2,8,310,314,624,37,FALSE
js-validate,0.0.2,0.0.3,1,3,137,18,155,9,FALSE
js-validate,0.2.2,0.3.0,6,7,131,19,150,8,TRUE
js-validate,0.2.1,0.2.2,5,8,180,72,252,10,TRUE
ms-phone,1.0.0,1.0.1,1,5,18,3,21,5,FALSE
ms-phone,1.0.1,1.0.2,2,1,14,14,28,1,FALSE
ms-phone,1.0.0,1.0.1,1,5,18,3,21,5,TRUE
ms-phone,1.0.1,1.0.2,2,1,14,14,28,1,TRUE
aliyun-push,1.0.4,1.1.0,5,1,16,7,23,2,FALSE
aliyun-push,1.1.0,1.1.1,6,1,5,1,6,1,FALSE
aliyun-push,1.0.0,1.0.1,1,1,17,14,31,2,FALSE
aliyun-push,1.0.1,1.0.2,2,1,1,1,2,1,FALSE
aliyun-push,1.0.2,1.0.3,3,1,2,0,2,1,FALSE
aliyun-push,1.0.3,1.0.4,4,1,1,1,2,1,FALSE
aliyun-push,1.0.3,1.0.4,4,1,1,1,2,1,TRUE
aliyun-push,1.0.1,1.0.2,2,1,1,1,2,1,TRUE
aliyun-push,1.0.0,1.0.1,1,1,17,14,31,2,TRUE
get-package-info,0.1.1,1.0.0,5,5,307,314,621,15,FALSE
get-package-info,0.1.0,0.1.1,4,4,16,3,19,5,FALSE
get-package-info,0.0.1,0.0.2,1,4,66,12,78,15,FALSE
get-package-info,0.0.3,0.1.0,3,3,26,10,36,5,FALSE
get-package-info,0.0.2,0.0.3,2,15,22,16,38,15,FALSE
get-package-info,0.0.3,0.1.0,3,3,26,10,36,5,TRUE
msal,0.1.0,0.1.1,1,29,1600,967,2567,90,FALSE
msal,0.1.0,0.1.1,1,29,1600,967,2567,90,TRUE
meshblu-server-http,3.1.2,3.2.0,75,1,14,1,15,3,FALSE
meshblu-server-http,3.1.0,3.1.2,74,2,16,12,28,4,FALSE
meshblu-server-http,3.0.0,3.0.1,72,1,12,3,15,4,FALSE
meshblu-server-http,2.0.0,2.1.0,70,1,4,3,7,3,FALSE
meshblu-server-http,3.3.0,3.3.1,77,1,2,2,4,2,FALSE
meshblu-server-http,2.1.0,3.0.0,71,1,11,3,14,3,FALSE
meshblu-server-http,1.24.0,1.25.0,63,1,1,1,2,1,FALSE
meshblu-server-http,1.14.2,1.14.3,44,1,8,3,11,3,FALSE
meshblu-server-http,1.14.3,1.14.4,45,1,1,17,18,2,FALSE
meshblu-server-http,1.14.1,1.14.2,43,1,10,9,19,3,FALSE
meshblu-server-http,1.18.0,1.19.0,53,8,244,81,325,24,FALSE
meshblu-server-http,1.14.4,1.14.5,46,2,34,1,35,3,FALSE
meshblu-server-http,1.14.5,1.15.0,47,1,156,2,158,4,FALSE
meshblu-server-http,3.0.1,3.1.0,73,1,77,4,81,4,FALSE
meshblu-server-http,1.15.0,1.16.0,48,1,83,2,85,4,FALSE
meshblu-server-http,1.21.2,1.22.0,60,1,237,44,281,4,FALSE
meshblu-server-http,1.6.0,1.7.1,14,2,123,9,132,7,FALSE
meshblu-server-http,1.23.0,1.24.0,62,3,201,131,332,12,FALSE
meshblu-server-http,1.9.0,1.9.1,17,1,1,1,2,1,FALSE
meshblu-server-http,1.9.3,1.9.4,20,1,1,1,2,1,FALSE
meshblu-server-http,1.9.2,1.9.3,19,1,1,1,2,1,FALSE
meshblu-server-http,1.9.5,1.10.0,22,1,53,111,164,14,FALSE
meshblu-server-http,1.9.4,1.9.5,21,1,4,2,6,2,FALSE
meshblu-server-http,1.7.1,1.8.0,15,1,4,4,8,3,FALSE
meshblu-server-http,1.4.0,1.4.1,4,1,10,2,12,2,FALSE
meshblu-server-http,1.4.1,1.4.2,5,1,2,2,4,2,FALSE
meshblu-server-http,1.4.2,1.4.3,6,1,4,1,5,1,FALSE
meshblu-server-http,1.4.3,1.4.4,7,1,8,11,19,6,FALSE
meshblu-server-http,1.4.4,1.4.5,8,1,17,4,21,2,FALSE
meshblu-server-http,1.4.5,1.4.6,9,1,118,2,120,6,FALSE
meshblu-server-http,1.4.6,1.4.7,10,3,45,23,68,9,FALSE
meshblu-server-http,1.4.7,1.4.8,11,2,27,16,43,5,FALSE
meshblu-server-http,1.4.8,1.5.0,12,2,123,15,138,7,FALSE
meshblu-server-http,1.21.0,1.21.1,58,1,12,9,21,3,FALSE
meshblu-server-http,1.21.1,1.21.2,59,1,1,1,2,1,FALSE
meshblu-server-http,1.5.0,1.6.0,13,2,215,9,224,10,FALSE
meshblu-server-http,1.20.1,1.21.0,57,1,112,29,141,4,FALSE
meshblu-server-http,1.20.0,1.20.1,56,1,18,3,21,3,FALSE
meshblu-server-http,1.9.1,1.9.2,18,1,1,1,2,1,FALSE
meshblu-server-http,1.3.1,1.4.0,3,3,295,479,774,23,FALSE
meshblu-server-http,1.3.0,1.3.1,2,1,107,58,165,7,FALSE
meshblu-server-http,1.12.8,1.12.10,40,2,25,13,38,13,FALSE
meshblu-server-http,1.22.0,1.23.0,61,1,66,2,68,4,FALSE
meshblu-server-http,1.12.4,1.12.5,36,1,3,3,6,3,FALSE
meshblu-server-http,1.12.5,1.12.6,37,1,14,12,26,3,FALSE
meshblu-server-http,1.12.6,1.12.7,38,1,3,42,45,4,FALSE
meshblu-server-http,1.12.7,1.12.8,39,2,10,3,13,9,FALSE
meshblu-server-http,1.12.0,1.12.1,32,1,23,11,34,3,FALSE
meshblu-server-http,1.12.1,1.12.2,33,1,19,8,27,4,FALSE
meshblu-server-http,1.12.2,1.12.3,34,1,81,7,88,14,FALSE
meshblu-server-http,1.12.3,1.12.4,35,1,7,4,11,2,FALSE
meshblu-server-http,1.19.0,1.19.1,54,1,1,1,2,1,FALSE
meshblu-server-http,1.11.1,1.12.0,31,1,63,69,132,14,FALSE
meshblu-server-http,1.11.0,1.11.1,30,1,68,100,168,11,FALSE
meshblu-server-http,1.27.0,1.27.1,68,1,38,1,39,3,FALSE
meshblu-server-http,1.27.1,2.0.0,69,1,18,2,20,3,FALSE
meshblu-server-http,1.12.10,1.13.0,41,2,16,8,24,6,FALSE
meshblu-server-http,1.2.7,1.3.0,1,8,192,72,264,36,FALSE
meshblu-server-http,1.10.6,1.11.0,29,1,25,21,46,10,FALSE
meshblu-server-http,1.8.0,1.9.0,16,1,112,4,116,4,FALSE
meshblu-server-http,1.13.0,1.14.1,42,3,59,7,66,17,FALSE
meshblu-server-http,1.10.5,1.10.6,28,1,19,20,39,15,FALSE
meshblu-server-http,1.10.2,1.10.3,25,1,17,1,18,3,FALSE
meshblu-server-http,1.10.3,1.10.4,26,1,2,2,4,2,FALSE
meshblu-server-http,1.10.0,1.10.1,23,1,7,9,16,6,FALSE
meshblu-server-http,1.10.1,1.10.2,24,1,2,2,4,2,FALSE
meshblu-server-http,1.16.0,1.16.1,49,1,10,10,20,8,FALSE
meshblu-server-http,1.16.1,1.17.0,50,1,102,21,123,5,FALSE
meshblu-server-http,3.3.2,3.3.3,79,3,30,38,68,20,FALSE
meshblu-server-http,1.17.1,1.18.0,52,3,171,34,205,11,FALSE
meshblu-server-http,1.17.0,1.17.1,51,1,3,3,6,3,FALSE
meshblu-server-http,1.25.0,1.25.1,64,1,9,9,18,3,FALSE
meshblu-server-http,1.25.1,1.26.0,65,2,97,58,155,7,FALSE
meshblu-server-http,1.26.1,1.27.0,67,1,151,2,153,6,FALSE
meshblu-server-http,1.26.0,1.26.1,66,1,18,8,26,4,FALSE
meshblu-server-http,3.3.1,3.3.2,78,1,9,1,10,2,FALSE
meshblu-server-http,3.2.0,3.3.0,76,1,18,4,22,3,FALSE
meshblu-server-http,1.10.4,1.10.5,27,1,4,1,5,2,FALSE
meshblu-server-http,1.19.1,1.20.0,55,1,116,1,117,4,FALSE
meshblu-server-http,1.14.5,1.15.0,47,1,156,2,158,4,TRUE
meshblu-server-http,3.0.1,3.1.0,73,1,77,4,81,4,TRUE
meshblu-server-http,1.20.1,1.21.0,57,1,112,29,141,4,TRUE
meshblu-server-http,1.10.2,1.10.3,25,1,17,1,18,3,TRUE
meshblu-server-http,1.14.3,1.14.4,45,1,1,17,18,2,TRUE
meshblu-server-http,1.12.8,1.12.10,40,2,25,13,38,13,TRUE
meshblu-server-http,1.12.2,1.12.3,34,1,81,7,88,14,TRUE
meshblu-server-http,1.4.8,1.5.0,12,2,123,15,138,7,TRUE
meshblu-server-http,1.12.10,1.13.0,41,2,16,8,24,6,TRUE
meshblu-server-http,1.14.2,1.14.3,44,1,8,3,11,3,TRUE
meshblu-server-http,1.10.0,1.10.1,23,1,7,9,16,6,TRUE
meshblu-server-http,3.1.2,3.2.0,75,1,14,1,15,3,TRUE
meshblu-server-http,1.12.5,1.12.6,37,1,14,12,26,3,TRUE
mongot,1.1.3,1.1.4,18,2,8,4,12,4,FALSE
mongot,1.1.2,1.1.3,17,2,123,6,129,15,FALSE
mongot,1.0.0,1.0.1,15,2,2346,2186,4532,42,FALSE
mongot,1.0.1,1.1.2,16,6,441,80,521,33,FALSE
mongot,0.2.7,0.2.8,7,2,25,11,36,4,FALSE
mongot,0.2.6,0.2.7,6,2,24,2,26,4,FALSE
mongot,0.2.5,0.2.6,5,2,83,10,93,4,FALSE
mongot,0.2.4,0.2.5,4,2,17,51,68,2,FALSE
mongot,0.2.3,0.2.4,3,2,2,2,4,2,FALSE
mongot,0.2.2,0.2.3,2,3,102,13,115,5,FALSE
mongot,0.2.1,0.2.2,1,2,30,16,46,8,FALSE
mongot,1.1.5,1.2.0,20,3,415,82,497,66,FALSE
mongot,0.2.9,0.2.10,9,2,2,2,4,2,FALSE
mongot,1.1.4,1.1.5,19,2,258,168,426,31,FALSE
mongot,0.3.1,1.0.0,14,2,2441,2239,4680,56,FALSE
mongot,0.2.8,0.2.9,8,2,16,6,22,5,FALSE
mongot,1.4.0,1.4.1,25,2,14,12,26,6,FALSE
mongot,1.4.1,1.4.2,26,2,91,12,103,20,FALSE
mongot,0.2.13,0.3.1,13,6,2289,72,2361,75,FALSE
mongot,0.2.12,0.2.13,12,2,10,3,13,3,FALSE
mongot,0.2.11,0.2.12,11,2,18,5,23,4,FALSE
mongot,0.2.10,0.2.11,10,2,81,14,95,4,FALSE
mongot,1.3.0,1.4.0,24,2,222,103,325,31,FALSE
mongot,1.2.2,1.3.0,23,2,272,226,498,34,FALSE
mongot,1.2.0,1.2.1,21,2,8,3,11,6,FALSE
mongot,1.2.1,1.2.2,22,2,53,51,104,26,FALSE
mongot,1.1.2,1.1.3,17,2,123,6,129,15,TRUE
mongot,1.0.0,1.0.1,15,2,2346,2186,4532,42,TRUE
mongot,1.0.1,1.1.2,16,6,441,80,521,33,TRUE
mongot,0.2.6,0.2.7,6,2,24,2,26,4,TRUE
mongot,0.2.1,0.2.2,1,2,30,16,46,8,TRUE
mongot,1.1.5,1.2.0,20,3,415,82,497,66,TRUE
mongot,0.2.9,0.2.10,9,2,2,2,4,2,TRUE
mongot,0.3.1,1.0.0,14,2,2441,2239,4680,56,TRUE
mongot,0.2.13,0.3.1,13,6,2289,72,2361,75,TRUE
mongot,0.2.12,0.2.13,12,2,10,3,13,3,TRUE
mongot,1.3.0,1.4.0,24,2,222,103,325,31,TRUE
mongot,1.2.2,1.3.0,23,2,272,226,498,34,TRUE
generator-react-redux-modules,1.1.1,1.1.2,4,3,22,31,53,3,FALSE
generator-react-redux-modules,1.1.0,1.1.1,3,2,191,1,192,9,FALSE
generator-react-redux-modules,1.1.3,1.1.7,6,12,88,44,132,16,FALSE
generator-react-redux-modules,1.1.2,1.1.3,5,4,219,17,236,8,FALSE
generator-react-redux-modules,1.0.1,1.0.2,1,5,3798,978,4776,172,FALSE
generator-react-redux-modules,1.0.2,1.1.0,2,4,35,75,110,9,FALSE
generator-react-redux-modules,1.3.0,1.3.1,9,2,3,3,6,3,FALSE
generator-react-redux-modules,1.2.0,1.3.0,8,3,110,3,113,7,TRUE
generator-react-redux-modules,1.1.7,1.2.0,7,6,611,449,1060,10,FALSE
generator-react-redux-modules,1.3.0,1.3.1,9,2,3,3,6,3,TRUE
generator-react-redux-modules,1.2.0,1.3.0,8,3,110,3,113,7,FALSE
openrest,1.3.405,1.3.406,409,1,1,1,2,1,FALSE
openrest,1.3.404,1.3.405,408,1,1,1,2,1,FALSE
openrest,1.3.407,1.3.408,411,1,1,1,2,1,FALSE
openrest,1.3.406,1.3.407,410,1,1,1,2,1,FALSE
openrest,1.3.401,1.3.402,405,1,1,1,2,1,FALSE
openrest,1.3.400,1.3.401,404,1,1,1,2,1,FALSE
openrest,1.3.403,1.3.404,407,1,1,1,2,1,FALSE
openrest,1.3.402,1.3.403,406,1,1,1,2,1,FALSE
openrest,1.3.409,1.3.410,413,1,1,1,2,1,FALSE
openrest,1.3.408,1.3.409,412,1,1,1,2,1,FALSE
openrest,1.3.59,1.3.60,63,1,1,1,2,1,FALSE
openrest,1.3.58,1.3.59,62,1,1,1,2,1,FALSE
openrest,1.3.57,1.3.58,61,1,1,1,2,1,FALSE
openrest,1.3.56,1.3.57,60,1,1,1,2,1,FALSE
openrest,1.3.55,1.3.56,59,1,1,1,2,1,FALSE
openrest,1.3.54,1.3.55,58,1,1,1,2,1,FALSE
openrest,1.3.53,1.3.54,57,1,1,1,2,1,FALSE
openrest,1.3.52,1.3.53,56,1,1,1,2,1,FALSE
openrest,1.3.51,1.3.52,55,1,1,1,2,1,FALSE
openrest,1.3.50,1.3.51,54,1,1,1,2,1,FALSE
openrest,1.3.168,1.3.169,172,1,1,1,2,1,FALSE
openrest,1.3.169,1.3.170,173,1,1,1,2,1,FALSE
openrest,1.3.166,1.3.167,170,1,1,1,2,1,FALSE
openrest,1.3.167,1.3.168,171,1,1,1,2,1,FALSE
openrest,1.3.164,1.3.165,168,1,1,1,2,1,FALSE
openrest,1.3.165,1.3.166,169,1,1,1,2,1,FALSE
openrest,1.3.162,1.3.163,166,1,1,1,2,1,FALSE
openrest,1.3.163,1.3.164,167,1,1,1,2,1,FALSE
openrest,1.3.160,1.3.161,164,1,1,1,2,1,FALSE
openrest,1.3.161,1.3.162,165,1,1,1,2,1,FALSE
openrest,1.3.308,1.3.309,312,1,1,1,2,1,FALSE
openrest,1.3.309,1.3.310,313,1,1,1,2,1,FALSE
openrest,1.3.302,1.3.303,306,1,1,1,2,1,FALSE
openrest,1.3.303,1.3.304,307,1,1,1,2,1,FALSE
openrest,1.3.300,1.3.301,304,1,1,1,2,1,FALSE
openrest,1.3.301,1.3.302,305,1,1,1,2,1,FALSE
openrest,1.3.306,1.3.307,310,1,1,1,2,1,FALSE
openrest,1.3.307,1.3.308,311,1,1,1,2,1,FALSE
openrest,1.3.304,1.3.305,308,1,1,1,2,1,FALSE
openrest,1.3.305,1.3.306,309,1,1,1,2,1,FALSE
openrest,1.3.276,1.3.277,280,1,1,1,2,1,FALSE
openrest,1.3.277,1.3.278,281,1,1,1,2,1,FALSE
openrest,1.3.274,1.3.275,278,1,1,1,2,1,FALSE
openrest,1.3.275,1.3.276,279,1,1,1,2,1,FALSE
openrest,1.3.272,1.3.273,276,1,1,1,2,1,FALSE
openrest,1.3.273,1.3.274,277,1,1,1,2,1,FALSE
openrest,1.3.270,1.3.271,274,1,1,1,2,1,FALSE
openrest,1.3.271,1.3.272,275,1,1,1,2,1,FALSE
openrest,1.3.278,1.3.279,282,1,1,1,2,1,FALSE
openrest,1.3.279,1.3.280,283,1,1,1,2,1,FALSE
openrest,1.3.379,1.3.380,383,1,1,1,2,1,TRUE
openrest,1.3.378,1.3.379,382,1,1,1,2,1,FALSE
openrest,1.3.377,1.3.378,381,1,1,1,2,1,FALSE
openrest,1.3.376,1.3.377,380,1,1,1,2,1,FALSE
openrest,1.3.375,1.3.376,379,1,1,1,2,1,FALSE
openrest,1.3.374,1.3.375,378,1,1,1,2,1,FALSE
openrest,1.3.373,1.3.374,377,1,1,1,2,1,FALSE
openrest,1.3.372,1.3.373,376,1,1,1,2,1,FALSE
openrest,1.3.371,1.3.372,375,1,1,1,2,1,FALSE
openrest,1.3.370,1.3.371,374,1,1,1,2,1,FALSE
openrest,1.3.382,1.3.383,386,1,1,1,2,1,FALSE
openrest,1.3.383,1.3.384,387,1,1,1,2,1,FALSE
openrest,1.3.289,1.3.290,293,1,1,1,2,1,FALSE
openrest,1.3.288,1.3.289,292,1,1,1,2,1,FALSE
openrest,1.3.283,1.3.284,287,1,1,1,2,1,FALSE
openrest,1.3.282,1.3.283,286,1,1,1,2,1,FALSE
openrest,1.3.281,1.3.282,285,1,1,1,2,1,FALSE
openrest,1.3.280,1.3.281,284,1,1,1,2,1,FALSE
openrest,1.3.287,1.3.288,291,1,1,1,2,1,FALSE
openrest,1.3.286,1.3.287,290,1,1,1,2,1,FALSE
openrest,1.3.285,1.3.286,289,1,1,1,2,1,FALSE
openrest,1.3.284,1.3.285,288,1,1,1,2,1,FALSE
openrest,1.3.262,1.3.263,266,1,1,1,2,1,FALSE
openrest,1.3.122,1.3.123,126,1,1,1,2,1,FALSE
openrest,1.3.123,1.3.124,127,1,1,1,2,1,FALSE
openrest,1.3.120,1.3.121,124,1,1,1,2,1,FALSE
openrest,1.3.121,1.3.122,125,1,1,1,2,1,FALSE
openrest,1.3.126,1.3.127,130,1,1,1,2,1,FALSE
openrest,1.3.127,1.3.128,131,1,1,1,2,1,FALSE
openrest,1.3.124,1.3.125,128,1,1,1,2,1,FALSE
openrest,1.3.125,1.3.126,129,1,1,1,2,1,FALSE
openrest,1.3.128,1.3.129,132,1,1,1,2,1,FALSE
openrest,1.3.129,1.3.130,133,1,1,1,2,1,FALSE
openrest,1.3.88,1.3.89,92,1,1,1,2,1,FALSE
openrest,1.3.89,1.3.90,93,1,1,1,2,1,FALSE
openrest,1.3.84,1.3.85,88,1,1,1,2,1,FALSE
openrest,1.3.85,1.3.86,89,1,1,1,2,1,FALSE
openrest,1.3.86,1.3.87,90,1,1,1,2,1,FALSE
openrest,1.3.87,1.3.88,91,1,1,1,2,1,FALSE
openrest,1.3.80,1.3.81,84,1,1,1,2,1,FALSE
openrest,1.3.81,1.3.82,85,1,1,1,2,1,FALSE
openrest,1.3.82,1.3.83,86,1,1,1,2,1,FALSE
openrest,1.3.83,1.3.84,87,1,1,1,2,1,FALSE
openrest,1.3.458,1.3.459,462,1,1,1,2,1,FALSE
openrest,1.3.459,1.3.460,463,1,1,1,2,1,FALSE
openrest,1.3.456,1.3.457,460,1,1,1,2,1,FALSE
openrest,1.3.457,1.3.458,461,1,1,1,2,1,FALSE
openrest,1.3.454,1.3.455,458,1,1,1,2,1,FALSE
openrest,1.3.455,1.3.456,459,1,1,1,2,1,FALSE
openrest,1.3.452,1.3.453,456,1,1,1,2,1,FALSE
openrest,1.3.453,1.3.454,457,1,1,1,2,1,FALSE
openrest,1.3.450,1.3.451,454,1,1,1,2,1,FALSE
openrest,1.3.451,1.3.452,455,1,1,1,2,1,FALSE
openrest,1.3.66,1.3.67,70,1,1,1,2,1,FALSE
openrest,1.3.67,1.3.68,71,1,1,1,2,1,FALSE
openrest,1.3.64,1.3.65,68,1,1,1,2,1,FALSE
openrest,1.3.65,1.3.66,69,1,1,1,2,1,FALSE
openrest,1.3.62,1.3.63,66,1,1,1,2,1,FALSE
openrest,1.3.63,1.3.64,67,1,1,1,2,1,FALSE
openrest,1.3.60,1.3.61,64,1,1,1,2,1,FALSE
openrest,1.3.61,1.3.62,65,1,1,1,2,1,FALSE
openrest,1.3.68,1.3.69,72,1,1,1,2,1,FALSE
openrest,1.3.69,1.3.70,73,1,1,1,2,1,FALSE
openrest,1.3.157,1.3.158,161,1,1,1,2,1,FALSE
openrest,1.3.156,1.3.157,160,1,1,1,2,1,FALSE
openrest,1.3.155,1.3.156,159,1,1,1,2,1,FALSE
openrest,1.3.154,1.3.155,158,1,1,1,2,1,FALSE
openrest,1.3.153,1.3.154,157,1,1,1,2,1,FALSE
openrest,1.3.152,1.3.153,156,1,1,1,2,1,FALSE
openrest,1.3.151,1.3.152,155,1,1,1,2,1,FALSE
openrest,1.3.150,1.3.151,154,1,1,1,2,1,FALSE
openrest,1.3.159,1.3.160,163,1,1,1,2,1,FALSE
openrest,1.3.158,1.3.159,162,1,1,1,2,1,FALSE
openrest,1.3.13,1.3.14,17,1,1,1,2,1,FALSE
openrest,1.3.12,1.3.13,16,1,1,1,2,1,FALSE
openrest,1.3.11,1.3.12,15,1,1,1,2,1,FALSE
openrest,1.3.10,1.3.11,14,1,1,1,2,1,FALSE
openrest,1.3.17,1.3.18,21,1,1,1,2,1,FALSE
openrest,1.3.16,1.3.17,20,1,1,1,2,1,FALSE
openrest,1.3.15,1.3.16,19,1,1,1,2,1,FALSE
openrest,1.3.14,1.3.15,18,1,1,1,2,1,FALSE
openrest,1.3.19,1.3.20,23,1,1,1,2,1,FALSE
openrest,1.3.18,1.3.19,22,1,1,1,2,1,FALSE
openrest,1.3.333,1.3.334,337,1,1,1,2,1,FALSE
openrest,1.3.332,1.3.333,336,1,1,1,2,1,FALSE
openrest,1.3.331,1.3.332,335,1,1,1,2,1,FALSE
openrest,1.3.330,1.3.331,334,1,1,1,2,1,FALSE
openrest,1.3.337,1.3.338,341,1,1,1,2,1,FALSE
openrest,1.3.336,1.3.337,340,1,1,1,2,1,FALSE
openrest,1.3.335,1.3.336,339,1,1,1,2,1,FALSE
openrest,1.3.334,1.3.335,338,1,1,1,2,1,FALSE
openrest,1.3.232,1.3.233,236,1,1,1,2,1,FALSE
openrest,1.3.233,1.3.234,237,1,1,1,2,1,FALSE
openrest,1.3.339,1.3.340,343,1,1,1,2,1,FALSE
openrest,1.3.338,1.3.339,342,1,1,1,2,1,FALSE
openrest,1.3.236,1.3.237,240,1,1,1,2,1,FALSE
openrest,1.3.237,1.3.238,241,1,1,1,2,1,FALSE
openrest,1.3.234,1.3.235,238,1,1,1,2,1,FALSE
openrest,1.3.235,1.3.236,239,1,1,1,2,1,FALSE
openrest,1.3.249,1.3.250,253,1,1,1,2,1,FALSE
openrest,1.3.248,1.3.249,252,1,1,1,2,1,FALSE
openrest,1.3.247,1.3.248,251,1,1,1,2,1,FALSE
openrest,1.3.246,1.3.247,250,1,15,1,16,2,FALSE
openrest,1.3.245,1.3.246,249,1,1,1,2,1,FALSE
openrest,1.3.244,1.3.245,248,1,1,1,2,1,FALSE
openrest,1.3.243,1.3.244,247,1,1,1,2,1,FALSE
openrest,1.3.242,1.3.243,246,1,1,1,2,1,FALSE
openrest,1.3.241,1.3.242,245,1,1,1,2,1,FALSE
openrest,1.3.240,1.3.241,244,1,1,1,2,1,FALSE
openrest,1.3.412,1.3.413,416,1,1,1,2,1,FALSE
openrest,1.3.413,1.3.414,417,1,1,1,2,1,FALSE
openrest,1.3.410,1.3.411,414,1,1,1,2,1,FALSE
openrest,1.3.411,1.3.412,415,1,1,1,2,1,FALSE
openrest,1.3.416,1.3.417,420,1,1,1,2,1,FALSE
openrest,1.3.417,1.3.418,421,1,1,1,2,1,FALSE
openrest,1.3.414,1.3.415,418,1,1,1,2,1,FALSE
openrest,1.3.415,1.3.416,419,1,1,1,2,1,FALSE
openrest,1.3.418,1.3.419,422,1,1,1,2,1,FALSE
openrest,1.3.419,1.3.420,423,1,1,1,2,1,FALSE
openrest,1.3.28,1.3.29,32,1,1,1,2,1,FALSE
openrest,1.3.29,1.3.30,33,1,1,1,2,1,FALSE
openrest,1.3.22,1.3.23,26,1,1,1,2,1,FALSE
openrest,1.3.23,1.3.24,27,1,1,1,2,1,FALSE
openrest,1.3.20,1.3.21,24,1,1,1,2,1,FALSE
openrest,1.3.21,1.3.22,25,1,1,1,2,1,FALSE
openrest,1.3.26,1.3.27,30,1,1,1,2,1,FALSE
openrest,1.3.27,1.3.28,31,1,1,1,2,1,FALSE
openrest,1.3.24,1.3.25,28,1,1,1,2,1,FALSE
openrest,1.3.25,1.3.26,29,1,1,1,2,1,FALSE
openrest,1.3.119,1.3.120,123,1,1,1,2,1,FALSE
openrest,1.3.118,1.3.119,122,1,1,1,2,1,FALSE
openrest,1.3.113,1.3.114,117,1,1,1,2,1,FALSE
openrest,1.3.112,1.3.113,116,1,1,1,2,1,FALSE
openrest,1.3.111,1.3.112,115,1,1,1,2,1,FALSE
openrest,1.3.110,1.3.111,114,1,1,1,2,1,FALSE
openrest,1.3.117,1.3.118,121,1,1,1,2,1,FALSE
openrest,1.3.116,1.3.117,120,1,1,1,2,1,FALSE
openrest,1.3.115,1.3.116,119,1,1,1,2,1,FALSE
openrest,1.3.114,1.3.115,118,1,1,1,2,1,FALSE
openrest,1.3.460,1.3.461,464,1,1,1,2,1,FALSE
openrest,1.3.263,1.3.264,267,1,1,1,2,1,FALSE
openrest,1.3.203,1.3.204,207,1,1,1,2,1,FALSE
openrest,1.3.202,1.3.203,206,1,1,1,2,1,FALSE
openrest,1.3.201,1.3.202,205,1,1,1,2,1,FALSE
openrest,1.3.200,1.3.201,204,1,1,1,2,1,FALSE
openrest,1.3.207,1.3.208,211,1,1,1,2,1,FALSE
openrest,1.3.206,1.3.207,210,1,1,1,2,1,FALSE
openrest,1.3.205,1.3.206,209,1,1,1,2,1,FALSE
openrest,1.3.204,1.3.205,208,1,1,1,2,1,FALSE
openrest,1.3.131,1.3.132,135,1,1,1,2,1,FALSE
openrest,1.3.209,1.3.210,213,1,1,1,2,1,FALSE
openrest,1.3.208,1.3.209,212,1,1,1,2,1,FALSE
openrest,1.3.368,1.3.369,372,1,1,1,2,1,FALSE
openrest,1.3.369,1.3.370,373,1,1,1,2,1,FALSE
openrest,1.3.364,1.3.365,368,1,1,1,2,1,FALSE
openrest,1.3.365,1.3.366,369,1,1,1,2,1,FALSE
openrest,1.3.366,1.3.367,370,1,1,1,2,1,FALSE
openrest,1.3.367,1.3.368,371,1,1,1,2,1,FALSE
openrest,1.3.360,1.3.361,364,1,1,1,2,1,FALSE
openrest,1.3.361,1.3.362,365,1,1,1,2,1,FALSE
openrest,1.3.362,1.3.363,366,1,1,1,2,1,FALSE
openrest,1.3.363,1.3.364,367,1,1,1,2,1,FALSE
openrest,1.3.130,1.3.131,134,1,1,1,2,1,FALSE
openrest,1.3.133,1.3.134,137,1,1,1,2,1,FALSE
openrest,1.3.298,1.3.299,302,1,1,1,2,1,FALSE
openrest,1.3.299,1.3.300,303,1,1,1,2,1,FALSE
openrest,1.3.290,1.3.291,294,1,1,1,2,1,FALSE
openrest,1.3.291,1.3.292,295,1,1,1,2,1,FALSE
openrest,1.3.292,1.3.293,296,1,1,1,2,1,FALSE
openrest,1.3.293,1.3.294,297,1,1,1,2,1,FALSE
openrest,1.3.294,1.3.295,298,1,1,1,2,1,FALSE
openrest,1.3.295,1.3.296,299,1,1,1,2,1,FALSE
openrest,1.3.296,1.3.297,300,1,1,1,2,1,FALSE
openrest,1.3.297,1.3.298,301,1,1,1,2,1,FALSE
openrest,1.3.396,1.3.397,400,1,1,1,2,1,FALSE
openrest,1.2.0,1.3.0,3,2,30,23,53,2,FALSE
openrest,1.3.391,1.3.392,395,1,1,1,2,1,FALSE
openrest,1.3.390,1.3.391,394,1,1,1,2,1,FALSE
openrest,1.3.135,1.3.136,139,1,1,1,2,1,FALSE
openrest,1.3.99,1.3.100,103,1,1,1,2,1,FALSE
openrest,1.3.98,1.3.99,102,1,1,1,2,1,FALSE
openrest,1.3.134,1.3.135,138,1,1,1,2,1,FALSE
openrest,1.3.93,1.3.94,97,1,1,1,2,1,FALSE
openrest,1.3.92,1.3.93,96,1,1,1,2,1,FALSE
openrest,1.3.91,1.3.92,95,1,1,1,2,1,FALSE
openrest,1.3.90,1.3.91,94,1,1,1,2,1,FALSE
openrest,1.3.97,1.3.98,101,1,1,1,2,1,FALSE
openrest,1.3.96,1.3.97,100,1,1,1,2,1,FALSE
openrest,1.3.95,1.3.96,99,1,1,1,2,1,FALSE
openrest,1.3.94,1.3.95,98,1,1,1,2,1,FALSE
openrest,1.3.429,1.3.430,433,1,1,1,2,1,FALSE
openrest,1.3.0,1.3.1,4,1,3,0,3,1,FALSE
openrest,1.3.423,1.3.424,427,1,1,1,2,1,FALSE
openrest,1.3.422,1.3.423,426,1,1,1,2,1,FALSE
openrest,1.3.421,1.3.422,425,1,1,1,2,1,FALSE
openrest,1.3.420,1.3.421,424,1,1,1,2,1,FALSE
openrest,1.3.427,1.3.428,431,1,1,1,2,1,FALSE
openrest,1.3.426,1.3.427,430,1,1,1,2,1,FALSE
openrest,1.3.425,1.3.426,429,1,1,1,2,1,FALSE
openrest,1.3.424,1.3.425,428,1,1,1,2,1,FALSE
openrest,1.3.75,1.3.76,79,1,1,1,2,1,FALSE
openrest,1.3.74,1.3.75,78,1,1,1,2,1,FALSE
openrest,1.3.77,1.3.78,81,1,1,1,2,1,FALSE
openrest,1.3.76,1.3.77,80,1,1,1,2,1,FALSE
openrest,1.3.71,1.3.72,75,1,1,1,2,1,FALSE
openrest,1.3.70,1.3.71,74,1,1,1,2,1,FALSE
openrest,1.3.73,1.3.74,77,1,1,1,2,1,FALSE
openrest,1.3.72,1.3.73,76,1,1,1,2,1,FALSE
openrest,1.3.250,1.3.251,254,1,1,1,2,1,FALSE
openrest,1.3.132,1.3.133,136,1,1,1,2,1,FALSE
openrest,1.3.79,1.3.80,83,1,1,1,2,1,FALSE
openrest,1.3.78,1.3.79,82,1,1,1,2,1,FALSE
openrest,1.3.251,1.3.252,255,1,1,1,2,1,FALSE
openrest,1.3.144,1.3.145,148,1,1,1,2,1,FALSE
openrest,1.3.145,1.3.146,149,1,1,1,2,1,FALSE
openrest,1.3.146,1.3.147,150,1,1,1,2,1,FALSE
openrest,1.3.147,1.3.148,151,1,1,1,2,1,FALSE
openrest,1.3.140,1.3.141,144,1,1,1,2,1,FALSE
openrest,1.3.141,1.3.142,145,1,1,1,2,1,FALSE
openrest,1.3.142,1.3.143,146,1,1,1,2,1,FALSE
openrest,1.3.143,1.3.144,147,1,1,1,2,1,FALSE
openrest,1.3.148,1.3.149,152,1,1,1,2,1,FALSE
openrest,1.3.149,1.3.150,153,1,1,1,2,1,FALSE
openrest,1.3.320,1.3.321,324,1,1,1,2,1,FALSE
openrest,1.3.321,1.3.322,325,1,1,1,2,1,FALSE
openrest,1.3.322,1.3.323,326,1,1,1,2,1,FALSE
openrest,1.3.323,1.3.324,327,1,1,1,2,1,FALSE
openrest,1.3.324,1.3.325,328,1,1,1,2,1,FALSE
openrest,1.3.325,1.3.326,329,1,1,1,2,1,FALSE
openrest,1.3.326,1.3.327,330,1,1,1,2,1,FALSE
openrest,1.3.327,1.3.328,331,1,1,1,2,1,FALSE
openrest,1.3.328,1.3.329,332,1,1,1,2,1,FALSE
openrest,1.3.329,1.3.330,333,1,1,1,2,1,FALSE
openrest,1.3.238,1.3.239,242,1,1,1,2,1,FALSE
openrest,1.3.239,1.3.240,243,1,1,1,2,1,FALSE
openrest,1.3.230,1.3.231,234,1,1,1,2,1,FALSE
openrest,1.3.395,1.3.396,399,1,1,1,2,1,FALSE
openrest,1.3.394,1.3.395,398,1,1,1,2,1,FALSE
openrest,1.3.397,1.3.398,401,1,1,1,2,1,FALSE
openrest,1.3.231,1.3.232,235,1,1,1,2,1,FALSE
openrest,1.3.258,1.3.259,262,1,1,1,2,1,FALSE
openrest,1.3.259,1.3.260,263,1,1,1,2,1,FALSE
openrest,1.3.393,1.3.394,397,1,1,1,2,1,FALSE
openrest,1.3.392,1.3.393,396,1,1,1,2,1,FALSE
openrest,1.3.254,1.3.255,258,1,1,1,2,1,FALSE
openrest,1.3.255,1.3.256,259,1,1,1,2,1,FALSE
openrest,1.3.256,1.3.257,260,1,1,1,2,1,FALSE
openrest,1.3.257,1.3.258,261,1,1,1,2,1,FALSE
openrest,1.3.399,1.3.400,403,1,1,1,2,1,FALSE
openrest,1.3.398,1.3.399,402,1,1,1,2,1,FALSE
openrest,1.3.252,1.3.253,256,1,1,1,2,1,FALSE
openrest,1.3.253,1.3.254,257,1,1,1,2,1,FALSE
openrest,1.3.193,1.3.194,197,1,1,1,2,1,FALSE
openrest,1.3.192,1.3.193,196,1,1,1,2,1,FALSE
openrest,1.3.191,1.3.192,195,1,1,1,2,1,FALSE
openrest,1.3.190,1.3.191,194,1,1,1,2,1,FALSE
openrest,1.3.197,1.3.198,201,1,1,1,2,1,FALSE
openrest,1.3.196,1.3.197,200,1,1,1,2,1,FALSE
openrest,1.3.195,1.3.196,199,1,1,1,2,1,FALSE
openrest,1.3.194,1.3.195,198,1,1,2,3,1,FALSE
openrest,1.3.199,1.3.200,203,1,1,1,2,1,FALSE
openrest,1.3.198,1.3.199,202,1,1,1,2,1,FALSE
openrest,1.3.39,1.3.40,43,1,1,1,2,1,FALSE
openrest,1.3.38,1.3.39,42,1,1,1,2,1,FALSE
openrest,1.3.31,1.3.32,35,1,1,1,2,1,FALSE
openrest,1.3.30,1.3.31,34,1,1,1,2,1,FALSE
openrest,1.3.33,1.3.34,37,1,1,1,2,1,FALSE
openrest,1.3.32,1.3.33,36,1,1,1,2,1,FALSE
openrest,1.3.35,1.3.36,39,1,1,1,2,1,FALSE
openrest,1.3.34,1.3.35,38,1,1,1,2,1,FALSE
openrest,1.3.37,1.3.38,41,1,1,1,2,1,FALSE
openrest,1.3.36,1.3.37,40,1,1,1,2,1,FALSE
openrest,1.3.108,1.3.109,112,1,1,1,2,1,FALSE
openrest,1.3.109,1.3.110,113,1,1,1,2,1,FALSE
openrest,1.3.100,1.3.101,104,1,1,1,2,1,FALSE
openrest,1.3.101,1.3.102,105,1,1,1,2,1,FALSE
openrest,1.3.102,1.3.103,106,1,1,1,2,1,FALSE
openrest,1.3.103,1.3.104,107,1,1,1,2,1,FALSE
openrest,1.3.104,1.3.105,108,1,1,1,2,1,FALSE
openrest,1.3.105,1.3.106,109,1,1,1,2,1,FALSE
openrest,1.3.106,1.3.107,110,1,1,1,2,1,FALSE
openrest,1.3.107,1.3.108,111,1,1,1,2,1,FALSE
openrest,1.3.210,1.3.211,214,1,1,1,2,1,FALSE
openrest,1.3.211,1.3.212,215,1,1,1,2,1,FALSE
openrest,1.3.212,1.3.213,216,1,1,1,2,1,FALSE
openrest,1.3.213,1.3.214,217,1,1,1,2,1,FALSE
openrest,1.3.214,1.3.215,218,1,1,1,2,1,FALSE
openrest,1.3.215,1.3.216,219,1,1,1,2,1,FALSE
openrest,1.3.216,1.3.217,220,1,1,1,2,1,FALSE
openrest,1.3.217,1.3.218,221,1,1,1,2,1,FALSE
openrest,1.3.218,1.3.219,222,1,1,1,2,1,FALSE
openrest,1.3.219,1.3.220,223,1,1,1,2,1,FALSE
openrest,1.3.1,1.3.2,5,3,60,4,64,4,FALSE
openrest,1.3.359,1.3.360,363,1,1,1,2,1,FALSE
openrest,1.3.358,1.3.359,362,1,1,1,2,1,FALSE
openrest,1.3.351,1.3.352,355,1,1,1,2,1,FALSE
openrest,1.3.350,1.3.351,354,1,1,1,2,1,FALSE
openrest,1.3.353,1.3.354,357,1,1,1,2,1,FALSE
openrest,1.3.352,1.3.353,356,1,1,1,2,1,FALSE
openrest,1.3.355,1.3.356,359,1,1,1,2,1,FALSE
openrest,1.3.354,1.3.355,358,1,1,1,2,1,FALSE
openrest,1.3.357,1.3.358,361,1,1,1,2,1,FALSE
openrest,1.3.356,1.3.357,360,1,1,1,2,1,FALSE
openrest,1.3.438,1.3.439,442,1,1,1,2,1,FALSE
openrest,1.3.439,1.3.440,443,1,1,1,2,1,FALSE
openrest,1.3.430,1.3.431,434,1,1,1,2,1,FALSE
openrest,1.3.431,1.3.432,435,1,1,1,2,1,FALSE
openrest,1.3.432,1.3.433,436,1,1,1,2,1,FALSE
openrest,1.3.433,1.3.434,437,1,1,1,2,1,FALSE
openrest,1.3.434,1.3.435,438,1,1,1,2,1,FALSE
openrest,1.3.435,1.3.436,439,1,1,1,2,1,FALSE
openrest,1.3.436,1.3.437,440,1,1,1,2,1,FALSE
openrest,1.3.437,1.3.438,441,1,1,1,2,1,FALSE
openrest,1.3.40,1.3.41,44,1,1,1,2,1,FALSE
openrest,1.3.41,1.3.42,45,1,1,1,2,1,FALSE
openrest,1.3.42,1.3.43,46,1,1,1,2,1,FALSE
openrest,1.3.43,1.3.44,47,1,1,1,2,1,FALSE
openrest,1.3.44,1.3.45,48,1,1,1,2,1,FALSE
openrest,1.3.45,1.3.46,49,1,1,1,2,1,FALSE
openrest,1.3.46,1.3.47,50,1,1,1,2,1,FALSE
openrest,1.3.47,1.3.48,51,1,1,1,2,1,FALSE
openrest,1.3.48,1.3.49,52,1,1,1,2,1,FALSE
openrest,1.3.49,1.3.50,53,1,1,1,2,1,FALSE
openrest,1.3.171,1.3.172,175,1,1,1,2,1,FALSE
openrest,1.3.170,1.3.171,174,1,1,1,2,1,FALSE
openrest,1.3.173,1.3.174,177,1,1,1,2,1,FALSE
openrest,1.3.172,1.3.173,176,1,1,1,2,1,FALSE
openrest,1.3.175,1.3.176,179,1,1,1,2,1,FALSE
openrest,1.3.174,1.3.175,178,1,1,1,2,1,FALSE
openrest,1.3.177,1.3.178,181,1,1,1,2,1,FALSE
openrest,1.3.176,1.3.177,180,1,1,1,2,1,FALSE
openrest,1.3.179,1.3.180,183,1,1,1,2,1,FALSE
openrest,1.3.178,1.3.179,182,1,1,1,2,1,FALSE
openrest,1.3.319,1.3.320,323,1,1,1,2,1,FALSE
openrest,1.3.318,1.3.319,322,1,1,1,2,1,FALSE
openrest,1.3.315,1.3.316,319,1,1,1,2,1,FALSE
openrest,1.3.314,1.3.315,318,1,1,1,2,1,FALSE
openrest,1.3.317,1.3.318,321,1,1,1,2,1,FALSE
openrest,1.3.316,1.3.317,320,1,1,1,2,1,FALSE
openrest,1.3.311,1.3.312,315,1,1,1,2,1,FALSE
openrest,1.3.310,1.3.311,314,1,1,1,2,1,FALSE
openrest,1.3.313,1.3.314,317,1,1,1,2,1,FALSE
openrest,1.3.312,1.3.313,316,1,1,1,2,1,FALSE
openrest,1.3.269,1.3.270,273,1,1,1,2,1,FALSE
openrest,1.3.268,1.3.269,272,1,1,1,2,1,FALSE
openrest,1.3.380,1.3.381,384,1,1,1,2,1,FALSE
openrest,1.3.381,1.3.382,385,1,3,0,3,1,FALSE
openrest,1.3.386,1.3.387,390,1,1,1,2,1,FALSE
openrest,1.3.387,1.3.388,391,1,1,1,2,1,FALSE
openrest,1.3.384,1.3.385,388,1,1,1,2,1,FALSE
openrest,1.3.385,1.3.386,389,1,1,1,2,1,FALSE
openrest,1.3.261,1.3.262,265,1,1,1,2,1,FALSE
openrest,1.3.260,1.3.261,264,1,1,1,2,1,FALSE
openrest,1.3.388,1.3.389,392,1,1,1,2,1,FALSE
openrest,1.3.389,1.3.390,393,1,1,1,2,1,FALSE
openrest,1.3.265,1.3.266,269,1,1,1,2,1,FALSE
openrest,1.3.264,1.3.265,268,1,1,1,2,1,FALSE
openrest,1.3.267,1.3.268,271,1,1,1,2,1,FALSE
openrest,1.3.266,1.3.267,270,1,1,1,2,1,FALSE
openrest,1.3.342,1.3.343,346,1,1,1,2,1,FALSE
openrest,1.3.343,1.3.344,347,1,1,1,2,1,FALSE
openrest,1.3.180,1.3.181,184,1,1,1,2,1,FALSE
openrest,1.3.181,1.3.182,185,1,1,1,2,1,FALSE
openrest,1.3.182,1.3.183,186,1,1,1,2,1,FALSE
openrest,1.3.183,1.3.184,187,1,1,1,2,1,FALSE
openrest,1.3.184,1.3.185,188,1,1,1,2,1,FALSE
openrest,1.3.185,1.3.186,189,1,1,1,2,1,FALSE
openrest,1.3.186,1.3.187,190,1,1,1,2,1,FALSE
openrest,1.3.187,1.3.188,191,1,1,1,2,1,FALSE
openrest,1.3.188,1.3.189,192,1,1,1,2,1,FALSE
openrest,1.3.189,1.3.190,193,1,1,1,2,1,FALSE
openrest,1.3.348,1.3.349,352,1,1,1,2,1,FALSE
openrest,1.3.349,1.3.350,353,1,1,1,2,1,FALSE
openrest,1.3.3,1.3.4,7,6,126,12,138,11,FALSE
openrest,1.3.2,1.3.3,6,4,102,4,106,4,FALSE
openrest,1.3.137,1.3.138,141,1,1,1,2,1,FALSE
openrest,1.3.136,1.3.137,140,1,1,1,2,1,FALSE
openrest,1.3.7,1.3.8,11,1,10,126,136,5,FALSE
openrest,1.3.6,1.3.7,10,1,1,1,2,1,FALSE
openrest,1.3.5,1.3.6,9,1,1,1,2,1,FALSE
openrest,1.3.4,1.3.5,8,1,4,7,11,2,FALSE
openrest,1.3.9,1.3.10,13,1,1,0,1,1,FALSE
openrest,1.3.8,1.3.9,12,1,1,1,2,1,FALSE
openrest,1.3.139,1.3.140,143,1,1,1,2,1,FALSE
openrest,1.3.138,1.3.139,142,1,1,1,2,1,FALSE
openrest,1.3.441,1.3.442,445,1,1,1,2,1,FALSE
openrest,1.3.440,1.3.441,444,1,1,1,2,1,FALSE
openrest,1.3.443,1.3.444,447,1,1,1,2,1,FALSE
openrest,1.3.442,1.3.443,446,1,1,1,2,1,FALSE
openrest,1.3.445,1.3.446,449,1,1,1,2,1,FALSE
openrest,1.3.444,1.3.445,448,1,1,1,2,1,FALSE
openrest,1.3.447,1.3.448,451,1,1,1,2,1,FALSE
openrest,1.3.446,1.3.447,450,1,1,1,2,1,FALSE
openrest,1.3.449,1.3.450,453,1,1,1,2,1,FALSE
openrest,1.3.448,1.3.449,452,1,1,1,2,1,FALSE
openrest,1.3.428,1.3.429,432,1,1,1,2,1,FALSE
openrest,1.3.346,1.3.347,350,1,1,1,2,1,FALSE
openrest,1.3.347,1.3.348,351,1,1,1,2,1,FALSE
openrest,1.3.344,1.3.345,348,1,1,1,2,1,FALSE
openrest,1.3.345,1.3.346,349,1,1,1,2,1,FALSE
openrest,1.3.229,1.3.230,233,1,1,1,2,1,FALSE
openrest,1.3.228,1.3.229,232,1,1,1,2,1,FALSE
openrest,1.3.340,1.3.341,344,1,1,1,2,1,FALSE
openrest,1.3.341,1.3.342,345,1,1,1,2,1,FALSE
openrest,1.3.225,1.3.226,229,1,1,1,2,1,FALSE
openrest,1.3.224,1.3.225,228,1,1,1,2,1,FALSE
openrest,1.3.227,1.3.228,231,1,1,1,2,1,FALSE
openrest,1.3.226,1.3.227,230,1,1,1,2,1,FALSE
openrest,1.3.221,1.3.222,225,1,1,1,2,1,FALSE
openrest,1.3.220,1.3.221,224,1,1,1,2,1,FALSE
openrest,1.3.223,1.3.224,227,1,1,1,2,1,FALSE
openrest,1.3.222,1.3.223,226,1,1,1,2,1,FALSE
openrest,1.1.1,1.1.2,1,2,44,0,44,2,FALSE
openrest,1.1.2,1.2.0,2,4,128,35,163,8,FALSE
openrest,1.3.379,1.3.380,383,1,1,1,2,1,FALSE
openrest,1.3.297,1.3.298,301,1,1,1,2,1,TRUE
openrest,1.3.371,1.3.372,375,1,1,1,2,1,TRUE
openrest,1.3.337,1.3.338,341,1,1,1,2,1,TRUE
openrest,1.3.115,1.3.116,119,1,1,1,2,1,TRUE
openrest,1.3.206,1.3.207,210,1,1,1,2,1,TRUE
openrest,1.3.146,1.3.147,150,1,1,1,2,1,TRUE
openrest,1.3.397,1.3.398,401,1,1,1,2,1,TRUE
openrest,1.3.34,1.3.35,38,1,1,1,2,1,TRUE
openrest,1.3.49,1.3.50,53,1,1,1,2,1,TRUE
openrest,1.3.310,1.3.311,314,1,1,1,2,1,TRUE
openrest,1.3.180,1.3.181,184,1,1,1,2,1,TRUE
openrest,1.3.181,1.3.182,185,1,1,1,2,1,TRUE
openrest,1.3.127,1.3.128,131,1,1,1,2,1,TRUE
openrest,1.3.128,1.3.129,132,1,1,1,2,1,TRUE
openrest,1.3.57,1.3.58,61,1,1,1,2,1,TRUE
openrest,1.3.56,1.3.57,60,1,1,1,2,1,TRUE
openrest,1.3.55,1.3.56,59,1,1,1,2,1,TRUE
openrest,1.3.403,1.3.404,407,1,1,1,2,1,TRUE
openrest,1.3.52,1.3.53,56,1,1,1,2,1,TRUE
openrest,1.3.12,1.3.13,16,1,1,1,2,1,TRUE
openrest,1.3.17,1.3.18,21,1,1,1,2,1,TRUE
openrest,1.3.208,1.3.209,212,1,1,1,2,1,TRUE
openrest,1.3.140,1.3.141,144,1,1,1,2,1,TRUE
openrest,1.3.259,1.3.260,263,1,1,1,2,1,TRUE
openrest,1.3.373,1.3.374,377,1,1,1,2,1,TRUE
openrest,1.3.339,1.3.340,343,1,1,1,2,1,TRUE
openrest,1.3.338,1.3.339,342,1,1,1,2,1,TRUE
openrest,1.3.236,1.3.237,240,1,1,1,2,1,TRUE
openrest,1.3.209,1.3.210,213,1,1,1,2,1,TRUE
openrest,1.3.358,1.3.359,362,1,1,1,2,1,TRUE
openrest,1.3.269,1.3.270,273,1,1,1,2,1,TRUE
openrest,1.3.139,1.3.140,143,1,1,1,2,1,TRUE
openrest,1.3.340,1.3.341,344,1,1,1,2,1,TRUE
openrest,1.3.270,1.3.271,274,1,1,1,2,1,TRUE
openrest,1.3.84,1.3.85,88,1,1,1,2,1,TRUE
openrest,1.3.61,1.3.62,65,1,1,1,2,1,TRUE
openrest,1.3.10,1.3.11,14,1,1,1,2,1,TRUE
openrest,1.3.23,1.3.24,27,1,1,1,2,1,TRUE
openrest,1.3.111,1.3.112,115,1,1,1,2,1,TRUE
openrest,1.3.217,1.3.218,221,1,1,1,2,1,TRUE
openrest,1.3.311,1.3.312,315,1,1,1,2,1,TRUE
openrest,1.3.261,1.3.262,265,1,1,1,2,1,TRUE
openrest,1.3.183,1.3.184,187,1,1,1,2,1,TRUE
openrest,1.3.105,1.3.106,109,1,1,1,2,1,TRUE
bedrock-permission,1.1.1,1.1.2,6,3,16,4,20,5,FALSE
bedrock-permission,2.0.1,2.1.0,9,4,254,42,296,7,FALSE
bedrock-permission,2.0.0,2.0.1,8,3,10,7,17,4,FALSE
bedrock-permission,2.3.0,2.3.1,12,4,15,21,36,5,FALSE
bedrock-permission,2.3.1,2.3.2,13,4,19,14,33,6,FALSE
bedrock-permission,2.3.2,2.4.0,14,4,14,12,26,4,FALSE
bedrock-permission,2.2.0,2.3.0,11,3,33,3,36,5,FALSE
bedrock-permission,2.4.2,2.4.3,17,6,253,133,386,17,FALSE
bedrock-permission,2.1.0,2.2.0,10,3,27,4,31,6,FALSE
bedrock-permission,2.4.0,2.4.1,15,7,294,10,304,15,FALSE
bedrock-permission,2.4.1,2.4.2,16,5,18,10,28,5,TRUE
bedrock-permission,2.4.1,2.4.2,16,5,18,10,28,5,FALSE
bedrock-permission,0.1.0,1.0.0,2,6,237,31,268,7,FALSE
bedrock-permission,1.0.0,1.0.1,3,4,11,8,19,5,FALSE
bedrock-permission,1.0.1,1.1.0,4,6,107,19,126,9,FALSE
bedrock-permission,1.1.0,1.1.1,5,4,20,7,27,6,FALSE
unpack-stream,1.0.0,1.0.1,3,3,290,10,300,13,FALSE
unpack-stream,1.0.1,1.0.2,4,2,4,3,7,3,FALSE
unpack-stream,1.0.2,1.1.0,5,3,6,6,12,5,FALSE
unpack-stream,0.1.0,0.1.1,1,1,1,1,2,1,FALSE
unpack-stream,1.0.1,1.0.2,4,2,4,3,7,3,TRUE
unpack-stream,1.0.2,1.1.0,5,3,6,6,12,5,TRUE
ng-jwt,0.1.0,0.2.0,2,1,67,59,126,7,FALSE
ng-jwt,0.2.0,0.2.1,3,1,7371,0,7371,9,FALSE
ng-jwt,0.0.0,0.1.0,1,2,674,0,674,29,FALSE
ng-jwt,0.2.1,0.2.2,4,1,15,12,27,3,FALSE
ng-jwt,0.2.18,0.2.19,18,1,7371,0,7371,9,FALSE
ng-jwt,0.2.17,0.2.18,17,1,7371,0,7371,9,FALSE
ng-jwt,0.2.16,0.2.17,16,1,7371,0,7371,9,FALSE
ng-jwt,0.2.15,0.2.16,15,1,7371,0,7371,9,FALSE
ng-jwt,0.2.14,0.2.15,14,1,7371,0,7371,9,FALSE
ng-jwt,0.2.13,0.2.14,13,1,7371,0,7371,9,FALSE
ng-jwt,0.2.12,0.2.13,12,1,7371,0,7371,9,FALSE
ng-jwt,0.2.11,0.2.12,11,1,7371,0,7371,9,FALSE
ng-jwt,0.2.10,0.2.11,10,1,7371,0,7371,9,FALSE
ng-jwt,0.2.7,0.2.9,8,1,7371,0,7371,9,TRUE
ng-jwt,0.2.6,0.2.7,7,1,7371,0,7371,9,FALSE
ng-jwt,0.2.5,0.2.6,6,2,892,931,1823,40,FALSE
ng-jwt,0.2.2,0.2.5,5,1,7371,0,7371,9,TRUE
ng-jwt,0.2.9,0.2.10,9,1,7371,0,7371,9,FALSE
ng-jwt,0.2.7,0.2.9,8,1,7371,0,7371,9,FALSE
sir,1.1.0,1.2.0,14,3,44,10,54,9,FALSE
sir,1.0.1,1.1.0,13,3,250,230,480,7,FALSE
sir,2.0.0,2.1.0,30,1,3,59,62,7,FALSE
sir,0.2.2,0.3.0,8,1,14,2,16,2,FALSE
sir,0.1.0,0.1.1,6,1,6,3,9,3,FALSE
sir,0.1.1,0.2.2,7,8,237,145,382,19,FALSE
sir,0.0.5,0.0.6,4,2,16,8,24,3,TRUE
sir,0.0.4,0.0.5,3,2,7,4,11,3,FALSE
sir,0.0.6,0.1.0,5,3,136,47,183,12,FALSE
sir,0.0.1,0.0.2,1,2,2,0,2,2,FALSE
sir,0.0.2,0.0.4,2,9,1037,55,1092,446,FALSE
sir,0.3.0,0.3.1,9,1,1,6,7,3,FALSE
sir,0.3.1,0.4.1,10,3,81,3,84,5,FALSE
sir,1.6.0,1.7.0,27,3,2666,23,2689,13,FALSE
sir,0.4.1,0.4.2,11,1,178,179,357,4,FALSE
sir,0.4.2,1.0.1,12,26,2766,2286,5052,98,FALSE
sir,1.7.1,2.0.0,29,2,23,136,159,11,FALSE
sir,1.7.0,1.7.1,28,1,3,2,5,2,FALSE
sir,1.4.0,1.4.1,22,5,5,5,10,5,FALSE
sir,1.4.1,1.4.2,23,1,7,4,11,3,FALSE
sir,1.4.2,1.4.3,24,8,51,32,83,12,FALSE
sir,1.4.3,1.5.0,25,1,7,2,9,4,FALSE
sir,1.5.0,1.6.0,26,1,74,4,78,5,FALSE
sir,1.3.1,1.4.0,21,2,151,123,274,8,FALSE
sir,1.2.5,1.3.0,19,7,77,61,138,19,FALSE
sir,1.2.2,1.2.3,17,4,32,24,56,6,FALSE
sir,1.2.3,1.2.5,18,20,1471,3014,4485,258,FALSE
sir,1.2.0,1.2.1,15,2,12,10,22,6,FALSE
sir,1.2.1,1.2.2,16,5,264,250,514,5,FALSE
sir,1.3.0,1.3.1,20,4,26,44,70,6,FALSE
sir,0.0.5,0.0.6,4,2,16,8,24,3,FALSE
sir,0.0.4,0.0.5,3,2,7,4,11,3,TRUE
sir,0.0.6,0.1.0,5,3,136,47,183,12,TRUE
sir,1.2.2,1.2.3,17,4,32,24,56,6,TRUE
sir,1.2.1,1.2.2,16,5,264,250,514,5,TRUE
sir,1.5.0,1.6.0,26,1,74,4,78,5,TRUE
victory-chart,1.1.1,1.2.0,4,7,431,311,742,17,FALSE
victory-chart,2.0.3,2.0.4,11,3,104,130,234,9,FALSE
victory-chart,2.0.2,2.0.3,10,4,5037,1695,6732,9,FALSE
victory-chart,2.0.1,2.0.2,9,26,337334,106241,443575,148,FALSE
victory-chart,2.0.0,2.0.1,8,8,7055,57277,64332,18,TRUE
victory-chart,1.1.0,1.1.1,3,4,1837,95061,96898,10,FALSE
victory-chart,3.0.0,4.0.0,18,8,41423,33165,74588,26,FALSE
victory-chart,1.3.0,2.0.0,7,54,101183,27555,128738,133,FALSE
victory-chart,0.0.5,1.1.0,2,21,219986,30201,250187,54,FALSE
victory-chart,1.2.0,1.2.1,5,8,98828,2917,101745,16,FALSE
victory-chart,1.2.1,1.3.0,6,29,35495,129501,164996,53,TRUE
victory-chart,0.0.3,0.0.5,1,14,3306,72696,76002,36,FALSE
victory-chart,2.0.0,2.0.1,8,8,7055,57277,64332,18,FALSE
victory-chart,1.2.1,1.3.0,6,29,35495,129501,164996,53,FALSE
victory-chart,6.0.1,7.0.0,24,92,42619,33288,75907,592,FALSE
victory-chart,6.0.0,6.0.1,23,5,24856,24856,49712,7,FALSE
victory-chart,9.1.1,9.1.2,31,6,365,329,694,25,FALSE
victory-chart,9.1.0,9.1.1,30,7,2567,4993,7560,26,FALSE
victory-chart,9.1.3,9.2.0,33,27,12218,12660,24878,176,FALSE
victory-chart,9.1.2,9.1.3,32,10,2266,949,3215,24,FALSE
victory-chart,9.0.0,9.1.0,29,31,3028,1129,4157,182,FALSE
victory-chart,10.2.6,10.3.0,44,47,4387,2188,6575,158,FALSE
victory-chart,10.3.0,11.0.0,45,26,9118,7209,16327,205,FALSE
victory-chart,10.2.4,10.2.5,42,11,538,420,958,38,TRUE
victory-chart,10.2.3,10.2.4,41,5,9,5,14,6,FALSE
victory-chart,10.2.2,10.2.3,40,6,386,239,625,12,FALSE
victory-chart,10.2.1,10.2.2,39,5,10,6,16,6,TRUE
victory-chart,10.2.0,10.2.1,38,3,646,945,1591,5,FALSE
victory-chart,11.0.0,11.0.1,46,5,1629,1589,3218,6,FALSE
victory-chart,11.0.1,12.0.0,47,82,39390,25135,64525,476,FALSE
victory-chart,10.2.5,10.2.6,43,16,437,233,670,29,FALSE
victory-chart,5.0.0,5.0.1,20,17,15049,32359,47408,91,FALSE
victory-chart,5.0.2,6.0.0,22,38,25600,13550,39150,389,FALSE
victory-chart,7.0.2,8.0.0,27,65,14482,16915,31397,497,FALSE
victory-chart,5.0.1,5.0.2,21,21,1125,1625,2750,58,FALSE
victory-chart,7.0.0,7.0.1,25,4,13,4,17,5,FALSE
victory-chart,7.0.1,7.0.2,26,4,48,21,69,9,FALSE
victory-chart,8.0.0,9.0.0,28,64,41645,40165,81810,366,FALSE
victory-chart,10.1.0,10.2.0,37,115,62368,52523,114891,764,FALSE
victory-chart,10.0.0,10.1.0,36,33,86857,92972,179829,291,FALSE
victory-chart,12.0.0,12.0.1,48,16,10124,10935,21059,59,FALSE
victory-chart,9.2.0,9.2.1,34,71,17388,10548,27936,340,FALSE
victory-chart,9.2.1,10.0.0,35,50,55964,43895,99859,294,FALSE
victory-chart,13.2.4,14.0.0,60,5,25,27,52,7,FALSE
victory-chart,13.2.0,13.2.1,56,4,9,7,16,4,FALSE
victory-chart,13.2.1,13.2.2,57,4,32,18,50,5,FALSE
victory-chart,13.2.2,13.2.3,58,6,107,80,187,8,FALSE
victory-chart,13.2.3,13.2.4,59,5,112,72,184,9,FALSE
victory-chart,14.0.1,14.0.2,62,6,337,107,444,9,FALSE
victory-chart,14.0.0,14.0.1,61,4,23,45,68,18,FALSE
victory-chart,16.0.1,16.1.0,69,6,1346,1024,2370,30,FALSE
victory-chart,16.0.0,16.0.1,68,4,10,5,15,6,FALSE
victory-chart,13.0.2,13.0.3,52,8,8353,13763,22116,26,FALSE
victory-chart,13.0.3,13.1.0,53,13,341,49004,49345,44,FALSE
victory-chart,13.0.0,13.0.1,50,10,118,105,223,14,FALSE
victory-chart,13.0.1,13.0.2,51,8,17026,11486,28512,10,FALSE
victory-chart,16.1.2,17.0.0,72,51,3528,1676,5204,271,FALSE
victory-chart,16.1.0,16.1.1,70,3,11,3,14,5,FALSE
victory-chart,4.0.0,5.0.0,19,76,30505,34127,64632,518,FALSE
victory-chart,10.2.4,10.2.5,42,11,538,420,958,38,FALSE
victory-chart,10.2.1,10.2.2,39,5,10,6,16,6,FALSE
victory-chart,19.1.0,19.1.1,84,4,7,1,8,4,FALSE
victory-chart,19.1.1,20.0.0,85,23,1553,589,2142,126,FALSE
victory-chart,15.0.0,15.0.1,66,4,7,3,10,4,FALSE
victory-chart,15.0.1,16.0.0,67,41,4796,3276,8072,230,FALSE
victory-chart,17.0.0,17.0.1,73,4,8,3,11,4,FALSE
victory-chart,18.1.0,18.1.1,76,4,31,21,52,4,FALSE
victory-chart,18.1.1,18.1.2,77,7,65,24,89,17,FALSE
victory-chart,18.1.2,18.1.3,78,6,87,68,155,20,FALSE
victory-chart,18.1.3,18.1.4,79,17,235,151,386,55,FALSE
victory-chart,18.1.4,18.2.0,80,30,1966,590,2556,124,FALSE
victory-chart,18.0.0,18.1.0,75,11,203,722,925,37,FALSE
victory-chart,16.1.1,16.1.2,71,5,34,21,55,7,FALSE
victory-chart,13.1.1,13.2.0,55,20,1295,24864,26159,50,FALSE
victory-chart,13.1.0,13.1.1,54,6,97,122,219,14,TRUE
victory-chart,18.2.1,19.0.0,82,18,2700,5667,8367,174,FALSE
victory-chart,18.2.0,18.2.1,81,11,1337,232,1569,50,FALSE
victory-chart,17.0.1,18.0.0,74,15,458,229,687,36,FALSE
victory-chart,14.0.4,15.0.0,65,15,1570,716,2286,72,FALSE
victory-chart,19.0.0,19.1.0,83,27,2759,594,3353,145,FALSE
victory-chart,14.0.3,14.0.4,64,4,89,21,110,6,FALSE
victory-chart,14.0.2,14.0.3,63,4,345,3,348,8,FALSE
victory-chart,12.0.1,13.0.0,49,60,23343,43873,67216,473,FALSE
victory-chart,10.1.0,10.2.0,37,115,62368,52523,114891,764,TRUE
victory-chart,13.1.0,13.1.1,54,6,97,122,219,14,FALSE
victory-chart,2.0.4,2.1.0,12,18,23807,283478,307285,51,FALSE
victory-chart,2.2.0,3.0.0,17,9,27608,21461,49069,14,FALSE
victory-chart,2.1.2,2.1.3,15,2,2360,4489,6849,6,FALSE
victory-chart,2.1.3,2.2.0,16,44,6333,8604,14937,109,FALSE
victory-chart,2.1.0,2.1.1,13,3,65,67,132,5,FALSE
victory-chart,2.1.1,2.1.2,14,10,334,158,492,16,FALSE
victory-chart,19.1.1,20.0.0,85,23,1553,589,2142,126,TRUE
victory-chart,2.2.0,3.0.0,17,9,27608,21461,49069,14,TRUE
victory-chart,18.1.3,18.1.4,79,17,235,151,386,55,TRUE
victory-chart,13.0.0,13.0.1,50,10,118,105,223,14,TRUE
victory-chart,18.1.0,18.1.1,76,4,31,21,52,4,TRUE
victory-chart,19.0.0,19.1.0,83,27,2759,594,3353,145,TRUE
victory-chart,2.1.1,2.1.2,14,10,334,158,492,16,TRUE
systemjs-server,1.1.1,1.1.2,6,1,169,12,181,9,FALSE
systemjs-server,1.1.0,1.1.1,5,1,169,12,181,9,FALSE
systemjs-server,1.1.3,1.1.4,8,1,169,12,181,9,FALSE
systemjs-server,1.1.2,1.1.3,7,1,169,12,181,9,FALSE
systemjs-server,1.0.1,1.0.2,2,1,169,12,181,9,FALSE
systemjs-server,1.0.2,1.0.3,3,1,169,12,181,9,FALSE
systemjs-server,1.0.3,1.1.0,4,1,76,0,76,6,FALSE
systemjs-server,1.1.9,1.1.10,14,1,169,12,181,9,FALSE
systemjs-server,1.1.8,1.1.9,13,1,169,12,181,9,FALSE
systemjs-server,1.1.54,1.1.55,58,1,169,12,181,9,FALSE
systemjs-server,1.1.60,1.1.61,64,1,169,12,181,9,FALSE
systemjs-server,1.1.72,1.1.73,76,1,169,12,181,9,FALSE
systemjs-server,1.1.5,1.1.6,10,1,169,12,181,9,FALSE
systemjs-server,1.1.49,1.1.50,53,1,169,12,181,9,FALSE
systemjs-server,1.1.4,1.1.5,9,3,8605,46,8651,63,FALSE
systemjs-server,1.1.24,1.1.25,28,1,169,12,181,9,FALSE
systemjs-server,1.1.25,1.1.26,29,1,169,12,181,9,FALSE
systemjs-server,1.1.26,1.1.27,30,1,169,12,181,9,FALSE
systemjs-server,1.1.27,1.1.28,31,1,169,12,181,9,FALSE
systemjs-server,1.1.20,1.1.21,24,1,169,12,181,9,FALSE
systemjs-server,1.1.7,1.1.8,12,1,169,12,181,9,FALSE
systemjs-server,1.1.22,1.1.23,26,1,169,12,181,9,FALSE
systemjs-server,1.1.23,1.1.24,27,1,277,225,502,22,FALSE
systemjs-server,1.1.6,1.1.7,11,1,169,12,181,9,FALSE
systemjs-server,1.1.28,1.1.29,32,1,169,12,181,9,FALSE
systemjs-server,1.1.29,1.1.30,33,1,169,12,181,9,FALSE
systemjs-server,1.1.46,1.1.47,50,1,169,12,181,9,FALSE
systemjs-server,1.1.61,1.1.62,65,1,169,12,181,9,FALSE
systemjs-server,1.1.44,1.1.45,48,1,169,12,181,9,FALSE
systemjs-server,1.1.45,1.1.46,49,1,169,12,181,9,FALSE
systemjs-server,1.1.64,1.1.65,68,1,169,12,181,9,FALSE
systemjs-server,1.1.65,1.1.66,69,1,169,12,181,9,FALSE
systemjs-server,1.1.40,1.1.41,44,1,169,12,181,9,FALSE
systemjs-server,1.1.41,1.1.42,45,1,169,12,181,9,FALSE
systemjs-server,1.1.68,1.1.69,72,1,169,12,181,9,FALSE
systemjs-server,1.1.42,1.1.43,46,1,169,12,181,9,FALSE
systemjs-server,1.1.62,1.1.63,66,1,169,12,181,9,FALSE
systemjs-server,1.1.71,1.1.72,75,1,169,12,181,9,FALSE
systemjs-server,1.1.48,1.1.49,52,1,169,12,181,9,FALSE
systemjs-server,1.1.43,1.1.44,47,1,169,12,181,9,FALSE
systemjs-server,1.1.66,1.1.67,70,1,169,12,181,9,FALSE
systemjs-server,1.1.67,1.1.68,71,1,169,12,181,9,FALSE
systemjs-server,1.1.47,1.1.48,51,1,169,12,181,9,FALSE
systemjs-server,1.1.52,1.1.53,56,1,169,12,181,9,FALSE
systemjs-server,1.1.69,1.1.70,73,1,169,12,181,9,TRUE
systemjs-server,1.1.63,1.1.64,67,1,169,12,181,9,FALSE
systemjs-server,1.1.21,1.1.22,25,1,169,12,181,9,FALSE
systemjs-server,1.1.33,1.1.34,37,1,169,12,181,9,FALSE
systemjs-server,1.1.32,1.1.33,36,1,169,12,181,9,FALSE
systemjs-server,1.1.31,1.1.32,35,1,169,12,181,9,FALSE
systemjs-server,1.1.30,1.1.31,34,1,169,12,181,9,FALSE
systemjs-server,1.1.37,1.1.38,41,1,169,12,181,9,FALSE
systemjs-server,1.1.36,1.1.37,40,1,169,12,181,9,FALSE
systemjs-server,1.1.35,1.1.36,39,1,169,12,181,9,FALSE
systemjs-server,1.1.34,1.1.35,38,1,169,12,181,9,FALSE
systemjs-server,1.1.59,1.1.60,63,1,169,12,181,9,FALSE
systemjs-server,1.1.39,1.1.40,43,1,169,12,181,9,FALSE
systemjs-server,1.1.38,1.1.39,42,1,169,12,181,9,FALSE
systemjs-server,1.1.55,1.1.56,59,1,169,12,181,9,FALSE
systemjs-server,1.1.58,1.1.59,62,1,169,12,181,9,FALSE
systemjs-server,1.1.19,1.1.20,23,1,169,12,181,9,FALSE
systemjs-server,1.1.18,1.1.19,22,1,169,12,181,9,FALSE
systemjs-server,1.1.57,1.1.58,61,1,169,12,181,9,FALSE
systemjs-server,1.1.56,1.1.57,60,1,169,12,181,9,FALSE
systemjs-server,1.1.51,1.1.52,55,1,169,12,181,9,FALSE
systemjs-server,1.1.50,1.1.51,54,1,169,12,181,9,FALSE
systemjs-server,1.1.53,1.1.54,57,1,169,12,181,9,FALSE
systemjs-server,1.1.16,1.1.17,20,1,169,12,181,9,FALSE
systemjs-server,1.1.10,1.1.12,15,1,169,12,181,9,FALSE
systemjs-server,1.1.13,1.1.14,17,1,169,12,181,9,FALSE
systemjs-server,1.1.12,1.1.13,16,1,169,12,181,9,FALSE
systemjs-server,1.1.15,1.1.16,19,1,169,12,181,9,FALSE
systemjs-server,1.1.14,1.1.15,18,1,169,12,181,9,FALSE
systemjs-server,1.1.17,1.1.18,21,1,169,12,181,9,FALSE
systemjs-server,1.1.70,1.1.71,74,1,169,12,181,9,FALSE
systemjs-server,1.1.69,1.1.70,73,1,169,12,181,9,FALSE
systemjs-server,1.1.3,1.1.4,8,1,169,12,181,9,TRUE
systemjs-server,1.0.3,1.1.0,4,1,76,0,76,6,TRUE
systemjs-server,1.1.4,1.1.5,9,3,8605,46,8651,63,TRUE
systemjs-server,1.1.24,1.1.25,28,1,169,12,181,9,TRUE
systemjs-server,1.1.27,1.1.28,31,1,169,12,181,9,TRUE
systemjs-server,1.1.33,1.1.34,37,1,169,12,181,9,TRUE
systemjs-server,1.1.32,1.1.33,36,1,169,12,181,9,TRUE
react-folder-tree,1.0.4,1.0.5,7,1,8,6,14,3,FALSE
react-folder-tree,1.0.5,1.0.6,8,1,8,6,14,3,FALSE
react-folder-tree,1.0.6,1.0.7,9,1,338,35,373,8,FALSE
react-folder-tree,1.0.7,1.1.0,10,1,8,6,14,3,FALSE
react-folder-tree,1.0.0,1.0.1,3,1,8,6,14,3,FALSE
react-folder-tree,1.0.1,1.0.2,4,1,8,6,14,3,FALSE
react-folder-tree,1.0.2,1.0.3,5,1,8,6,14,3,FALSE
react-folder-tree,1.0.3,1.0.4,6,1,8,6,14,3,FALSE
react-folder-tree,1.2.1,1.2.2,18,1,8,6,14,3,FALSE
react-folder-tree,1.1.3,1.1.5,14,1,8,6,14,3,FALSE
react-folder-tree,1.1.2,1.1.3,13,1,8,6,14,3,FALSE
react-folder-tree,1.1.6,1.2.0,16,1,8,6,14,3,FALSE
react-folder-tree,0.2.0,1.0.0,2,1,8,6,14,3,FALSE
react-folder-tree,0.1.0,0.2.0,1,12,12570,1745972,1758542,20058,FALSE
react-folder-tree,1.1.5,1.1.6,15,1,172,167,339,3,FALSE
react-folder-tree,1.2.0,1.2.1,17,1,8,6,14,3,FALSE
react-folder-tree,1.4.0,2.0.0,31,10,204,83,287,33,FALSE
react-folder-tree,1.1.1,1.1.2,12,1,8,6,14,3,FALSE
react-folder-tree,1.3.3,1.3.4,24,1,8,6,14,3,FALSE
react-folder-tree,1.3.2,1.3.3,23,1,8,6,14,3,FALSE
react-folder-tree,1.3.1,1.3.2,22,1,8,6,14,3,FALSE
react-folder-tree,1.3.0,1.3.1,21,1,2908,16,2924,13,FALSE
react-folder-tree,1.2.2,1.2.3,19,1,8,6,14,3,FALSE
react-folder-tree,1.2.3,1.3.0,20,1,9,3,12,2,FALSE
react-folder-tree,1.3.5,1.3.6,26,5,325,243,568,19,FALSE
react-folder-tree,1.3.4,1.3.5,25,1,8,6,14,3,FALSE
react-folder-tree,1.1.0,1.1.1,11,1,17,4,21,3,FALSE
react-folder-tree,2.10.1,2.11.1,38,7,56,46,102,12,FALSE
react-folder-tree,2.10.0,2.10.1,37,2,4,4,8,4,FALSE
react-folder-tree,2.11.1,3.0.0,39,3,16,12,28,6,FALSE
react-folder-tree,2.0.0,2.5.0,32,39,3039,2298,5337,112,FALSE
react-folder-tree,1.3.8,1.3.9,29,4,35,26,61,4,FALSE
react-folder-tree,2.5.0,2.7.0,33,3,45,10,55,9,FALSE
react-folder-tree,2.9.0,2.10.0,36,26,6670,3646,10316,158,FALSE
react-folder-tree,2.7.0,2.8.0,34,1,35,8,43,3,FALSE
react-folder-tree,2.8.0,2.9.0,35,9,286,188,474,16,FALSE
react-folder-tree,1.3.7,1.3.8,28,45,3002,2365,5367,128,FALSE
react-folder-tree,1.3.6,1.3.7,27,24,1106,609,1715,64,FALSE
react-folder-tree,1.3.6,1.3.7,27,24,1106,609,1715,64,TRUE
react-folder-tree,1.3.5,1.3.6,26,5,325,243,568,19,TRUE
react-folder-tree,2.11.1,3.0.0,39,3,16,12,28,6,TRUE
react-folder-tree,2.10.1,2.11.1,38,7,56,46,102,12,TRUE
generic-website,0.1.0,0.1.1,2,27,744,257,1001,82,FALSE
generic-website,0.0.1,0.1.0,1,53,787,276,1063,119,TRUE
generic-website,0.0.1,0.1.0,1,53,787,276,1063,119,FALSE
react-native-media-queries,0.0.5,0.1.0,5,1,232,15,247,4,FALSE
react-native-media-queries,0.0.4,0.0.5,4,2,6,3,9,3,FALSE
react-native-media-queries,0.0.3,0.0.4,3,1,4,4,8,2,FALSE
react-native-media-queries,0.0.2,0.0.3,2,2,64,11,75,3,FALSE
react-native-media-queries,0.2.1,0.3.0,8,1,18,2,20,2,TRUE
react-native-media-queries,0.2.0,0.2.1,7,1,2,2,4,1,FALSE
react-native-media-queries,0.1.0,0.2.0,6,4,57,5,62,6,FALSE
react-native-media-queries,0.0.1,0.0.2,1,1,10,5,15,1,FALSE
react-native-media-queries,0.2.1,0.3.0,8,1,18,2,20,2,FALSE
react-native-media-queries,0.0.5,0.1.0,5,1,232,15,247,4,TRUE
mtwitter,1.0.0,1.0.1,1,2,88,54,142,7,FALSE
mtwitter,1.0.1,1.0.2,2,1,11,9,20,3,FALSE
mtwitter,1.0.2,1.0.3,3,7,991,898,1889,21,FALSE
mtwitter,1.5.1,1.5.2,18,1,4,4,8,1,FALSE
mtwitter,1.5.0,1.5.1,17,1,5,5,10,2,FALSE
mtwitter,1.5.3,1.6.0,20,4,29,14,43,6,FALSE
mtwitter,1.5.2,1.5.3,19,2,10,6,16,3,FALSE
mtwitter,1.6.2,1.6.3,23,1,4,4,8,1,FALSE
mtwitter,1.6.3,1.6.4,24,2,19,23,42,8,FALSE
mtwitter,1.6.0,1.6.1,21,1,46,28,74,3,FALSE
mtwitter,1.6.1,1.6.2,22,2,5,6,11,3,FALSE
mtwitter,1.4.0,1.4.1,11,1,4,4,8,3,FALSE
mtwitter,1.4.1,1.4.2,12,4,14,12,26,6,FALSE
mtwitter,1.4.2,1.4.3,13,1,4,4,8,1,FALSE
mtwitter,1.4.3,1.4.4,14,3,284,233,517,13,FALSE
mtwitter,1.4.4,1.4.5,15,1,6,6,12,3,FALSE
mtwitter,1.4.5,1.5.0,16,7,138,96,234,18,FALSE
mtwitter,1.3.2,1.3.3,7,1,2,2,4,1,FALSE
mtwitter,1.3.5,1.4.0,10,2,25,14,39,5,FALSE
mtwitter,1.3.4,1.3.5,9,2,162,38,200,8,FALSE
mtwitter,1.3.0,1.3.1,5,2,113,55,168,4,FALSE
mtwitter,1.3.1,1.3.2,6,1,31,91,122,4,FALSE
mtwitter,1.3.3,1.3.4,8,1,11,2,13,2,FALSE
mtwitter,1.3.2,1.3.3,7,1,2,2,4,1,TRUE
mtwitter,1.0.3,1.3.0,4,12,1229,1837,3066,45,FALSE
mtwitter,1.4.1,1.4.2,12,4,14,12,26,6,TRUE
mtwitter,1.5.3,1.6.0,20,4,29,14,43,6,TRUE
redux-vcr.replay,0.1.8,0.1.9,37,2,20,25,45,10,FALSE
redux-vcr.replay,0.1.9,0.1.10,38,1,20,20,40,8,FALSE
redux-vcr.replay,0.2.3,0.3.0,45,14,947,441,1388,79,FALSE
redux-vcr.replay,0.2.2,0.2.3,44,1,20,20,40,8,FALSE
redux-vcr.replay,0.0.39,0.0.40,25,2,7,9,16,6,FALSE
redux-vcr.replay,0.1.0,0.1.1,29,2,47,36,83,14,FALSE
redux-vcr.replay,0.1.1,0.1.2,30,1,28,18,46,8,FALSE
redux-vcr.replay,0.1.2,0.1.3,31,1,17,17,34,8,FALSE
redux-vcr.replay,0.1.3,0.1.4,32,4,8,38,46,5,FALSE
redux-vcr.replay,0.1.4,0.1.5,33,1,20,20,40,8,FALSE
redux-vcr.replay,0.1.5,0.1.6,34,1,20,20,40,8,FALSE
redux-vcr.replay,0.1.6,0.1.7,35,1,20,20,40,8,FALSE
redux-vcr.replay,0.1.7,0.1.8,36,4,157,151,308,45,FALSE
redux-vcr.replay,0.3.2,0.3.3,48,2,90,75,165,15,FALSE
redux-vcr.replay,0.3.0,0.3.1,46,2,160,51,211,12,FALSE
redux-vcr.replay,0.3.1,0.3.2,47,11,1093,623,1716,57,FALSE
redux-vcr.replay,0.0.42,0.1.0,28,2,120,16,136,11,FALSE
redux-vcr.replay,0.0.40,0.0.41,26,1,14,14,28,8,FALSE
redux-vcr.replay,0.0.41,0.0.42,27,3,106,20,126,12,FALSE
redux-vcr.replay,0.1.12,0.1.13,41,2,94,77,171,12,FALSE
redux-vcr.replay,0.1.13,0.1.14,42,2,62,22,84,12,FALSE
redux-vcr.replay,0.1.10,0.1.11,39,2,43,36,79,18,FALSE
redux-vcr.replay,0.1.11,0.1.12,40,2,19,17,36,9,FALSE
redux-vcr.replay,0.1.14,0.2.2,43,6,169,156,325,10,FALSE
redux-vcr.replay,0.0.1,0.0.2,1,6,1536,488,2024,98,FALSE
redux-vcr.replay,0.0.12,0.0.13,8,1,20,20,40,8,FALSE
redux-vcr.replay,0.0.14,0.0.23,10,1,33,28,61,10,FALSE
redux-vcr.replay,0.0.11,0.0.12,7,1,20,20,40,8,FALSE
redux-vcr.replay,0.0.10,0.0.11,6,15,1765,346,2111,100,FALSE
redux-vcr.replay,0.0.13,0.0.14,9,1,20,20,40,8,FALSE
redux-vcr.replay,0.0.38,0.0.39,24,8,572,143,715,27,FALSE
redux-vcr.replay,0.0.37,0.0.38,23,2,20,25,45,9,FALSE
redux-vcr.replay,0.0.35,0.0.36,21,3,45,21,66,35,FALSE
redux-vcr.replay,0.0.34,0.0.35,20,4,67,141,208,189,FALSE
redux-vcr.replay,0.0.33,0.0.34,19,14,2480,779,3259,92,FALSE
redux-vcr.replay,0.0.32,0.0.33,18,1,20,20,40,8,FALSE
redux-vcr.replay,0.0.31,0.0.32,17,1,107,54,161,16,FALSE
redux-vcr.replay,0.0.30,0.0.31,16,1,97,20,117,15,FALSE
redux-vcr.replay,0.0.5,0.0.6,4,5,149,62,211,16,FALSE
redux-vcr.replay,0.0.6,0.0.10,5,1,20,20,40,8,FALSE
redux-vcr.replay,0.0.3,0.0.5,3,5,196,18,214,14,FALSE
redux-vcr.replay,0.0.2,0.0.3,2,1,49,21,70,16,FALSE
redux-vcr.replay,0.0.23,0.0.26,11,7,497,145,642,30,FALSE
redux-vcr.replay,0.0.26,0.0.27,12,4,203,111,314,16,FALSE
redux-vcr.replay,0.0.27,0.0.28,13,2,214,44,258,17,FALSE
redux-vcr.replay,0.0.28,0.0.29,14,1,13,13,26,11,FALSE
redux-vcr.replay,0.0.29,0.0.30,15,16,959,592,1551,90,FALSE
redux-vcr.replay,0.0.36,0.0.37,22,15,779,525,1304,65,FALSE
redux-vcr.replay,0.0.33,0.0.34,19,14,2480,779,3259,92,TRUE
redux-vcr.replay,0.0.3,0.0.5,3,5,196,18,214,14,TRUE
redux-vcr.replay,0.1.3,0.1.4,32,4,8,38,46,5,TRUE
redux-vcr.replay,0.0.41,0.0.42,27,3,106,20,126,12,TRUE
redux-vcr.replay,0.0.36,0.0.37,22,15,779,525,1304,65,TRUE
redux-vcr.replay,0.0.42,0.1.0,28,2,120,16,136,11,TRUE
redux-vcr.replay,0.1.14,0.2.2,43,6,169,156,325,10,TRUE
redux-vcr.replay,0.0.38,0.0.39,24,8,572,143,715,27,TRUE
redux-vcr.replay,0.0.39,0.0.40,25,2,7,9,16,6,TRUE
wui-bigdata,0.2.7,0.2.8,25,3,187,155,342,20,FALSE
wui-bigdata,0.1.9,0.1.10,10,3,762,19,781,11,FALSE
wui-bigdata,0.2.5,0.2.6,23,3,2,2,4,2,FALSE
wui-bigdata,0.2.4,0.2.5,22,3,2,2,4,3,FALSE
wui-bigdata,0.2.3,0.2.4,21,3,7,1,8,3,FALSE
wui-bigdata,0.2.0,0.2.3,20,9,179,92,271,14,FALSE
wui-bigdata,0.1.5,0.1.6,6,3,287,31,318,11,FALSE
wui-bigdata,0.1.6,0.1.7,7,5,1337,100,1437,19,FALSE
wui-bigdata,0.1.7,0.1.8,8,3,5,7,12,5,FALSE
wui-bigdata,0.2.6,0.2.7,24,3,3,2,5,3,FALSE
wui-bigdata,0.2.8,0.2.9,26,1,3,3,6,1,FALSE
wui-bigdata,0.1.12,0.1.13,13,1,3,3,6,1,FALSE
wui-bigdata,0.1.13,0.1.14,14,1,3,3,6,1,FALSE
wui-bigdata,0.1.10,0.1.11,11,3,561,121,682,14,FALSE
wui-bigdata,0.1.11,0.1.12,12,3,11537,94,11631,9,FALSE
wui-bigdata,0.1.16,0.1.17,17,3,49,10,59,2,FALSE
wui-bigdata,0.1.17,0.1.18,18,3,265,16,281,11,FALSE
wui-bigdata,0.1.14,0.1.15,15,3,78,11425,11503,9,FALSE
wui-bigdata,0.1.15,0.1.16,16,3,2,2,4,2,FALSE
wui-bigdata,0.1.18,0.2.0,19,3,170,85,255,7,FALSE
wui-bigdata,0.1.8,0.1.9,9,3,649,17,666,13,FALSE
wui-bigdata,0.1.0,0.1.1,1,1,3,3,6,1,FALSE
wui-bigdata,0.1.1,0.1.2,2,4,1049,188,1237,26,FALSE
wui-bigdata,0.1.2,0.1.3,3,2,1,1,2,1,FALSE
wui-bigdata,0.1.3,0.1.4,4,5,282,89,371,18,FALSE
wui-bigdata,0.1.4,0.1.5,5,3,9678,23,9701,8,FALSE
wui-bigdata,0.1.18,0.2.0,19,3,170,85,255,7,TRUE
wui-bigdata,0.2.8,0.2.9,26,1,3,3,6,1,TRUE
wui-bigdata,0.1.10,0.1.11,11,3,561,121,682,14,TRUE
tune-reporting,1.0.4,1.0.5,28,1,453,161,614,14,FALSE
tune-reporting,1.0.5,1.0.6,29,1,453,161,614,14,FALSE
tune-reporting,1.0.6,1.0.7,30,1,453,161,614,14,FALSE
tune-reporting,1.0.7,1.0.8,31,3,163,169,332,53,FALSE
tune-reporting,1.0.0,1.0.1,24,1,453,161,614,14,FALSE
tune-reporting,1.0.1,1.0.2,25,2,902,816,1718,58,FALSE
tune-reporting,1.0.2,1.0.3,26,1,453,161,614,14,FALSE
tune-reporting,1.0.3,1.0.4,27,1,453,161,614,14,FALSE
tune-reporting,0.1.20,0.9.0,19,2,342,178,520,32,FALSE
tune-reporting,1.0.8,1.0.9,32,2,12,1108,1120,6,FALSE
tune-reporting,1.0.9,1.0.10,33,71,2325,1445,3770,238,FALSE
tune-reporting,0.1.19,0.1.20,18,2,14,10,24,6,FALSE
tune-reporting,0.9.2,0.9.3,22,2,348,152,500,36,FALSE
tune-reporting,0.9.1,0.9.2,21,4,28,30,58,10,FALSE
tune-reporting,0.9.3,1.0.0,23,11,4652,3542,8194,83,FALSE
tune-reporting,0.9.0,0.9.1,20,4,52,28,80,14,FALSE
tune-reporting,1.0.10,1.0.11,34,4,160,1948,2108,78,FALSE
tune-reporting,0.1.20,0.9.0,19,2,342,178,520,32,TRUE
tune-reporting,0.1.16,0.1.17,15,3,821,673,1494,118,FALSE
tune-reporting,0.1.17,0.1.18,16,3,2579,863,3442,126,FALSE
tune-reporting,0.1.14,0.1.15,13,1,341,3775,4116,45,FALSE
tune-reporting,0.1.15,0.1.16,14,3,6953,3785,10738,73,FALSE
tune-reporting,0.1.18,0.1.19,17,2,1798,1826,3624,72,FALSE
tune-reporting,0.1.8,0.1.9,8,4,476,366,842,66,FALSE
tune-reporting,0.1.9,0.1.10,9,2,4732,4138,8870,56,FALSE
tune-reporting,0.1.0,0.1.1,1,1,453,161,614,14,FALSE
tune-reporting,0.1.1,0.1.2,2,1,13,15,28,2,FALSE
tune-reporting,0.1.2,0.1.3,3,3,79,31,110,6,FALSE
tune-reporting,0.1.3,0.1.5,4,8,3024,1212,4236,232,FALSE
tune-reporting,0.1.5,0.1.6,5,2,1088,1004,2092,88,FALSE
tune-reporting,0.1.6,0.1.7,6,2,348,200,548,54,FALSE
tune-reporting,0.1.7,0.1.8,7,2,1830,1792,3622,118,FALSE
tune-reporting,0.1.12,0.1.13,11,1,453,161,614,14,FALSE
tune-reporting,0.1.13,0.1.14,12,2,64,30,94,14,FALSE
tune-reporting,0.1.10,0.1.12,10,4,536,410,946,62,FALSE
tune-reporting,0.9.0,0.9.1,20,4,52,28,80,14,TRUE
tune-reporting,0.1.18,0.1.19,17,2,1798,1826,3624,72,TRUE
tune-reporting,1.0.0,1.0.1,24,1,453,161,614,14,TRUE
tune-reporting,0.1.8,0.1.9,8,4,476,366,842,66,TRUE
angular-grid,1.14.0,1.14.1,24,3,854,458,1312,10,FALSE
angular-grid,1.14.1,1.15.0,25,8,2185,975,3160,140,FALSE
angular-grid,1.15.1,1.16.0,27,5,3430,1338,4768,85,FALSE
angular-grid,1.15.0,1.15.1,26,10,571,122,693,47,FALSE
angular-grid,1.6.0,1.7.0,5,14,14479,12929,27408,182,FALSE
angular-grid,1.9.1,1.9.2,10,4,589,289,878,35,FALSE
angular-grid,1.9.0,1.9.1,9,1,12,12,24,8,FALSE
angular-grid,1.9.2,1.10.0,11,15,5778,2918,8696,202,FALSE
angular-grid,1.8.0,1.8.1,7,4,50,36,86,11,FALSE
angular-grid,1.8.1,1.9.0,8,18,92106,82649,174755,232,FALSE
angular-grid,1.7.0,1.8.0,6,23,2272,580,2852,186,FALSE
angular-grid,1.4.0,1.4.1,2,13,453,300,753,59,FALSE
angular-grid,1.4.1,1.5.0,3,27,4226,1964,6190,288,FALSE
angular-grid,1.5.0,1.6.0,4,21,2134,776,2910,113,FALSE
angular-grid,1.13.0,1.14.0,23,25,2624,1394,4018,218,FALSE
angular-grid,1.12.8,1.13.0,22,13,2038,1069,3107,77,FALSE
angular-grid,1.12.4,1.12.5,18,33,5509,3212,8721,278,FALSE
angular-grid,1.12.5,1.12.6,19,1,236,244,480,68,FALSE
angular-grid,1.12.6,1.12.7,20,8,2864,2169,5033,104,FALSE
angular-grid,1.12.7,1.12.8,21,3,185,83,268,18,FALSE
angular-grid,1.12.1,1.12.3,16,5,416,354,770,79,FALSE
angular-grid,1.12.3,1.12.4,17,14,1691,1264,2955,124,FALSE
angular-grid,1.11.1,1.12.1,15,45,12319,8347,20666,234,FALSE
angular-grid,1.11.0,1.11.1,14,2,16460,15760,32220,15,FALSE
angular-grid,1.10.0,1.10.1,12,4,53,67,120,10,FALSE
angular-grid,1.10.1,1.11.0,13,32,26590,23893,50483,430,FALSE
angular-grid,1.16.0,1.16.1,28,2,508,266,774,82,FALSE
angular-grid,1.12.4,1.12.5,18,33,5509,3212,8721,278,TRUE
angular-grid,1.12.1,1.12.3,16,5,416,354,770,79,TRUE
angular-grid,1.12.3,1.12.4,17,14,1691,1264,2955,124,TRUE
angular-grid,1.15.1,1.16.0,27,5,3430,1338,4768,85,TRUE
bdt,0.1.12,0.1.13,17,1,15,7,22,3,FALSE
bdt,0.1.13,0.1.14,18,5,79,39,118,5,FALSE
bdt,0.1.10,0.1.11,15,1,4,2,6,2,TRUE
bdt,0.1.11,0.1.12,16,1,2,2,4,2,FALSE
bdt,0.1.14,0.1.15,19,1,7,6,13,2,FALSE
bdt,0.1.8,0.1.9,13,2,2,2,4,2,FALSE
bdt,0.1.9,0.1.10,14,1,2,2,4,1,FALSE
bdt,0.1.0,0.1.1,6,1,5,2,7,1,FALSE
bdt,0.1.1,0.1.3,7,1,1,1,2,2,FALSE
bdt,0.1.3,0.1.4,8,1,2,2,4,1,FALSE
bdt,0.1.4,0.1.5,9,1,5,2,7,1,FALSE
bdt,0.1.5,0.1.6,10,3,3,3,6,3,FALSE
bdt,0.1.6,0.1.7,11,2,2,2,4,2,FALSE
bdt,0.1.7,0.1.8,12,1,2,2,4,1,FALSE
bdt,0.0.4,0.1.0,5,3,85,7,92,8,FALSE
bdt,0.1.10,0.1.11,15,1,4,2,6,2,FALSE
bdt,0.0.1,0.0.2,2,1,5,2,7,1,FALSE
bdt,0.0.3,0.0.4,4,1,5,2,7,1,FALSE
bdt,0.0.2,0.0.3,3,3,166,1061,1227,34,FALSE
bdt,0.1.9,0.1.10,14,1,2,2,4,1,TRUE
bdt,0.0.4,0.1.0,5,3,85,7,92,8,TRUE
regionsjs,0.2.5,0.2.6,5,2,2,2,4,2,FALSE
regionsjs,0.2.3,0.2.5,4,2,103,27,130,4,FALSE
regionsjs,0.2.2,0.2.3,3,1,2,2,4,2,FALSE
regionsjs,0.2.1,0.2.2,2,1,2,2,4,2,FALSE
regionsjs,0.2.0,0.2.1,1,1,13,12,25,3,FALSE
regionsjs,0.2.5,0.2.6,5,2,2,2,4,2,TRUE
stf-angular-select,1.0.4,1.0.5,23,1,1,1,2,1,FALSE
stf-angular-select,1.0.5,1.0.6,24,2,5,3,8,3,FALSE
stf-angular-select,1.0.6,1.0.7,25,1,9,2,11,1,FALSE
stf-angular-select,1.0.7,1.0.8,26,1,1,1,2,1,FALSE
stf-angular-select,1.0.0,1.0.1,19,1,7,4,11,2,FALSE
stf-angular-select,1.0.1,1.0.2,20,1,6,6,12,1,FALSE
stf-angular-select,1.0.2,1.0.3,21,1,4,4,8,2,FALSE
stf-angular-select,1.0.3,1.0.4,22,1,11,8,19,2,FALSE
stf-angular-select,1.1.9,1.1.10,54,1,3,3,6,2,FALSE
stf-angular-select,1.1.8,1.1.9,53,1,47,47,94,4,FALSE
stf-angular-select,1.0.8,1.0.9,27,2,20,14,34,4,FALSE
stf-angular-select,1.0.9,1.0.11,28,4,41,51,92,6,FALSE
stf-angular-select,1.1.2,1.1.3,47,1,59,12,71,3,FALSE
stf-angular-select,1.1.5,1.1.6,50,1,1,1,2,1,FALSE
stf-angular-select,0.8.16,0.8.17,16,1,9,2,11,2,FALSE
stf-angular-select,1.1.3,1.1.4,48,1,2,1,3,2,FALSE
stf-angular-select,1.1.4,1.1.5,49,1,226,46,272,6,FALSE
stf-angular-select,1.1.24,1.1.25,68,1,2,3,5,2,FALSE
stf-angular-select,1.1.25,1.1.26,69,2,18,3,21,3,FALSE
stf-angular-select,1.1.26,1.1.27,70,1,10,3,13,2,FALSE
stf-angular-select,1.1.27,1.1.28,71,1,4,2,6,4,FALSE
stf-angular-select,1.1.20,1.1.21,64,1,15,10,25,4,FALSE
stf-angular-select,0.8.18,1.0.0,18,4,84,39,123,6,FALSE
stf-angular-select,1.1.22,1.1.23,66,1,47,8,55,5,FALSE
stf-angular-select,1.1.23,1.1.24,67,1,2,2,4,2,FALSE
stf-angular-select,0.8.15,0.8.16,15,1,2,2,4,2,FALSE
stf-angular-select,0.8.14,0.8.15,14,1,1,4,5,2,FALSE
stf-angular-select,0.8.17,0.8.18,17,1,2,5,7,2,FALSE
stf-angular-select,1.1.6,1.1.7,51,1,1,1,2,1,FALSE
stf-angular-select,0.8.11,0.8.12,11,2,234,35,269,24,FALSE
stf-angular-select,1.1.29,1.1.30,73,2,9,8,17,4,FALSE
stf-angular-select,0.8.13,0.8.14,13,2,20,18,38,3,FALSE
stf-angular-select,0.8.12,0.8.13,12,1,2,2,4,2,FALSE
stf-angular-select,1.0.16,1.0.17,34,1,1,1,2,1,FALSE
stf-angular-select,1.0.17,1.0.18,35,3,63,54,117,5,FALSE
stf-angular-select,1.0.14,1.0.15,32,3,14,9,23,4,FALSE
stf-angular-select,1.0.15,1.0.16,33,1,1,1,2,1,FALSE
stf-angular-select,1.0.12,1.0.13,30,2,8,5,13,2,FALSE
stf-angular-select,1.0.13,1.0.14,31,2,116,41,157,6,FALSE
stf-angular-select,1.0.11,1.0.12,29,1,2,1,3,2,FALSE
stf-angular-select,1.0.18,1.0.20,36,2,4,4,8,3,FALSE
stf-angular-select,1.1.1,1.1.2,46,1,2,2,4,2,FALSE
stf-angular-select,0.8.9,0.8.11,10,1,3,1,4,2,FALSE
stf-angular-select,0.8.8,0.8.9,9,1,1,1,2,1,FALSE
stf-angular-select,0.8.5,0.8.6,6,2,2,2,4,2,FALSE
stf-angular-select,0.8.4,0.8.5,5,3,9,4,13,4,FALSE
stf-angular-select,0.8.7,0.8.8,8,3,41,7,48,7,FALSE
stf-angular-select,0.8.6,0.8.7,7,2,37,31,68,3,FALSE
stf-angular-select,0.8.1,0.8.2,2,5,278,374,652,38,FALSE
stf-angular-select,0.8.0,0.8.1,1,1,597,2,599,15,FALSE
stf-angular-select,0.8.3,0.8.4,4,2,17,2,19,5,FALSE
stf-angular-select,0.8.2,0.8.3,3,1,1,1,2,1,FALSE
stf-angular-select,1.0.199,1.1.0,44,5,21,18,39,8,FALSE
stf-angular-select,1.1.10,1.1.12,55,2,28,22,50,3,FALSE
stf-angular-select,1.1.12,1.1.13,56,1,5,1,6,2,FALSE
stf-angular-select,1.1.13,1.1.14,57,1,5,2,7,3,FALSE
stf-angular-select,1.1.21,1.1.22,65,1,2,2,4,2,FALSE
stf-angular-select,1.1.0,1.1.1,45,1,9,2,11,2,FALSE
stf-angular-select,1.1.31,1.1.32,75,1,5,3,8,2,FALSE
stf-angular-select,1.1.30,1.1.31,74,1,20,2,22,3,FALSE
stf-angular-select,1.1.28,1.1.29,72,1,9,8,17,4,FALSE
stf-angular-select,1.1.15,1.1.16,59,1,6,4,10,2,FALSE
stf-angular-select,1.1.14,1.1.15,58,1,28,4,32,3,FALSE
stf-angular-select,1.1.19,1.1.20,63,1,8,3,11,2,FALSE
stf-angular-select,1.1.18,1.1.19,62,1,22,2,24,3,FALSE
stf-angular-select,1.1.17,1.1.18,61,1,13,4,17,3,FALSE
stf-angular-select,1.1.7,1.1.8,52,1,1,1,2,1,FALSE
stf-angular-select,1.1.16,1.1.17,60,1,7,7,14,2,FALSE
stf-angular-select,1.0.25,1.0.26,42,1,1,1,2,1,FALSE
stf-angular-select,1.0.24,1.0.25,41,1,1,1,2,1,FALSE
stf-angular-select,1.0.23,1.0.24,40,1,1,1,2,1,FALSE
stf-angular-select,1.0.22,1.0.23,39,1,1,1,2,1,FALSE
stf-angular-select,1.0.21,1.0.22,38,1,5,3,8,2,FALSE
stf-angular-select,1.0.20,1.0.21,37,1,1,1,2,1,FALSE
stf-angular-select,1.1.22,1.1.23,66,1,47,8,55,5,TRUE
stf-angular-select,0.8.6,0.8.7,7,2,37,31,68,3,TRUE
stf-angular-select,0.8.18,1.0.0,18,4,84,39,123,6,TRUE
stf-angular-select,1.1.24,1.1.25,68,1,2,3,5,2,TRUE
stf-angular-select,1.1.25,1.1.26,69,2,18,3,21,3,TRUE
stf-angular-select,1.1.27,1.1.28,71,1,4,2,6,4,TRUE
stf-angular-select,1.1.20,1.1.21,64,1,15,10,25,4,TRUE
stf-angular-select,1.1.23,1.1.24,67,1,2,2,4,2,TRUE
stf-angular-select,1.1.29,1.1.30,73,2,9,8,17,4,TRUE
stf-angular-select,0.8.7,0.8.8,8,3,41,7,48,7,TRUE
stf-angular-select,1.1.31,1.1.32,75,1,5,3,8,2,TRUE
stf-angular-select,1.1.28,1.1.29,72,1,9,8,17,4,TRUE
nemo-runner,0.0.15,0.0.16,15,2,22,9,31,4,FALSE
nemo-runner,1.0.0-alpha.1,1.0.0-alpha.2,24,3,87,1031,1118,11,FALSE
nemo-runner,1.0.0-alpha.2,1.0.0-alpha.3,25,10,137,71,208,15,FALSE
nemo-runner,0.0.17,0.0.18,17,2,10,1,11,3,FALSE
nemo-runner,0.0.20,0.0.22,20,4,40,4,44,5,FALSE
nemo-runner,0.0.22,0.0.23,21,2,4,4,8,2,FALSE
nemo-runner,0.0.16,0.0.17,16,2,2,2,4,2,FALSE
nemo-runner,0.0.24,1.0.0-alpha.1,23,2,53,50,103,6,FALSE
nemo-runner,0.0.19,0.0.20,19,3,1056,366,1422,11,FALSE
nemo-runner,0.0.18,0.0.19,18,2,3,3,6,2,FALSE
nemo-runner,0.0.23,0.0.24,22,2,4,4,8,2,FALSE
nemo-runner,0.0.14,0.0.15,14,2,2,1,3,2,FALSE
nemo-runner,0.0.11,0.0.12,11,2,22,20,42,3,FALSE
nemo-runner,0.0.10,0.0.11,10,2,45,17,62,3,FALSE
nemo-runner,0.0.13,0.0.14,13,2,42,29,71,3,FALSE
nemo-runner,0.0.12,0.0.13,12,2,4,2,6,2,FALSE
nemo-runner,0.0.5,0.0.6,5,2,291,86,377,6,FALSE
nemo-runner,0.0.4,0.0.5,4,2,10,6,16,3,FALSE
nemo-runner,0.0.7,0.0.8,7,2,4,3,7,3,FALSE
nemo-runner,0.0.6,0.0.7,6,2,75,89,164,3,FALSE
nemo-runner,0.0.9,0.0.10,9,2,5,5,10,3,FALSE
nemo-runner,0.0.8,0.0.9,8,2,27,14,41,3,FALSE
nemo-runner,0.0.1,0.0.2,1,2,1,41,42,2,FALSE
nemo-runner,0.0.3,0.0.4,3,2,71,7,78,4,FALSE
nemo-runner,0.0.2,0.0.3,2,2,93,2,95,4,FALSE
nemo-runner,0.0.24,1.0.0-alpha.1,23,2,53,50,103,6,TRUE
lacona-phrase-digitstring,0.1.0,0.1.1,2,2,6,218,224,4,FALSE
lacona-phrase-digitstring,0.1.1,0.2.0,3,2,47,24,71,4,FALSE
lacona-phrase-digitstring,0.0.1,0.1.0,1,2,225,43,268,5,FALSE
lacona-phrase-digitstring,0.2.0,0.2.1,4,3,95,159,254,5,TRUE
lacona-phrase-digitstring,0.2.0,0.2.1,4,3,95,159,254,5,FALSE
react-addons-shallow-compare,15.5.0,15.5.1,51,34,9949,7143,17092,437,FALSE
react-addons-shallow-compare,15.5.0-alpha.0,15.5.0-rc.1,48,53,11117,6482,17599,410,FALSE
react-addons-shallow-compare,16.0.0-alpha.2,16.0.0-alpha.3,57,73,4214,2956,7170,232,FALSE
react-addons-shallow-compare,15.5.1,15.5.2,52,1,1,1,2,1,FALSE
react-addons-shallow-compare,15.5.0-rc.1,15.5.0-rc.2,49,7,96,217,313,18,FALSE
react-addons-shallow-compare,15.5.2,15.6.0-rc.1,53,216,26619,54836,81455,959,FALSE
react-addons-shallow-compare,16.0.0-alpha.0,16.0.0-alpha.2,56,104,5411,3952,9363,372,FALSE
react-addons-shallow-compare,16.0.0-alpha,16.0.0-alpha.0,55,98,5428,2697,8125,285,FALSE
react-addons-shallow-compare,15.4.2,15.5.0-alpha.0,47,461,91046,67579,158625,2911,FALSE
react-addons-shallow-compare,15.5.1,15.5.2,52,1,1,1,2,1,TRUE
react-close-on-escape,1.0.0,1.0.1,1,4,6,6,12,4,FALSE
react-close-on-escape,1.0.1,1.0.2,2,3,5,3,8,3,FALSE
react-close-on-escape,1.0.2,1.0.3,3,2,2,2,4,2,FALSE
react-close-on-escape,1.0.3,2.0.0,4,5,14,10,24,7,FALSE
react-close-on-escape,1.0.0,1.0.1,1,4,6,6,12,4,TRUE
primeng-custom-dev,1.0.4,1.0.5,2,1,2,2,4,1,FALSE
primeng-custom-dev,1.0.5,1.0.6,3,1,2,2,4,1,FALSE
primeng-custom-dev,1.0.6,1.0.7,4,1,2,2,4,1,FALSE
primeng-custom-dev,1.0.7,1.0.8,5,4,50,37,87,10,FALSE
primeng-custom-dev,1.0.2,1.0.4,1,3,104,50,154,5,FALSE
primeng-custom-dev,1.0.8,1.0.9,6,38,2924,2582,5506,171,FALSE
primeng-custom-dev,1.0.2,1.0.4,1,3,104,50,154,5,TRUE
primeng-custom-dev,1.0.8,1.0.9,6,38,2924,2582,5506,171,TRUE
google-maps-react,1.0.0,1.0.1,1,6,458,1393,1851,39,FALSE
google-maps-react,1.0.1,1.0.2,2,4,84,12,96,6,FALSE
google-maps-react,1.0.2,1.0.3,3,2,2,1,3,2,FALSE
google-maps-react,1.0.16,1.0.17,16,4,4,4,8,4,FALSE
google-maps-react,1.0.17,1.0.18,17,2,2,2,4,2,FALSE
google-maps-react,1.0.18,1.0.19,18,9,126,20,146,12,FALSE
google-maps-react,1.0.15,1.0.16,15,2,53,31,84,10,FALSE
google-maps-react,1.0.4,1.0.5,5,3,11,5,16,5,FALSE
google-maps-react,1.0.5,1.0.6,6,2,4,3,7,2,FALSE
google-maps-react,1.0.6,1.0.7,7,2,3,2,5,2,FALSE
google-maps-react,1.0.7,1.0.8,8,2,7,2,9,2,FALSE
google-maps-react,1.0.3,1.0.4,4,3,29,14,43,8,FALSE
google-maps-react,1.0.8,1.0.9,9,2,5,3,8,2,FALSE
google-maps-react,1.0.9,1.0.10,10,3,50,7,57,6,FALSE
google-maps-react,1.0.12,1.0.13,13,2,3,4,7,2,FALSE
google-maps-react,1.0.13,1.0.15,14,16,77,51,128,23,FALSE
google-maps-react,1.0.10,1.0.11,11,3,166,23,189,7,FALSE
google-maps-react,1.0.11,1.0.12,12,2,10,2,12,3,FALSE
google-maps-react,1.0.16,1.0.17,16,4,4,4,8,4,TRUE
google-maps-react,1.0.3,1.0.4,4,3,29,14,43,8,TRUE
google-maps-react,1.0.4,1.0.5,5,3,11,5,16,5,TRUE
iMemoized,1.1.1,1.1.2,15,2,32,35,67,11,FALSE
iMemoized,1.1.0,1.1.1,14,1,23,25,48,5,FALSE
iMemoized,1.1.3,1.1.4,17,1,1,0,1,1,FALSE
iMemoized,1.1.2,1.1.3,16,2,8,6,14,5,FALSE
iMemoized,1.1.5,1.1.6,19,2,1256,2,1258,8,FALSE
iMemoized,1.0.1,1.0.2,11,1,57,12,69,3,FALSE
iMemoized,1.1.7,1.1.8,21,2,20,1261,1281,10,FALSE
iMemoized,1.0.3,1.1.0,13,1,12,32,44,1,FALSE
iMemoized,1.1.6,1.1.7,20,3,9,14,23,5,FALSE
iMemoized,0.0.9,0.0.10,8,2,8,3,11,3,FALSE
iMemoized,0.0.7,0.0.8,6,3,41,16428,16469,8,FALSE
iMemoized,0.0.8,0.0.9,7,1,98,43,141,8,FALSE
iMemoized,0.0.5,0.0.6,4,9,197,54,251,23,FALSE
iMemoized,0.0.10,1.0.0,9,4,915,71,986,8,FALSE
iMemoized,0.0.6,0.0.7,5,1,51,15,66,6,FALSE
iMemoized,0.0.3,0.0.5,3,1,5,0,5,1,TRUE
iMemoized,1.0.2,1.0.3,12,4,115,49,164,9,FALSE
iMemoized,1.0.0,1.0.1,10,2,3,2,5,2,FALSE
iMemoized,1.1.4,1.1.5,18,2,201,1333,1534,11,FALSE
iMemoized,0.0.3,0.0.5,3,1,5,0,5,1,FALSE
iMemoized,0.0.6,0.0.7,5,1,51,15,66,6,TRUE
iMemoized,1.1.6,1.1.7,20,3,9,14,23,5,TRUE
mvn-artifact-filename,1.0.4,1.0.5,5,9,154,2517,2671,27,FALSE
mvn-artifact-filename,1.0.5,2.0.0,6,21,320,154,474,56,FALSE
mvn-artifact-filename,2.0.0,2.0.1,7,3,19,9,28,5,FALSE
mvn-artifact-filename,1.0.0,1.0.1,1,1,7,7,14,11,FALSE
mvn-artifact-filename,1.0.1,1.0.2,2,3,7146,228,7374,42,FALSE
mvn-artifact-filename,1.0.3,1.0.4,4,4,94,73,167,18,FALSE
mvn-artifact-filename,1.0.2,1.0.3,3,3,7193,259,7452,45,FALSE
mvn-artifact-filename,1.0.2,1.0.3,3,3,7193,259,7452,45,TRUE
extract-docs,1.4.0,1.5.0,6,2,29,91,120,7,FALSE
extract-docs,1.5.1,1.5.2,8,1,11,2,13,1,FALSE
extract-docs,1.5.0,1.5.1,7,1,3,3,6,3,FALSE
extract-docs,1.1.0,1.2.0,3,2,105,75,180,10,FALSE
extract-docs,1.0.0,1.0.1,1,4,45,38,83,8,FALSE
extract-docs,1.0.1,1.1.0,2,2,44,28,72,6,FALSE
extract-docs,1.3.0,1.4.0,5,2,4121,3120,7241,9,FALSE
extract-docs,1.2.0,1.3.0,4,2,22,7,29,5,FALSE
extract-docs,1.2.0,1.3.0,4,2,22,7,29,5,TRUE
extract-docs,1.1.0,1.2.0,3,2,105,75,180,10,TRUE
organism-react-popup,0.0.5,0.0.6,5,4,1579,1025,2604,29,FALSE
organism-react-popup,0.0.4,0.0.5,4,1,239,202,441,4,FALSE
organism-react-popup,0.0.7,0.0.8,7,3,7892,8126,16018,12,FALSE
organism-react-popup,0.0.6,0.0.7,6,1,36,14,50,4,FALSE
organism-react-popup,0.0.1,0.0.2,2,10,56671,493,57164,54,FALSE
organism-react-popup,0.0.0,0.0.1,1,1,6,5,11,2,FALSE
organism-react-popup,0.0.2,0.0.4,3,1,15,16,31,6,FALSE
organism-react-popup,0.0.9,0.0.10,9,4,848,491,1339,16,FALSE
organism-react-popup,0.0.8,0.0.9,8,1,61,51,112,8,FALSE
organism-react-popup,0.0.10,0.0.11,10,1,1103,848,1951,8,FALSE
organism-react-popup,0.0.6,0.0.7,6,1,36,14,50,4,TRUE
organism-react-popup,0.0.15,0.0.16,15,1,132,127,259,18,FALSE
organism-react-popup,0.0.14,0.0.15,14,1,1,3,4,1,FALSE
organism-react-popup,0.0.17,0.0.19,17,112,118664,65671,184335,640,FALSE
organism-react-popup,0.0.16,0.0.17,16,1,61,51,112,8,FALSE
organism-react-popup,0.0.11,0.0.12,11,9,2473,208,2681,32,FALSE
organism-react-popup,0.0.13,0.0.14,13,110,257224,116357,373581,567,FALSE
organism-react-popup,0.0.12,0.0.13,12,1,8946,3553,12499,9,FALSE
organism-react-popup,0.0.19,0.0.20,18,1,61,51,112,8,FALSE
organism-react-popup,0.0.20,0.0.21,19,39,13684,72168,85852,219,FALSE
organism-react-popup,0.0.17,0.0.19,17,112,118664,65671,184335,640,TRUE
react-redux-subdivide,0.0.1,0.0.2,1,1,1,1,2,1,FALSE
react-redux-subdivide,0.0.3,0.0.4,3,3,8,40,48,4,FALSE
react-redux-subdivide,0.0.2,0.0.3,2,2,46,3,49,3,FALSE
react-redux-subdivide,0.0.3,0.0.4,3,3,8,40,48,4,TRUE
larynx-sdk,1.0.4,1.0.5,5,2,2,2,4,2,FALSE
larynx-sdk,1.0.5,1.0.6,6,2,2,2,4,2,FALSE
larynx-sdk,1.0.6,1.0.7,7,2,11,11,22,3,FALSE
larynx-sdk,1.0.0,1.0.1,1,2,3,4,7,3,FALSE
larynx-sdk,1.0.1,1.0.2,2,2,3,2,5,2,FALSE
larynx-sdk,1.0.2,1.0.3,3,2,49,17,66,2,FALSE
larynx-sdk,1.0.3,1.0.4,4,2,6,2,8,3,FALSE
larynx-sdk,1.0.5,1.0.6,6,2,2,2,4,2,TRUE
larynx-sdk,1.0.0,1.0.1,1,2,3,4,7,3,TRUE
larynx-sdk,1.0.4,1.0.5,5,2,2,2,4,2,TRUE
larynx-sdk,1.0.6,1.0.7,7,2,11,11,22,3,TRUE
larynx-sdk,1.0.2,1.0.3,3,2,49,17,66,2,TRUE
nunjucks,0.1.0,0.1.1,8,3,13,6,19,4,FALSE
nunjucks,0.1.1,0.1.2,9,1,132,1,133,5,FALSE
nunjucks,0.1.2,0.1.3,10,7,603,77,680,16,FALSE
nunjucks,1.0.4,1.0.5,25,16,113,101,214,32,FALSE
nunjucks,1.0.5,1.0.6,26,19,478,283,761,55,FALSE
nunjucks,1.0.6,1.0.7,27,3,18,13,31,12,FALSE
nunjucks,1.0.7,1.1.0,28,26,1370,629,1999,101,FALSE
nunjucks,2.0.0,2.1.0,35,47,11306,7706,19012,99,FALSE
nunjucks,3.0.0,3.0.1,46,30,2896,1085,3981,65,FALSE
nunjucks,2.2.0,2.3.0,37,33,23896,9465,33361,71,FALSE
nunjucks,2.1.0,2.2.0,36,47,1150,432,1582,116,FALSE
nunjucks,2.3.0,2.4.0,38,135,22543,13072,35615,354,FALSE
nunjucks,1.3.3,1.3.4,33,6,124,15,139,7,FALSE
nunjucks,1.3.1,1.3.3,32,2,5,5,10,5,FALSE
nunjucks,1.3.0,1.3.1,31,6,38,27775,27813,60,FALSE
nunjucks,1.2.0,1.3.0,30,54,73488,1334,74822,496,FALSE
nunjucks,1.3.4,2.0.0,34,94,20291,13637,33928,284,FALSE
nunjucks,2.4.3,2.5.0,42,1,132,1,133,5,FALSE
nunjucks,2.4.2,2.4.3,41,50,1597,335,1932,152,FALSE
nunjucks,2.4.1,2.4.2,40,39,440,212,652,76,FALSE
nunjucks,2.4.0,2.4.1,39,31,1974,731,2705,133,FALSE
nunjucks,2.5.2,3.0.0,45,43,1035,357,1392,85,FALSE
nunjucks,2.5.0,2.5.1,43,3,90,43,133,11,FALSE
nunjucks,2.5.1,2.5.2,44,5,883,55,938,12,FALSE
nunjucks,1.1.0,1.2.0,29,32,773,263,1036,61,FALSE
nunjucks,1.0.0,1.0.1,21,33,402,98,500,44,FALSE
nunjucks,1.0.1,1.0.2,22,30,499,182,681,54,FALSE
nunjucks,1.0.2,1.0.3,23,9,46,7,53,11,FALSE
nunjucks,1.0.3,1.0.4,24,1,1,1,2,1,FALSE
nunjucks,0.1.4,0.1.5,13,27,5167,3503,8670,104,FALSE
nunjucks,0.1.5,0.1.6,14,17,241,68,309,31,FALSE
nunjucks,0.1.6,0.1.7,15,29,796,307,1103,77,FALSE
nunjucks,0.1.7,0.1.8-a,16,252,40776,19698,60474,819,FALSE
nunjucks,2.2.0,2.3.0,37,33,23896,9465,33361,71,TRUE
nunjucks,2.4.1,2.4.2,40,39,440,212,652,76,TRUE
nunjucks,0.1.9,0.1.10,19,66,14777,8058,22835,293,FALSE
nunjucks,0.1.10,1.0.0,20,47,7291,6144,13435,133,FALSE
nunjucks,2.0.0,2.1.0,35,47,11306,7706,19012,99,TRUE
nunjucks,0.1.8,0.1.9,18,72,15494,4594,20088,264,FALSE
nunjucks,3.0.0,3.0.1,46,30,2896,1085,3981,65,TRUE
ngcreate,0.3.2,0.4.0,2,3,367,267,634,14,FALSE
ngcreate,0.3.0,0.3.2,1,3,43,18,61,7,FALSE
ngcreate,0.5.4,0.5.5,9,2,5,3,8,5,FALSE
ngcreate,0.5.5,0.5.6,10,2,6,6,12,2,FALSE
ngcreate,0.4.1,0.5.0,4,2,328,70,398,22,FALSE
ngcreate,0.4.0,0.4.1,3,1,64,5,69,8,FALSE
ngcreate,0.5.0,0.5.1,5,1,3,3,6,2,FALSE
ngcreate,0.5.1,0.5.2,6,1,3,3,6,2,FALSE
ngcreate,0.5.2,0.5.3,7,2,2,2,4,9,FALSE
ngcreate,0.5.3,0.5.4,8,1,4,4,8,3,FALSE
ngcreate,0.4.1,0.5.0,4,2,328,70,398,22,TRUE
here-we-go,1.4.0,1.5.0,5,8,3089,3082,6171,12,FALSE
here-we-go,1.1.0,1.2.0,2,139,158932,225866,384798,606,FALSE
here-we-go,1.0.0,1.1.0,1,545,512929,568562,1081491,1847,FALSE
here-we-go,1.5.1,1.6.0,7,8,171,79,250,39,FALSE
here-we-go,1.5.0,1.5.1,6,9,653,690,1343,17,FALSE
here-we-go,1.6.0,1.6.1,8,5,8,42,50,8,FALSE
here-we-go,1.2.0,1.3.0,3,31,6771,7116,13887,238,FALSE
here-we-go,1.3.0,1.4.0,4,12,471,1108,1579,14,FALSE
here-we-go,1.2.0,1.3.0,3,31,6771,7116,13887,238,TRUE
here-we-go,1.3.0,1.4.0,4,12,471,1108,1579,14,TRUE
here-we-go,1.5.1,1.6.0,7,8,171,79,250,39,TRUE
octobus.js,0.14.5,0.14.6,33,6,234,765,999,10,FALSE
octobus.js,0.3.1,0.3.2,9,2,18,21,39,2,FALSE
octobus.js,0.31.0,0.31.1,62,1,29,27,56,5,FALSE
octobus.js,0.26.1,0.27.0,57,3,83,70,153,6,FALSE
octobus.js,0.2.1,0.3.0,7,2,31,17,48,4,FALSE
octobus.js,0.2.0,0.2.1,6,1,20,3,23,2,FALSE
octobus.js,0.1.1,0.1.2,3,1,1,1,2,1,FALSE
octobus.js,0.1.2,0.1.3,4,1,2,3,5,2,FALSE
octobus.js,0.1.3,0.2.0,5,5,90,27,117,10,FALSE
octobus.js,0.12.0,0.12.1,25,4,28,47,75,9,FALSE
octobus.js,0.10.1,0.10.2,21,1,2,3,5,2,FALSE
octobus.js,0.10.0,0.10.1,20,1,11,7,18,3,FALSE
octobus.js,0.10.2,0.11.0,22,2,34,17,51,5,FALSE
octobus.js,0.22.0,0.22.1,51,1,3,1,4,2,FALSE
octobus.js,0.3.2,0.4.0,10,7,267,119,386,13,FALSE
octobus.js,0.6.2,0.7.0,15,4,67,29,96,6,FALSE
octobus.js,0.3.0,0.3.1,8,1,2,1,3,2,FALSE
octobus.js,0.6.0,0.6.1,13,3,75,38,113,5,FALSE
octobus.js,0.11.0,0.11.1,23,1,3,2,5,2,FALSE
octobus.js,0.11.1,0.12.0,24,1,5,4,9,2,FALSE
octobus.js,0.7.0,0.7.1,16,1,788,1,789,2,FALSE
octobus.js,0.7.1,0.8.0,17,13,437,408,845,29,FALSE
octobus.js,0.24.0,0.25.0,54,3,102,4,106,10,FALSE
octobus.js,0.12.1,0.13.0,26,3,116,101,217,9,FALSE
octobus.js,0.17.1,0.18.0,43,7,268,70,338,25,FALSE
octobus.js,0.16.3,0.17.0,41,2,18,16,34,4,FALSE
octobus.js,0.16.2,0.16.3,40,2,53,28,81,4,FALSE
octobus.js,0.16.1,0.16.2,39,2,2,2,4,2,FALSE
octobus.js,0.16.0,0.16.1,38,6,157,86,243,10,FALSE
octobus.js,0.20.0,0.21.0,48,2,3,1,4,2,FALSE
octobus.js,0.23.0,0.24.0,53,5,336,287,623,14,FALSE
octobus.js,0.5.0,0.6.0,12,2,39,16,55,3,FALSE
octobus.js,0.13.0,0.14.0,27,3,17,24,41,8,FALSE
octobus.js,0.9.0,0.10.0,19,4,67,28,95,6,FALSE
octobus.js,0.14.4,0.14.5,32,1,2,2,4,2,FALSE
octobus.js,0.14.7,0.14.8,35,4,84,58,142,14,FALSE
octobus.js,0.14.6,0.14.7,34,4,39,6,45,7,FALSE
octobus.js,0.14.1,0.14.2,29,2,6,5,11,2,FALSE
octobus.js,0.14.0,0.14.1,28,1,5,4,9,2,FALSE
octobus.js,0.14.3,0.14.4,31,2,3,4,7,2,FALSE
octobus.js,0.22.1,0.23.0,52,2,25,20,45,4,FALSE
octobus.js,0.21.1,0.22.0,50,4,107,90,197,11,FALSE
octobus.js,0.21.0,0.21.1,49,2,5,2,7,2,FALSE
octobus.js,0.14.8,0.15.0,36,11,459,348,807,35,FALSE
octobus.js,0.25.0,0.26.0,55,2,9,5,14,3,FALSE
octobus.js,0.29.0,0.30.0,60,3,3962,60,4022,6,FALSE
octobus.js,0.4.0,0.5.0,11,5,98,60,158,7,FALSE
octobus.js,0.18.1,0.18.2,45,3,30,13,43,4,FALSE
octobus.js,0.18.0,0.18.1,44,2,9,9,18,4,FALSE
octobus.js,0.26.0,0.26.1,56,2,2,2,4,2,FALSE
octobus.js,0.18.2,0.19.0,46,2,60,4,64,3,FALSE
octobus.js,0.28.0,0.29.0,59,1,2,1,3,1,FALSE
octobus.js,0.17.0,0.17.1,42,2,4,4,8,3,FALSE
octobus.js,0.27.0,0.28.0,58,2,177,108,285,13,FALSE
octobus.js,0.19.0,0.20.0,47,23,2378,3797,6175,138,FALSE
octobus.js,0.14.2,0.14.3,30,1,9,2,11,2,FALSE
octobus.js,0.8.0,0.9.0,18,2,21,25,46,3,FALSE
octobus.js,0.30.0,0.31.0,61,2,57,54,111,3,FALSE
octobus.js,0.15.0,0.16.0,37,10,718,561,1279,28,FALSE
octobus.js,0.6.1,0.6.2,14,4,13,8,21,5,FALSE
octobus.js,0.6.0,0.6.1,13,3,75,38,113,5,TRUE
octobus.js,0.1.0,0.1.1,2,1,3,3,6,1,FALSE
octobus.js,0.1.3,0.2.0,5,5,90,27,117,10,TRUE
octobus.js,0.0.1,0.1.0,1,2,92,74,166,8,FALSE
octobus.js,0.14.6,0.14.7,34,4,39,6,45,7,TRUE
octobus.js,0.7.0,0.7.1,16,1,788,1,789,2,TRUE
octobus.js,0.3.2,0.4.0,10,7,267,119,386,13,TRUE
octobus.js,0.5.0,0.6.0,12,2,39,16,55,3,TRUE
angular2-elastic,0.9.0,0.10.0,1,5,108,12,120,10,TRUE
angular2-elastic,0.10.0,0.10.1,2,2,14,1,15,3,TRUE
angular2-elastic,0.10.1,0.11.0,3,2,20,16,36,5,FALSE
angular2-elastic,0.11.0,0.11.1,4,4,14,8,22,5,TRUE
angular2-elastic,0.11.1,0.12.0,5,1,17,15,32,4,FALSE
angular2-elastic,0.12.0,0.13.0,6,2,14,5,19,5,FALSE
angular2-elastic,0.9.0,0.10.0,1,5,108,12,120,10,FALSE
angular2-elastic,0.10.0,0.10.1,2,2,14,1,15,3,FALSE
angular2-elastic,0.11.0,0.11.1,4,4,14,8,22,5,FALSE
mt940-js,0.3.0,0.4.0,4,1,252,15,267,19,FALSE
mt940-js,0.2.0,0.3.0,3,6,53,25,78,13,FALSE
mt940-js,0.4.0,0.4.1,5,1,16,3,19,4,FALSE
mt940-js,0.1.0,0.1.1,1,4,60,5,65,6,FALSE
mt940-js,0.1.1,0.2.0,2,1,3878,2,3880,4,FALSE
mt940-js,0.3.0,0.4.0,4,1,252,15,267,19,TRUE
mt940-js,0.2.0,0.3.0,3,6,53,25,78,13,TRUE
mt940-js,0.4.0,0.4.1,5,1,16,3,19,4,TRUE
mt940-js,0.1.1,0.2.0,2,1,3878,2,3880,4,TRUE
pixi.js,3.0.6,3.0.7,32,69,29092,28797,57889,160,FALSE
pixi.js,3.0.7,3.0.8,33,162,47456,44996,92452,561,FALSE
pixi.js,3.0.4,3.0.5,30,7,1353,1355,2708,95,FALSE
pixi.js,3.0.5,3.0.6,31,33,5041,4906,9947,64,FALSE
pixi.js,3.0.2,3.0.3,28,30,8600,8414,17014,163,FALSE
pixi.js,3.0.3,3.0.4,29,34,1372,1522,2894,122,FALSE
pixi.js,3.0.1,3.0.2,27,26,2033,432,2465,54,FALSE
pixi.js,3.0.8,3.0.9,34,72,94201,90123,184324,159,FALSE
pixi.js,3.0.9,3.0.10,35,279,309743,307954,617697,1470,FALSE
pixi.js,3.0.0-rc3,3.0.0-rc4,24,55,13191,12613,25804,202,FALSE
pixi.js,4.0.1,4.0.2,41,36,45214,44238,89452,541,FALSE
pixi.js,4.0.0,4.0.1,40,33,48480,47987,96467,85,FALSE
pixi.js,4.0.3,4.1.0,43,148,12576,7282,19858,458,FALSE
pixi.js,4.0.2,4.0.3,42,77,67379,129373,196752,772,FALSE
pixi.js,4.1.0,4.1.1,44,58,23740,49683,73423,300,FALSE
pixi.js,4.1.1,4.2.1,45,75,29210,50910,80120,505,FALSE
pixi.js,4.3.4,4.3.5,53,59,3396,1341,4737,154,FALSE
pixi.js,3.0.10,3.0.11,36,138,67966,64601,132567,545,FALSE
pixi.js,3.0.11,4.0.0-rc3,37,323,99409,87101,186510,1238,FALSE
pixi.js,4.0.0-rc4,4.0.0,39,6,33699,29497,63196,253,FALSE
pixi.js,4.5.0,4.5.1,60,20,2593,2130,4723,62,FALSE
pixi.js,4.5.1,4.5.2,61,25,1659,693,2352,62,FALSE
pixi.js,4.4.4,4.5.0,59,15,4719,1629,6348,149,FALSE
pixi.js,4.0.0-rc3,4.0.0-rc4,38,64,54338,55280,109618,186,FALSE
pixi.js,4.4.1,4.4.2,56,11,429,101,530,31,FALSE
pixi.js,4.4.0,4.4.1,55,13,308,185,493,29,FALSE
pixi.js,4.4.3,4.4.4,58,12,1073,132,1205,31,FALSE
pixi.js,4.4.2,4.4.3,57,11,615,237,852,26,FALSE
pixi.js,4.2.3,4.3.0,48,33,810,243,1053,55,FALSE
pixi.js,4.2.2,4.2.3,47,11,155,125,280,31,FALSE
pixi.js,4.2.1,4.2.2,46,8,130,76,206,19,FALSE
pixi.js,4.3.5,4.4.0,54,31,4103,1430,5533,141,FALSE
pixi.js,4.3.2,4.3.3,51,15,805,188,993,31,FALSE
pixi.js,4.3.3,4.3.4,52,8,1026,712,1738,74,FALSE
pixi.js,4.3.0,4.3.1,49,40,2628,306,2934,126,FALSE
pixi.js,4.3.1,4.3.2,50,19,519,1013,1532,92,FALSE
pixi.js,3.0.2,3.0.3,28,30,8600,8414,17014,163,TRUE
pixi.js,4.4.3,4.4.4,58,12,1073,132,1205,31,TRUE
pixi.js,3.0.0,3.0.1,26,349,168106,367518,535624,1772,FALSE
pixi.js,3.0.0-rc1,3.0.0-rc2,22,33,45860,17597,63457,92,FALSE
pixi.js,3.0.0-rc2,3.0.0-rc3,23,99,9478,9184,18662,339,FALSE
pixi.js,2.0.0,2.1.0,10,87,10666,2630,13296,560,FALSE
pixi.js,2.2.5,2.2.6,17,196,59592,554021,613613,2071,FALSE
pixi.js,2.2.4,2.2.5,16,1,18,0,18,1,FALSE
pixi.js,2.2.7,2.2.8,19,211,54175,22931,77106,696,FALSE
pixi.js,2.2.6,2.2.7,18,1,241,90,331,5,FALSE
pixi.js,2.2.1,2.2.3,14,6,162,162,324,23,FALSE
pixi.js,2.2.0,2.2.1,13,63,10513,260427,270940,945,FALSE
pixi.js,2.2.3,2.2.4,15,187,18407,15907,34314,993,FALSE
pixi.js,2.1.0,2.1.1,11,4,59,37,96,13,FALSE
pixi.js,2.1.1,2.2.0,12,91,39723,26568,66291,490,FALSE
pixi.js,2.2.8,2.2.9,20,136,40526,44554,85080,402,FALSE
pixi.js,1.6.0,1.6.1,8,30,1981,980,2961,154,FALSE
pixi.js,1.6.1,2.0.0,9,285,241748,85489,327237,2026,FALSE
pixi.js,1.4.0,1.4.1,1,7,5630,1938,7568,278,FALSE
pixi.js,1.4.1,1.4.3,2,58,2895,1475,4370,188,FALSE
pixi.js,1.4.3,1.5.0,3,114,58925,56350,115275,1102,FALSE
pixi.js,1.5.1,1.5.2,5,75,131353,27401,158754,690,FALSE
pixi.js,1.5.0,1.5.1,4,20,910,843,1753,65,FALSE
pixi.js,1.5.3,1.6.0,7,105,73404,29351,102755,959,FALSE
pixi.js,1.5.2,1.5.3,6,76,8092,1981,10073,363,FALSE
pixi.js,3.0.0-rc1,3.0.0-rc2,22,33,45860,17597,63457,92,TRUE
pixi.js,2.2.5,2.2.6,17,196,59592,554021,613613,2071,TRUE
pixi.js,1.5.1,1.5.2,5,75,131353,27401,158754,690,TRUE
pixi.js,1.6.0,1.6.1,8,30,1981,980,2961,154,TRUE
pixi.js,4.1.1,4.2.1,45,75,29210,50910,80120,505,TRUE
pixi.js,3.0.7,3.0.8,33,162,47456,44996,92452,561,TRUE
pixi.js,4.4.2,4.4.3,57,11,615,237,852,26,TRUE
pixi.js,4.1.0,4.1.1,44,58,23740,49683,73423,300,TRUE
trixion,0.0.3,0.0.4,3,2,9658,3,9661,51,FALSE
trixion,0.0.2,0.0.3,2,1,11,4,15,1,FALSE
trixion,0.0.5,0.1.0,5,6,366,388,754,17,FALSE
trixion,0.0.4,0.0.5,4,2,6,9,15,2,FALSE
trixion,0.1.0,1.0.0,6,5,323,562,885,10,FALSE
trixion,0.0.5,0.1.0,5,6,366,388,754,17,TRUE
trixion,0.0.4,0.0.5,4,2,6,9,15,2,TRUE
trixion,0.1.0,1.0.0,6,5,323,562,885,10,TRUE
diffhtml,0.0.4,0.0.5,4,1,6,2,8,2,FALSE
diffhtml,0.0.0,0.0.2,1,18,1935,8257,10192,52,FALSE
diffhtml,0.0.3,0.0.4,3,11,568,365,933,20,FALSE
diffhtml,0.0.2,0.0.3,2,3,3,3,6,3,FALSE
diffhtml,1.0.0-beta,1.0.0-beta.1,33,5,65,58,123,34,FALSE
diffhtml,0.7.0,0.8.0,23,6,2094,1587,3681,37,FALSE
diffhtml,0.2.0,0.3.0,7,42,3159,1950,5109,124,FALSE
diffhtml,0.0.5,0.0.6,5,68,34931,28996,63927,466,FALSE
diffhtml,0.0.6,0.2.0,6,29,3775,2275,6050,186,FALSE
diffhtml,0.6.3,0.6.4,19,5,571,279,850,38,FALSE
diffhtml,0.6.2,0.6.3,18,2,2,1,3,2,FALSE
diffhtml,0.3.0,0.4.0,8,5,2645,1973,4618,60,FALSE
diffhtml,0.6.0,0.6.1,16,2,2,2,4,2,FALSE
diffhtml,0.6.6,0.7.0,22,9,1892,4253,6145,111,FALSE
diffhtml,0.6.5,0.6.6,21,1,3,3,6,3,FALSE
diffhtml,0.6.4,0.6.5,20,3,354,284,638,15,FALSE
diffhtml,0.4.1,0.4.2,10,11,1126,1071,2197,61,FALSE
diffhtml,0.4.0,0.4.1,9,7,937,943,1880,32,FALSE
diffhtml,0.4.3,0.4.4,12,7,1634,1215,2849,68,FALSE
diffhtml,0.4.2,0.4.3,11,4,185,149,334,15,FALSE
diffhtml,0.5.0,0.5.1,14,9,350,330,680,30,FALSE
diffhtml,0.4.4,0.5.0,13,4,852,500,1352,40,FALSE
diffhtml,0.9.0,0.9.1,30,5,99,9,108,11,FALSE
diffhtml,0.9.1,0.9.2,31,20,3367,1949,5316,98,TRUE
diffhtml,0.9.2,1.0.0-beta,32,208,109797,93291,203088,1265,FALSE
diffhtml,0.8.5,0.9.0,29,20,8853,6978,15831,198,FALSE
diffhtml,0.8.4,0.8.5,28,6,152,1092,1244,33,FALSE
diffhtml,0.8.1,0.8.2,25,2,4,4,8,4,FALSE
diffhtml,0.8.0,0.8.1,24,4,61,24,85,9,FALSE
diffhtml,0.8.3,0.8.4,27,2,11,2,13,3,FALSE
diffhtml,0.8.2,0.8.3,26,2,19,4,23,5,FALSE
diffhtml,0.5.1,0.6.0,15,4,384,178,562,28,FALSE
diffhtml,0.6.1,0.6.2,17,1,2,2,4,2,FALSE
diffhtml,0.9.1,0.9.2,31,20,3367,1949,5316,98,FALSE
diffhtml,0.4.3,0.4.4,12,7,1634,1215,2849,68,TRUE
diffhtml,0.6.3,0.6.4,19,5,571,279,850,38,TRUE
diffhtml,0.5.0,0.5.1,14,9,350,330,680,30,TRUE
diffhtml,0.4.4,0.5.0,13,4,852,500,1352,40,TRUE
diffhtml,0.8.0,0.8.1,24,4,61,24,85,9,TRUE
diffhtml,0.3.0,0.4.0,8,5,2645,1973,4618,60,TRUE
diffhtml,0.7.0,0.8.0,23,6,2094,1587,3681,37,TRUE
diffhtml,0.4.0,0.4.1,9,7,937,943,1880,32,TRUE
mocha-tcov-reporter,1.0.4,1.0.5,15,3,3,4,7,3,FALSE
mocha-tcov-reporter,1.1.0,1.1.1,17,4,221,194,415,28,FALSE
mocha-tcov-reporter,1.1.3,1.1.4,20,6,65,59,124,15,FALSE
mocha-tcov-reporter,1.1.2,1.1.3,19,2,13,27,40,6,FALSE
mocha-tcov-reporter,1.1.5,1.1.6,22,2,2,3,5,2,FALSE
mocha-tcov-reporter,1.0.1,1.0.2,12,2,4,4,8,3,FALSE
mocha-tcov-reporter,1.0.2,1.0.3,13,2,4,4,8,3,FALSE
mocha-tcov-reporter,1.0.3,1.0.4,14,2,6,4,10,3,FALSE
mocha-tcov-reporter,0.1.0,0.1.1,8,3,4,4,8,3,FALSE
mocha-tcov-reporter,0.1.1,0.1.2,9,2,2,2,4,2,FALSE
mocha-tcov-reporter,0.1.2,1.0.0,10,20,1357,1125,2482,85,FALSE
mocha-tcov-reporter,1.1.4,1.1.5,21,2,14,14,28,6,FALSE
mocha-tcov-reporter,0.0.5,0.0.6,5,3,38,43,81,13,FALSE
mocha-tcov-reporter,0.0.4,0.0.5,4,16,308,231,539,50,FALSE
mocha-tcov-reporter,0.0.7,0.1.0,7,2,2,2,4,2,FALSE
mocha-tcov-reporter,0.0.6,0.0.7,6,7,142,94,236,22,TRUE
mocha-tcov-reporter,0.0.3,0.0.4,3,15,441,267,708,51,FALSE
mocha-tcov-reporter,0.0.2,0.0.3,2,11,380,104,484,47,FALSE
mocha-tcov-reporter,1.1.1,1.1.2,18,3,16,3,19,6,FALSE
mocha-tcov-reporter,1.0.0,1.0.1,11,6,122,160,282,19,FALSE
mocha-tcov-reporter,1.0.5,1.1.0,16,6,28,48,76,17,FALSE
mocha-tcov-reporter,0.0.6,0.0.7,6,7,142,94,236,22,FALSE
mocha-tcov-reporter,0.0.1,0.0.2,1,10,79,42,121,25,FALSE
mocha-tcov-reporter,1.1.0,1.1.1,17,4,221,194,415,28,TRUE
mocha-tcov-reporter,0.0.7,0.1.0,7,2,2,2,4,2,TRUE
mocha-tcov-reporter,1.1.2,1.1.3,19,2,13,27,40,6,TRUE
tsbundler,1.0.0-alpha.1,1.0.0-beta.4,1,3,4123,8650,12773,136,TRUE
tsbundler,1.0.0-rc.3,1.0.0-rc.4,5,1,693,294,987,27,FALSE
tsbundler,1.0.0-rc.2,1.0.0-rc.3,4,1,80,48,128,7,FALSE
tsbundler,1.0.0-rc.1,1.0.0-rc.2,3,1,81,66,147,9,TRUE
tsbundler,1.0.0-beta.4,1.0.0-rc.1,2,1,106,80,186,13,TRUE
tsbundler,1.0.0-alpha.1,1.0.0-beta.4,1,3,4123,8650,12773,136,FALSE
tsbundler,1.0.0-rc.1,1.0.0-rc.2,3,1,81,66,147,9,FALSE
tsbundler,1.0.0-beta.4,1.0.0-rc.1,2,1,106,80,186,13,FALSE
npms-cli,1.0.4,1.1.0,5,12,463,89,552,33,FALSE
npms-cli,1.1.0,1.2.0,6,3,15,14,29,4,FALSE
npms-cli,1.0.0,1.0.1,1,12,226,141,367,18,FALSE
npms-cli,1.0.1,1.0.2,2,6,48,22,70,7,FALSE
npms-cli,1.0.2,1.0.3,3,3,40,31,71,5,FALSE
npms-cli,1.0.3,1.0.4,4,2,8,15,23,2,FALSE
npms-cli,1.5.1,1.6.0,16,2,5,13,18,6,FALSE
npms-cli,1.5.0,1.5.1,15,9,35,25,60,12,FALSE
npms-cli,1.3.2,1.4.0,13,6,77,10,87,8,FALSE
npms-cli,1.3.0,1.3.1,11,5,62,36,98,7,FALSE
npms-cli,1.2.2,1.2.3,9,5,24,23,47,5,FALSE
npms-cli,1.2.3,1.3.0,10,17,938,123,1061,64,FALSE
npms-cli,1.2.0,1.2.1,7,5,22,20,42,5,FALSE
npms-cli,1.2.1,1.2.2,8,4,9,10,19,4,FALSE
npms-cli,1.4.0,1.5.0,14,6,71,89,160,16,FALSE
npms-cli,1.3.1,1.3.2,12,3,5,5,10,3,FALSE
npms-cli,1.5.0,1.5.1,15,9,35,25,60,12,TRUE
npms-cli,1.0.0,1.0.1,1,12,226,141,367,18,TRUE
npms-cli,1.4.0,1.5.0,14,6,71,89,160,16,TRUE
npms-cli,1.2.3,1.3.0,10,17,938,123,1061,64,TRUE
lathet,2.0.0,2.1.0,2,1,6,1,7,1,FALSE
lathet,2.2.1,2.2.2,6,71,73,73,146,71,FALSE
lathet,2.2.0,2.2.1,5,60,66,60,126,61,FALSE
lathet,2.2.2,2.2.3,7,8,23,23,46,8,FALSE
lathet,2.1.0,2.1.1,3,8,20,14,34,15,FALSE
lathet,2.1.1,2.2.0,4,63,66,62,128,63,FALSE
lathet,1.0.0,2.0.0,1,7,129,25,154,10,FALSE
lathet,2.2.0,2.2.1,5,60,66,60,126,61,TRUE
lathet,2.2.1,2.2.2,6,71,73,73,146,71,TRUE
react-cmf-bootstrap,0.1.0,0.1.1,3,3,145,60,205,9,FALSE
react-cmf-bootstrap,0.0.1,0.1.0,2,29,247118,229029,476147,310,FALSE
react-cmf-bootstrap,0.0.0,0.0.1,1,6,128,181,309,22,FALSE
react-cmf-bootstrap,0.0.1,0.1.0,2,29,247118,229029,476147,310,TRUE
single-market-robot-simulator-viz-plotly,0.3.1,0.4.0,9,2,8,12,20,4,FALSE
single-market-robot-simulator-viz-plotly,1.0.0,1.1.1,18,4,104,56,160,5,FALSE
single-market-robot-simulator-viz-plotly,0.5.0,0.6.0,11,2,77,1,78,3,FALSE
single-market-robot-simulator-viz-plotly,0.3.0,0.3.1,8,3,3,3,6,3,FALSE
single-market-robot-simulator-viz-plotly,0.6.0,0.7.0,12,2,83,187,270,3,FALSE
single-market-robot-simulator-viz-plotly,0.8.1,0.8.2,15,2,3,3,6,3,FALSE
single-market-robot-simulator-viz-plotly,0.8.0,0.8.1,14,2,3,3,6,3,FALSE
single-market-robot-simulator-viz-plotly,0.7.0,0.8.0,13,2,55,2,57,3,FALSE
single-market-robot-simulator-viz-plotly,0.8.2,0.8.3,16,2,7,1,8,3,FALSE
single-market-robot-simulator-viz-plotly,0.8.3,1.0.0,17,2,22,22,44,2,FALSE
single-market-robot-simulator-viz-plotly,0.2.1,0.2.2,6,2,11,11,22,3,FALSE
single-market-robot-simulator-viz-plotly,0.2.0,0.2.1,5,2,9,1,10,3,FALSE
single-market-robot-simulator-viz-plotly,0.1.0,0.1.2,1,4,11,4,15,4,FALSE
single-market-robot-simulator-viz-plotly,0.4.0,0.5.0,10,2,25,10,35,3,FALSE
single-market-robot-simulator-viz-plotly,0.1.2,0.1.3,2,2,3,3,6,2,FALSE
single-market-robot-simulator-viz-plotly,0.1.3,0.1.4,3,2,74,2,76,3,FALSE
single-market-robot-simulator-viz-plotly,0.1.4,0.2.0,4,2,883,377,1260,8,FALSE
single-market-robot-simulator-viz-plotly,0.2.2,0.3.0,7,2,19,9,28,4,FALSE
single-market-robot-simulator-viz-plotly,0.6.0,0.7.0,12,2,83,187,270,3,TRUE
single-market-robot-simulator-viz-plotly,0.8.3,1.0.0,17,2,22,22,44,2,TRUE
single-market-robot-simulator-viz-plotly,0.7.0,0.8.0,13,2,55,2,57,3,TRUE
json-merge-patch,0.2.2,0.2.3,5,2,2,1,3,2,FALSE
json-merge-patch,0.1.1,0.2.0,2,3,221,1,222,7,FALSE
json-merge-patch,0.2.1,0.2.2,4,2,8,3,11,3,FALSE
json-merge-patch,0.2.0,0.2.1,3,2,27,26,53,2,FALSE
json-merge-patch,0.1.0,0.1.1,1,5,714,5,719,17,FALSE
json-merge-patch,0.2.0,0.2.1,3,2,27,26,53,2,TRUE
generator-code,1.1.1,1.1.2,46,1,5,1,6,2,FALSE
generator-code,1.1.0,1.1.1,45,1,3,5,8,4,FALSE
generator-code,1.1.3,1.1.4,48,1,1,1,2,1,FALSE
generator-code,1.1.2,1.1.3,47,1,2,1,3,2,FALSE
generator-code,1.0.0,1.1.0,44,1,32,1,33,4,FALSE
generator-code,1.1.4,1.1.5,49,5,400,257,657,15,FALSE
generator-code,1.1.7,1.1.8,52,1,3,3,6,2,FALSE
generator-code,1.1.6,1.1.7,51,1,2,2,4,2,FALSE
generator-code,1.1.13-next.1,1.1.13,57,5,39,35,74,6,FALSE
generator-code,1.1.8,1.1.10,53,19,445,85,530,40,FALSE
generator-code,0.10.20,1.0.0-beta.1,42,3,31,22,53,13,FALSE
generator-code,1.1.5,1.1.6,50,4,9,6,15,6,FALSE
generator-code,0.1.3,0.10.0-pre.1,1,6,1200,201,1401,51,FALSE
generator-code,1.0.0-beta.1,1.0.0,43,1,17,8,25,7,FALSE
generator-code,0.10.1,0.10.4,20,4,13,4,17,5,FALSE
generator-code,0.10.0,0.10.1,19,7,87,13,100,15,FALSE
generator-code,0.10.5,0.10.7-pre1,22,3,14,11,25,8,FALSE
generator-code,0.10.4,0.10.5,21,3,3,3,6,3,FALSE
generator-code,0.10.7,0.10.8,28,1,2,2,4,2,FALSE
generator-code,0.10.9,0.10.10,30,1,2,2,4,2,FALSE
generator-code,0.10.8,0.10.9,29,4,12,12,24,10,FALSE
generator-code,0.10.7-pre2,0.10.7-pre4,24,2,3,3,6,3,FALSE
generator-code,0.10.7-pre1,0.10.7-pre2,23,4,16,12,28,6,FALSE
generator-code,0.10.7-pre7,0.10.7,27,3,198,191,389,3,FALSE
generator-code,0.10.7-pre5,0.10.7-pre7,26,2,8,8,16,8,FALSE
generator-code,0.10.7-pre4,0.10.7-pre5,25,2,4,3,7,3,FALSE
generator-code,0.10.15,0.10.16,36,1,3,2,5,2,FALSE
generator-code,0.10.14,0.10.15,35,3,443,27,470,9,FALSE
generator-code,0.10.17,0.10.18,39,3,28,4,32,4,FALSE
generator-code,0.10.16,0.10.17-next.1,37,1,10,10,20,6,FALSE
generator-code,0.10.11,0.10.12,32,1,2,2,4,2,FALSE
generator-code,0.10.10,0.10.11,31,2,1286,1280,2566,38,FALSE
generator-code,0.10.13,0.10.14,34,3,20,1,21,3,FALSE
generator-code,0.10.12,0.10.13,33,1,2,2,4,2,FALSE
generator-code,0.10.0-pre.11,0.10.0-pre.12,12,2,6,4,10,4,FALSE
generator-code,0.10.0-pre.10,0.10.0-pre.11,11,1,51,5,56,5,FALSE
generator-code,0.10.0-pre.13,0.10.0-pre.14,14,1,115,26,141,9,FALSE
generator-code,0.10.0-pre.12,0.10.0-pre.13,13,2,10,10,20,8,FALSE
generator-code,0.10.0-pre.15,0.10.0-pre.16,16,2,10,1,11,4,FALSE
generator-code,0.10.18,0.10.19,40,4,4,4,8,4,FALSE
generator-code,0.10.0-pre.17,0.10.0,18,3,18,14,32,4,FALSE
generator-code,0.10.0-pre.14,0.10.0-pre.15,15,1,1,10,11,4,FALSE
generator-code,0.10.17-next.1,0.10.17,38,1,1,1,2,1,FALSE
generator-code,1.1.11,1.1.12,55,12,1159,233,1392,20,FALSE
generator-code,1.1.10,1.1.11,54,5,5,5,10,5,FALSE
generator-code,0.10.0-pre.16,0.10.0-pre.17,17,2,3,3,6,2,FALSE
generator-code,1.1.12,1.1.13-next.1,56,9,711,567,1278,30,FALSE
generator-code,0.10.19,0.10.20,41,3,5,1,6,5,FALSE
generator-code,0.10.0-pre.3,0.10.0-pre.4,4,2,9,9,18,2,FALSE
generator-code,0.10.0-pre.2,0.10.0-pre.3,3,1,2,2,4,2,FALSE
generator-code,0.10.0-pre.5,0.10.0-pre.6,6,1,3,5,8,3,FALSE
generator-code,0.10.0-pre.4,0.10.0-pre.5,5,2,9,35,44,10,FALSE
generator-code,0.10.0-pre.7,0.10.0-pre.8,8,1,17,9,26,6,FALSE
generator-code,0.10.0-pre.6,0.10.0-pre.7,7,1,158,46,204,15,FALSE
generator-code,0.10.0-pre.9,0.10.0-pre.10,10,2,2,7,9,7,FALSE
generator-code,0.10.0-pre.8,0.10.0-pre.9,9,1,2,2,4,2,FALSE
generator-code,0.10.0-pre.1,0.10.0-pre.2,2,2,8,8,16,5,FALSE
generator-code,0.10.0-pre.17,0.10.0,18,3,18,14,32,4,TRUE
generator-code,0.10.7-pre1,0.10.7-pre2,23,4,16,12,28,6,TRUE
vsoagent-installer,0.5.10,0.6.0,56,3,654,46,700,14,FALSE
vsoagent-installer,0.6.3,0.6.4,60,3,164,62,226,7,FALSE
vsoagent-installer,0.6.2,0.6.3,59,2,16,0,16,2,FALSE
vsoagent-installer,0.6.1,0.6.2,58,5,122,88,210,11,FALSE
vsoagent-installer,0.6.0,0.6.1,57,1,3,0,3,1,FALSE
vsoagent-installer,0.6.4,0.6.5,61,1,3,0,3,1,FALSE
vsoagent-installer,0.5.8,0.5.9,54,2,1812,428,2240,7,FALSE
vsoagent-installer,0.5.9,0.5.10,55,45,6426,2420,8846,158,FALSE
vsoagent-installer,0.5.4,0.5.5,50,3,5,5,10,5,FALSE
vsoagent-installer,0.5.5,0.5.6,51,14,3237,1160,4397,34,FALSE
vsoagent-installer,0.4.3,0.4.4,43,2,102,13,115,6,FALSE
vsoagent-installer,0.4.2,0.4.3,42,3,77,20,97,9,FALSE
vsoagent-installer,0.4.5,0.5.0,45,2,22,7,29,6,FALSE
vsoagent-installer,0.4.4,0.4.5,44,12,473,328,801,28,FALSE
vsoagent-installer,0.5.2,0.5.3,48,5,289,102,391,10,FALSE
vsoagent-installer,0.5.3,0.5.4,49,11,117,100,217,14,FALSE
vsoagent-installer,0.4.0,0.4.2,41,20,2168,1272,3440,59,FALSE
vsoagent-installer,0.5.6,0.5.7,52,4,27,9,36,7,FALSE
vsoagent-installer,0.5.7,0.5.8,53,26,2892,960,3852,74,FALSE
vsoagent-installer,0.5.0,0.5.1,46,11,219,123,342,26,FALSE
vsoagent-installer,0.5.1,0.5.2,47,12,796,451,1247,23,FALSE
vsoagent-installer,0.2.13,0.2.14,23,1,5,4,9,4,FALSE
vsoagent-installer,0.2.12,0.2.13,22,6,157,104,261,8,FALSE
vsoagent-installer,0.2.11,0.2.12,21,12,76,78,154,15,FALSE
vsoagent-installer,0.2.10,0.2.11,20,4,14,3,17,6,FALSE
vsoagent-installer,0.2.7,0.2.8,17,2,139,74,213,5,FALSE
vsoagent-installer,0.2.6,0.2.7,16,2,74,58,132,4,FALSE
vsoagent-installer,0.2.5,0.2.6,15,9,2895,267,3162,47,FALSE
vsoagent-installer,0.2.9,0.2.10,19,11,557,381,938,30,FALSE
vsoagent-installer,0.2.8,0.2.9,18,3,135,89,224,8,FALSE
vsoagent-installer,0.2.26,0.2.27,31,6,15,10,25,7,FALSE
vsoagent-installer,0.2.27,0.2.28,32,28,29520,6582,36102,193,FALSE
vsoagent-installer,0.2.24,0.2.25,29,3,46,41,87,13,FALSE
vsoagent-installer,0.2.25,0.2.26,30,15,1280,692,1972,55,FALSE
vsoagent-installer,0.2.22,0.2.23,27,3,62,19,81,11,FALSE
vsoagent-installer,0.2.23,0.2.24,28,1,3,2,5,2,FALSE
vsoagent-installer,0.2.20,0.2.21,25,2,14,22,36,4,FALSE
vsoagent-installer,0.2.21,0.2.22,26,1,13,2,15,3,FALSE
vsoagent-installer,0.2.28,0.2.29,33,46,11025,3747,14772,288,FALSE
vsoagent-installer,0.2.29,0.3.7,34,41,5128,2423,7551,121,FALSE
vsoagent-installer,0.2.4,0.2.5,14,19,4107,1859,5966,95,FALSE
vsoagent-installer,0.3.8,0.3.10,36,5,74,6,80,9,FALSE
vsoagent-installer,0.3.7,0.3.8,35,6,108,30,138,16,FALSE
vsoagent-installer,0.3.12,0.3.13,39,1,3,0,3,1,FALSE
vsoagent-installer,0.3.13,0.4.0,40,9,7852,4450,12302,49,FALSE
vsoagent-installer,0.2.14,0.2.20,24,25,1652,1543,3195,114,FALSE
vsoagent-installer,0.3.10,0.3.11,37,1,3,0,3,1,FALSE
vsoagent-installer,0.3.11,0.3.12,38,5,59,31,90,9,FALSE
vsoagent-installer,0.2.3,0.2.4,13,47,4663,1504,6167,238,FALSE
vsoagent-installer,0.2.2,0.2.3,12,6,260,306,566,25,FALSE
vsoagent-installer,0.2.1,0.2.2,11,1,46,17,63,7,FALSE
vsoagent-installer,0.2.0,0.2.1,10,16,1848,407,2255,73,FALSE
vsoagent-installer,0.1.0,0.1.1,1,5,212,21,233,16,FALSE
vsoagent-installer,0.1.1,0.1.2,2,1,3,2,5,2,FALSE
vsoagent-installer,0.1.2,0.1.3,3,9,674,540,1214,40,FALSE
vsoagent-installer,0.1.3,0.1.4,4,29,4456,3945,8401,133,FALSE
vsoagent-installer,0.1.4,0.1.5,5,1,150,43,193,7,FALSE
vsoagent-installer,0.1.5,0.1.6,6,1,11,4,15,5,FALSE
vsoagent-installer,0.1.6,0.1.7,7,2,55,5,60,6,FALSE
vsoagent-installer,0.1.7,0.1.8,8,12,1903,36,1939,57,FALSE
vsoagent-installer,0.1.8,0.2.0,9,1,3,0,3,1,FALSE
vsoagent-installer,0.3.8,0.3.10,36,5,74,6,80,9,TRUE
vsoagent-installer,0.3.7,0.3.8,35,6,108,30,138,16,TRUE
vsoagent-installer,0.2.21,0.2.22,26,1,13,2,15,3,TRUE
vsoagent-installer,0.2.11,0.2.12,21,12,76,78,154,15,TRUE
vsoagent-installer,0.2.6,0.2.7,16,2,74,58,132,4,TRUE
vsoagent-installer,0.2.5,0.2.6,15,9,2895,267,3162,47,TRUE
vsoagent-installer,0.2.9,0.2.10,19,11,557,381,938,30,TRUE
vsoagent-installer,0.5.0,0.5.1,46,11,219,123,342,26,TRUE
vsoagent-installer,0.5.1,0.5.2,47,12,796,451,1247,23,TRUE
vsoagent-installer,0.2.12,0.2.13,22,6,157,104,261,8,TRUE
vsoagent-installer,0.2.26,0.2.27,31,6,15,10,25,7,TRUE
vsoagent-installer,0.2.14,0.2.20,24,25,1652,1543,3195,114,TRUE
react-search-results,0.1.12,0.1.13,14,9,31,9,40,14,FALSE
react-search-results,0.1.13,0.1.14,15,5,22,24,46,9,FALSE
react-search-results,0.1.10,0.1.11,12,2,4,4,8,2,FALSE
react-search-results,0.1.11,0.1.12,13,7,7,7,14,7,FALSE
react-search-results,0.0.1,0.1.0,1,4,242,116,358,14,FALSE
react-search-results,0.1.14,0.1.15,16,27,214,220,434,37,FALSE
react-search-results,0.1.15,0.1.16,17,2,6,6,12,2,FALSE
react-search-results,0.1.5,0.1.6,7,2,3,3,6,2,FALSE
react-search-results,0.1.8,0.1.9,10,7,15,15,30,8,FALSE
react-search-results,0.1.9,0.1.10,11,4,6,6,12,4,FALSE
react-search-results,0.1.0,0.1.1,2,3,6,2,8,3,FALSE
react-search-results,0.1.1,0.1.2,3,4,14,14,28,4,FALSE
react-search-results,0.1.2,0.1.3,4,39,60,57,117,44,FALSE
react-search-results,0.1.3,0.1.4,5,53,66,178,244,58,FALSE
react-search-results,0.1.4,0.1.5,6,2,4,4,8,2,TRUE
react-search-results,0.1.16,0.1.17,18,13,20,20,40,15,FALSE
react-search-results,0.1.6,0.1.7,8,3,7,7,14,3,FALSE
react-search-results,0.1.7,0.1.8,9,19,24,28,52,21,TRUE
react-search-results,0.1.4,0.1.5,6,2,4,4,8,2,FALSE
react-search-results,0.1.7,0.1.8,9,19,24,28,52,21,FALSE
react-search-results,0.1.11,0.1.12,13,7,7,7,14,7,TRUE
react-search-results,0.1.5,0.1.6,7,2,3,3,6,2,TRUE
react-search-results,0.1.0,0.1.1,2,3,6,2,8,3,TRUE
react-search-results,0.1.1,0.1.2,3,4,14,14,28,4,TRUE
react-search-results,0.1.2,0.1.3,4,39,60,57,117,44,TRUE
react-search-results,0.1.3,0.1.4,5,53,66,178,244,58,TRUE
react-search-results,0.1.6,0.1.7,8,3,7,7,14,3,TRUE
react-search-results,0.1.14,0.1.15,16,27,214,220,434,37,TRUE
require-hacker,1.1.0,1.2.0,3,2,44,8,52,6,FALSE
require-hacker,2.0.4,2.1.0,12,1,1,1,2,1,FALSE
require-hacker,1.0.0,1.0.1,1,5,13,11,24,5,FALSE
require-hacker,1.0.1,1.1.0,2,2,55,5,60,5,FALSE
require-hacker,2.0.1,2.0.2,9,3,136,150,286,7,FALSE
require-hacker,2.0.0,2.0.1,8,3,34,37,71,5,FALSE
require-hacker,1.2.2,1.2.3,6,2,9,8,17,3,FALSE
require-hacker,1.2.3,2.0.0,7,4,314,79,393,13,FALSE
require-hacker,1.2.0,1.2.1,4,3,12,5,17,3,FALSE
require-hacker,1.2.1,1.2.2,5,2,26,3,29,4,FALSE
require-hacker,2.1.2,2.1.3,15,3,116,33,149,5,FALSE
require-hacker,2.1.3,2.1.4,16,3,13,5,18,5,FALSE
require-hacker,2.1.0,2.1.1,13,5,189,21,210,9,FALSE
require-hacker,2.0.3,2.0.4,11,2,88,15,103,4,FALSE
require-hacker,2.1.1,2.1.2,14,2,4,22,26,3,FALSE
require-hacker,2.1.4,3.0.0,17,2,35,304,339,6,FALSE
require-hacker,2.0.2,2.0.3,10,3,27,23,50,6,FALSE
require-hacker,1.2.3,2.0.0,7,4,314,79,393,13,TRUE
require-hacker,2.1.3,2.1.4,16,3,13,5,18,5,TRUE
require-hacker,2.1.4,3.0.0,17,2,35,304,339,6,TRUE
require-hacker,2.1.0,2.1.1,13,5,189,21,210,9,TRUE
reactjs-admin-lte,0.3.0,0.4.0,3,7,558,136,694,35,FALSE
reactjs-admin-lte,0.2.0,0.3.0,2,2,2,1,3,2,FALSE
reactjs-admin-lte,0.1.0,0.2.0,1,2,12,9,21,5,FALSE
reactjs-admin-lte,0.4.0,0.5.0,4,89,21634,13991,35625,603,FALSE
reactjs-admin-lte,0.5.0,0.5.1,5,3,10,9,19,4,FALSE
reactjs-admin-lte,0.3.0,0.4.0,3,7,558,136,694,35,TRUE
ng2-mobx,1.1.0,1.1.2,4,7,104,12,116,12,FALSE
ng2-mobx,1.1.2,1.1.3,5,1,30,9,39,3,FALSE
ng2-mobx,1.0.0,1.0.1,2,1,0,1,1,1,FALSE
ng2-mobx,1.0.1,1.1.0,3,13,832,136,968,54,FALSE
ng2-mobx,1.2.6,1.2.7,13,1,11,4,15,3,FALSE
ng2-mobx,1.2.7,1.2.8,14,1,22,49,71,9,FALSE
ng2-mobx,1.2.5,1.2.6,12,1,7,3,10,3,FALSE
ng2-mobx,1.2.8,1.2.9,15,1,10,1,11,3,FALSE
ng2-mobx,1.2.4,1.2.5,11,2,11,1,12,4,FALSE
ng2-mobx,1.2.3,1.2.4,10,1,8,4,12,2,FALSE
ng2-mobx,1.2.2,1.2.3,9,9,1352,341,1693,54,FALSE
ng2-mobx,1.2.0,1.2.1,7,2,289,29,318,7,FALSE
ng2-mobx,1.2.1,1.2.2,8,4,79,42,121,8,FALSE
ng2-mobx,1.1.2,1.1.3,5,1,30,9,39,3,TRUE
ng2-mobx,1.0.1,1.1.0,3,13,832,136,968,54,TRUE
ng2-mobx,1.1.3,1.2.0,6,19,1598,491,2089,135,TRUE
ng2-mobx,1.2.6,1.2.7,13,1,11,4,15,3,TRUE
ng2-mobx,1.2.4,1.2.5,11,2,11,1,12,4,TRUE
ng2-mobx,1.2.5,1.2.6,12,1,7,3,10,3,TRUE
ng2-mobx,1.2.2,1.2.3,9,9,1352,341,1693,54,TRUE
ng2-mobx,1.2.8,1.2.9,15,1,10,1,11,3,TRUE
ng2-mobx,1.1.3,1.2.0,6,19,1598,491,2089,135,FALSE
yocto-orika,1.0.4,1.0.5,5,1,9,9,18,3,FALSE
yocto-orika,1.0.5,1.0.6,6,1,10,3,13,4,FALSE
yocto-orika,1.0.6,1.0.7,7,1,52,34,86,11,FALSE
yocto-orika,1.0.7,1.0.8,8,2,9,5,14,7,FALSE
yocto-orika,1.0.0,1.0.1,1,1,3,3,6,3,FALSE
yocto-orika,1.0.1,1.0.2,2,1,2,2,4,1,FALSE
yocto-orika,1.0.2,1.0.3,3,1,2,1,3,1,FALSE
yocto-orika,1.0.3,1.0.4,4,1,3,3,6,3,FALSE
yocto-orika,1.1.9,1.1.10,20,1,12,9,21,4,FALSE
yocto-orika,1.1.8,1.1.9,19,3,77,34,111,12,FALSE
yocto-orika,1.0.8,1.0.9,9,1,9,7,16,4,FALSE
yocto-orika,1.0.9,1.1.0,10,1,6,6,12,5,FALSE
yocto-orika,1.1.2,1.1.3,13,1,100,36,136,11,FALSE
yocto-orika,1.1.6,1.1.7,17,1,14,5,19,3,FALSE
yocto-orika,1.1.5,1.1.6,16,1,85,13,98,4,FALSE
yocto-orika,1.1.4,1.1.5,15,1,93,43,136,5,TRUE
yocto-orika,1.1.7,1.1.8,18,1,19,5,24,4,FALSE
yocto-orika,1.1.1,1.1.2,12,1,4,4,8,4,FALSE
yocto-orika,1.2.6,1.2.7,31,1,17,9,26,8,FALSE
yocto-orika,1.2.7,1.2.8,32,1,11,4,15,5,TRUE
yocto-orika,1.2.4,1.2.5,29,1,8,5,13,4,FALSE
yocto-orika,1.2.5,1.2.6,30,2,820,50,870,28,FALSE
yocto-orika,1.2.2,1.2.3,27,1,14,8,22,4,FALSE
yocto-orika,1.2.3,1.2.4,28,1,7,4,11,4,FALSE
yocto-orika,1.2.0,1.2.1,25,1,34,22,56,12,FALSE
yocto-orika,1.2.1,1.2.2,26,1,17,14,31,4,FALSE
yocto-orika,1.2.8,2.0.0,33,1,32,23,55,13,FALSE
yocto-orika,1.1.0,1.1.1,11,1,103,19,122,9,FALSE
yocto-orika,1.1.11,1.1.12,22,1,12,7,19,4,FALSE
yocto-orika,1.1.10,1.1.11,21,1,3,3,6,3,FALSE
yocto-orika,1.1.13,1.2.0,24,2,753,35,788,32,FALSE
yocto-orika,1.1.12,1.1.13,23,1,28,11,39,7,FALSE
yocto-orika,1.1.3,1.1.4,14,1,7,3,10,3,TRUE
yocto-orika,1.1.4,1.1.5,15,1,93,43,136,5,FALSE
yocto-orika,1.2.7,1.2.8,32,1,11,4,15,5,FALSE
yocto-orika,1.1.3,1.1.4,14,1,7,3,10,3,FALSE
yocto-orika,1.1.8,1.1.9,19,3,77,34,111,12,TRUE
react-super-components,1.1.0,1.2.0,18,1,350,41,391,11,FALSE
react-super-components,1.0.0,1.1.0,17,7,1137,700,1837,41,FALSE
react-super-components,0.2.0,0.3.0,3,3,228,11,239,8,FALSE
react-super-components,0.1.0,0.2.0,2,2,127,2,129,5,FALSE
react-super-components,0.3.8,0.3.9,12,2,3,3,6,2,FALSE
react-super-components,0.3.9,0.3.10,13,3,71,1167,1238,18,FALSE
react-super-components,0.0.1,0.1.0,1,11,582,32675,33257,48,FALSE
react-super-components,0.3.2,0.3.3,6,5,69,39,108,12,FALSE
react-super-components,0.3.3,0.3.4,7,12,1931,1553,3484,59,FALSE
react-super-components,0.3.0,0.3.1,4,101,8207,4456,12663,384,FALSE
react-super-components,0.3.1,0.3.2,5,10,412,155,567,30,FALSE
react-super-components,0.3.6,0.3.7,10,2,8,9,17,3,FALSE
react-super-components,0.3.7,0.3.8,11,6,1529,319,1848,21,FALSE
react-super-components,0.3.4,0.3.5,8,10,287,174,461,17,FALSE
react-super-components,0.3.5,0.3.6,9,4,37,33,70,5,FALSE
react-super-components,1.6.2,1.6.3,30,8,157,43,200,11,FALSE
react-super-components,1.6.3,1.6.4,31,1,1,1,2,1,FALSE
react-super-components,1.6.0,1.6.1,28,1,1,1,2,1,FALSE
react-super-components,1.6.1,1.6.2,29,2,30,10,40,2,FALSE
react-super-components,1.6.4,1.6.5,32,2,6,33,39,2,FALSE
react-super-components,0.4.1,1.0.0,16,2,24,28,52,4,FALSE
react-super-components,0.4.0,0.4.1,15,4,9,8,17,4,FALSE
react-super-components,0.3.10,0.4.0,14,3,51,12,63,5,FALSE
react-super-components,1.4.0,1.4.1,23,9,155,171,326,17,FALSE
react-super-components,1.4.1,1.4.2,24,3,58,74,132,11,FALSE
react-super-components,1.4.2,1.4.3,25,5,62,46,108,9,FALSE
react-super-components,1.4.3,1.5.0,26,1,4,1547,1551,14,FALSE
react-super-components,1.5.0,1.6.0,27,1,1,0,1,1,FALSE
react-super-components,1.3.0,1.4.0,22,11,457,383,840,23,FALSE
react-super-components,1.2.2,1.3.0,21,3,156,66,222,4,FALSE
react-super-components,1.2.0,1.2.1,19,1,2,1,3,2,FALSE
react-super-components,1.2.1,1.2.2,20,1,7,0,7,2,FALSE
react-super-components,1.1.0,1.2.0,18,1,350,41,391,11,TRUE
react-super-components,0.3.2,0.3.3,6,5,69,39,108,12,TRUE
react-super-components,0.3.5,0.3.6,9,4,37,33,70,5,TRUE
react-super-components,1.2.0,1.2.1,19,1,2,1,3,2,TRUE
react-super-components,1.0.0,1.1.0,17,7,1137,700,1837,41,TRUE
react-super-components,1.5.0,1.6.0,27,1,1,0,1,1,TRUE
react-super-components,1.4.0,1.4.1,23,9,155,171,326,17,TRUE
react-super-components,0.3.1,0.3.2,5,10,412,155,567,30,TRUE
react-super-components,0.3.7,0.3.8,11,6,1529,319,1848,21,TRUE
react-super-components,1.6.3,1.6.4,31,1,1,1,2,1,TRUE
bore,1.0.0,1.0.1,1,2,5,1,6,2,FALSE
bore,1.0.1,1.0.2,2,1,1,1,2,1,FALSE
bore,1.2.0,2.0.0,10,10,811,450,1261,20,TRUE
bore,2.0.0,2.0.1,11,1,42,21,63,3,TRUE
bore,1.0.4,1.0.5,5,1,1,1,2,1,FALSE
bore,1.0.5,1.0.6,6,5,254,161,415,14,FALSE
bore,1.0.6,1.1.0,7,1,116,4,120,3,FALSE
bore,1.0.3,1.0.4,4,2,1,1,2,2,FALSE
bore,1.1.0,1.1.1,8,3,27,13,40,3,FALSE
bore,2.0.0,2.0.1,11,1,42,21,63,3,FALSE
bore,1.1.1,1.2.0,9,7,962,608,1570,18,FALSE
bore,1.2.0,2.0.0,10,10,811,450,1261,20,FALSE
bore,1.0.2,1.0.3,3,1,12,4,16,2,FALSE
pixi-stick,0.0.1,0.0.2,1,1,1,0,1,2,FALSE
pixi-stick,0.0.5,0.0.6,5,2,1121,1431,2552,23,FALSE
pixi-stick,0.0.4,0.0.5,4,1,3,9,12,3,FALSE
pixi-stick,0.0.6,0.0.7,6,3,173,168,341,16,FALSE
pixi-stick,0.0.3,0.0.4,3,5,1512,1223,2735,51,FALSE
pixi-stick,0.1.1,0.1.2,8,1,28,328,356,7,FALSE
pixi-stick,0.0.7,0.1.1,7,4,325,354,679,22,FALSE
pixi-stick,0.0.2,0.0.3,2,15,36068,35262,71330,81,FALSE
pixi-stick,0.1.1,0.1.2,8,1,28,328,356,7,TRUE
xen-api,0.3.1,0.3.2,7,14,152,24,176,17,TRUE
xen-api,0.7.2,0.7.3,30,2,2,2,4,2,FALSE
xen-api,0.6.6,0.6.7,24,3,18,11,29,3,FALSE
xen-api,0.7.0,0.7.1,28,2,2,2,4,2,FALSE
xen-api,0.2.1,0.3.0,5,2,9,1,10,2,FALSE
xen-api,0.2.0,0.2.1,4,2,4,4,8,2,FALSE
xen-api,0.1.0,0.1.1,2,3,75,30,105,4,FALSE
xen-api,0.1.1,0.2.0,3,2,2,13,15,2,FALSE
xen-api,0.7.1,0.7.2,29,2,2,2,4,2,FALSE
xen-api,0.6.9,0.7.0,27,4,26,8,34,4,FALSE
xen-api,0.6.8,0.6.9,26,2,9,7,16,2,FALSE
xen-api,0.0.0,0.1.0,1,3,32,6,38,3,TRUE
xen-api,0.6.3,0.6.4,21,5,17,10,27,6,FALSE
xen-api,0.6.2,0.6.3,20,5,25,5,30,5,FALSE
xen-api,0.7.4,0.8.0-0,32,3,48,17,65,4,FALSE
xen-api,0.6.0,0.6.1,18,3,81,33,114,4,FALSE
xen-api,0.6.7,0.6.8,25,7,50,40,90,11,FALSE
xen-api,0.7.3,0.7.4,31,4,23,13,36,4,FALSE
xen-api,0.6.5,0.6.6,23,4,22,18,40,5,FALSE
xen-api,0.6.4,0.6.5,22,3,27,3,30,5,FALSE
xen-api,0.5.4,0.5.5,15,19,185,63,248,26,FALSE
xen-api,0.4.0,0.5.0,10,3,78,2,80,5,FALSE
xen-api,0.5.6,0.6.0,17,12,223,120,343,13,TRUE
xen-api,0.5.0,0.5.1,11,2,3,1,4,2,FALSE
xen-api,0.5.1,0.5.2,12,3,3,3,6,3,TRUE
xen-api,0.5.2,0.5.3,13,3,5,5,10,3,FALSE
xen-api,0.5.3,0.5.4,14,3,16,2,18,3,TRUE
xen-api,0.5.5,0.5.6,16,6,54,21,75,11,FALSE
xen-api,0.6.1,0.6.2,19,2,2,2,4,2,FALSE
xen-api,0.8.0-0,0.8.0,33,2,10,1,11,2,FALSE
xen-api,0.3.2,0.3.3,8,2,4,4,8,2,FALSE
xen-api,0.3.0,0.3.1,6,5,43,120,163,5,FALSE
xen-api,0.10.0,0.11.0,46,5,1155,1206,2361,11,FALSE
xen-api,0.11.0,0.12.0,47,4,368,297,665,7,FALSE
xen-api,0.12.1,0.12.2,49,2,152,63,215,6,FALSE
xen-api,0.12.0,0.12.1,48,2,20,22,42,4,FALSE
xen-api,0.5.6,0.6.0,17,12,223,120,343,13,FALSE
xen-api,0.5.1,0.5.2,12,3,3,3,6,3,FALSE
xen-api,0.5.3,0.5.4,14,3,16,2,18,3,FALSE
xen-api,0.9.0,0.9.1-0,35,4,16,6,22,4,FALSE
xen-api,0.9.1,0.9.2,37,6,38,32,70,7,FALSE
xen-api,0.9.2,0.9.3,38,2,2,2,4,2,FALSE
xen-api,0.9.3,0.9.4,39,2,35,22,57,2,FALSE
xen-api,0.9.4,0.9.5,40,9,55,93,148,20,FALSE
xen-api,0.9.5,0.9.6,41,2,6,20,26,2,FALSE
xen-api,0.9.6,0.10.0-0,42,8,3704,41,3745,11,FALSE
xen-api,0.8.0,0.9.0,34,14,319,261,580,27,FALSE
xen-api,0.9.1-0,0.9.1,36,1,1,1,2,1,FALSE
xen-api,0.10.0-0,0.10.0-1,43,4,277,179,456,5,FALSE
xen-api,0.10.0-1,0.10.0-2,44,1,1,1,2,1,FALSE
xen-api,0.10.0-2,0.10.0,45,8,688,544,1232,13,FALSE
xen-api,0.9.0,0.9.1-0,35,4,16,6,22,4,TRUE
xen-api,0.0.0,0.1.0,1,3,32,6,38,3,FALSE
xen-api,0.3.1,0.3.2,7,14,152,24,176,17,FALSE
xen-api,0.4.0,0.5.0,10,3,78,2,80,5,TRUE
xen-api,0.6.0,0.6.1,18,3,81,33,114,4,TRUE
xen-api,0.10.0-2,0.10.0,45,8,688,544,1232,13,TRUE
xen-api,0.11.0,0.12.0,47,4,368,297,665,7,TRUE
xen-api,0.10.0,0.11.0,46,5,1155,1206,2361,11,TRUE
xen-api,0.3.0,0.3.1,6,5,43,120,163,5,TRUE
xen-api,0.5.5,0.5.6,16,6,54,21,75,11,TRUE
ranka,0.1.0,0.1.1,1,1,126,52,178,5,FALSE
ranka,0.1.1,0.1.2,2,1,23,6,29,2,FALSE
ranka,0.1.2,0.1.3,3,2,136,18,154,6,FALSE
ranka,0.1.3,0.1.4,4,3,77,18,95,6,FALSE
ranka,0.1.4,0.1.5,5,2,45,18,63,4,FALSE
ranka,0.1.5,0.1.6,6,3,77,8,85,5,FALSE
ranka,0.1.6,1.0.0,7,1,6,6,12,1,TRUE
ranka,0.1.4,0.1.5,5,2,45,18,63,4,TRUE
ranka,0.1.6,1.0.0,7,1,6,6,12,1,FALSE
postcss,1.0.0,2.0.0,9,68,4724,3867,8591,185,FALSE
postcss,5.0.18,5.0.19,71,3,18,8,26,6,FALSE
postcss,5.0.19,5.0.20,72,39,167,134,301,62,FALSE
postcss,5.0.12,5.0.13,65,81,2030,1603,3633,133,FALSE
postcss,5.0.13,5.0.14,66,33,72,28,100,37,FALSE
postcss,5.0.10,5.0.11,63,50,142,91,233,53,FALSE
postcss,5.0.11,5.0.12,64,11,49,17,66,15,FALSE
postcss,5.0.16,5.0.17,69,25,1129,1037,2166,54,FALSE
postcss,5.0.17,5.0.18,70,12,54,24,78,15,FALSE
postcss,5.0.14,5.0.15,67,58,180,333,513,74,FALSE
postcss,5.0.15,5.0.16,68,10,278,211,489,27,FALSE
postcss,4.0.1,4.0.2,30,6,43,11,54,9,FALSE
postcss,4.0.0,4.0.1,29,16,282,64,346,42,FALSE
postcss,4.0.3,4.0.4,32,55,2011,1581,3592,135,FALSE
postcss,4.0.2,4.0.3,31,3,252,230,482,18,FALSE
postcss,4.0.5,4.0.6,34,6,14,10,24,7,FALSE
postcss,4.0.4,4.0.5,33,76,1499,1214,2713,87,FALSE
postcss,4.0.6,4.1.0,35,127,4161,2443,6604,266,FALSE
postcss,0.3.2,0.3.3,5,4,11,14,25,7,FALSE
postcss,0.3.3,0.3.4,6,4,11,5,16,6,FALSE
postcss,0.3.0,0.3.1,3,11,113,26,139,15,FALSE
postcss,0.3.1,0.3.2,4,2,45,10,55,4,FALSE
postcss,0.3.4,0.3.5,7,16,118,33,151,20,FALSE
postcss,0.3.5,1.0.0,8,45,1031,556,1587,119,FALSE
postcss,5.2.2,5.2.3,80,3,72,42,114,8,FALSE
postcss,5.2.3,5.2.4,81,4,177,174,351,13,FALSE
postcss,5.2.0,5.2.1,78,20,123,71,194,29,FALSE
postcss,5.2.1,5.2.2,79,2,9,4,13,4,FALSE
postcss,5.2.6,5.2.7,84,11,4633,77,4710,18,FALSE
postcss,5.2.7,5.2.8,85,4,20,14,34,6,FALSE
postcss,5.2.4,5.2.5,82,5,39,24,63,10,FALSE
postcss,5.2.5,5.2.6,83,21,86,50,136,28,FALSE
postcss,5.2.8,5.2.9,86,17,1442,2484,3926,46,FALSE
postcss,5.2.9,5.2.10,87,3,32,27,59,6,FALSE
postcss,5.0.0,5.0.1,53,6,49,13,62,10,FALSE
postcss,5.0.1,5.0.2,54,9,80,32,112,18,FALSE
postcss,5.0.2,5.0.3,55,47,299,262,561,53,FALSE
postcss,5.0.3,5.0.4,56,18,119,71,190,33,FALSE
postcss,5.0.4,5.0.5,57,47,595,507,1102,76,FALSE
postcss,5.0.5,5.0.6,58,31,91,34,125,36,FALSE
postcss,5.0.6,5.0.7,59,8,41,26,67,9,FALSE
postcss,5.0.7,5.0.8,60,1,5,1,6,2,FALSE
postcss,5.0.8,5.0.9,61,25,137,62,199,30,FALSE
postcss,5.0.9,5.0.10,62,8,36,10,46,10,FALSE
postcss,3.0.6,3.0.7,27,6,85,27,112,10,FALSE
postcss,3.0.7,4.0.0,28,59,2326,1266,3592,217,FALSE
postcss,3.0.4,3.0.5,25,15,943,392,1335,35,FALSE
postcss,3.0.5,3.0.6,26,9,171,138,309,66,FALSE
postcss,3.0.2,3.0.3,23,7,24,13,37,9,FALSE
postcss,3.0.3,3.0.4,24,2,16,4,20,4,FALSE
postcss,3.0.0,3.0.1,21,11,32,74,106,14,FALSE
postcss,3.0.1,3.0.2,22,4,79,29,108,7,FALSE
postcss,4.1.4,4.1.5,40,22,318,137,455,29,FALSE
postcss,4.1.5,4.1.6,41,23,74,35,109,26,FALSE
postcss,4.1.6,4.1.7,42,35,378,366,744,43,FALSE
postcss,4.1.7,4.1.8,43,4,31,19,50,8,FALSE
postcss,4.1.0,4.1.1,36,5,35,26,61,10,FALSE
postcss,4.1.1,4.1.2,37,4,24,5,29,6,FALSE
postcss,4.1.2,4.1.3,38,29,148,109,257,61,FALSE
postcss,4.1.3,4.1.4,39,11,34,23,57,15,FALSE
postcss,4.1.8,4.1.9,44,28,288,58,346,34,FALSE
postcss,4.1.9,4.1.10,45,35,366,266,632,45,FALSE
postcss,5.2.14,5.2.15,92,9,68,48,116,13,FALSE
postcss,5.2.15,5.2.16,93,11,158,122,280,20,FALSE
postcss,5.2.16,5.2.17,94,12,323,222,545,16,FALSE
postcss,5.2.17,6.0.0,95,43,4653,5340,9993,133,FALSE
postcss,5.2.10,5.2.11,88,3,453,491,944,6,FALSE
postcss,5.2.11,5.2.12,89,7,702,697,1399,13,FALSE
postcss,5.2.12,5.2.13,90,5,185,167,352,11,FALSE
postcss,5.2.13,5.2.14,91,4,19,10,29,7,FALSE
postcss,5.0.21,5.1.0,74,116,6710,6694,13404,248,FALSE
postcss,5.0.20,5.0.21,73,2,19,4,23,4,FALSE
postcss,2.0.0,2.1.0,10,7,161,58,219,17,FALSE
postcss,2.2.5,2.2.6,19,26,194,110,304,29,FALSE
postcss,2.2.4,2.2.5,18,10,445,422,867,12,FALSE
postcss,2.2.6,3.0.0,20,110,4255,3233,7488,305,FALSE
postcss,2.2.1,2.2.2,15,10,88,47,135,13,FALSE
postcss,2.2.0,2.2.1,14,11,122,52,174,14,FALSE
postcss,2.2.3,2.2.4,17,6,22,10,32,8,FALSE
postcss,2.2.2,2.2.3,16,1,11,1,12,2,FALSE
postcss,6.0.0,6.0.1,96,5,16,21,37,7,FALSE
postcss,0.2.0,0.3.0,2,73,2474,1428,3902,239,FALSE
postcss,2.1.2,2.2.0,13,8,82,28,110,14,FALSE
postcss,2.1.0,2.1.1,11,16,250,79,329,43,FALSE
postcss,2.1.1,2.1.2,12,6,41,26,67,11,FALSE
postcss,4.1.16,5.0.0,52,285,8012,7392,15404,690,FALSE
postcss,4.1.14,4.1.15,50,12,92,35,127,15,FALSE
postcss,4.1.15,4.1.16,51,2,11,6,17,5,FALSE
postcss,4.1.12,4.1.13,48,7,42,10,52,9,FALSE
postcss,4.1.13,4.1.14,49,34,186,130,316,38,FALSE
postcss,4.1.10,4.1.11,46,13,129,694,823,34,FALSE
postcss,4.1.11,4.1.12,47,87,468,377,845,93,FALSE
postcss,5.1.1,5.1.2,76,8,69,23,92,13,FALSE
postcss,5.1.0,5.1.1,75,10,31,15,46,15,FALSE
postcss,5.1.2,5.2.0,77,27,395,224,619,49,FALSE
postcss,4.1.5,4.1.6,41,23,74,35,109,26,TRUE
postcss,4.0.5,4.0.6,34,6,14,10,24,7,TRUE
postcss,5.0.5,5.0.6,58,31,91,34,125,36,TRUE
postcss,5.0.0,5.0.1,53,6,49,13,62,10,TRUE
postcss,2.0.0,2.1.0,10,7,161,58,219,17,TRUE
postcss,2.1.0,2.1.1,11,16,250,79,329,43,TRUE
postcss,0.1.0,0.2.0,1,39,1676,593,2269,106,FALSE
postcss,5.1.1,5.1.2,76,8,69,23,92,13,TRUE
postcss,4.1.12,4.1.13,48,7,42,10,52,9,TRUE
postcss,3.0.6,3.0.7,27,6,85,27,112,10,TRUE
postcss,0.3.4,0.3.5,7,16,118,33,151,20,TRUE
postcss,4.0.1,4.0.2,30,6,43,11,54,9,TRUE
postcss,4.0.3,4.0.4,32,55,2011,1581,3592,135,TRUE
postcss,4.0.2,4.0.3,31,3,252,230,482,18,TRUE
postcss,3.0.2,3.0.3,23,7,24,13,37,9,TRUE
postcss,3.0.0,3.0.1,21,11,32,74,106,14,TRUE
postcss,3.0.1,3.0.2,22,4,79,29,108,7,TRUE
postcss,4.1.4,4.1.5,40,22,318,137,455,29,TRUE
postcss,4.1.7,4.1.8,43,4,31,19,50,8,TRUE
postcss,4.1.8,4.1.9,44,28,288,58,346,34,TRUE
postcss,5.2.10,5.2.11,88,3,453,491,944,6,TRUE
postcss,5.2.12,5.2.13,90,5,185,167,352,11,TRUE
postcss,5.2.2,5.2.3,80,3,72,42,114,8,TRUE
postcss,4.1.10,4.1.11,46,13,129,694,823,34,TRUE
postcss,5.0.2,5.0.3,55,47,299,262,561,53,TRUE
postcss,5.2.11,5.2.12,89,7,702,697,1399,13,TRUE
postcss,5.2.8,5.2.9,86,17,1442,2484,3926,46,TRUE
postcss,4.0.6,4.1.0,35,127,4161,2443,6604,266,TRUE
postcss,4.1.9,4.1.10,45,35,366,266,632,45,TRUE
postcss,4.1.0,4.1.1,36,5,35,26,61,10,TRUE
postcss,4.1.2,4.1.3,38,29,148,109,257,61,TRUE
postcss,5.0.10,5.0.11,63,50,142,91,233,53,TRUE
postcss,5.2.15,5.2.16,93,11,158,122,280,20,TRUE
postcss,5.0.4,5.0.5,57,47,595,507,1102,76,TRUE
postcss,5.0.15,5.0.16,68,10,278,211,489,27,TRUE
short-term-memory,0.0.1,0.0.2,1,2,75,15,90,6,TRUE
short-term-memory,0.0.2,0.0.3,2,5,80,27,107,6,FALSE
short-term-memory,0.0.1,0.0.2,1,2,75,15,90,6,FALSE
animakit-core,2.0.0-beta.1,2.0.0,12,4,15,11,26,5,FALSE
animakit-core,2.0.0-beta,2.0.0-beta.1,11,2,13,3,16,3,FALSE
animakit-core,1.1.0,2.0.0-beta,10,3,196,12,208,8,FALSE
animakit-core,1.0.4,1.0.5,5,2,1,18,19,2,FALSE
animakit-core,1.0.5,1.0.6,6,1,19,3,22,2,FALSE
animakit-core,1.0.6,1.0.7,7,1,5,4,9,2,FALSE
animakit-core,1.0.7,1.0.8,8,4,59,6,65,5,FALSE
animakit-core,1.0.0,1.0.1,1,1,2,2,4,1,FALSE
animakit-core,1.0.1,1.0.2,2,2,11,7,18,4,FALSE
animakit-core,1.0.2,1.0.3,3,2,18,5,23,3,FALSE
animakit-core,1.0.3,1.0.4,4,1,3,3,6,2,FALSE
animakit-core,1.0.1,1.0.2,2,2,11,7,18,4,TRUE
animakit-core,1.0.8,1.1.0,9,5,13,12,25,8,FALSE
super-res,0.0.4,1.0.0,4,7,500,156,656,20,FALSE
super-res,3.1.0,3.1.1,12,6,256,36,292,28,FALSE
super-res,0.0.1,0.0.2,1,2,56,18,74,8,FALSE
super-res,2.0.1,2.0.2,7,2,2,2,4,2,FALSE
super-res,0.0.3,0.0.4,3,5,90,29,119,8,FALSE
super-res,2.0.0,2.0.1,6,2,63,23,86,5,FALSE
super-res,0.0.2,0.0.3,2,2,9,6,15,2,FALSE
super-res,3.0.1,3.1.0,11,4,589,547,1136,20,FALSE
super-res,3.0.0,3.0.1,10,4,608,571,1179,16,FALSE
super-res,2.0.3,3.0.0,9,7,256,57,313,13,FALSE
super-res,1.0.0,2.0.0,5,2,186,27,213,8,FALSE
super-res,2.0.2,2.0.3,8,2,12,6,18,6,FALSE
super-res,1.0.0,2.0.0,5,2,186,27,213,8,TRUE
super-res,0.0.3,0.0.4,3,5,90,29,119,8,TRUE
super-res,0.0.1,0.0.2,1,2,56,18,74,8,TRUE
hypernova-amp,2.0.0,2.0.1,6,3,9,3,12,4,FALSE
hypernova-amp,1.4.0,2.0.0,5,3,201,33,234,18,FALSE
hypernova-amp,1.1.0,1.2.0,2,3,115,3,118,10,FALSE
hypernova-amp,1.0.0,1.1.0,1,4,107,23,130,7,FALSE
hypernova-amp,1.3.0,1.4.0,4,3,23,1,24,6,FALSE
hypernova-amp,1.2.0,1.3.0,3,3,37,27,64,8,FALSE
hypernova-amp,1.0.0,1.1.0,1,4,107,23,130,7,TRUE
hdu-cas-client,0.3.2,0.3.3,3,3,109,105,214,8,FALSE
hdu-cas-client,0.3.3,0.3.4,4,3,84,67,151,6,FALSE
hdu-cas-client,0.3.0,0.3.1,1,5,407,765,1172,18,FALSE
hdu-cas-client,0.3.1,0.3.2,2,4,166,112,278,17,FALSE
hdu-cas-client,0.3.3,0.3.4,4,3,84,67,151,6,TRUE
hdu-cas-client,0.3.1,0.3.2,2,4,166,112,278,17,TRUE
hdu-cas-client,0.3.2,0.3.3,3,3,109,105,214,8,TRUE
archmage-client,0.3.2,0.3.3,5,2,4,2,6,2,FALSE
archmage-client,0.3.3,0.3.4,6,2,2,2,4,2,FALSE
archmage-client,0.3.0,0.3.1,3,2,3,1,4,2,FALSE
archmage-client,0.3.1,0.3.2,4,2,5,7,12,3,FALSE
archmage-client,0.3.6,0.3.7,9,3,6,3,9,3,FALSE
archmage-client,0.3.7,0.4.0,10,3,105,90,195,6,FALSE
archmage-client,0.3.4,0.3.5,7,2,5,5,10,3,FALSE
archmage-client,0.3.5,0.3.6,8,3,28,20,48,7,FALSE
archmage-client,0.4.0,0.4.1,11,2,3,3,6,2,FALSE
archmage-client,0.2.0,0.3.0,2,2,44,4,48,3,FALSE
archmage-client,0.1.0,0.2.0,1,4,24,47,71,10,FALSE
archmage-client,0.5.14,0.5.15,33,2,39,16,55,2,FALSE
archmage-client,0.5.15,0.5.16,34,1,1,1,2,1,FALSE
archmage-client,0.5.12,0.5.13,31,11,161,63,224,17,FALSE
archmage-client,0.5.13,0.5.14,32,2,17,12,29,4,FALSE
archmage-client,0.5.10,0.5.11,29,5,15,9,24,6,FALSE
archmage-client,0.5.11,0.5.12,30,4,17,2,19,4,FALSE
archmage-client,0.5.8,0.5.9,27,1,1,1,2,1,FALSE
archmage-client,0.5.9,0.5.10,28,1,1,1,2,1,FALSE
archmage-client,0.5.4,0.5.5,23,2,120,104,224,3,FALSE
archmage-client,0.5.5,0.5.6,24,2,8,7,15,4,FALSE
archmage-client,0.5.6,0.5.7,25,2,6,3,9,3,FALSE
archmage-client,0.5.7,0.5.8,26,2,19,16,35,3,FALSE
archmage-client,0.4.5,0.4.6,16,2,44,38,82,4,FALSE
archmage-client,0.4.4,0.4.5,15,2,17,11,28,4,FALSE
archmage-client,0.4.7,0.5.0,18,3,60,53,113,5,FALSE
archmage-client,0.4.6,0.4.7,17,2,3,2,5,2,FALSE
archmage-client,0.4.1,0.4.2,12,2,5,5,10,4,FALSE
archmage-client,0.4.3,0.4.4,14,2,37,22,59,6,FALSE
archmage-client,0.4.2,0.4.3,13,2,34,28,62,3,FALSE
archmage-client,0.5.0,0.5.1,19,2,2,2,4,2,FALSE
archmage-client,0.5.1,0.5.2,20,5,44,15,59,7,FALSE
archmage-client,0.5.2,0.5.3,21,2,14,9,23,2,FALSE
archmage-client,0.5.3,0.5.4,22,3,37,9,46,7,FALSE
archmage-client,0.3.3,0.3.4,6,2,2,2,4,2,TRUE
archmage-client,0.5.1,0.5.2,20,5,44,15,59,7,TRUE
archmage-client,0.1.0,0.2.0,1,4,24,47,71,10,TRUE
archmage-client,0.5.15,0.5.16,34,1,1,1,2,1,TRUE
archmage-client,0.3.6,0.3.7,9,3,6,3,9,3,TRUE
archmage-client,0.3.5,0.3.6,8,3,28,20,48,7,TRUE
archmage-client,0.5.5,0.5.6,24,2,8,7,15,4,TRUE
archmage-client,0.4.2,0.4.3,13,2,34,28,62,3,TRUE
nxus-data-manager,4.0.0-1,4.0.0-2,1,7,280,58,338,9,FALSE
nxus-data-manager,4.0.0-2,4.0.0-3,2,2,1,2,3,2,FALSE
nxus-data-manager,4.0.0-1,4.0.0-2,1,7,280,58,338,9,TRUE
react-redux,5.0.0-beta.2,5.0.0-beta.3,54,2,2,44,46,3,FALSE
react-redux,5.0.0-rc.2,5.0.0,57,1,1,1,2,1,FALSE
react-redux,5.0.0-rc.1,5.0.0-rc.2,56,3,200,208,408,6,FALSE
react-redux,5.0.3,5.0.4,61,9,551,503,1054,16,FALSE
react-redux,5.0.4,5.0.5,62,9,278,487,765,16,FALSE
react-redux,5.0.0-beta.3,5.0.0-rc.1,55,9,4015,314,4329,19,FALSE
react-redux,5.0.2,5.0.3,60,18,718,544,1262,25,FALSE
react-redux,5.0.1,5.0.2,59,10,203,155,358,12,FALSE
react-redux,5.0.0,5.0.1,58,4,39,12,51,4,FALSE
react-redux,5.0.0-alpha.1,5.0.0-beta.1,52,12,1314,493,1807,46,FALSE
react-redux,5.0.0-beta.1,5.0.0-beta.2,53,9,243,108,351,20,FALSE
react-redux,4.4.5,4.4.6,48,121,5222,3736,8958,312,TRUE
react-redux,4.4.4,4.4.5,47,5,152,24,176,6,TRUE
react-redux,4.4.7,4.4.8,50,7,549,502,1051,14,FALSE
react-redux,4.4.6,4.4.7,49,45,5125,1232,6357,66,FALSE
react-redux,4.4.1,4.4.2,44,11,164,46,210,22,TRUE
react-redux,4.4.0,4.4.1,43,12,34,32,66,19,FALSE
react-redux,4.4.3,4.4.4,46,3,127,13,140,5,FALSE
react-redux,4.4.2,4.4.3,45,6,239,163,402,10,FALSE
react-redux,4.2.1,4.3.0,41,9,436,243,679,12,FALSE
react-redux,4.2.0,4.2.1,40,5,115,62,177,13,TRUE
react-redux,4.3.0,4.4.0,42,2,1,2,3,2,FALSE
react-redux,3.1.1,3.1.2,28,4,107,8,115,6,FALSE
react-redux,3.1.0,3.1.1,27,43,2730,2842,5572,134,FALSE
react-redux,4.0.1,4.0.2,31,7,193,21,214,9,FALSE
react-redux,4.0.0,4.0.1,30,37,1871,1759,3630,93,FALSE
react-redux,4.0.3,4.0.4,33,3,6,4,10,3,FALSE
react-redux,4.0.2,4.0.3,32,5,287,137,424,7,FALSE
react-redux,4.0.5,4.0.6,35,4,69,45,114,17,FALSE
react-redux,4.1.1,4.1.2,38,2,30,20,50,2,FALSE
react-redux,4.1.2,4.2.0,39,3,38,88,126,10,FALSE
react-redux,4.0.6,4.1.0,36,5,44,27,71,6,FALSE
react-redux,4.1.0,4.1.1,37,2,3,2,5,2,FALSE
react-redux,4.0.4,4.0.5,34,2,2,2,4,2,FALSE
react-redux,4.4.5,4.4.6,48,121,5222,3736,8958,312,FALSE
react-redux,4.4.4,4.4.5,47,5,152,24,176,6,FALSE
react-redux,4.4.1,4.4.2,44,11,164,46,210,22,FALSE
react-redux,4.2.0,4.2.1,40,5,115,62,177,13,FALSE
react-redux,1.0.0,1.0.1,18,4,4,4,8,4,FALSE
react-redux,1.0.1,2.0.0,19,10,155,119,274,16,FALSE
react-redux,3.0.0,3.0.1,25,4,123,1,124,5,FALSE
react-redux,2.0.0,2.1.0,20,15,195,44,239,18,FALSE
react-redux,1.0.0-alpha,1.0.0,17,141,6438,4486,10924,291,FALSE
react-redux,0.1.0,0.2.0,1,4,6,4,10,4,FALSE
react-redux,0.2.2,0.3.0,4,30,1869,1684,3553,98,FALSE
react-redux,0.2.1,0.2.2,3,3,6,11,17,4,FALSE
react-redux,0.2.0,0.2.1,2,1,1,1,2,1,FALSE
react-redux,2.1.2,3.0.0-alpha,23,10,1093,1005,2098,16,TRUE
react-redux,2.1.0,2.1.1,21,5,110,27,137,9,FALSE
react-redux,2.1.1,2.1.2,22,2,3,3,6,2,FALSE
react-redux,0.3.0,0.4.0,5,2,29,152,181,10,FALSE
react-redux,0.6.0,0.7.0,11,6,139,131,270,7,FALSE
react-redux,0.7.0,0.8.0,12,9,199,39,238,13,FALSE
react-redux,0.4.0,0.5.0,6,25,1936,1423,3359,66,FALSE
react-redux,3.0.0-alpha,3.0.0,24,5,135,34,169,6,FALSE
react-redux,0.5.0,0.5.1,7,13,128,115,243,14,FALSE
react-redux,0.5.1,0.5.2,8,5,129,39,168,7,FALSE
react-redux,0.5.2,0.5.3,9,2,56,10,66,3,FALSE
react-redux,0.5.3,0.6.0,10,3,447,371,818,9,FALSE
react-redux,0.8.1,0.8.2,14,5,153,65,218,6,FALSE
react-redux,0.8.0,0.8.1,13,8,115,15,130,10,FALSE
react-redux,0.8.2,0.9.0,15,10,522,69,591,15,FALSE
react-redux,3.0.1,3.1.0,26,10,107,63,170,19,FALSE
react-redux,2.1.2,3.0.0-alpha,23,10,1093,1005,2098,16,FALSE
react-redux,1.0.1,2.0.0,19,10,155,119,274,16,TRUE
react-redux,4.0.6,4.1.0,36,5,44,27,71,6,TRUE
react-redux,4.1.1,4.1.2,38,2,30,20,50,2,TRUE
react-redux,4.2.1,4.3.0,41,9,436,243,679,12,TRUE
react-redux,4.0.4,4.0.5,34,2,2,2,4,2,TRUE
react-redux,3.0.0-alpha,3.0.0,24,5,135,34,169,6,TRUE
react-redux,1.0.0,1.0.1,18,4,4,4,8,4,TRUE
react-redux,2.0.0,2.1.0,20,15,195,44,239,18,TRUE
react-redux,0.2.2,0.3.0,4,30,1869,1684,3553,98,TRUE
react-redux,4.0.3,4.0.4,33,3,6,4,10,3,TRUE
react-redux,5.0.0-alpha.1,5.0.0-beta.1,52,12,1314,493,1807,46,TRUE
react-redux,5.0.0-rc.1,5.0.0-rc.2,56,3,200,208,408,6,TRUE
react-redux,5.0.2,5.0.3,60,18,718,544,1262,25,TRUE
react-redux,4.1.0,4.1.1,37,2,3,2,5,2,TRUE
react-redux,3.1.0,3.1.1,27,43,2730,2842,5572,134,TRUE
react-redux,0.1.0,0.2.0,1,4,6,4,10,4,TRUE
react-redux,2.1.1,2.1.2,22,2,3,3,6,2,TRUE
react-redux,4.0.0,4.0.1,30,37,1871,1759,3630,93,TRUE
react-redux,4.1.2,4.2.0,39,3,38,88,126,10,TRUE
serializerjs,1.0.0-beta,1.0.0-beta.1,1,15,1710,416,2126,88,TRUE
serializerjs,1.0.0-beta,1.0.0-beta.1,1,15,1710,416,2126,88,FALSE
ubique,0.5.0,0.5.1,21,2,1993,2111,4104,11,FALSE
ubique,0.1.4,0.1.5,14,8,442,354,796,52,FALSE
ubique,0.1.5,0.1.6,15,3,1103,807,1910,40,FALSE
ubique,0.1.8,0.1.9,18,5,1561,1119,2680,66,FALSE
ubique,0.1.9,0.2.0,19,1,73,7,80,1,FALSE
ubique,0.2.0,0.5.0,20,10,22203,19770,41973,526,FALSE
ubique,0.1.1,0.1.2,11,3,169,73,242,21,FALSE
ubique,0.1.2,0.1.3,12,1,1370,570,1940,25,FALSE
ubique,0.1.3,0.1.4,13,16,11590,4399,15989,972,FALSE
ubique,0.1.6,0.1.7,16,1,1081,398,1479,19,FALSE
ubique,0.1.7,0.1.8,17,1,642,483,1125,12,FALSE
ubique,0.0.7,0.0.8,6,10,3554,954,4508,84,FALSE
ubique,0.0.6,0.0.7,5,9,1199,181,1380,40,FALSE
ubique,0.0.5,0.0.6,4,3,252,156,408,23,FALSE
ubique,0.1.5,0.1.6,15,3,1103,807,1910,40,TRUE
ubique,0.1.9,0.2.0,19,1,73,7,80,1,TRUE
ubique,0.0.4,0.0.5,3,9,13827,6793,20620,88,FALSE
ubique,0.0.3,0.0.4,2,8,353,28,381,20,FALSE
ubique,0.0.8,0.0.9,7,17,5016,657,5673,263,FALSE
ubique,0.0.21,0.1.0,9,58,24244,8769,33013,527,FALSE
ubique,0.1.0,0.1.1,10,5,12305,257,12562,37,FALSE
ubique,0.1.3,0.1.4,13,16,11590,4399,15989,972,TRUE
pnpm-logger,0.1.0,0.2.0,3,2,2,2,4,2,FALSE
pnpm-logger,0.0.1,0.1.0,2,2,13,8,21,2,FALSE
pnpm-logger,0.0.0,0.0.1,1,2,2,2,4,2,FALSE
pnpm-logger,0.2.0,0.3.0,4,4,576,12,588,5,FALSE
pnpm-logger,0.1.0,0.2.0,3,2,2,2,4,2,TRUE
pnpm-logger,0.0.1,0.1.0,2,2,13,8,21,2,TRUE
pnpm-logger,0.0.0,0.0.1,1,2,2,2,4,2,TRUE
pnpm-logger,0.2.0,0.3.0,4,4,576,12,588,5,TRUE
usgs-earthquake-reports,0.2.2,0.2.3,3,11,59,53,112,11,FALSE
usgs-earthquake-reports,0.2.1,0.2.2,2,19,1579,748,2327,44,FALSE
usgs-earthquake-reports,0.2.0,0.2.1,1,6,12,12,24,12,FALSE
usgs-earthquake-reports,0.2.1,0.2.2,2,19,1579,748,2327,44,TRUE
icedfrisby,1.1.0,1.2.0,22,5,3577,3479,7056,17,FALSE
icedfrisby,1.0.0,1.1.0,21,8,776,427,1203,27,FALSE
icedfrisby,0.2.4,0.3.0,18,12,94,64,158,18,FALSE
icedfrisby,0.2.3,0.2.4,17,4,40,23,63,5,FALSE
icedfrisby,0.0.10,0.1.0,10,9,827,166,993,20,FALSE
icedfrisby,0.2.1,0.2.2,15,3,21,4,25,5,FALSE
icedfrisby,0.2.0,0.2.1,14,3,16,10,26,7,FALSE
icedfrisby,0.1.0,0.1.1,11,7,374,91,465,29,FALSE
icedfrisby,0.1.1,0.1.2,12,4,725,119,844,13,FALSE
icedfrisby,0.1.2,0.2.0,13,12,695,81,776,29,FALSE
icedfrisby,0.0.5,0.0.6,5,3,28,6,34,5,FALSE
icedfrisby,0.0.4,0.0.5,4,3,63,7,70,7,FALSE
icedfrisby,0.0.7,0.0.8,7,5,43,2,45,7,FALSE
icedfrisby,0.0.6,0.0.7,6,2,3,3,6,3,FALSE
icedfrisby,0.0.1,0.0.2,1,12,137,46,183,14,FALSE
icedfrisby,0.0.3,0.0.4,3,3,720,27,747,9,FALSE
icedfrisby,0.0.2,0.0.3,2,4,727,229,956,9,FALSE
icedfrisby,0.3.0,0.4.0,19,27,1115,617,1732,74,FALSE
icedfrisby,0.0.9,0.0.10,9,7,963,164,1127,13,FALSE
icedfrisby,0.0.8,0.0.9,8,5,97,9,106,6,FALSE
icedfrisby,0.4.0,1.0.0,20,1,4,1,5,2,FALSE
icedfrisby,0.2.2,0.2.3,16,4,47,4,51,8,FALSE
icedfrisby,0.2.3,0.2.4,17,4,40,23,63,5,TRUE
icedfrisby,0.1.2,0.2.0,13,12,695,81,776,29,TRUE
icedfrisby,0.0.8,0.0.9,8,5,97,9,106,6,TRUE
icedfrisby,0.2.0,0.2.1,14,3,16,10,26,7,TRUE
icedfrisby,0.0.2,0.0.3,2,4,727,229,956,9,TRUE
icedfrisby,0.0.6,0.0.7,6,2,3,3,6,3,TRUE
icedfrisby,0.2.4,0.3.0,18,12,94,64,158,18,TRUE
icedfrisby,0.0.1,0.0.2,1,12,137,46,183,14,TRUE
icedfrisby,1.1.0,1.2.0,22,5,3577,3479,7056,17,TRUE
icedfrisby,0.0.10,0.1.0,10,9,827,166,993,20,TRUE
angular-extends,0.2.7,0.2.8,7,1,6,6,12,4,FALSE
angular-extends,0.2.6,0.2.7,6,5,41,74,115,14,FALSE
angular-extends,0.2.5,0.2.6,5,3,15,23,38,6,FALSE
angular-extends,0.2.4,0.2.5,4,4,52,12,64,9,FALSE
angular-extends,0.2.3,0.2.4,3,5,56,209,265,12,FALSE
angular-extends,0.2.1,0.2.3,2,6,216,215,431,15,FALSE
angular-extends,0.2.0,0.2.1,1,2,239,107,346,18,FALSE
angular-extends,0.2.8,0.2.9,8,3,27,219,246,12,FALSE
angular-extends,0.2.11,0.2.12,10,3,12,12,24,8,FALSE
angular-extends,0.2.9,0.2.11,9,5,71,119,190,15,FALSE
angular-extends,0.2.8,0.2.9,8,3,27,219,246,12,TRUE
angular-extends,0.2.6,0.2.7,6,5,41,74,115,14,TRUE
angular-extends,0.2.1,0.2.3,2,6,216,215,431,15,TRUE
angular-extends,0.2.11,0.2.12,10,3,12,12,24,8,TRUE
angular-extends,0.2.7,0.2.8,7,1,6,6,12,4,TRUE
angular-extends,0.2.9,0.2.11,9,5,71,119,190,15,TRUE
6bin,1.0.4,1.0.5,5,1,1,1,2,1,FALSE
6bin,1.0.5,1.0.6,6,16,214,257,471,69,FALSE
6bin,1.0.6,1.0.7,7,1,1,1,2,1,FALSE
6bin,1.0.7,1.1.0,8,1,1,1,2,1,FALSE
6bin,1.0.0,1.0.1,1,1,22,6,28,2,FALSE
6bin,1.0.1,1.0.2,2,1,1,1,2,1,FALSE
6bin,1.0.2,1.0.3,3,1,1,1,2,1,FALSE
6bin,1.0.3,1.0.4,4,1,1,1,2,1,FALSE
6bin,1.2.10,1.2.11,20,3,37,7,44,7,FALSE
6bin,1.2.11,1.2.12,21,3,11,4,15,4,FALSE
6bin,1.2.12,1.2.13,22,5,5,5,10,5,FALSE
6bin,1.2.13,1.2.14,23,1,46,9,55,8,FALSE
6bin,1.2.14,1.2.15,24,1,1,1,2,1,FALSE
6bin,1.2.15,1.2.16,25,1,1,1,2,1,FALSE
6bin,1.2.16,1.2.17,26,3,9,9,18,5,FALSE
6bin,1.2.17,1.3.0,27,10,171,238,409,25,FALSE
6bin,1.2.6,1.2.7,16,4,298,119,417,23,FALSE
6bin,1.2.7,1.2.8,17,4,73,22,95,7,FALSE
6bin,1.2.4,1.2.5,14,1,15,5,20,3,FALSE
6bin,1.2.5,1.2.6,15,2,51,13,64,6,FALSE
6bin,1.2.2,1.2.3,12,1,1,1,2,1,FALSE
6bin,1.2.3,1.2.4,13,1,20,8,28,6,FALSE
6bin,1.2.0,1.2.1,10,1,9,7,16,2,FALSE
6bin,1.2.1,1.2.2,11,5,485,203,688,26,FALSE
6bin,1.2.8,1.2.9,18,5,118,216,334,69,FALSE
6bin,1.2.9,1.2.10,19,3,118,216,334,66,FALSE
6bin,1.1.0,1.2.0,9,14,967,733,1700,89,FALSE
6bin,1.3.1,1.3.2,29,1,5,2,7,2,FALSE
6bin,1.3.0,1.3.1,28,1,108,98,206,4,FALSE
6bin,1.3.1,1.3.2,29,1,5,2,7,2,TRUE
6bin,1.2.10,1.2.11,20,3,37,7,44,7,TRUE
6bin,1.2.8,1.2.9,18,5,118,216,334,69,TRUE
6bin,1.0.5,1.0.6,6,16,214,257,471,69,TRUE
6bin,1.1.0,1.2.0,9,14,967,733,1700,89,TRUE
6bin,1.2.17,1.3.0,27,10,171,238,409,25,TRUE
6bin,1.2.16,1.2.17,26,3,9,9,18,5,TRUE
6bin,1.2.7,1.2.8,17,4,73,22,95,7,TRUE
latlon-formatter,0.2.0,0.2.1,2,3,8,1,9,3,FALSE
latlon-formatter,0.1.0,0.2.0,1,15,624,150,774,51,FALSE
latlon-formatter,0.1.0,0.2.0,1,15,624,150,774,51,TRUE
react-redux-oop,1.0.4,1.0.5,5,1,1,1,2,1,FALSE
react-redux-oop,1.0.5,1.0.6,6,1,1,1,2,1,FALSE
react-redux-oop,1.0.6,1.0.7,7,1,1,1,2,1,FALSE
react-redux-oop,1.0.7,1.0.8,8,1,1,1,2,1,FALSE
react-redux-oop,1.0.0,1.0.1,1,1,6,5,11,1,FALSE
react-redux-oop,1.0.1,1.0.2,2,1,1,1,2,1,FALSE
react-redux-oop,1.0.2,1.0.3,3,2,60,40,100,8,FALSE
react-redux-oop,1.0.3,1.0.4,4,1,1,1,2,1,FALSE
react-redux-oop,1.0.8,1.0.9,9,1,1,1,2,1,FALSE
react-redux-oop,2.0.5,2.0.6,17,1,46,1,47,2,FALSE
react-redux-oop,2.0.7,2.1.0,19,1,25,42,67,2,FALSE
react-redux-oop,2.0.4,2.0.5,16,1,1,1,2,1,FALSE
react-redux-oop,2.1.3,2.1.4,23,1,1,1,2,1,FALSE
react-redux-oop,2.1.2,2.1.3,22,1,1,1,2,1,FALSE
react-redux-oop,2.0.3,2.0.4,15,1,2,2,4,2,FALSE
react-redux-oop,2.1.0,2.1.1,20,1,1,1,2,1,FALSE
react-redux-oop,2.1.1,2.1.2,21,1,1,1,2,1,FALSE
react-redux-oop,2.0.2,2.0.3,14,2,38,5,43,5,FALSE
react-redux-oop,2.0.1,2.0.2,13,1,1,1,2,1,FALSE
react-redux-oop,2.0.0,2.0.1,12,1,1,1,2,1,FALSE
react-redux-oop,2.0.6,2.0.7,18,1,1,1,2,1,FALSE
react-redux-oop,1.0.10,2.0.0,11,3,445,79,524,17,FALSE
react-redux-oop,1.0.9,1.0.10,10,1,1,1,2,1,FALSE
react-redux-oop,1.0.7,1.0.8,8,1,1,1,2,1,TRUE
react-redux-oop,1.0.10,2.0.0,11,3,445,79,524,17,TRUE
react-redux-oop,2.0.0,2.0.1,12,1,1,1,2,1,TRUE
react-redux-oop,2.1.1,2.1.2,21,1,1,1,2,1,TRUE
backbone-async-event,0.1.0,0.1.1,1,2,57,221,278,11,FALSE
backbone-async-event,0.1.1,0.1.2,2,6,84,29,113,13,FALSE
backbone-async-event,0.1.2,0.1.3,3,1,14,11,25,5,FALSE
backbone-async-event,0.3.0,0.4.0,6,7,38,18,56,13,FALSE
backbone-async-event,0.2.0,0.3.0,5,5,45,11,56,12,FALSE
backbone-async-event,0.4.0,0.5.0,7,19,900,463,1363,29,FALSE
backbone-async-event,0.1.3,0.2.0,4,13,137,27,164,22,FALSE
backbone-async-event,0.1.3,0.2.0,4,13,137,27,164,22,TRUE
eslint-config-algolia,7.0.2,7.0.3,36,6,223,201,424,7,FALSE
eslint-config-algolia,5.5.1,6.0.0,31,11,29,26,55,16,FALSE
eslint-config-algolia,6.0.1,7.0.0,33,8,4393,326,4719,18,FALSE
eslint-config-algolia,6.0.0,6.0.1,32,12,23,25,48,12,FALSE
eslint-config-algolia,5.4.0,5.5.0,29,2,2,1,3,2,FALSE
eslint-config-algolia,7.0.3,8.0.0,37,2,228,700,928,14,FALSE
eslint-config-algolia,9.0.0,10.0.0,39,2,17,2,19,4,FALSE
eslint-config-algolia,7.0.0,7.0.1,34,6,250,139,389,6,FALSE
eslint-config-algolia,5.1.0,5.2.0,23,2,13,1,14,4,FALSE
eslint-config-algolia,5.2.2,5.3.0,26,3,59,1,60,5,FALSE
eslint-config-algolia,5.2.0,5.2.1,24,10,322,11,333,24,FALSE
eslint-config-algolia,5.2.1,5.2.2,25,3,15,15,30,4,FALSE
eslint-config-algolia,7.0.1,7.0.2,35,2,179,175,354,3,FALSE
eslint-config-algolia,5.5.0,5.5.1,30,10,10,10,20,10,FALSE
eslint-config-algolia,8.0.0,9.0.0,38,3,146,8,154,7,FALSE
eslint-config-algolia,5.0.0,5.1.0,22,2,19,2,21,3,FALSE
eslint-config-algolia,5.3.0,5.3.1,27,2,2,1,3,2,FALSE
eslint-config-algolia,5.3.1,5.4.0,28,5,22,14,36,6,FALSE
eslint-config-algolia,7.0.1,7.0.2,35,2,179,175,354,3,TRUE
eslint-config-algolia,2.0.4,2.1.0,5,5,13,4,17,6,FALSE
eslint-config-algolia,2.0.3,2.0.4,4,2,5,2,7,3,FALSE
eslint-config-algolia,2.0.2,2.0.3,3,3,19,9,28,5,FALSE
eslint-config-algolia,2.2.0,3.0.0,9,1,122,12,134,5,FALSE
eslint-config-algolia,2.1.2,2.2.0,8,2,7,3,10,3,FALSE
eslint-config-algolia,2.1.0,2.1.1,6,2,9,2,11,3,FALSE
eslint-config-algolia,2.1.1,2.1.2,7,5,49,17,66,7,FALSE
eslint-config-algolia,5.5.1,6.0.0,31,11,29,26,55,16,TRUE
eslint-config-algolia,6.0.0,6.0.1,32,12,23,25,48,12,TRUE
eslint-config-algolia,5.2.2,5.3.0,26,3,59,1,60,5,TRUE
eslint-config-algolia,5.1.0,5.2.0,23,2,13,1,14,4,TRUE
eslint-config-algolia,5.2.0,5.2.1,24,10,322,11,333,24,TRUE
eslint-config-algolia,4.5.0,4.6.0,19,6,16,7,23,8,FALSE
eslint-config-algolia,4.0.0,4.1.0,11,3,10,4,14,3,FALSE
eslint-config-algolia,4.1.0,4.2.0,12,4,11,7,18,6,FALSE
eslint-config-algolia,4.4.0,4.5.0,18,3,5,4,9,4,FALSE
eslint-config-algolia,4.2.0,4.3.0,13,3,13,3,16,6,FALSE
eslint-config-algolia,4.3.2,4.3.3,16,2,19,2,21,5,FALSE
eslint-config-algolia,4.3.3,4.4.0,17,3,10,8,18,6,FALSE
eslint-config-algolia,4.3.0,4.3.1,14,2,3,3,6,3,FALSE
eslint-config-algolia,4.3.1,4.3.2,15,2,2,2,4,2,FALSE
eslint-config-algolia,4.6.0,4.7.0,20,2,3,2,5,2,FALSE
eslint-config-algolia,8.0.0,9.0.0,38,3,146,8,154,7,TRUE
eslint-config-algolia,4.2.0,4.3.0,13,3,13,3,16,6,TRUE
catalog,2.1.0-beta.4,2.1.0-beta.5,48,14,1696,1007,2703,102,FALSE
catalog,2.1.0-beta.5,2.1.0-beta.6,49,4,27,26,53,5,FALSE
catalog,2.0.0-beta.5,2.0.0-beta.6,28,3,34,5,39,3,FALSE
catalog,2.0.0-beta.4,2.0.0-beta.5,27,2,4,3,7,2,FALSE
catalog,2.1.0-beta.12,2.1.0-beta.13,55,1,1,1,2,1,FALSE
catalog,2.0.0-alpha9,2.0.0-beta.1,23,111,3786,6334,10120,346,FALSE
catalog,2.0.0-alpha8,2.0.0-alpha9,22,5,10,16,26,10,FALSE
catalog,2.1.0-beta.13,2.1.0-beta.14,56,1,1,1,2,1,FALSE
catalog,2.0.0-alpha3,2.0.0-alpha4,17,19,6372,1645,8017,387,FALSE
catalog,2.0.0-alpha2,2.0.0-alpha20,15,154,15731,7993,23724,858,FALSE
catalog,2.0.0-alpha1,2.0.0-alpha10,4,75,12754,2658,15412,614,FALSE
catalog,2.0.0-alpha7,2.0.0-alpha8,21,17,302,242,544,39,FALSE
catalog,2.0.0-alpha6,2.0.0-alpha7,20,4,125,2,127,5,FALSE
catalog,2.0.0-alpha5,2.0.0-alpha6,19,2,6,7,13,5,FALSE
catalog,2.0.0-alpha4,2.0.0-alpha5,18,7,205,193,398,20,FALSE
catalog,2.1.0-beta.16,2.1.0-beta.17,59,1,1,1,2,1,FALSE
catalog,2.1.0-beta.17,2.1.0,60,6,145,117,262,15,FALSE
catalog,2.1.0-beta.14,2.1.0-beta.15,57,2,2,2,4,2,FALSE
catalog,2.0.0-alpha18,2.0.0-alpha19,13,7,406,335,741,20,FALSE
catalog,2.0.0-alpha17,2.0.0-alpha18,12,21,1581,1447,3028,91,FALSE
catalog,2.0.0-alpha16,2.0.0-alpha17,11,6,276,214,490,21,FALSE
catalog,2.0.0-alpha15,2.0.0-alpha16,10,3,131,138,269,13,FALSE
catalog,2.0.0-alpha14,2.0.0-alpha15,9,13,544,260,804,47,FALSE
catalog,2.0.0-alpha13,2.0.0-alpha14,8,11,87,3025,3112,64,FALSE
catalog,2.0.0-alpha12,2.0.0-alpha13,7,7,27,30,57,8,FALSE
catalog,2.0.0-alpha11,2.0.0-alpha12,6,4,41,26,67,8,FALSE
catalog,2.0.0-alpha10,2.0.0-alpha11,5,4,12,10,22,5,FALSE
catalog,2.1.0-beta.8,2.1.0-beta.9,52,8,99,87,186,13,FALSE
catalog,2.1.0-beta.9,2.1.0-beta.10,53,6,84,68,152,11,FALSE
catalog,2.0.0-beta.9,2.0.0-beta.10,32,3,216,336,552,20,FALSE
catalog,2.0.0-beta.8,2.0.0-beta.9,31,3,184,22,206,17,FALSE
catalog,2.0.0-beta.3,2.0.0-beta.4,26,2,13,5,18,6,FALSE
catalog,2.0.0-beta.2,2.0.0-beta.3,25,4,11,11,22,5,FALSE
catalog,2.0.0-beta.1,2.0.0-beta.2,24,7,78,30,108,16,FALSE
catalog,2.1.0-beta.3,2.1.0-beta.4,47,12,96,137,233,20,FALSE
catalog,2.0.0-beta.7,2.0.0-beta.8,30,4,66,897005,897071,165,FALSE
catalog,2.0.0-beta.6,2.0.0-beta.7,29,6,35,30,65,9,FALSE
catalog,2.1.0-beta.6,2.1.0-beta.7,50,8,56,37,93,18,FALSE
catalog,2.1.0-beta.7,2.1.0-beta.8,51,2,1,3,4,2,FALSE
catalog,2.2.2,2.2.3,66,6,30,18,48,7,FALSE
catalog,2.5.0-beta.1,2.5.0-beta.2,84,3,13,11,24,3,FALSE
catalog,2.5.0-beta.2,2.5.0-beta.3,85,3,66,46,112,9,FALSE
catalog,2.0.2,2.0.3,43,18,540,259,799,43,FALSE
catalog,2.0.1,2.0.2,42,7,52,13,65,8,FALSE
catalog,2.0.0,2.0.1,41,3,245,223,468,13,FALSE
catalog,2.2.5,2.2.7,69,5,70,49,119,5,FALSE
catalog,2.2.4,2.2.5,68,4,35,7,42,6,FALSE
catalog,2.2.7,2.2.8,70,3,17,4,21,4,FALSE
catalog,2.2.1,2.2.2,65,1,1,1,2,1,FALSE
catalog,2.2.0,2.2.1,64,19,658,495,1153,72,FALSE
catalog,2.2.3,2.2.4,67,4,25,31,56,7,FALSE
catalog,2.1.0-beta.15,2.1.0-beta.16,58,2,2,2,4,2,FALSE
catalog,2.2.9,2.3.0-beta.1,72,13,612,429,1041,60,FALSE
catalog,2.2.8,2.2.9,71,2,9,10,19,3,FALSE
catalog,2.5.0-beta.4,2.5.0-beta.5,87,2,189,79,268,4,FALSE
catalog,2.5.0-beta.5,2.5.0-beta.6,88,3,26,5,31,4,FALSE
catalog,2.5.0-beta.6,2.5.0-beta.7,89,2,2,2,4,3,FALSE
catalog,2.5.0-beta.7,2.5.0,90,4,4790,41,4831,12,FALSE
catalog,2.6.0-test1,2.6.0-test2,95,1,2,2,4,1,FALSE
catalog,2.6.0-test2,3.0.0-beta.1,96,2,86,286,372,11,FALSE
catalog,2.5.0-beta.3,2.5.0-beta.4,86,2,29,4,33,3,FALSE
catalog,2.3.0-beta.2,2.3.0,74,5,56,3,59,5,FALSE
catalog,2.3.0-beta.1,2.3.0-beta.2,73,2,73,3,76,3,FALSE
catalog,2.0.0-beta.17,2.0.0,40,2,7,3,10,3,FALSE
catalog,2.0.0-beta.16,2.0.0-beta.17,39,3,138,79,217,14,FALSE
catalog,2.0.0-beta.15,2.0.0-beta.16,38,2,4,4,8,3,FALSE
catalog,2.0.0-beta.14,2.0.0-beta.15,37,18,246,192,438,32,FALSE
catalog,2.0.0-beta.13,2.0.0-beta.14,36,2,17,19,36,5,FALSE
catalog,2.0.0-beta.12,2.0.0-beta.13,35,9,304,46,350,18,FALSE
catalog,2.0.0-beta.11,2.0.0-beta.12,34,2,2,2,4,2,FALSE
catalog,2.0.0-beta.10,2.0.0-beta.11,33,1,1,1,2,1,FALSE
catalog,2.4.3,2.4.4,79,8,203,151,354,24,FALSE
catalog,2.4.2,2.4.3,78,4,7,4,11,4,FALSE
catalog,2.4.1,2.4.2,77,3,7,2,9,3,FALSE
catalog,2.4.0,2.4.1,76,3,6,1,7,3,FALSE
catalog,2.4.7,2.5.0-beta.1,83,11,1601,666,2267,68,FALSE
catalog,2.4.6,2.4.7,82,6,14,6,20,7,FALSE
catalog,2.4.5,2.4.6,81,4,18,14,32,5,FALSE
catalog,2.4.4,2.4.5,80,6,19,9,28,7,FALSE
catalog,2.1.0-beta.10,2.1.0-beta.12,54,4,4,3,7,4,FALSE
catalog,3.0.0-beta.4,3.0.0-beta.5,100,1,75,46,121,7,FALSE
catalog,3.0.0-beta.5,3.0.0-beta.6,101,1,1,1,2,1,FALSE
catalog,3.0.0-beta.6,3.0.0-beta.7,102,1,1,1,2,1,FALSE
catalog,3.0.0-beta.7,3.0.0-beta.8,103,1,1,1,2,1,FALSE
catalog,3.0.0-beta.1,3.0.0-beta.2,97,1,1,1,2,1,FALSE
catalog,3.0.0-beta.2,3.0.0-beta.3,98,1,1,1,2,1,FALSE
catalog,3.0.0-beta.3,3.0.0-beta.4,99,1,1,1,2,1,FALSE
catalog,2.1.2,2.2.0,63,2,3,2,5,2,FALSE
catalog,2.1.0,2.1.1,61,5,33,30,63,11,FALSE
catalog,2.1.1,2.1.2,62,15,860,682,1542,100,FALSE
catalog,2.3.0,2.4.0,75,3,196,4,200,9,FALSE
catalog,2.5.2,2.5.3,93,3,7,5,12,6,FALSE
catalog,2.5.3,2.6.0-test1,94,51,2379,1688,4067,171,FALSE
catalog,2.5.0,2.5.1,91,3,69,56,125,6,FALSE
catalog,2.5.1,2.5.2,92,3,9,5,14,4,FALSE
catalog,2.1.0-beta.1,2.1.0-beta.2,45,2,7,10,17,3,FALSE
catalog,2.1.0-beta.2,2.1.0-beta.3,46,12,318,165,483,33,FALSE
catalog,3.0.0-beta.8,3.0.0-beta.9,104,1,1,6,7,2,FALSE
catalog,3.0.0-beta.9,3.0.0-beta.10,105,1,1,1,2,1,FALSE
catalog,3.0.0-rc.1,3.0.0-rc.2,110,4,74,19,93,8,FALSE
catalog,3.0.0-rc.2,3.0.0-rc.3,111,3,4027,1244,5271,65,FALSE
catalog,3.0.0-beta.12,3.0.0-beta.13,108,3,39,18,57,6,FALSE
catalog,3.0.0-beta.13,3.0.0-rc.1,109,14,15992,594,16586,72,FALSE
catalog,3.0.0-beta.10,3.0.0-beta.11,106,1,1,1,2,1,FALSE
catalog,3.0.0-beta.11,3.0.0-beta.12,107,8,17720,4453,22173,187,FALSE
catalog,2.4.3,2.4.4,79,8,203,151,354,24,TRUE
catalog,3.0.0-beta.8,3.0.0-beta.9,104,1,1,6,7,2,TRUE
catalog,2.5.1,2.5.2,92,3,9,5,14,4,TRUE
catalog,3.0.0-beta.4,3.0.0-beta.5,100,1,75,46,121,7,TRUE
catalog,3.0.0-rc.1,3.0.0-rc.2,110,4,74,19,93,8,TRUE
catalog,3.0.0-rc.2,3.0.0-rc.3,111,3,4027,1244,5271,65,TRUE
catalog,2.0.0-alpha14,2.0.0-alpha15,9,13,544,260,804,47,TRUE
catalog,2.4.2,2.4.3,78,4,7,4,11,4,TRUE
catalog,2.1.0-beta.3,2.1.0-beta.4,47,12,96,137,233,20,TRUE
catalog,1.1.12,1.2.0,2,2,127,53,180,9,FALSE
catalog,2.0.0-alpha16,2.0.0-alpha17,11,6,276,214,490,21,TRUE
catalog,3.0.0-beta.7,3.0.0-beta.8,103,1,1,1,2,1,TRUE
catalog,2.1.0,2.1.1,61,5,33,30,63,11,TRUE
catalog,2.0.2,2.0.3,43,18,540,259,799,43,TRUE
catalog,2.4.5,2.4.6,81,4,18,14,32,5,TRUE
catalog,2.0.0-alpha3,2.0.0-alpha4,17,19,6372,1645,8017,387,TRUE
catalog,2.0.0-alpha17,2.0.0-alpha18,12,21,1581,1447,3028,91,TRUE
catalog,2.0.0-alpha13,2.0.0-alpha14,8,11,87,3025,3112,64,TRUE
catalog,2.3.0-beta.2,2.3.0,74,5,56,3,59,5,TRUE
catalog,2.3.0-beta.1,2.3.0-beta.2,73,2,73,3,76,3,TRUE
catalog,2.5.3,2.6.0-test1,94,51,2379,1688,4067,171,TRUE
catalog,2.0.0-alpha12,2.0.0-alpha13,7,7,27,30,57,8,TRUE
catalog,2.0.0-beta.11,2.0.0-beta.12,34,2,2,2,4,2,TRUE
catalog,2.2.3,2.2.4,67,4,25,31,56,7,TRUE
catalog,2.2.8,2.2.9,71,2,9,10,19,3,TRUE
catalog,2.1.0-beta.4,2.1.0-beta.5,48,14,1696,1007,2703,102,TRUE
catalog,2.0.0-alpha1,2.0.0-alpha10,4,75,12754,2658,15412,614,TRUE
catalog,2.0.0-alpha7,2.0.0-alpha8,21,17,302,242,544,39,TRUE
catalog,2.1.0-beta.10,2.1.0-beta.12,54,4,4,3,7,4,TRUE
catalog,2.1.1,2.1.2,62,15,860,682,1542,100,TRUE
catalog,2.0.0-alpha18,2.0.0-alpha19,13,7,406,335,741,20,TRUE
catalog,2.0.0-alpha9,2.0.0-beta.1,23,111,3786,6334,10120,346,TRUE
catalog,2.0.0-alpha2,2.0.0-alpha20,15,154,15731,7993,23724,858,TRUE
react-collapse,1.1.1,1.1.2,5,9,215,19,234,17,FALSE
react-collapse,1.1.0,1.1.1,4,2,2,2,4,2,FALSE
react-collapse,1.1.3,1.2.0,7,24,524,62,586,40,FALSE
react-collapse,1.1.2,1.1.3,6,3,3,5,8,3,FALSE
react-collapse,1.0.0,1.0.1,1,2,73,1,74,3,FALSE
react-collapse,1.0.1,1.0.2,2,5,40,19,59,9,FALSE
react-collapse,1.0.2,1.1.0,3,6,395,71,466,18,FALSE
react-collapse,1.5.0,1.6.0,13,15,604,421,1025,30,FALSE
react-collapse,1.6.2,1.6.3,16,3,1,5,6,5,FALSE
react-collapse,1.6.3,1.7.0,17,38,1735,1800,3535,91,FALSE
react-collapse,1.6.0,1.6.1,14,1,7,0,7,1,FALSE
react-collapse,1.6.1,1.6.2,15,13,452,436,888,57,FALSE
react-collapse,1.7.1,1.7.2,19,2,2,2,4,2,FALSE
react-collapse,1.2.0,1.3.0,8,24,320,565,885,57,FALSE
react-collapse,1.3.0,1.3.1,9,2,4,1,5,2,FALSE
react-collapse,1.4.0,1.5.0,12,84,1067,1085,2152,178,FALSE
react-collapse,1.3.1,1.3.2,10,7,108,45,153,15,TRUE
react-collapse,1.7.2,2.0.0,20,20,91,90,181,26,FALSE
react-collapse,1.3.2,1.4.0,11,3,55,59,114,5,FALSE
react-collapse,1.7.0,1.7.1,18,5,19,5,24,5,FALSE
react-collapse,4.0.1,4.0.2,44,8,43,34,77,13,FALSE
react-collapse,4.0.0,4.0.1,43,2,2,1,3,2,FALSE
react-collapse,2.3.4,2.4.0,32,14,658,582,1240,75,FALSE
react-collapse,3.3.1,4.0.0,42,1,1,1,2,1,FALSE
react-collapse,3.3.0,3.3.1,41,1,122,136,258,4,FALSE
react-collapse,3.2.1,3.2.2,39,1,1,1,2,1,FALSE
react-collapse,3.2.2,3.3.0,40,10,330,468,798,41,FALSE
react-collapse,2.4.0,2.4.1,33,18,206,270,476,32,FALSE
react-collapse,2.0.0,2.1.0,21,97,1087,988,2075,158,FALSE
react-collapse,3.1.1,3.2.0,37,8,76,16,92,12,FALSE
react-collapse,2.2.4,2.3.0,27,4,36,8,44,7,FALSE
react-collapse,3.1.0,3.1.1,36,3,19,19,38,9,FALSE
react-collapse,2.2.1,2.2.2,24,7,13,13,26,7,FALSE
react-collapse,2.2.0,2.2.1,23,5,19,5,24,5,FALSE
react-collapse,2.2.3,2.2.4,26,3,15,3,18,3,FALSE
react-collapse,2.2.2,2.2.3,25,4,8,8,16,4,FALSE
react-collapse,2.1.0,2.2.0,22,12,590,343,933,41,FALSE
react-collapse,3.0.0,3.1.0,35,6,677,131,808,48,FALSE
react-collapse,2.3.0,2.3.1,28,5,111,75,186,14,FALSE
react-collapse,2.3.1,2.3.2,29,15,88,118,206,32,FALSE
react-collapse,2.3.2,2.3.3,30,2,7,9,16,2,FALSE
react-collapse,2.3.3,2.3.4,31,38,2335,1452,3787,161,FALSE
react-collapse,1.3.1,1.3.2,10,7,108,45,153,15,FALSE
react-collapse,3.2.0,3.2.1,38,11,375,221,596,47,FALSE
react-collapse,4.0.1,4.0.2,44,8,43,34,77,13,TRUE
react-collapse,1.0.2,1.1.0,3,6,395,71,466,18,TRUE
react-collapse,1.6.2,1.6.3,16,3,1,5,6,5,TRUE
react-collapse,1.6.1,1.6.2,15,13,452,436,888,57,TRUE
react-collapse,1.1.1,1.1.2,5,9,215,19,234,17,TRUE
react-collapse,1.6.3,1.7.0,17,38,1735,1800,3535,91,TRUE
react-collapse,1.3.0,1.3.1,9,2,4,1,5,2,TRUE
koco,2.0.1,2.1.0,43,2,583,542,1125,9,FALSE
koco,2.0.0,2.0.1,42,2,31,19,50,3,FALSE
koco,1.8.19,1.8.20,29,2,301,398,699,12,FALSE
koco,1.8.16,1.8.17,26,2,3,3,6,3,FALSE
koco,2.2.1,2.2.2,46,2,5,5,10,3,TRUE
koco,2.2.0,2.2.1,45,2,13,5,18,3,FALSE
koco,1.8.18,1.8.19,28,2,349,310,659,5,FALSE
koco,2.2.2,2.2.3,47,2,11,34,45,6,FALSE
koco,1.8.30,1.8.31,40,2,1,9,10,2,FALSE
koco,1.8.17,1.8.18,27,2,23,21,44,6,FALSE
koco,2.1.0,2.2.0,44,2,530,686,1216,12,FALSE
koco,1.8.15,1.8.16,25,2,9,5,14,3,FALSE
koco,1.8.12,1.8.13,22,2,83,89,172,8,FALSE
koco,1.8.13,1.8.14,23,1,1,1,2,1,FALSE
koco,1.8.10,1.8.11,20,2,2,2,4,2,FALSE
koco,1.8.11,1.8.12,21,2,19,19,38,4,FALSE
koco,1.8.26,1.8.27,36,2,14,16,30,3,FALSE
koco,1.6.0,1.7.0,8,5,1959,1514,3473,25,FALSE
koco,1.8.8,1.8.9,18,2,5,5,10,5,FALSE
koco,1.8.9,1.8.10,19,2,3,3,6,3,FALSE
koco,1.8.4,1.8.5,14,2,11,55,66,5,FALSE
koco,1.8.5,1.8.6,15,2,5,5,10,3,FALSE
koco,1.8.6,1.8.7,16,2,1097,1014,2111,7,FALSE
koco,1.8.7,1.8.8,17,2,9,9,18,7,FALSE
koco,1.8.0,1.8.1,10,2,122,127,249,4,FALSE
koco,1.8.1,1.8.2,11,2,153,217,370,5,FALSE
koco,1.8.2,1.8.3,12,2,18,1,19,3,FALSE
koco,1.8.3,1.8.4,13,2,3,5,8,3,FALSE
koco,1.8.27,1.8.28,37,2,186,219,405,3,FALSE
koco,1.4.1,1.5.0,6,2,113,22,135,3,FALSE
koco,1.8.25,1.8.26,35,2,92,92,184,7,FALSE
koco,1.8.24,1.8.25,34,2,154,144,298,5,FALSE
koco,1.8.23,1.8.24,33,2,74,54,128,3,FALSE
koco,1.8.22,1.8.23,32,2,37,23,60,6,FALSE
koco,1.8.21,1.8.22,31,2,9,35,44,5,FALSE
koco,1.8.20,1.8.21,30,2,1,3,4,3,FALSE
koco,1.5.0,1.6.0,7,2,17,17,34,3,FALSE
koco,1.8.29,1.8.30,39,2,28,22,50,4,FALSE
koco,1.8.28,1.8.29,38,2,13,3,16,3,FALSE
koco,1.8.14,1.8.15,24,2,280,3,283,5,FALSE
koco,1.8.31,2.0.0,41,2,71,52,123,7,FALSE
koco,1.7.0,1.8.0,9,4,1907,1504,3411,27,FALSE
koco,2.2.1,2.2.2,46,2,5,5,10,3,FALSE
koco,1.1.0,1.2.0,2,2,3,3,6,2,FALSE
koco,1.0.0,1.1.0,1,2,8,7,15,3,FALSE
koco,1.4.0,1.4.1,5,2,4,1,5,2,FALSE
koco,1.3.0,1.4.0,4,2,13,18,31,4,FALSE
koco,1.2.0,1.3.0,3,2,10,14,24,4,FALSE
koco,1.8.23,1.8.24,33,2,74,54,128,3,TRUE
koco,2.0.0,2.0.1,42,2,31,19,50,3,TRUE
koco,1.8.11,1.8.12,21,2,19,19,38,4,TRUE
koco,1.8.6,1.8.7,16,2,1097,1014,2111,7,TRUE
koco,1.8.5,1.8.6,15,2,5,5,10,3,TRUE
koco,1.7.0,1.8.0,9,4,1907,1504,3411,27,TRUE
koco,1.8.26,1.8.27,36,2,14,16,30,3,TRUE
koco,1.8.25,1.8.26,35,2,92,92,184,7,TRUE
koco,1.8.22,1.8.23,32,2,37,23,60,6,TRUE
jkef-model,0.0.1,0.0.2,1,1,70,8,78,5,FALSE
jkef-model,0.0.3,0.2.0,3,3,130,198,328,12,FALSE
jkef-model,0.0.2,0.0.3,2,1,3917,1,3918,9,FALSE
jkef-model,0.2.7,0.2.8,10,1,12,10,22,3,FALSE
jkef-model,0.2.6,0.2.7,9,1,183,135,318,9,FALSE
jkef-model,0.2.4,0.2.6,8,1,183,135,318,9,FALSE
jkef-model,0.2.3,0.2.4,7,1,22,20,42,3,FALSE
jkef-model,0.2.2,0.2.3,6,2,29,24,53,4,FALSE
jkef-model,0.2.1,0.2.2,5,5,609,1515,2124,16,FALSE
jkef-model,0.2.0,0.2.1,4,1,183,135,318,9,FALSE
jkef-model,0.2.8,0.2.9,11,1,2,2,4,2,FALSE
jkef-model,0.2.1,0.2.2,5,5,609,1515,2124,16,TRUE
omni-common-ui,0.11.0-dev.709,0.11.0-dev.710,322,1,2,2,4,2,FALSE
omni-common-ui,0.11.0-dev.708,0.11.0-dev.709,321,1,2,0,2,1,FALSE
omni-common-ui,0.11.0-dev.703,0.11.0-dev.704,316,1,6,1,7,1,FALSE
omni-common-ui,0.11.0-dev.702,0.11.0-dev.703,315,1,2,2,4,2,FALSE
omni-common-ui,0.11.0-dev.701,0.11.0-dev.702,314,1,4,4,8,2,FALSE
omni-common-ui,0.11.0-dev.700,0.11.0-dev.701,313,1,1,1,2,1,FALSE
omni-common-ui,0.11.0-dev.707,0.11.0-dev.708,320,3,367,11,378,10,FALSE
omni-common-ui,0.11.0-dev.706,0.11.0-dev.707,319,2,72,46,118,4,FALSE
omni-common-ui,0.11.0-dev.705,0.11.0-dev.706,318,1,112,6,118,4,FALSE
omni-common-ui,0.11.0-dev.704,0.11.0-dev.705,317,1,3,1,4,1,FALSE
omni-common-ui,0.14.0-dev.1015,0.14.0-dev.1016,579,1,4,0,4,1,FALSE
omni-common-ui,0.14.0-dev.995,0.14.0-dev.998,562,1,50,55,105,7,FALSE
omni-common-ui,0.17.2,0.17.3,736,5,13,10,23,6,FALSE
omni-common-ui,0.17.3,0.17.4,737,5,20,8,28,5,FALSE
omni-common-ui,0.11.0-dev.796,0.11.0-dev.797,404,1,3,1,4,1,FALSE
omni-common-ui,0.11.0-dev.797,0.11.0-dev.798,405,1,26,7,33,5,FALSE
omni-common-ui,0.11.0-dev.790,0.11.0-dev.791,398,1,2,0,2,1,FALSE
omni-common-ui,0.11.0-dev.791,0.11.0-dev.792,399,1,2,1,3,2,FALSE
omni-common-ui,0.8.0-dev.638,0.8.0-dev.639,255,1,3,1,4,1,FALSE
omni-common-ui,0.8.0-dev.639,0.8.0-dev.640,256,2,297,188,485,8,FALSE
omni-common-ui,0.8.0-dev.636,0.8.0-dev.638,254,2,866,203,1069,43,FALSE
omni-common-ui,0.7.0-dev.572,0.7.0-dev.573,201,1,1,2,3,1,FALSE
omni-common-ui,0.8.0-dev.634,0.8.0-dev.635,252,1,80,16,96,4,FALSE
omni-common-ui,0.8.0-dev.635,0.8.0-dev.636,253,1,1,1,2,1,FALSE
omni-common-ui,0.8.0-dev.632,0.8.0-dev.633,250,1,2,0,2,2,FALSE
omni-common-ui,0.8.0-dev.633,0.8.0-dev.634,251,1,18,11,29,2,FALSE
omni-common-ui,0.8.0-dev.630,0.8.0-dev.631,248,1,1,1,2,1,FALSE
omni-common-ui,0.8.0-dev.631,0.8.0-dev.632,249,1,5,0,5,1,FALSE
omni-common-ui,0.7.0-dev.570,0.7.0-dev.571,199,1,1,1,2,1,FALSE
omni-common-ui,0.12.0-dev.909,0.12.0-dev.910,499,1,33,9,42,2,FALSE
omni-common-ui,0.11.0-dev.778,0.11.0-dev.779,387,1,1,0,1,3,FALSE
omni-common-ui,0.11.0-dev.779,0.11.0-dev.780,388,1,4,9,13,1,FALSE
omni-common-ui,0.11.0-dev.776,0.11.0-dev.777,385,1,0,1,1,1,FALSE
omni-common-ui,0.11.0-dev.777,0.11.0-dev.778,386,5,155,77,232,12,FALSE
omni-common-ui,0.11.0-dev.775,0.11.0-dev.776,384,1,23,2,25,3,FALSE
omni-common-ui,0.11.0-dev.772,0.11.0-dev.773,382,1,3,1,4,1,FALSE
omni-common-ui,0.11.0-dev.773,0.11.0-dev.775,383,1,1,0,1,1,FALSE
omni-common-ui,0.11.0-dev.771,0.11.0-dev.772,381,2,11,12,23,3,FALSE
omni-common-ui,0.0.18-dev.377,0.0.18-dev.378,29,1,1,1,2,1,FALSE
omni-common-ui,0.0.18-dev.379,0.0.18-dev.380,31,2,12,13,25,3,FALSE
omni-common-ui,0.0.18-dev.378,0.0.18-dev.379,30,2,3,1,4,3,FALSE
omni-common-ui,0.11.0-dev.831,0.11.0-dev.832,431,1,58,4,62,5,FALSE
omni-common-ui,0.11.0-dev.830,0.11.0-dev.831,430,1,7,1,8,2,FALSE
omni-common-ui,0.11.0-dev.833,0.11.0-dev.835,433,1,3,1,4,1,FALSE
omni-common-ui,0.11.0-dev.832,0.11.0-dev.833,432,1,10,1,11,2,FALSE
omni-common-ui,0.11.0-dev.835,0.11.0-dev.836,434,1,0,2,2,1,FALSE
omni-common-ui,0.12.0-dev.900,0.12.0-dev.901,490,3,53,21,74,6,FALSE
omni-common-ui,0.11.0-dev.837,0.11.0-dev.838,436,1,3,1,4,1,FALSE
omni-common-ui,0.11.0-dev.836,0.11.0-dev.837,435,1,3,1,4,1,FALSE
omni-common-ui,0.11.0-dev.839,0.11.0-dev.840,438,1,3,1,4,1,FALSE
omni-common-ui,0.11.0-dev.838,0.11.0-dev.839,437,1,3,1,4,1,FALSE
omni-common-ui,0.12.0-dev.901,0.12.0-dev.902,491,1,3,1,4,1,FALSE
omni-common-ui,0.3.0-dev.419,0.3.0-dev.420,62,4,43,25,68,4,FALSE
omni-common-ui,0.3.0-dev.418,0.3.0-dev.419,61,6,1093,26,1119,30,FALSE
omni-common-ui,0.3.0-dev.411,0.3.0-dev.412,54,2,340,5,345,15,FALSE
omni-common-ui,0.3.0-dev.410,0.3.0-dev.411,53,1,3,1,4,1,FALSE
omni-common-ui,0.3.0-dev.413,0.3.0-dev.414,56,3,4,1059,1063,25,FALSE
omni-common-ui,0.3.0-dev.412,0.3.0-dev.413,55,2,1059,1,1060,24,FALSE
omni-common-ui,0.3.0-dev.415,0.3.0-dev.416,58,2,53,20,73,4,FALSE
omni-common-ui,0.3.0-dev.414,0.3.0-dev.415,57,1,3,1,4,1,FALSE
omni-common-ui,0.3.0-dev.417,0.3.0-dev.418,60,1,1,1,2,1,FALSE
omni-common-ui,0.3.0-dev.416,0.3.0-dev.417,59,1,1,1,2,1,FALSE
omni-common-ui,0.7.0-dev.573,0.7.0-dev.574,202,1,3,1,4,1,FALSE
omni-common-ui,0.12.0-dev.863,0.12.0-dev.864,461,1,2,1,3,2,FALSE
omni-common-ui,0.12.0-dev.865,0.12.0-dev.866,463,1,2,1,3,1,FALSE
omni-common-ui,0.12.0-dev.864,0.12.0-dev.865,462,1,38,9,47,2,FALSE
omni-common-ui,0.13.0-dev.964,0.13.0-dev.965,540,2,28,4,32,3,FALSE
omni-common-ui,0.12.0-dev.866,0.12.0-dev.868,464,1,8,4,12,1,FALSE
omni-common-ui,0.12.0-dev.869,0.12.0-dev.870,466,1,77,0,77,2,FALSE
omni-common-ui,0.12.0-dev.868,0.12.0-dev.869,465,1,7,2,9,2,FALSE
omni-common-ui,0.7.0-dev.571,0.7.0-dev.572,200,1,1,1,2,1,FALSE
omni-common-ui,0.7.0-dev.543,0.7.0-dev.544,176,1,4,3,7,1,FALSE
omni-common-ui,0.7.0-dev.542,0.7.0-dev.543,175,1,71,58,129,2,FALSE
omni-common-ui,0.7.0-dev.541,0.7.0-dev.542,174,1,3,1,4,1,FALSE
omni-common-ui,0.7.0-dev.540,0.7.0-dev.541,173,1,3,1,4,1,FALSE
omni-common-ui,0.7.0-dev.547,0.7.0-dev.548,180,1,69,21,90,1,FALSE
omni-common-ui,0.7.0-dev.546,0.7.0-dev.547,179,1,8,8,16,2,FALSE
omni-common-ui,0.7.0-dev.545,0.7.0-dev.546,178,1,155,8,163,4,FALSE
omni-common-ui,0.7.0-dev.544,0.7.0-dev.545,177,3,201,85,286,10,FALSE
omni-common-ui,0.7.0-dev.549,0.7.0-dev.550,182,1,21,31,52,3,FALSE
omni-common-ui,0.7.0-dev.548,0.7.0-dev.549,181,1,3,1,4,1,FALSE
omni-common-ui,0.12.0-dev.911,0.12.0-dev.912,501,1,4,0,4,1,FALSE
omni-common-ui,0.12.0-dev.910,0.12.0-dev.911,500,1,2,5,7,1,FALSE
omni-common-ui,0.12.0-dev.912,0.12.0-dev.916,502,1,3,1,4,1,FALSE
omni-common-ui,0.1.0-dev.387,0.1.0-dev.388,36,4,62,36,98,12,FALSE
omni-common-ui,0.1.0-dev.385,0.1.0-dev.387,35,2,6,3,9,5,FALSE
omni-common-ui,0.18.0-dev.1289,0.18.0-dev.1290,786,1,4,0,4,1,FALSE
omni-common-ui,0.1.0-dev.382,0.1.0-dev.385,34,1,2,2,4,1,FALSE
omni-common-ui,0.17.0-dev.1181,0.17.0-dev.1182,707,1,24,4,28,2,FALSE
omni-common-ui,0.17.0-dev.1180,0.17.0-dev.1181,706,2,25,9,34,3,FALSE
omni-common-ui,0.17.0-dev.1182,0.17.0-dev.1186,708,1,3,1,4,1,FALSE
omni-common-ui,0.1.0-dev.389,0.1.0-dev.390,38,1,3,1,4,2,FALSE
omni-common-ui,0.17.0-dev.1186,0.17.0-dev.1190,709,1,76,148,224,8,FALSE
omni-common-ui,0.10.0-dev.689,0.10.0-dev.690,304,1,7,1,8,1,FALSE
omni-common-ui,0.10.0-dev.688,0.10.0-dev.689,303,1,2,1,3,1,FALSE
omni-common-ui,0.10.0-dev.683,0.10.0-dev.684,298,2,43,11,54,7,FALSE
omni-common-ui,0.10.0-dev.682,0.10.0-dev.683,297,1,1,2,3,1,FALSE
omni-common-ui,0.10.0-dev.681,0.10.0-dev.682,296,1,33,6,39,3,FALSE
omni-common-ui,0.10.0-dev.680,0.10.0-dev.681,295,6,69,112,181,13,FALSE
omni-common-ui,0.10.0-dev.687,0.10.0-dev.688,302,1,3,1,4,1,FALSE
omni-common-ui,0.10.0-dev.686,0.10.0-dev.687,301,2,14,7,21,2,FALSE
omni-common-ui,0.10.0-dev.685,0.10.0-dev.686,300,1,1,0,1,1,FALSE
omni-common-ui,0.10.0-dev.684,0.10.0-dev.685,299,1,3,1,4,1,FALSE
omni-common-ui,0.18.0-dev.1276,0.18.0-dev.1277,778,1,11,2,13,2,FALSE
omni-common-ui,0.18.0-dev.1238,0.18.0-dev.1241,749,4,14,6,20,4,FALSE
omni-common-ui,0.18.0-dev.1277,0.18.0-dev.1281,779,3,14,10,24,4,FALSE
omni-common-ui,0.18.0-dev.1232,0.18.0-dev.1235,746,2,3,3,6,3,FALSE
omni-common-ui,0.18.0-dev.1230,0.18.0-dev.1232,745,4,12,9,21,5,FALSE
omni-common-ui,0.17.0,0.17.1,734,7,100,74,174,12,FALSE
omni-common-ui,0.18.0-dev.1235,0.18.0-dev.1237,747,1,3,1,4,1,FALSE
omni-common-ui,0.17.1,0.17.2,735,5,6,6,12,6,FALSE
omni-common-ui,0.15.0-dev.1129,0.15.0-dev.1130,661,1,4,0,4,1,FALSE
omni-common-ui,0.15.0-dev.1128,0.15.0-dev.1129,660,7,19,29,48,11,FALSE
omni-common-ui,0.14.0-dev.1074,0.14.0-dev.1075,618,1,5,1,6,1,FALSE
omni-common-ui,0.18.0-dev.1272,0.18.0-dev.1273,774,1,4,1,5,1,FALSE
omni-common-ui,0.14.0-dev.1076,0.14.0-dev.1077,620,1,3,1,4,1,FALSE
omni-common-ui,0.14.0-dev.1077,0.14.0-dev.1079,621,1,5,5,10,2,FALSE
omni-common-ui,0.14.0-dev.1070,0.14.0-dev.1073,616,2,4,6,10,3,FALSE
omni-common-ui,0.15.0-dev.1123,0.15.0-dev.1124,655,1,5,1,6,2,FALSE
omni-common-ui,0.14.0-dev.1073,0.14.0-dev.1074,617,1,7,1,8,1,FALSE
omni-common-ui,0.5.0-dev.462,0.5.0-dev.463,100,1,2,2,4,1,FALSE
omni-common-ui,0.5.0-dev.463,0.5.0-dev.464,101,1,0,31,31,3,FALSE
omni-common-ui,0.5.0-dev.461,0.5.0-dev.462,99,1,1,1,2,1,FALSE
omni-common-ui,0.5.0-dev.466,0.5.0-dev.467,103,1,2,5,7,1,FALSE
omni-common-ui,0.5.0-dev.464,0.5.0-dev.466,102,3,40,59,99,13,FALSE
omni-common-ui,0.5.0-dev.468,0.5.0-dev.469,105,1,4,1,5,2,FALSE
omni-common-ui,0.5.0-dev.469,0.5.0-dev.470,106,1,1,0,1,1,FALSE
omni-common-ui,0.11.0-dev.732,0.11.0-dev.733,345,1,0,1,1,1,FALSE
omni-common-ui,0.11.0-dev.733,0.11.0-dev.734,346,1,1,1,2,1,FALSE
omni-common-ui,0.11.0-dev.730,0.11.0-dev.731,343,1,1,1,2,1,FALSE
omni-common-ui,0.11.0-dev.731,0.11.0-dev.732,344,1,1,1,2,1,FALSE
omni-common-ui,0.11.0-dev.736,0.11.0-dev.737,349,1,0,209,209,20,FALSE
omni-common-ui,0.11.0-dev.737,0.11.0-dev.738,350,1,1,1,2,1,FALSE
omni-common-ui,0.11.0-dev.734,0.11.0-dev.735,347,1,6,0,6,1,FALSE
omni-common-ui,0.11.0-dev.735,0.11.0-dev.736,348,1,1,1,2,1,FALSE
omni-common-ui,0.11.0-dev.738,0.11.0-dev.739,351,2,45,0,45,2,FALSE
omni-common-ui,0.11.0-dev.739,0.11.0-dev.740,352,1,33,0,33,3,FALSE
omni-common-ui,0.11.0-dev.798,0.11.0-dev.799,406,1,3,6,9,3,FALSE
omni-common-ui,0.11.0-dev.799,0.11.0-dev.800,407,1,3,1,4,2,FALSE
omni-common-ui,0.18.0-dev.1245,0.18.0-dev.1250,754,5,180,47,227,16,FALSE
omni-common-ui,0.18.0-dev.1244,0.18.0-dev.1245,753,1,1,2,3,2,FALSE
omni-common-ui,0.18.0-dev.1243,0.18.0-dev.1244,752,1,0,1,1,1,FALSE
omni-common-ui,0.18.0-dev.1242,0.18.0-dev.1243,751,1,164,90,254,6,FALSE
omni-common-ui,0.18.0-dev.1241,0.18.0-dev.1242,750,1,24,11,35,2,FALSE
omni-common-ui,0.1.0,0.2.0-dev.394,41,13,215,91,306,48,FALSE
omni-common-ui,0.11.0-dev.794,0.11.0-dev.795,402,1,0,1,1,1,FALSE
omni-common-ui,0.16.0-dev.1151,0.16.0-dev.1152,681,1,17,34,51,4,FALSE
omni-common-ui,0.16.0-dev.1150,0.16.0-dev.1151,680,1,3,4,7,3,FALSE
omni-common-ui,0.16.0-dev.1153,0.16.0-dev.1154,683,2,78,155,233,7,FALSE
omni-common-ui,0.16.0-dev.1152,0.16.0-dev.1153,682,1,6,3,9,3,FALSE
omni-common-ui,0.6.0-dev.511,0.6.0-dev.512,147,1,5,2,7,1,FALSE
omni-common-ui,0.6.0-dev.510,0.6.0-dev.511,146,1,1,1,2,1,FALSE
omni-common-ui,0.16.0-dev.1157,0.16.0-dev.1158,687,1,12,4,16,2,FALSE
omni-common-ui,0.6.0-dev.512,0.6.0-dev.513,148,1,3,1,4,1,FALSE
omni-common-ui,0.11.0-dev.840,0.11.0-dev.841,439,1,89,41,130,13,FALSE
omni-common-ui,0.11.0-dev.841,0.11.0-dev.842,440,1,97,8,105,5,FALSE
omni-common-ui,0.11.0-dev.842,0.11.0-dev.843,441,1,76,38,114,1,FALSE
omni-common-ui,0.11.0-dev.843,0.11.0-dev.844,442,1,3,1,4,1,FALSE
omni-common-ui,0.6.0-dev.518,0.6.0,154,2,9829,285,10114,31,FALSE
omni-common-ui,0.11.0-dev.846,0.11.0-dev.847,445,1,3,1,4,1,FALSE
omni-common-ui,0.13.0-dev.942,0.13.0-dev.943,526,1,3,1,4,1,FALSE
omni-common-ui,0.13.0-dev.941,0.13.0-dev.942,525,2,3,0,3,2,FALSE
omni-common-ui,0.13.0-dev.940,0.13.0-dev.941,524,3,125,122,247,6,FALSE
omni-common-ui,0.13.0-dev.947,0.13.0-dev.955,531,7,249,72,321,23,FALSE
omni-common-ui,0.11.0-dev.795,0.11.0-dev.796,403,1,3,1,4,1,FALSE
omni-common-ui,0.13.0-dev.945,0.13.0-dev.946,529,1,48,37,85,3,FALSE
omni-common-ui,0.13.0-dev.944,0.13.0-dev.945,528,1,6,6,12,2,FALSE
omni-common-ui,0.6.0-dev.515,0.6.0-dev.516,151,2,16,17,33,4,FALSE
omni-common-ui,0.3.0-dev.440,0.3.0-dev.441,81,1,1,0,1,1,FALSE
omni-common-ui,0.3.0-dev.441,0.3.0,82,2,1994,147,2141,77,FALSE
omni-common-ui,0.15.0-dev.1094,0.15.0-dev.1097,634,4,8,2,10,5,FALSE
omni-common-ui,0.15.0-dev.1097,0.15.0-dev.1098,635,3,152,30,182,11,FALSE
omni-common-ui,0.15.0-dev.1099,0.15.0-dev.1100,637,1,46,23,69,2,FALSE
omni-common-ui,0.15.0-dev.1098,0.15.0-dev.1099,636,7,98,36,134,16,FALSE
omni-common-ui,0.18.0-dev.1288,0.18.0-dev.1289,785,1,54,28,82,1,FALSE
omni-common-ui,0.11.0-dev.812,0.11.0-dev.813,415,1,3,1,4,1,FALSE
omni-common-ui,0.19.0-dev.1338,0.19.0-dev.1342,808,2,38,16,54,4,FALSE
omni-common-ui,0.13.0-dev.937,0.13.0-dev.938,521,1,3,1,4,1,FALSE
omni-common-ui,0.13.0-dev.935,0.13.0-dev.936,519,1,1,0,1,1,FALSE
omni-common-ui,0.13.0-dev.932,0.13.0-dev.933,517,1,1,0,1,1,FALSE
omni-common-ui,0.13.0-dev.933,0.13.0-dev.935,518,1,443,26,469,4,FALSE
omni-common-ui,0.13.0-dev.930,0.13.0-dev.932,516,3,5,3,8,3,FALSE
omni-common-ui,0.18.0,0.18.1,797,5,20,11,31,5,FALSE
omni-common-ui,0.19.0-dev.1330,0.19.0-dev.1331,803,1,3,1,4,1,FALSE
omni-common-ui,0.19.0-dev.1331,0.19.0-dev.1332,804,1,6,3,9,1,FALSE
omni-common-ui,0.19.0-dev.1332,0.19.0-dev.1333,805,1,3,1,4,1,FALSE
omni-common-ui,0.19.0-dev.1333,0.19.0-dev.1335,806,4,14,8,22,4,FALSE
omni-common-ui,0.19.0-dev.1335,0.19.0-dev.1338,807,4,17,2,19,5,FALSE
omni-common-ui,0.13.0-dev.938,0.13.0-dev.939,522,1,1,2,3,1,FALSE
omni-common-ui,0.13.0-dev.939,0.13.0-dev.940,523,1,211,26,237,14,FALSE
omni-common-ui,0.17.0-dev.1178,0.17.0-dev.1179,704,1,0,1,1,1,FALSE
omni-common-ui,0.17.0-dev.1179,0.17.0-dev.1180,705,1,10,3,13,1,FALSE
omni-common-ui,0.6.0-dev.514,0.6.0-dev.515,150,5,9328,7,9335,6,FALSE
omni-common-ui,0.13.0-dev.929,0.13.0-dev.930,515,1,53,0,53,1,FALSE
omni-common-ui,0.17.0-dev.1175,0.17.0-dev.1178,703,1,29,26,55,6,FALSE
omni-common-ui,0.18.0-dev.1287,0.18.0-dev.1288,784,1,3,1,4,1,FALSE
omni-common-ui,0.7.0-dev.599,0.7.0,220,2,2223,849,3072,67,FALSE
omni-common-ui,0.6.0-dev.516,0.6.0-dev.517,152,1,243,173,416,12,FALSE
omni-common-ui,0.14.0-dev.1035,0.14.0-dev.1036,587,1,3,1,4,1,FALSE
omni-common-ui,0.14.0-dev.1036,0.14.0-dev.1037,588,1,3,1,4,1,FALSE
omni-common-ui,0.14.0-dev.1037,0.14.0-dev.1038,589,1,3,1,4,1,FALSE
omni-common-ui,0.14.0-dev.1038,0.14.0-dev.1039,590,1,3,1,4,1,FALSE
omni-common-ui,0.14.0-dev.1039,0.14.0-dev.1040,591,1,3,1,4,1,FALSE
omni-common-ui,0.7.0-dev.593,0.7.0-dev.594,216,2,15,12,27,2,FALSE
omni-common-ui,0.7.0-dev.594,0.7.0-dev.595,217,1,3,1,4,1,FALSE
omni-common-ui,0.7.0-dev.595,0.7.0-dev.596,218,4,340,252,592,13,FALSE
omni-common-ui,0.7.0-dev.596,0.7.0-dev.599,219,2,32,24,56,7,FALSE
omni-common-ui,0.16.0-dev.1154,0.16.0-dev.1155,684,6,63,144,207,17,FALSE
omni-common-ui,0.6.0-dev.513,0.6.0-dev.514,149,1,3,3,6,2,FALSE
omni-common-ui,0.16.0-dev.1156,0.16.0-dev.1157,686,2,61,3,64,6,FALSE
omni-common-ui,0.16.0-dev.1159,0.16.0-dev.1160,689,1,29,0,29,2,FALSE
omni-common-ui,0.16.0-dev.1158,0.16.0-dev.1159,688,1,0,49,49,3,FALSE
omni-common-ui,0.11.0-dev.792,0.11.0-dev.793,400,1,5,0,5,1,FALSE
omni-common-ui,0.11.0-dev.844,0.11.0-dev.845,443,1,10,0,10,1,FALSE
omni-common-ui,0.11.0-dev.845,0.11.0-dev.846,444,1,3,1,4,1,FALSE
omni-common-ui,0.11.0-dev.783,0.11.0-dev.784,392,2,5,11,16,6,FALSE
omni-common-ui,0.11.0-dev.782,0.11.0-dev.783,391,1,162,0,162,9,FALSE
omni-common-ui,0.8.0-dev.609,0.8.0-dev.610,229,1,10,22,32,3,FALSE
omni-common-ui,0.8.0-dev.608,0.8.0-dev.609,228,1,47,28,75,2,FALSE
omni-common-ui,0.11.0-dev.786,0.11.0-dev.788,395,2,70,1,71,2,FALSE
omni-common-ui,0.11.0-dev.785,0.11.0-dev.786,394,1,3,1,4,1,FALSE
omni-common-ui,0.11.0-dev.784,0.11.0-dev.785,393,2,19,2,21,2,FALSE
omni-common-ui,0.8.0-dev.603,0.8.0-dev.604,223,1,14,7,21,2,FALSE
omni-common-ui,0.11.0-dev.793,0.11.0-dev.794,401,1,124,120,244,4,FALSE
omni-common-ui,0.11.0-dev.789,0.11.0-dev.790,397,5,34,55,89,5,FALSE
omni-common-ui,0.11.0-dev.788,0.11.0-dev.789,396,1,3,1,4,1,FALSE
omni-common-ui,0.8.0-dev.607,0.8.0-dev.608,227,1,6,1,7,2,FALSE
omni-common-ui,0.8.0-dev.606,0.8.0-dev.607,226,1,3,1,4,1,FALSE
omni-common-ui,0.8.0-dev.605,0.8.0-dev.606,225,1,3,1,4,1,FALSE
omni-common-ui,0.8.0-dev.604,0.8.0-dev.605,224,1,16,3,19,1,FALSE
omni-common-ui,0.13.0-dev.943,0.13.0-dev.944,527,1,1,0,1,1,FALSE
omni-common-ui,0.11.0-dev.769,0.11.0-dev.771,380,2,46,4,50,4,FALSE
omni-common-ui,0.11.0-dev.768,0.11.0-dev.769,379,1,3,1,4,1,FALSE
omni-common-ui,0.11.0-dev.765,0.11.0-dev.766,376,1,3,1,4,1,FALSE
omni-common-ui,0.11.0-dev.764,0.11.0-dev.765,375,1,10,6,16,1,FALSE
omni-common-ui,0.11.0-dev.767,0.11.0-dev.768,378,2,20,1,21,2,FALSE
omni-common-ui,0.11.0-dev.766,0.11.0-dev.767,377,1,1,1,2,1,FALSE
omni-common-ui,0.11.0-dev.761,0.11.0-dev.762,372,1,65,15,80,18,FALSE
omni-common-ui,0.11.0-dev.760,0.11.0-dev.761,371,1,1,0,1,1,FALSE
omni-common-ui,0.11.0-dev.763,0.11.0-dev.764,374,1,5,2,7,1,FALSE
omni-common-ui,0.11.0-dev.762,0.11.0-dev.763,373,1,39,16,55,1,FALSE
omni-common-ui,0.4.0-dev.449,0.4.0-dev.450,88,1,1,2,3,1,FALSE
omni-common-ui,0.6.0-dev.491,0.6.0-dev.494,129,1,4,4,8,1,FALSE
omni-common-ui,0.18.0-dev.1274,0.18.0-dev.1275,776,1,1,1,2,1,FALSE
omni-common-ui,0.6.0-dev.494,0.6.0-dev.495,130,2,0,4,4,2,FALSE
omni-common-ui,0.6.0-dev.495,0.6.0-dev.496,131,1,9,9,18,1,FALSE
omni-common-ui,0.6.0-dev.496,0.6.0-dev.497,132,1,4,10,14,3,FALSE
omni-common-ui,0.6.0-dev.497,0.6.0-dev.498,133,2,29,24,53,7,FALSE
omni-common-ui,0.6.0-dev.498,0.6.0-dev.499,134,1,3,1,4,1,FALSE
omni-common-ui,0.6.0-dev.499,0.6.0-dev.500,135,1,2,1,3,1,FALSE
omni-common-ui,0.11.0-dev.806,0.11.0-dev.807,409,1,3,1,4,1,FALSE
omni-common-ui,0.11.0-dev.807,0.11.0-dev.808,410,1,3,1,4,1,FALSE
omni-common-ui,0.4.0-dev.445,0.4.0-dev.446,85,1,2,0,2,1,FALSE
omni-common-ui,0.4.0-dev.444,0.4.0-dev.445,84,1,1,1,2,1,FALSE
omni-common-ui,0.4.0-dev.447,0.4.0-dev.449,87,1,2,0,2,1,FALSE
omni-common-ui,0.4.0-dev.446,0.4.0-dev.447,86,5,220,306,526,12,FALSE
omni-common-ui,0.18.0-dev.1275,0.18.0-dev.1276,777,1,7,5,12,1,FALSE
omni-common-ui,0.3.0-dev.408,0.3.0-dev.409,51,1,24,28,52,2,FALSE
omni-common-ui,0.3.0-dev.409,0.3.0-dev.410,52,2,46,11,57,7,FALSE
omni-common-ui,0.3.0-dev.402,0.3.0-dev.404,48,2,16,14,30,2,FALSE
omni-common-ui,0.3.0-dev.404,0.3.0-dev.405,49,1,3,1,4,1,FALSE
omni-common-ui,0.3.0-dev.405,0.3.0-dev.408,50,2,23,24,47,2,FALSE
omni-common-ui,0.14.0-dev.999,0.14.0-dev.1000,564,1,3,3,6,1,FALSE
omni-common-ui,0.14.0-dev.984,0.14.0-dev.987,555,1,3,1,4,1,FALSE
omni-common-ui,0.13.0-dev.946,0.13.0-dev.947,530,3,54,52,106,5,FALSE
omni-common-ui,0.18.0-dev.1273,0.18.0-dev.1274,775,1,5,0,5,1,FALSE
omni-common-ui,0.6.0-dev.504,0.6.0-dev.505,140,1,33,17,50,2,FALSE
omni-common-ui,0.11.0-dev.800,0.11.0-dev.806,408,8,1630,513,2143,15,FALSE
omni-common-ui,0.11.0,0.12.0-dev.863,460,1,3,1,4,1,FALSE
omni-common-ui,0.18.0-dev.1270,0.18.0-dev.1272,773,2,6,2,8,2,FALSE
omni-common-ui,0.7.0-dev.558,0.7.0-dev.559,190,2,132,234,366,3,FALSE
omni-common-ui,0.7.0-dev.559,0.7.0-dev.562,191,2,207,13,220,8,FALSE
omni-common-ui,0.7.0-dev.555,0.7.0-dev.556,187,1,39,9,48,3,FALSE
omni-common-ui,0.7.0-dev.556,0.7.0-dev.557,188,1,10,0,10,1,FALSE
omni-common-ui,0.7.0-dev.557,0.7.0-dev.558,189,1,1,1,2,1,FALSE
omni-common-ui,0.7.0-dev.550,0.7.0-dev.551,183,2,15,15,30,2,FALSE
omni-common-ui,0.7.0-dev.551,0.7.0-dev.552,184,1,3,1,4,1,FALSE
omni-common-ui,0.7.0-dev.552,0.7.0-dev.553,185,1,1,1,2,1,FALSE
omni-common-ui,0.7.0-dev.553,0.7.0-dev.555,186,2,39,22,61,6,FALSE
omni-common-ui,0.1.0-dev.390,0.1.0-dev.392,39,2,33,2,35,6,FALSE
omni-common-ui,0.14.1,0.14.2,631,4,8,2,10,5,FALSE
omni-common-ui,0.14.0,0.14.1,630,6,113,38,151,32,FALSE
omni-common-ui,0.17.0-dev.1190,0.17.0-dev.1191,710,1,3,1,4,1,FALSE
omni-common-ui,0.17.0-dev.1191,0.17.0-dev.1193,711,2,9,8,17,3,FALSE
omni-common-ui,0.15.0-dev.1144,0.15.0,674,2,1244,695,1939,72,FALSE
omni-common-ui,0.15.0-dev.1141,0.15.0-dev.1144,673,12,412,464,876,60,FALSE
omni-common-ui,0.15.0-dev.1140,0.15.0-dev.1141,672,1,21,2,23,3,FALSE
omni-common-ui,0.10.0-dev.676,0.10.0-dev.679,293,1,11,5,16,2,FALSE
omni-common-ui,0.10.0-dev.679,0.10.0-dev.680,294,2,6,1,7,3,FALSE
omni-common-ui,0.19.0-dev.1342,0.19.0-dev.1346,809,5,78,31,109,11,FALSE
omni-common-ui,0.8.0-dev.649,0.8.0-dev.650,266,1,233,65,298,9,FALSE
omni-common-ui,0.19.0-dev.1346,0.19.0-dev.1350,810,3,55,59,114,7,FALSE
omni-common-ui,0.8.0-dev.647,0.8.0-dev.648,264,1,51,16,67,1,FALSE
omni-common-ui,0.8.0-dev.646,0.8.0-dev.647,263,1,3,1,4,1,FALSE
omni-common-ui,0.8.0-dev.645,0.8.0-dev.646,262,2,12,2,14,2,FALSE
omni-common-ui,0.8.0-dev.644,0.8.0-dev.645,261,1,1,1,2,1,FALSE
omni-common-ui,0.8.0-dev.643,0.8.0-dev.644,260,1,1,3,4,2,FALSE
omni-common-ui,0.8.0-dev.642,0.8.0-dev.643,259,1,2,0,2,1,FALSE
omni-common-ui,0.8.0-dev.641,0.8.0-dev.642,258,10,277,126,403,58,FALSE
omni-common-ui,0.8.0-dev.640,0.8.0-dev.641,257,1,3,1,4,1,FALSE
omni-common-ui,0.14.0-dev.1049,0.14.0-dev.1050,601,1,2,29,31,2,FALSE
omni-common-ui,0.14.0-dev.1048,0.14.0-dev.1049,600,2,45,0,45,2,FALSE
omni-common-ui,0.15.0-dev.1138,0.15.0-dev.1139,670,1,4,4,8,2,FALSE
omni-common-ui,0.15.0-dev.1139,0.15.0-dev.1140,671,1,1,0,1,1,FALSE
omni-common-ui,0.18.0-dev.1326,0.18.0,796,3,1309,251,1560,50,FALSE
omni-common-ui,0.3.0-dev.399,0.3.0-dev.402,47,4,94,59,153,14,FALSE
omni-common-ui,0.14.0-dev.1041,0.14.0-dev.1042,593,2,50,89,139,10,FALSE
omni-common-ui,0.15.0-dev.1133,0.15.0-dev.1134,665,2,2,1,3,2,FALSE
omni-common-ui,0.15.0-dev.1130,0.15.0-dev.1131,662,1,1,0,1,1,FALSE
omni-common-ui,0.15.0-dev.1131,0.15.0-dev.1132,663,1,1,1,2,1,FALSE
omni-common-ui,0.15.0-dev.1136,0.15.0-dev.1137,668,1,9,9,18,2,FALSE
omni-common-ui,0.15.0-dev.1137,0.15.0-dev.1138,669,2,9,2,11,2,FALSE
omni-common-ui,0.15.0-dev.1134,0.15.0-dev.1135,666,1,3,1,4,1,FALSE
omni-common-ui,0.15.0-dev.1135,0.15.0-dev.1136,667,1,4,4,8,2,FALSE
omni-common-ui,0.17.0-dev.1194,0.17.0-dev.1198,713,4,175,89,264,12,FALSE
omni-common-ui,0.11.0-dev.721,0.11.0-dev.722,334,1,1,1,2,1,FALSE
omni-common-ui,0.11.0-dev.720,0.11.0-dev.721,333,1,4,2,6,2,FALSE
omni-common-ui,0.11.0-dev.723,0.11.0-dev.724,336,1,4,17,21,1,FALSE
omni-common-ui,0.11.0-dev.722,0.11.0-dev.723,335,1,1,0,1,1,FALSE
omni-common-ui,0.11.0-dev.725,0.11.0-dev.726,338,1,22,18,40,6,FALSE
omni-common-ui,0.11.0-dev.724,0.11.0-dev.725,337,1,1,1,2,1,FALSE
omni-common-ui,0.11.0-dev.727,0.11.0-dev.728,340,1,1,1,2,1,FALSE
omni-common-ui,0.11.0-dev.726,0.11.0-dev.727,339,1,1,2,3,1,FALSE
omni-common-ui,0.11.0-dev.729,0.11.0-dev.730,342,7,806,0,806,18,FALSE
omni-common-ui,0.11.0-dev.728,0.11.0-dev.729,341,1,7,7,14,2,FALSE
omni-common-ui,0.17.0-dev.1193,0.17.0-dev.1194,712,1,21,2,23,1,FALSE
omni-common-ui,0.17.0-dev.1203,0.17.0-dev.1204,719,1,47,27,74,2,FALSE
omni-common-ui,0.12.0-dev.899,0.12.0-dev.900,489,1,16,13,29,2,FALSE
omni-common-ui,0.16.0-dev.1155,0.16.0-dev.1156,685,1,5,2,7,4,FALSE
omni-common-ui,0.18.0-dev.1258,0.18.0-dev.1259,762,2,7,15,22,3,FALSE
omni-common-ui,0.17.0-dev.1218,0.17.0,733,2,652,433,1085,45,FALSE
omni-common-ui,0.18.0-dev.1254,0.18.0-dev.1256,759,1,43,28,71,1,FALSE
omni-common-ui,0.17.0-dev.1214,0.17.0-dev.1216,730,1,57,22,79,2,FALSE
omni-common-ui,0.18.0-dev.1256,0.18.0-dev.1257,760,2,30,5,35,3,FALSE
omni-common-ui,0.18.0-dev.1257,0.18.0-dev.1258,761,1,128,1,129,4,FALSE
omni-common-ui,0.18.0-dev.1250,0.18.0-dev.1251,755,1,2,2,4,1,FALSE
omni-common-ui,0.18.0-dev.1251,0.18.0-dev.1252,756,1,1,0,1,1,FALSE
omni-common-ui,0.18.0-dev.1252,0.18.0-dev.1253,757,1,8,0,8,1,FALSE
omni-common-ui,0.18.0-dev.1253,0.18.0-dev.1254,758,1,12,1,13,1,FALSE
omni-common-ui,0.8.0-dev.625,0.8.0-dev.626,244,1,4,0,4,1,FALSE
omni-common-ui,0.17.0-dev.1198,0.17.0-dev.1199,714,1,11,5,16,2,FALSE
omni-common-ui,0.18.0-dev.1260,0.18.0-dev.1261,764,2,1,2,3,2,FALSE
omni-common-ui,0.17.0-dev.1199,0.17.0-dev.1200,715,1,41,32,73,2,FALSE
omni-common-ui,0.18.0-dev.1263,0.18.0-dev.1264,767,1,1,3,4,1,FALSE
omni-common-ui,0.12.0-dev.891,0.12.0-dev.892,481,2,12,0,12,3,FALSE
omni-common-ui,0.12.0-dev.892,0.12.0-dev.893,482,2,39,10,49,4,FALSE
omni-common-ui,0.8.0-dev.626,0.8.0-dev.628,245,4,40,3,43,4,FALSE
omni-common-ui,0.12.0-dev.894,0.12.0-dev.895,484,1,18,1,19,2,FALSE
omni-common-ui,0.12.0-dev.895,0.12.0-dev.896,485,2,52,26,78,6,FALSE
omni-common-ui,0.12.0-dev.896,0.12.0-dev.897,486,1,3,1,4,1,FALSE
omni-common-ui,0.12.0-dev.897,0.12.0-dev.898,487,1,0,0,0,2,FALSE
omni-common-ui,0.12.0-dev.898,0.12.0-dev.899,488,1,1,1,2,1,FALSE
omni-common-ui,0.17.0-dev.1206,0.17.0-dev.1207,722,1,3,1,4,1,FALSE
omni-common-ui,0.18.0-dev.1264,0.18.0-dev.1265,768,1,108,29,137,2,FALSE
omni-common-ui,0.6.0-dev.506,0.6.0-dev.507,142,1,3,1,4,1,FALSE
omni-common-ui,0.6.0-dev.507,0.6.0-dev.508,143,1,9,0,9,1,FALSE
omni-common-ui,0.11.0-dev.855,0.11.0-dev.856,454,1,3,1,4,1,FALSE
omni-common-ui,0.6.0-dev.505,0.6.0-dev.506,141,1,1,0,1,1,FALSE
omni-common-ui,0.6.0-dev.502,0.6.0-dev.503,138,2,10,1,11,3,FALSE
omni-common-ui,0.11.0-dev.852,0.11.0-dev.853,451,1,3,1,4,1,FALSE
omni-common-ui,0.6.0-dev.500,0.6.0-dev.501,136,1,1,0,1,1,FALSE
omni-common-ui,0.6.0-dev.501,0.6.0-dev.502,137,1,1,0,1,1,FALSE
omni-common-ui,0.17.0-dev.1205,0.17.0-dev.1206,721,2,58,42,100,5,FALSE
omni-common-ui,0.6.0-dev.508,0.6.0-dev.509,144,1,2,2,4,1,FALSE
omni-common-ui,0.11.0-dev.858,0.11.0-dev.859,457,1,5,5,10,1,FALSE
omni-common-ui,0.14.0-dev.1040,0.14.0-dev.1041,592,3,6,4,10,3,FALSE
omni-common-ui,0.9.0-dev.673,0.9.0-dev.674,289,1,9,20,29,2,FALSE
omni-common-ui,0.9.0-dev.672,0.9.0-dev.673,288,1,1,1,2,1,FALSE
omni-common-ui,0.9.0-dev.671,0.9.0-dev.672,287,1,1,1,2,1,FALSE
omni-common-ui,0.9.0-dev.670,0.9.0-dev.671,286,1,56,2,58,5,FALSE
omni-common-ui,0.9.0-dev.675,0.9.0,291,2,574,155,729,31,FALSE
omni-common-ui,0.9.0-dev.674,0.9.0-dev.675,290,1,15,1,16,2,FALSE
omni-common-ui,0.17.0-dev.1207,0.17.0-dev.1208,723,1,3,69,72,3,FALSE
omni-common-ui,0.15.0-dev.1089,0.15.0-dev.1094,633,6,113,38,151,32,FALSE
omni-common-ui,0.15.0-dev.1103,0.15.0-dev.1104,641,1,8,40,48,6,FALSE
omni-common-ui,0.15.0-dev.1102,0.15.0-dev.1103,640,2,20,0,20,2,FALSE
omni-common-ui,0.15.0-dev.1101,0.15.0-dev.1102,639,1,6,33,39,2,FALSE
omni-common-ui,0.15.0-dev.1100,0.15.0-dev.1101,638,1,34,22,56,2,FALSE
omni-common-ui,0.15.0-dev.1107,0.15.0-dev.1109,644,1,3,1,4,1,FALSE
omni-common-ui,0.15.0-dev.1105,0.15.0-dev.1107,643,2,109,17,126,9,FALSE
omni-common-ui,0.15.0-dev.1104,0.15.0-dev.1105,642,2,21,2,23,4,FALSE
omni-common-ui,0.15.0-dev.1109,0.15.0-dev.1110,645,1,39,0,39,1,FALSE
omni-common-ui,0.13.0-dev.925,0.13.0-dev.926,511,1,54,2,56,2,FALSE
omni-common-ui,0.13.0-dev.924,0.13.0-dev.925,510,1,5,9,14,1,FALSE
omni-common-ui,0.13.0-dev.927,0.13.0-dev.928,513,2,17,14,31,3,FALSE
omni-common-ui,0.13.0-dev.926,0.13.0-dev.927,512,1,15,14,29,1,FALSE
omni-common-ui,0.13.0-dev.921,0.13.0-dev.922,507,2,3,1,4,2,FALSE
omni-common-ui,0.13.0-dev.923,0.13.0-dev.924,509,1,28,28,56,3,FALSE
omni-common-ui,0.13.0-dev.922,0.13.0-dev.923,508,1,3,1,4,1,FALSE
omni-common-ui,0.18.1,0.18.2,798,4,17,2,19,5,FALSE
omni-common-ui,0.18.0-dev.1282,0.18.0-dev.1284,781,1,2,1,3,1,FALSE
omni-common-ui,0.18.0-dev.1281,0.18.0-dev.1282,780,1,7,12,19,3,FALSE
omni-common-ui,0.18.2,0.18.3,799,7,116,47,163,15,FALSE
omni-common-ui,0.13.0-dev.928,0.13.0-dev.929,514,1,71,52,123,2,FALSE
omni-common-ui,0.18.0-dev.1285,0.18.0-dev.1287,783,1,1,1,2,1,FALSE
omni-common-ui,0.18.0-dev.1284,0.18.0-dev.1285,782,1,1,0,1,1,FALSE
omni-common-ui,0.13.0-dev.936,0.13.0-dev.937,520,1,2,0,2,1,FALSE
omni-common-ui,0.14.0-dev.1009,0.14.0-dev.1010,573,2,23,10,33,3,FALSE
omni-common-ui,0.14.0-dev.1008,0.14.0-dev.1009,572,2,1,4,5,2,FALSE
omni-common-ui,0.14.0-dev.1005,0.14.0-dev.1006,569,1,3,1,4,1,FALSE
omni-common-ui,0.14.0-dev.1004,0.14.0-dev.1005,568,1,3,1,4,1,FALSE
omni-common-ui,0.14.0-dev.1007,0.14.0-dev.1008,571,1,8,1,9,2,FALSE
omni-common-ui,0.14.0-dev.1006,0.14.0-dev.1007,570,1,8,0,8,2,FALSE
omni-common-ui,0.14.0-dev.1001,0.14.0-dev.1002,566,3,110,9,119,9,FALSE
omni-common-ui,0.14.0-dev.1000,0.14.0-dev.1001,565,1,6,6,12,3,FALSE
omni-common-ui,0.14.0-dev.1002,0.14.0-dev.1004,567,1,1,1,2,1,FALSE
omni-common-ui,0.7.0-dev.565,0.7.0-dev.566,194,9,397,167,564,23,FALSE
omni-common-ui,0.14.0-dev.989,0.14.0-dev.990,557,1,36,0,36,4,FALSE
omni-common-ui,0.7.0-dev.567,0.7.0-dev.568,196,1,3,0,3,2,FALSE
omni-common-ui,0.7.0-dev.566,0.7.0-dev.567,195,1,19,3,22,2,FALSE
omni-common-ui,0.7.0-dev.562,0.7.0-dev.564,192,1,3,1,4,1,FALSE
omni-common-ui,0.7.0-dev.569,0.7.0-dev.570,198,1,2,0,2,1,FALSE
omni-common-ui,0.7.0-dev.568,0.7.0-dev.569,197,1,1,1,2,1,FALSE
omni-common-ui,0.14.0-dev.987,0.14.0-dev.989,556,1,126,31,157,3,FALSE
omni-common-ui,0.0.18-dev.380,0.0.18-dev.381,32,3,410,4,414,7,FALSE
omni-common-ui,0.0.18-dev.381,0.1.0-dev.382,33,3,493,28,521,19,FALSE
omni-common-ui,0.12.0-dev.877,0.12.0-dev.878,473,1,27,16,43,1,FALSE
omni-common-ui,0.8.0-dev.614,0.8.0-dev.615,233,1,3,1,4,1,FALSE
omni-common-ui,0.8.0-dev.615,0.8.0-dev.616,234,1,10,3,13,2,FALSE
omni-common-ui,0.8.0-dev.616,0.8.0-dev.617,235,1,3,1,4,1,FALSE
omni-common-ui,0.8.0-dev.617,0.8.0-dev.618,236,1,12,0,12,1,FALSE
omni-common-ui,0.8.0-dev.610,0.8.0-dev.611,230,1,1,0,1,1,FALSE
omni-common-ui,0.8.0-dev.611,0.8.0-dev.612,231,2,29,11,40,2,FALSE
omni-common-ui,0.8.0-dev.612,0.8.0-dev.614,232,2,6,1,7,2,FALSE
omni-common-ui,0.12.0-dev.880,0.12.0-dev.881,476,1,1,0,1,1,FALSE
omni-common-ui,0.8.0-dev.618,0.8.0-dev.619,237,2,145,1,146,6,FALSE
omni-common-ui,0.8.0-dev.619,0.8.0-dev.620,238,1,11,1,12,3,FALSE
omni-common-ui,0.16.0-dev.1161,0.16.0-dev.1163,691,4,65,20,85,20,FALSE
omni-common-ui,0.3.0-dev.398,0.3.0-dev.399,46,1,3,1,4,1,FALSE
omni-common-ui,0.11.0-dev.758,0.11.0-dev.759,369,1,7,2,9,1,FALSE
omni-common-ui,0.15.0-dev.1132,0.15.0-dev.1133,664,1,17,10,27,3,FALSE
omni-common-ui,0.3.0-dev.397,0.3.0-dev.398,45,2,8,2,10,4,FALSE
omni-common-ui,0.11.0-dev.750,0.11.0-dev.751,362,1,5,4,9,1,FALSE
omni-common-ui,0.11.0-dev.751,0.11.0-dev.752,363,1,1,1,2,1,FALSE
omni-common-ui,0.11.0-dev.752,0.11.0-dev.753,364,1,3,1,4,1,FALSE
omni-common-ui,0.11.0-dev.753,0.11.0-dev.755,365,1,3,1,4,1,FALSE
omni-common-ui,0.14.0-dev.1043,0.14.0-dev.1044,595,1,141,141,282,15,FALSE
omni-common-ui,0.11.0-dev.756,0.11.0-dev.757,367,1,3,1,4,1,FALSE
omni-common-ui,0.11.0-dev.757,0.11.0-dev.758,368,1,266,101,367,7,FALSE
omni-common-ui,0.11.0-dev.819,0.11.0-dev.821,422,1,39,8,47,3,FALSE
omni-common-ui,0.14.0-dev.1042,0.14.0-dev.1043,594,1,78,19,97,2,FALSE
omni-common-ui,0.11.0-dev.759,0.11.0-dev.760,370,1,91,22,113,8,FALSE
omni-common-ui,0.4.0-dev.452,0.4.0-dev.453,91,1,8,3,11,1,FALSE
omni-common-ui,0.14.0-dev.1045,0.14.0-dev.1046,597,1,3,1,4,1,FALSE
omni-common-ui,0.4.0-dev.450,0.4.0-dev.451,89,2,14,1,15,2,FALSE
omni-common-ui,0.4.0-dev.451,0.4.0-dev.452,90,1,18,1,19,1,FALSE
omni-common-ui,0.4.0-dev.456,0.4.0-dev.457,95,1,1,0,1,1,FALSE
omni-common-ui,0.11.0-dev.816,0.11.0-dev.817,419,2,57,85,142,8,FALSE
omni-common-ui,0.4.0-dev.454,0.4.0-dev.455,93,1,98,21,119,3,FALSE
omni-common-ui,0.14.0-dev.1044,0.14.0-dev.1045,596,2,9,5,14,2,FALSE
omni-common-ui,0.5.0-dev.490,0.5.0,127,3,1017,755,1772,82,FALSE
omni-common-ui,0.18.3,0.18.5,800,31,342,227,569,62,FALSE
omni-common-ui,0.14.0-dev.1047,0.14.0-dev.1048,599,3,108,25,133,7,FALSE
omni-common-ui,0.14.0-dev.1046,0.14.0-dev.1047,598,1,12,0,12,1,FALSE
omni-common-ui,0.3.0-dev.437,0.3.0-dev.438,78,1,1,1,2,1,FALSE
omni-common-ui,0.3.0-dev.436,0.3.0-dev.437,77,1,10,1,11,1,FALSE
omni-common-ui,0.3.0-dev.396,0.3.0-dev.397,44,1,2,1,3,2,FALSE
omni-common-ui,0.3.0-dev.434,0.3.0-dev.435,75,1,73,0,73,5,FALSE
omni-common-ui,0.3.0-dev.433,0.3.0-dev.434,74,1,54,0,54,5,FALSE
omni-common-ui,0.3.0-dev.432,0.3.0-dev.433,73,1,25,19,44,5,FALSE
omni-common-ui,0.3.0-dev.431,0.3.0-dev.432,72,1,1,1,2,1,FALSE
omni-common-ui,0.3.0-dev.439,0.3.0-dev.440,80,2,1,1,2,2,FALSE
omni-common-ui,0.3.0-dev.438,0.3.0-dev.439,79,1,1,0,1,1,FALSE
omni-common-ui,0.14.0-dev.978,0.14.0-dev.984,554,3,23,11,34,8,FALSE
omni-common-ui,0.14.0-dev.971,0.14.0-dev.972,547,1,3,1,4,1,FALSE
omni-common-ui,0.14.0-dev.970,0.14.0-dev.971,546,2,43,4,47,4,FALSE
omni-common-ui,0.14.0-dev.973,0.14.0-dev.974,549,2,4,2,6,2,FALSE
omni-common-ui,0.14.0-dev.972,0.14.0-dev.973,548,1,7,4,11,1,FALSE
omni-common-ui,0.14.0-dev.975,0.14.0-dev.976,551,1,60,1,61,6,FALSE
omni-common-ui,0.14.0-dev.974,0.14.0-dev.975,550,1,3,1,4,1,FALSE
omni-common-ui,0.14.0-dev.977,0.14.0-dev.978,553,3,15,27,42,7,FALSE
omni-common-ui,0.14.0-dev.976,0.14.0-dev.977,552,1,6,0,6,1,FALSE
omni-common-ui,0.6.0,0.6.1,155,11,710,408,1118,30,FALSE
omni-common-ui,0.11.0-dev.755,0.11.0-dev.756,366,1,3,1,4,1,FALSE
omni-common-ui,0.11.0-dev.848,0.11.0-dev.849,447,1,3,1,4,1,FALSE
omni-common-ui,0.16.0-dev.1173,0.16.0-dev.1174,700,1,3,19,22,1,FALSE
omni-common-ui,0.16.0-dev.1172,0.16.0-dev.1173,699,1,1,1,2,1,FALSE
omni-common-ui,0.16.0-dev.1171,0.16.0-dev.1172,698,1,3,0,3,1,FALSE
omni-common-ui,0.16.0-dev.1170,0.16.0-dev.1171,697,1,3,1,4,1,FALSE
omni-common-ui,0.4.0,0.5.0-dev.461,98,1,3,1,4,1,FALSE
omni-common-ui,0.11.0-dev.860,0.11.0,459,3,5396,1863,7259,170,FALSE
omni-common-ui,0.13.0-dev.961,0.13.0-dev.962,537,1,5,3,8,1,FALSE
omni-common-ui,0.13.0-dev.960,0.13.0-dev.961,536,1,5,3,8,1,FALSE
omni-common-ui,0.13.0-dev.963,0.13.0-dev.964,539,1,1,1,2,1,FALSE
omni-common-ui,0.13.0-dev.962,0.13.0-dev.963,538,1,1,1,2,1,FALSE
omni-common-ui,0.13.0-dev.965,0.13.0-dev.966,541,1,3,1,4,1,FALSE
omni-common-ui,0.4.0-dev.458,0.4.0,97,2,376,321,697,22,FALSE
omni-common-ui,0.13.0-dev.967,0.13.0,543,2,1611,798,2409,60,FALSE
omni-common-ui,0.13.0-dev.966,0.13.0-dev.967,542,1,139,9,148,5,FALSE
omni-common-ui,0.11.0-dev.849,0.11.0-dev.850,448,1,50,0,50,3,FALSE
omni-common-ui,0.11.0-dev.818,0.11.0-dev.819,421,1,0,449,449,17,FALSE
omni-common-ui,0.7.0-dev.591,0.7.0-dev.593,215,8,77,80,157,20,FALSE
omni-common-ui,0.7.0-dev.529,0.7.0-dev.530,163,1,26,22,48,4,FALSE
omni-common-ui,0.7.0-dev.528,0.7.0-dev.529,162,1,12,3,15,1,FALSE
omni-common-ui,0.7.0-dev.520,0.7.0-dev.522,157,3,640,322,962,18,FALSE
omni-common-ui,0.7.0-dev.523,0.7.0-dev.524,159,1,3,1,4,1,FALSE
omni-common-ui,0.7.0-dev.522,0.7.0-dev.523,158,4,68,81,149,7,FALSE
omni-common-ui,0.7.0-dev.524,0.7.0-dev.527,160,4,2,5,7,5,FALSE
omni-common-ui,0.7.0-dev.527,0.7.0-dev.528,161,1,1,1,2,1,FALSE
omni-common-ui,0.6.0-dev.517,0.6.0-dev.518,153,1,1,0,1,1,FALSE
omni-common-ui,0.11.0-dev.813,0.11.0-dev.814,416,1,3,1,4,1,FALSE
omni-common-ui,0.4.0-dev.453,0.4.0-dev.454,92,1,22,1,23,1,FALSE
omni-common-ui,0.11.0-dev.811,0.11.0-dev.812,414,7,93,13,106,7,FALSE
omni-common-ui,0.11.0-dev.810,0.11.0-dev.811,413,1,0,2,2,5,FALSE
omni-common-ui,0.11.0-dev.817,0.11.0-dev.818,420,1,2,1,3,1,FALSE
omni-common-ui,0.4.0-dev.457,0.4.0-dev.458,96,1,1,0,1,1,FALSE
omni-common-ui,0.11.0-dev.815,0.11.0-dev.816,418,2,52,45,97,3,FALSE
omni-common-ui,0.2.0,0.3.0-dev.396,43,1,1,1,2,1,FALSE
omni-common-ui,0.19.0-dev.1356,0.19.0-dev.1360,812,6,55,23,78,8,FALSE
omni-common-ui,0.11.0-dev.814,0.11.0-dev.815,417,1,3,1,4,1,FALSE
omni-common-ui,0.19.0-dev.1350,0.19.0-dev.1356,811,2,3,1,4,2,FALSE
omni-common-ui,0.8.0-dev.650,0.8.0,267,2,1219,184,1403,57,FALSE
omni-common-ui,0.14.0-dev.1052,0.14.0-dev.1053,604,2,9,10,19,3,FALSE
omni-common-ui,0.14.0-dev.1053,0.14.0-dev.1058,605,9,75,85,160,16,FALSE
omni-common-ui,0.14.0-dev.1050,0.14.0-dev.1051,602,2,7,1,8,2,FALSE
omni-common-ui,0.14.0-dev.1051,0.14.0-dev.1052,603,1,3,1,4,1,FALSE
omni-common-ui,0.14.0-dev.1058,0.14.0-dev.1060,606,1,29,32,61,2,FALSE
omni-common-ui,0.11.0-dev.718,0.11.0-dev.719,331,1,13,10,23,4,FALSE
omni-common-ui,0.11.0-dev.719,0.11.0-dev.720,332,1,221,5,226,7,FALSE
omni-common-ui,0.11.0-dev.714,0.11.0-dev.715,327,1,101,87,188,5,FALSE
omni-common-ui,0.11.0-dev.715,0.11.0-dev.716,328,1,3,1,4,1,FALSE
omni-common-ui,0.11.0-dev.716,0.11.0-dev.717,329,1,2,0,2,1,FALSE
omni-common-ui,0.11.0-dev.717,0.11.0-dev.718,330,1,40,9,49,5,FALSE
omni-common-ui,0.11.0-dev.710,0.11.0-dev.711,323,1,11,10,21,3,FALSE
omni-common-ui,0.11.0-dev.711,0.11.0-dev.712,324,1,7,12,19,1,FALSE
omni-common-ui,0.11.0-dev.712,0.11.0-dev.713,325,1,2,2,4,1,FALSE
omni-common-ui,0.11.0-dev.713,0.11.0-dev.714,326,1,2,1,3,2,FALSE
omni-common-ui,0.9.0-dev.662,0.9.0-dev.663,278,1,2,0,2,1,FALSE
omni-common-ui,0.7.0-dev.564,0.7.0-dev.565,193,1,14,20,34,2,FALSE
omni-common-ui,0.12.0-dev.917,0.12.0,504,3,988,659,1647,60,FALSE
omni-common-ui,0.12.0-dev.916,0.12.0-dev.917,503,1,77,27,104,3,FALSE
omni-common-ui,0.7.0-dev.590,0.7.0-dev.591,214,1,3,1,4,1,FALSE
omni-common-ui,0.14.0-dev.991,0.14.0-dev.992,559,1,141,141,282,15,FALSE
omni-common-ui,0.18.0-dev.1269,0.18.0-dev.1270,772,1,3,1,4,1,FALSE
omni-common-ui,0.18.0-dev.1268,0.18.0-dev.1269,771,1,11,12,23,1,FALSE
omni-common-ui,0.17.0-dev.1208,0.17.0-dev.1209,724,1,19,15,34,4,FALSE
omni-common-ui,0.17.0-dev.1209,0.17.0-dev.1210,725,1,65,6,71,7,FALSE
omni-common-ui,0.8.0-dev.629,0.8.0-dev.630,247,2,158,10,168,7,FALSE
omni-common-ui,0.8.0-dev.628,0.8.0-dev.629,246,1,14,2,16,1,FALSE
omni-common-ui,0.17.0-dev.1202,0.17.0-dev.1203,718,2,7,4,11,3,FALSE
omni-common-ui,0.8.0-dev.624,0.8.0-dev.625,243,1,83,22,105,3,FALSE
omni-common-ui,0.17.0-dev.1200,0.17.0-dev.1201,716,1,23,6,29,2,FALSE
omni-common-ui,0.17.0-dev.1201,0.17.0-dev.1202,717,1,2,1,3,1,FALSE
omni-common-ui,0.18.0-dev.1265,0.18.0-dev.1266,769,1,3,1,4,1,FALSE
omni-common-ui,0.8.0-dev.620,0.8.0-dev.621,239,2,18,3,21,2,FALSE
omni-common-ui,0.17.0-dev.1204,0.17.0-dev.1205,720,1,1,1,2,1,FALSE
omni-common-ui,0.18.0-dev.1266,0.18.0-dev.1268,770,1,3,1,4,1,FALSE
omni-common-ui,0.14.0-dev.1079,0.14.0-dev.1080,622,1,12,3,15,1,FALSE
omni-common-ui,0.3.0-dev.435,0.3.0-dev.436,76,1,0,3,3,1,FALSE
omni-common-ui,0.12.0-dev.887,0.12.0-dev.891,480,1,26,5,31,1,FALSE
omni-common-ui,0.12.0-dev.886,0.12.0-dev.887,479,1,21,3,24,3,FALSE
omni-common-ui,0.12.0-dev.885,0.12.0-dev.886,478,1,1,1,2,1,FALSE
omni-common-ui,0.14.0-dev.998,0.14.0-dev.999,563,5,142,101,243,9,FALSE
omni-common-ui,0.12.0-dev.881,0.12.0-dev.885,477,6,103,104,207,15,FALSE
omni-common-ui,0.18.0-dev.1262,0.18.0-dev.1263,766,1,24,35,59,1,FALSE
omni-common-ui,0.14.0-dev.1088,0.14.0,629,2,1549,783,2332,120,FALSE
omni-common-ui,0.11.0-dev.822,0.11.0-dev.823,424,1,3,1,4,1,FALSE
omni-common-ui,0.11.0-dev.823,0.11.0-dev.824,425,1,16,0,16,2,FALSE
omni-common-ui,0.11.0-dev.821,0.11.0-dev.822,423,2,2,2,4,2,FALSE
omni-common-ui,0.11.0-dev.827,0.11.0-dev.828,427,1,5,9,14,3,FALSE
omni-common-ui,0.11.0-dev.824,0.11.0-dev.827,426,2,15,13,28,4,FALSE
omni-common-ui,0.11.0-dev.828,0.11.0-dev.829,428,1,3,1,4,1,FALSE
omni-common-ui,0.11.0-dev.829,0.11.0-dev.830,429,1,1,0,1,1,FALSE
omni-common-ui,0.8.0-dev.621,0.8.0-dev.622,240,1,4,4,8,2,FALSE
omni-common-ui,0.18.0-dev.1259,0.18.0-dev.1260,763,1,0,0,0,2,FALSE
omni-common-ui,0.9.0-dev.668,0.9.0-dev.669,284,1,1,0,1,1,FALSE
omni-common-ui,0.9.0-dev.669,0.9.0-dev.670,285,1,36,2,38,2,FALSE
omni-common-ui,0.9.0-dev.664,0.9.0-dev.665,280,1,4,4,8,2,FALSE
omni-common-ui,0.9.0-dev.665,0.9.0-dev.666,281,2,99,9,108,5,FALSE
omni-common-ui,0.9.0-dev.666,0.9.0-dev.667,282,1,2,3,5,3,FALSE
omni-common-ui,0.9.0-dev.667,0.9.0-dev.668,283,1,2,10,12,1,FALSE
omni-common-ui,0.9.0-dev.660,0.9.0-dev.661,276,1,2,2,4,2,FALSE
omni-common-ui,0.9.0-dev.661,0.9.0-dev.662,277,1,4,4,8,2,FALSE
omni-common-ui,0.18.0-dev.1261,0.18.0-dev.1262,765,1,5,1,6,1,FALSE
omni-common-ui,0.9.0-dev.663,0.9.0-dev.664,279,1,5,1,6,2,FALSE
omni-common-ui,0.14.0-dev.1084,0.14.0-dev.1086,626,1,3,1,4,1,FALSE
omni-common-ui,0.14.0-dev.1087,0.14.0-dev.1088,628,1,10,9,19,1,FALSE
omni-common-ui,0.14.0-dev.1086,0.14.0-dev.1087,627,1,3,2,5,3,FALSE
omni-common-ui,0.14.0-dev.1080,0.14.0-dev.1082,623,1,1,1,2,1,FALSE
omni-common-ui,0.14.0-dev.1083,0.14.0-dev.1084,625,2,4,1,5,2,FALSE
omni-common-ui,0.14.0-dev.1082,0.14.0-dev.1083,624,1,1,1,2,1,FALSE
omni-common-ui,0.1.0-dev.388,0.1.0-dev.389,37,1,3,1,4,1,FALSE
omni-common-ui,0.17.0-dev.1217,0.17.0-dev.1218,732,1,0,2,2,1,FALSE
omni-common-ui,0.17.0-dev.1216,0.17.0-dev.1217,731,1,2,0,2,1,FALSE
omni-common-ui,0.17.0-dev.1211,0.17.0-dev.1212,727,2,2,1,3,7,FALSE
omni-common-ui,0.17.0-dev.1210,0.17.0-dev.1211,726,1,11,2,13,1,FALSE
omni-common-ui,0.12.0-dev.872,0.12.0-dev.874,469,1,3,1,4,1,FALSE
omni-common-ui,0.12.0-dev.870,0.12.0-dev.871,467,1,2,0,2,1,FALSE
omni-common-ui,0.12.0-dev.871,0.12.0-dev.872,468,1,3,1,4,1,FALSE
omni-common-ui,0.12.0-dev.876,0.12.0-dev.877,472,1,48,9,57,3,FALSE
omni-common-ui,0.17.0-dev.1213,0.17.0-dev.1214,729,1,30,6,36,2,FALSE
omni-common-ui,0.12.0-dev.874,0.12.0-dev.875,470,1,3,1,4,1,FALSE
omni-common-ui,0.12.0-dev.875,0.12.0-dev.876,471,1,3,1,4,1,FALSE
omni-common-ui,0.8.0-dev.623,0.8.0-dev.624,242,1,6,0,6,1,FALSE
omni-common-ui,0.12.0-dev.878,0.12.0-dev.879,474,1,4,4,8,2,FALSE
omni-common-ui,0.12.0-dev.879,0.12.0-dev.880,475,1,1,1,2,1,FALSE
omni-common-ui,0.14.0-dev.1075,0.14.0-dev.1076,619,2,14,3,17,3,FALSE
omni-common-ui,0.15.0-dev.1110,0.15.0-dev.1111,646,3,220,91,311,6,FALSE
omni-common-ui,0.15.0-dev.1111,0.15.0-dev.1112,647,1,3,1,4,1,FALSE
omni-common-ui,0.15.0-dev.1112,0.15.0-dev.1113,648,2,7,8,15,3,FALSE
omni-common-ui,0.15.0-dev.1113,0.15.0-dev.1114,649,1,283,0,283,4,FALSE
omni-common-ui,0.15.0-dev.1114,0.15.0-dev.1115,650,1,3,1,4,1,FALSE
omni-common-ui,0.15.0-dev.1115,0.15.0-dev.1117,651,4,51,172,223,5,FALSE
omni-common-ui,0.15.0-dev.1117,0.15.0-dev.1121,652,3,81,28,109,7,FALSE
omni-common-ui,0.18.0-dev.1298,0.18.0-dev.1299,792,1,1,1,2,1,FALSE
omni-common-ui,0.18.0-dev.1299,0.18.0-dev.1300,793,1,8,0,8,1,FALSE
omni-common-ui,0.8.0-dev.622,0.8.0-dev.623,241,2,1,18,19,2,FALSE
omni-common-ui,0.18.0-dev.1290,0.18.0-dev.1291,787,1,7,2,9,3,FALSE
omni-common-ui,0.13.0-dev.919,0.13.0-dev.921,506,1,3,1,4,1,FALSE
omni-common-ui,0.18.0-dev.1293,0.18.0-dev.1294,789,1,21,1,22,4,FALSE
omni-common-ui,0.18.0-dev.1294,0.18.0-dev.1296,790,1,5,2,7,1,FALSE
omni-common-ui,0.18.0-dev.1296,0.18.0-dev.1298,791,2,37,23,60,3,FALSE
omni-common-ui,0.14.0-dev.1018,0.14.0-dev.1020,582,3,60,28,88,6,FALSE
omni-common-ui,0.14.0-dev.1012,0.14.0-dev.1013,576,1,1,0,1,1,FALSE
omni-common-ui,0.14.0-dev.1013,0.14.0-dev.1014,577,1,0,1,1,1,FALSE
omni-common-ui,0.14.0-dev.1010,0.14.0-dev.1011,574,1,19,23,42,4,FALSE
omni-common-ui,0.14.0-dev.1011,0.14.0-dev.1012,575,1,3,1,4,1,FALSE
omni-common-ui,0.14.0-dev.1016,0.14.0-dev.1017,580,1,3,1,4,1,FALSE
omni-common-ui,0.14.0-dev.1017,0.14.0-dev.1018,581,1,3,1,4,1,FALSE
omni-common-ui,0.14.0-dev.1014,0.14.0-dev.1015,578,1,21,1,22,3,FALSE
omni-common-ui,0.4.0-dev.455,0.4.0-dev.456,94,1,10,7,17,1,FALSE
omni-common-ui,0.7.0-dev.576,0.7.0-dev.578,205,1,3,1,4,1,FALSE
omni-common-ui,0.7.0-dev.574,0.7.0-dev.575,203,1,85,1,86,2,FALSE
omni-common-ui,0.7.0-dev.575,0.7.0-dev.576,204,1,3,1,4,1,FALSE
omni-common-ui,0.14.0-dev.993,0.14.0-dev.995,561,1,3,1,4,1,FALSE
omni-common-ui,0.14.0-dev.992,0.14.0-dev.993,560,1,0,0,0,4,FALSE
omni-common-ui,0.12.0-dev.908,0.12.0-dev.909,498,1,14,1,15,2,FALSE
omni-common-ui,0.14.0-dev.990,0.14.0-dev.991,558,2,70,31,101,5,FALSE
omni-common-ui,0.12.0-dev.906,0.12.0-dev.907,496,1,1,0,1,1,FALSE
omni-common-ui,0.12.0-dev.907,0.12.0-dev.908,497,1,3,1,4,1,FALSE
omni-common-ui,0.12.0-dev.904,0.12.0-dev.905,494,3,10,41,51,6,FALSE
omni-common-ui,0.12.0-dev.905,0.12.0-dev.906,495,1,3,1,4,1,FALSE
omni-common-ui,0.12.0-dev.902,0.12.0-dev.903,492,4,185,20,205,14,FALSE
omni-common-ui,0.12.0-dev.903,0.12.0-dev.904,493,1,51,8,59,11,FALSE
omni-common-ui,0.7.0-dev.578,0.7.0-dev.579,206,1,12,11,23,4,FALSE
omni-common-ui,0.7.0-dev.579,0.7.0-dev.580,207,1,1,1,2,1,FALSE
omni-common-ui,0.15.0,0.15.1,675,27,349,533,882,85,FALSE
omni-common-ui,0.17.0-dev.1212,0.17.0-dev.1213,728,1,2,0,2,1,FALSE
omni-common-ui,0.10.0-dev.694,0.10.0-dev.695,308,3,23,3,26,5,FALSE
omni-common-ui,0.10.0-dev.695,0.10.0-dev.696,309,1,2,2,4,1,FALSE
omni-common-ui,0.10.0-dev.696,0.10.0,310,2,327,208,535,31,FALSE
omni-common-ui,0.10.0-dev.690,0.10.0-dev.691,305,1,13,4,17,2,FALSE
omni-common-ui,0.10.0-dev.691,0.10.0-dev.692,306,1,3,1,4,1,FALSE
omni-common-ui,0.10.0-dev.692,0.10.0-dev.694,307,5,185,118,303,17,FALSE
omni-common-ui,0.8.0-dev.600,0.8.0-dev.603,222,1,23,5,28,5,FALSE
omni-common-ui,0.19.0-dev.1363,0.19.0,814,125,6469,5414,11883,574,FALSE
omni-common-ui,0.18.0-dev.1228,0.18.0-dev.1230,744,4,5,5,10,5,FALSE
omni-common-ui,0.19.0-dev.1360,0.19.0-dev.1363,813,1,3,1,4,1,FALSE
omni-common-ui,0.18.0-dev.1224,0.18.0-dev.1227,742,4,83,71,154,8,FALSE
omni-common-ui,0.18.0-dev.1227,0.18.0-dev.1228,743,1,1,1,2,1,FALSE
omni-common-ui,0.18.0-dev.1221,0.18.0-dev.1222,739,1,11,1,12,2,FALSE
omni-common-ui,0.18.0-dev.1223,0.18.0-dev.1224,741,1,0,1,1,1,FALSE
omni-common-ui,0.18.0-dev.1222,0.18.0-dev.1223,740,1,6,1,7,1,FALSE
omni-common-ui,0.14.0-dev.1069,0.14.0-dev.1070,615,1,5,3,8,2,FALSE
omni-common-ui,0.14.0-dev.1068,0.14.0-dev.1069,614,1,24,4,28,1,FALSE
omni-common-ui,0.14.0-dev.1067,0.14.0-dev.1068,613,2,56,10,66,6,FALSE
omni-common-ui,0.14.0-dev.1065,0.14.0-dev.1067,612,6,237,233,470,29,FALSE
omni-common-ui,0.14.0-dev.1064,0.14.0-dev.1065,611,1,44,13,57,5,FALSE
omni-common-ui,0.14.0-dev.1063,0.14.0-dev.1064,610,1,0,1,1,1,FALSE
omni-common-ui,0.14.0-dev.1062,0.14.0-dev.1063,609,1,3,1,4,1,FALSE
omni-common-ui,0.14.0-dev.1061,0.14.0-dev.1062,608,2,2,2,4,2,FALSE
omni-common-ui,0.14.0-dev.1060,0.14.0-dev.1061,607,1,30,7,37,3,FALSE
omni-common-ui,0.5.0-dev.471,0.5.0-dev.472,108,1,4,0,4,1,FALSE
omni-common-ui,0.5.0-dev.470,0.5.0-dev.471,107,2,9,2,11,3,FALSE
omni-common-ui,0.5.0-dev.473,0.5.0-dev.474,110,1,3,1,4,1,FALSE
omni-common-ui,0.5.0-dev.472,0.5.0-dev.473,109,3,93,33,126,9,FALSE
omni-common-ui,0.5.0-dev.475,0.5.0-dev.476,112,1,64,33,97,11,FALSE
omni-common-ui,0.5.0-dev.474,0.5.0-dev.475,111,1,25,30,55,1,FALSE
omni-common-ui,0.5.0-dev.477,0.5.0-dev.478,114,2,1,9,10,2,FALSE
omni-common-ui,0.5.0-dev.476,0.5.0-dev.477,113,1,1,0,1,1,FALSE
omni-common-ui,0.5.0-dev.479,0.5.0-dev.480,116,13,197,341,538,47,FALSE
omni-common-ui,0.5.0-dev.478,0.5.0-dev.479,115,1,3,1,4,1,FALSE
omni-common-ui,0.18.0-dev.1237,0.18.0-dev.1238,748,1,6,2,8,1,FALSE
omni-common-ui,0.11.0-dev.747,0.11.0-dev.749,360,1,3,1,4,1,FALSE
omni-common-ui,0.11.0-dev.746,0.11.0-dev.747,359,2,167,56,223,6,FALSE
omni-common-ui,0.11.0-dev.745,0.11.0-dev.746,358,1,2,0,2,2,FALSE
omni-common-ui,0.11.0-dev.744,0.11.0-dev.745,357,4,59,38,97,5,FALSE
omni-common-ui,0.11.0-dev.743,0.11.0-dev.744,356,1,4,0,4,4,FALSE
omni-common-ui,0.11.0-dev.742,0.11.0-dev.743,355,1,1,0,1,1,FALSE
omni-common-ui,0.11.0-dev.741,0.11.0-dev.742,354,1,0,1,1,1,FALSE
omni-common-ui,0.11.0-dev.740,0.11.0-dev.741,353,2,5,2,7,2,FALSE
omni-common-ui,0.11.0-dev.749,0.11.0-dev.750,361,1,64,19,83,4,FALSE
omni-common-ui,0.5.0-dev.488,0.5.0-dev.489,125,1,3,1,4,1,FALSE
omni-common-ui,0.5.0-dev.489,0.5.0-dev.490,126,2,12,12,24,2,FALSE
omni-common-ui,0.14.0-dev.1033,0.14.0-dev.1035,586,1,3,1,4,1,FALSE
omni-common-ui,0.5.0-dev.484,0.5.0-dev.485,121,1,36,2,38,5,FALSE
omni-common-ui,0.5.0-dev.485,0.5.0-dev.486,122,1,1,1,2,1,FALSE
omni-common-ui,0.5.0-dev.486,0.5.0-dev.487,123,1,1,1,2,1,FALSE
omni-common-ui,0.5.0-dev.487,0.5.0-dev.488,124,15,208,174,382,29,FALSE
omni-common-ui,0.5.0-dev.480,0.5.0-dev.481,117,1,9,0,9,3,FALSE
omni-common-ui,0.5.0-dev.481,0.5.0-dev.482,118,7,406,122,528,21,FALSE
omni-common-ui,0.5.0-dev.482,0.5.0-dev.483,119,1,4,0,4,1,FALSE
omni-common-ui,0.5.0-dev.483,0.5.0-dev.484,120,2,2,2,4,2,FALSE
omni-common-ui,0.11.0-dev.698,0.11.0-dev.700,312,1,1,0,1,1,FALSE
omni-common-ui,0.16.0-dev.1174,0.16.0,701,2,287,500,787,71,FALSE
omni-common-ui,0.8.0-dev.648,0.8.0-dev.649,265,3,237,5,242,5,FALSE
omni-common-ui,0.13.0,0.13.1,544,13,158,49,207,29,FALSE
omni-common-ui,0.3.0-dev.420,0.3.0-dev.421,63,1,2,2,4,1,FALSE
omni-common-ui,0.3.0-dev.421,0.3.0-dev.422,64,1,8,7,15,1,FALSE
omni-common-ui,0.3.0-dev.422,0.3.0-dev.423,65,1,39,35,74,1,FALSE
omni-common-ui,0.3.0-dev.423,0.3.0-dev.425,66,2,8,6,14,4,FALSE
omni-common-ui,0.3.0-dev.425,0.3.0-dev.426,67,2,4,3,7,2,FALSE
omni-common-ui,0.3.0-dev.426,0.3.0-dev.427,68,1,22,0,22,1,FALSE
omni-common-ui,0.3.0-dev.427,0.3.0-dev.428,69,4,156,30,186,9,FALSE
omni-common-ui,0.3.0-dev.428,0.3.0-dev.429,70,1,10,1,11,1,FALSE
omni-common-ui,0.3.0-dev.429,0.3.0-dev.431,71,2,21,10,31,4,FALSE
omni-common-ui,0.11.0-dev.780,0.11.0-dev.781,389,4,19,68,87,13,FALSE
omni-common-ui,0.15.0-dev.1125,0.15.0-dev.1126,657,2,18,180,198,6,FALSE
omni-common-ui,0.12.0-dev.893,0.12.0-dev.894,483,2,93,46,139,7,FALSE
omni-common-ui,0.15.0-dev.1124,0.15.0-dev.1125,656,1,46,3,49,2,FALSE
omni-common-ui,0.15.0-dev.1127,0.15.0-dev.1128,659,2,71,85,156,3,FALSE
omni-common-ui,0.15.0-dev.1126,0.15.0-dev.1127,658,1,3,1,4,1,FALSE
omni-common-ui,0.16.0-dev.1148,0.16.0-dev.1149,678,3,9,20,29,6,FALSE
omni-common-ui,0.15.0-dev.1121,0.15.0-dev.1122,653,1,4,4,8,2,FALSE
omni-common-ui,0.16.0-dev.1149,0.16.0-dev.1150,679,1,1,2,3,2,FALSE
omni-common-ui,0.16.0-dev.1146,0.16.0-dev.1148,677,1,0,85,85,5,FALSE
omni-common-ui,0.16.0-dev.1166,0.16.0-dev.1167,693,1,22,0,22,2,FALSE
omni-common-ui,0.16.0-dev.1167,0.16.0-dev.1168,694,1,9,0,9,1,FALSE
omni-common-ui,0.16.0-dev.1160,0.16.0-dev.1161,690,1,0,8,8,1,FALSE
omni-common-ui,0.11.0-dev.781,0.11.0-dev.782,390,2,2,4,6,2,FALSE
omni-common-ui,0.16.0-dev.1163,0.16.0-dev.1166,692,1,6,0,6,2,FALSE
omni-common-ui,0.15.0-dev.1122,0.15.0-dev.1123,654,1,1,0,1,1,FALSE
omni-common-ui,0.16.0-dev.1168,0.16.0-dev.1169,695,1,3,0,3,1,FALSE
omni-common-ui,0.16.0-dev.1169,0.16.0-dev.1170,696,2,5,16,21,3,FALSE
omni-common-ui,0.13.0-dev.955,0.13.0-dev.956,532,1,18,18,36,2,FALSE
omni-common-ui,0.13.0-dev.956,0.13.0-dev.958,533,2,65,42,107,4,FALSE
omni-common-ui,0.13.0-dev.958,0.13.0-dev.959,534,1,13,2,15,2,FALSE
omni-common-ui,0.13.0-dev.959,0.13.0-dev.960,535,1,1,1,2,1,FALSE
omni-common-ui,0.9.0-dev.655,0.9.0-dev.656,271,1,5,0,5,1,FALSE
omni-common-ui,0.9.0-dev.654,0.9.0-dev.655,270,1,93,36,129,2,FALSE
omni-common-ui,0.9.0-dev.657,0.9.0-dev.658,273,1,4,4,8,2,FALSE
omni-common-ui,0.9.0-dev.656,0.9.0-dev.657,272,1,3,1,4,1,FALSE
omni-common-ui,0.9.0-dev.651,0.9.0-dev.654,269,1,9,1,10,2,FALSE
omni-common-ui,0.18.0-dev.1291,0.18.0-dev.1293,788,2,108,8,116,4,FALSE
omni-common-ui,0.9.0-dev.659,0.9.0-dev.660,275,1,3,1,4,1,FALSE
omni-common-ui,0.9.0-dev.658,0.9.0-dev.659,274,1,2,0,2,1,FALSE
omni-common-ui,0.5.0-dev.467,0.5.0-dev.468,104,1,1,1,2,1,FALSE
omni-common-ui,0.11.0-dev.857,0.11.0-dev.858,456,1,1,1,2,1,FALSE
omni-common-ui,0.7.0-dev.538,0.7.0-dev.539,171,1,5,0,5,1,FALSE
omni-common-ui,0.7.0-dev.539,0.7.0-dev.540,172,1,6,3,9,1,FALSE
omni-common-ui,0.11.0-dev.856,0.11.0-dev.857,455,1,3,1,4,1,FALSE
omni-common-ui,0.7.0-dev.533,0.7.0-dev.534,166,1,12,1,13,1,FALSE
omni-common-ui,0.7.0-dev.530,0.7.0-dev.531,164,1,11,1,12,1,FALSE
omni-common-ui,0.7.0-dev.531,0.7.0-dev.533,165,1,3,1,4,1,FALSE
omni-common-ui,0.7.0-dev.536,0.7.0-dev.537,169,1,6,0,6,1,FALSE
omni-common-ui,0.7.0-dev.537,0.7.0-dev.538,170,3,43,4,47,4,FALSE
omni-common-ui,0.7.0-dev.534,0.7.0-dev.535,167,1,3,1,4,1,FALSE
omni-common-ui,0.7.0-dev.535,0.7.0-dev.536,168,1,115,3,118,9,FALSE
omni-common-ui,0.11.0-dev.854,0.11.0-dev.855,453,1,87,1,88,2,FALSE
omni-common-ui,0.11.0-dev.853,0.11.0-dev.854,452,1,3,1,4,1,FALSE
omni-common-ui,0.6.0-dev.503,0.6.0-dev.504,139,1,127,10,137,4,FALSE
omni-common-ui,0.11.0-dev.851,0.11.0-dev.852,450,1,3,1,4,1,FALSE
omni-common-ui,0.11.0-dev.850,0.11.0-dev.851,449,1,2,1,3,1,FALSE
omni-common-ui,0.11.0-dev.808,0.11.0-dev.809,411,1,21,5,26,3,FALSE
omni-common-ui,0.19.0-dev.1327,0.19.0-dev.1330,802,1,3,1,4,1,FALSE
omni-common-ui,0.14.0-dev.1029,0.14.0-dev.1033,585,1,3,1,4,1,FALSE
omni-common-ui,0.11.0-dev.809,0.11.0-dev.810,412,1,3,1,4,1,FALSE
omni-common-ui,0.14.0-dev.1028,0.14.0-dev.1029,584,1,3,1,4,1,FALSE
omni-common-ui,0.18.0-dev.1302,0.18.0-dev.1326,795,10,72,88,160,13,FALSE
omni-common-ui,0.18.0-dev.1300,0.18.0-dev.1302,794,2,390,8,398,7,FALSE
omni-common-ui,0.14.0-dev.1020,0.14.0-dev.1028,583,5,95,101,196,10,FALSE
omni-common-ui,0.11.0-dev.859,0.11.0-dev.860,458,1,41,0,41,2,FALSE
omni-common-ui,0.7.0-dev.588,0.7.0-dev.590,213,1,5,4,9,1,FALSE
omni-common-ui,0.7.0-dev.587,0.7.0-dev.588,212,1,3,1,4,1,FALSE
omni-common-ui,0.7.0-dev.586,0.7.0-dev.587,211,1,1,0,1,1,FALSE
omni-common-ui,0.7.0-dev.585,0.7.0-dev.586,210,1,11,1,12,1,FALSE
omni-common-ui,0.6.0-dev.509,0.6.0-dev.510,145,1,1,1,2,1,FALSE
omni-common-ui,0.7.0-dev.582,0.7.0-dev.585,209,2,27,9,36,7,FALSE
omni-common-ui,0.7.0-dev.580,0.7.0-dev.582,208,1,13,7,20,1,FALSE
omni-common-ui,0.0.7-dev,0.0.8-dev,11,5,59,31,90,14,FALSE
omni-common-ui,0.0.6-dev,0.0.7-dev,10,4,257,97,354,23,FALSE
omni-common-ui,0.16.0-dev.1156,0.16.0-dev.1157,686,2,61,3,64,6,TRUE
omni-common-ui,0.16.0-dev.1161,0.16.0-dev.1163,691,4,65,20,85,20,TRUE
omni-common-ui,0.15.0,0.15.1,675,27,349,533,882,85,TRUE
omni-common-ui,0.15.0-dev.1112,0.15.0-dev.1113,648,2,7,8,15,3,TRUE
omni-common-ui,0.16.0-dev.1146,0.16.0-dev.1148,677,1,0,85,85,5,TRUE
omni-common-ui,0.14.0-dev.1067,0.14.0-dev.1068,613,2,56,10,66,6,TRUE
omni-common-ui,0.14.0-dev.1076,0.14.0-dev.1077,620,1,3,1,4,1,TRUE
omni-common-ui,0.15.0-dev.1138,0.15.0-dev.1139,670,1,4,4,8,2,TRUE
omni-common-ui,0.11.0-dev.831,0.11.0-dev.832,431,1,58,4,62,5,TRUE
omni-common-ui,0.11.0-dev.832,0.11.0-dev.833,432,1,10,1,11,2,TRUE
omni-common-ui,0.11.0-dev.858,0.11.0-dev.859,457,1,5,5,10,1,TRUE
omni-common-ui,0.6.0-dev.495,0.6.0-dev.496,131,1,9,9,18,1,TRUE
omni-common-ui,0.18.3,0.18.5,800,31,342,227,569,62,TRUE
omni-common-ui,0.19.0-dev.1346,0.19.0-dev.1350,810,3,55,59,114,7,TRUE
omni-common-ui,0.18.0-dev.1287,0.18.0-dev.1288,784,1,3,1,4,1,TRUE
omni-common-ui,0.18.0-dev.1291,0.18.0-dev.1293,788,2,108,8,116,4,TRUE
omni-common-ui,0.12.0-dev.868,0.12.0-dev.869,465,1,7,2,9,2,TRUE
omni-common-ui,0.18.0-dev.1299,0.18.0-dev.1300,793,1,8,0,8,1,TRUE
omni-common-ui,0.6.0-dev.498,0.6.0-dev.499,134,1,3,1,4,1,TRUE
omni-common-ui,0.15.0-dev.1135,0.15.0-dev.1136,667,1,4,4,8,2,TRUE
omni-common-ui,0.17.0-dev.1203,0.17.0-dev.1204,719,1,47,27,74,2,TRUE
omni-common-ui,0.15.0-dev.1124,0.15.0-dev.1125,656,1,46,3,49,2,TRUE
omni-common-ui,0.18.0-dev.1294,0.18.0-dev.1296,790,1,5,2,7,1,TRUE
omni-common-ui,0.16.0-dev.1154,0.16.0-dev.1155,684,6,63,144,207,17,TRUE
omni-common-ui,0.17.0-dev.1216,0.17.0-dev.1217,731,1,2,0,2,1,TRUE
omni-common-ui,0.18.0,0.18.1,797,5,20,11,31,5,TRUE
omni-common-ui,0.19.0-dev.1333,0.19.0-dev.1335,806,4,14,8,22,4,TRUE
omni-common-ui,0.17.3,0.17.4,737,5,20,8,28,5,TRUE
omni-common-ui,0.18.0-dev.1235,0.18.0-dev.1237,747,1,3,1,4,1,TRUE
omni-common-ui,0.19.0-dev.1363,0.19.0,814,125,6469,5414,11883,574,TRUE
omni-common-ui,0.18.0-dev.1302,0.18.0-dev.1326,795,10,72,88,160,13,TRUE
omni-common-ui,0.14.0-dev.973,0.14.0-dev.974,549,2,4,2,6,2,TRUE
omni-common-ui,0.13.0,0.13.1,544,13,158,49,207,29,TRUE
omni-common-ui,0.17.0-dev.1218,0.17.0,733,2,652,433,1085,45,TRUE
omni-common-ui,0.14.0-dev.989,0.14.0-dev.990,557,1,36,0,36,4,TRUE
omni-common-ui,0.14.0-dev.1088,0.14.0,629,2,1549,783,2332,120,TRUE
omni-common-ui,0.0.13-dev,0.0.14-dev,17,10,52024,68609,120633,256,FALSE
omni-common-ui,0.0.11-dev,0.0.12-dev,15,4,27,27,54,29,FALSE
omni-common-ui,0.0.15-dev,0.0.16-dev,19,10,179,75,254,39,FALSE
omni-common-ui,0.0.14-dev,0.0.15-dev,18,7,183,35,218,16,FALSE
omni-common-ui,0.0.16-dev,0.0.17-dev,20,18,786,510,1296,65,FALSE
omni-common-ui,0.0.12-dev,0.0.13-dev,16,5,17,11,28,6,FALSE
omni-common-ui,0.0.18-dev.375,0.0.18-dev.377,28,2,14,12,26,2,FALSE
omni-common-ui,0.0.18-dev.374,0.0.18-dev.375,27,1,17,15,32,3,FALSE
omni-common-ui,0.0.18-dev.373,0.0.18-dev.374,26,1,2,2,4,1,FALSE
omni-common-ui,0.0.18-dev.372,0.0.18-dev.373,25,2,4,6,10,2,FALSE
omni-common-ui,0.0.18-dev.371,0.0.18-dev.372,24,1,6,3,9,1,FALSE
omni-common-ui,0.0.18-dev.370,0.0.18-dev.371,23,1,0,1,1,1,FALSE
omni-common-ui,0.0.1,0.0.2-dev.2,1,250,9749,2912,12661,854,FALSE
omni-common-ui,0.0.2-dev.5,0.0.2-dev.6,5,14,237,603,840,49,FALSE
omni-common-ui,0.0.2-dev.4,0.0.2-dev.5,4,12,171,563,734,58,FALSE
omni-common-ui,0.0.4-dev,0.0.5-dev,8,4,9,37,46,6,FALSE
omni-common-ui,0.0.2-dev.3,0.0.2-dev.4,3,15,143,87,230,36,FALSE
omni-common-ui,0.0.2-dev.2,0.0.2-dev.3,2,15,268,98,366,36,FALSE
omni-common-ui,0.0.3-dev.1,0.0.4-dev,7,10,445,73,518,42,FALSE
omni-common-ui,0.0.2-dev.6,0.0.3-dev.1,6,11,149,49,198,36,FALSE
omni-common-ui,0.0.5-dev,0.0.6-dev,9,5,1265,31,1296,74,FALSE
omni-common-ui,0.0.2-dev.5,0.0.2-dev.6,5,14,237,603,840,49,TRUE
omni-common-ui,0.0.3-dev.1,0.0.4-dev,7,10,445,73,518,42,TRUE
react-mobile-components,1.1.3,1.1.4,5,1,22,15,37,8,FALSE
react-mobile-components,1.1.2,1.1.3,4,3,290,24,314,18,FALSE
react-mobile-components,1.0.0,1.0.1,1,1,37,29,66,15,FALSE
react-mobile-components,1.0.1,1.0.2,2,1,22,15,37,8,FALSE
react-mobile-components,1.0.2,1.1.2,3,6,1973,326,2299,108,FALSE
react-mobile-components,1.3.4,1.3.5,14,1,22,15,37,8,FALSE
react-mobile-components,1.3.3,1.3.4,13,3,848,218,1066,39,FALSE
react-mobile-components,1.3.2,1.3.3,12,1,18,18,36,12,FALSE
react-mobile-components,1.3.1,1.3.2,11,3,58,29,87,28,FALSE
react-mobile-components,1.3.0,1.3.1,10,1,22,15,37,8,FALSE
react-mobile-components,1.2.2,1.3.0,9,1,1091,1059,2150,79,FALSE
react-mobile-components,1.3.6,1.3.7,16,2,1289,1046,2335,77,FALSE
react-mobile-components,1.3.5,1.3.6,15,1,335,152,487,36,FALSE
react-mobile-components,1.2.1,1.2.2,8,1,1,2,3,2,FALSE
react-mobile-components,1.2.0,1.2.1,7,1,34,47,81,21,FALSE
react-mobile-components,1.3.7,1.3.8,17,1,56,95,151,5,FALSE
react-mobile-components,1.3.8,1.3.9,18,2,125,114,239,41,FALSE
react-mobile-components,1.1.4,1.2.0,6,2,909,36,945,37,FALSE
react-mobile-components,1.2.2,1.3.0,9,1,1091,1059,2150,79,TRUE
react-mobile-components,1.0.0,1.0.1,1,1,37,29,66,15,TRUE
react-mobile-components,1.0.2,1.1.2,3,6,1973,326,2299,108,TRUE
react-mobile-components,1.2.1,1.2.2,8,1,1,2,3,2,TRUE
react-mobile-components,1.3.0,1.3.1,10,1,22,15,37,8,TRUE
react-mobile-components,1.3.6,1.3.7,16,2,1289,1046,2335,77,TRUE
react-mobile-components,1.3.3,1.3.4,13,3,848,218,1066,39,TRUE
react-mobile-components,1.0.1,1.0.2,2,1,22,15,37,8,TRUE
react-mobile-components,1.1.3,1.1.4,5,1,22,15,37,8,TRUE
react-mobile-components,1.3.2,1.3.3,12,1,18,18,36,12,TRUE
react-mobile-components,1.3.1,1.3.2,11,3,58,29,87,28,TRUE
mscgenjs-inpage,1.4.0,1.4.1,9,7,389,268,657,17,FALSE
mscgenjs-inpage,1.4.1,1.4.2,10,3,103,30,133,10,FALSE
mscgenjs-inpage,1.6.2,1.6.3,19,3,57,7,64,4,FALSE
mscgenjs-inpage,1.6.3,1.7.0,20,3,131,42,173,7,FALSE
mscgenjs-inpage,1.6.0,1.6.1,17,4,156,71,227,13,FALSE
mscgenjs-inpage,1.6.1,1.6.2,18,1,95,25,120,4,FALSE
mscgenjs-inpage,1.9.1,1.9.2,24,2,10,14,24,6,FALSE
mscgenjs-inpage,1.9.0,1.9.1,23,2,42,30,72,9,FALSE
mscgenjs-inpage,1.9.2,1.9.10,25,2,335,388,723,11,FALSE
mscgenjs-inpage,1.8.0,1.9.0,22,2,1666,1128,2794,33,FALSE
mscgenjs-inpage,1.7.0,1.8.0,21,2,43,24,67,6,FALSE
mscgenjs-inpage,1.9.11,1.10.0,27,2,1399,1098,2497,12,FALSE
mscgenjs-inpage,1.9.10,1.9.11,26,3,76,16,92,7,FALSE
mscgenjs-inpage,1.4.2,1.4.3,11,7,523,656,1179,22,FALSE
mscgenjs-inpage,1.4.3,1.5.0,12,7,447,536,983,23,FALSE
mscgenjs-inpage,1.5.1,1.5.2,14,12,45,50,95,16,FALSE
mscgenjs-inpage,1.5.0,1.5.1,13,10,3798,754,4552,38,FALSE
mscgenjs-inpage,1.5.3,1.6.0,16,2,992,240,1232,11,FALSE
mscgenjs-inpage,1.5.2,1.5.3,15,2,1597,1386,2983,7,FALSE
mscgenjs-inpage,1.2.6,1.3.0,2,8,2071,1172,3243,13,FALSE
mscgenjs-inpage,1.3.2,1.3.5,5,3,971,344,1315,10,FALSE
mscgenjs-inpage,1.3.1,1.3.2,4,4,624,351,975,15,FALSE
mscgenjs-inpage,1.3.0,1.3.1,3,3,74,88,162,5,FALSE
mscgenjs-inpage,1.3.7,1.4.0,8,11,962,1621,2583,34,FALSE
mscgenjs-inpage,1.3.6,1.3.7,7,10,1369,1224,2593,52,FALSE
mscgenjs-inpage,1.3.5,1.3.6,6,5,58,591,649,12,FALSE
mscgenjs-inpage,1.11.0,1.12.1,29,2,46,29,75,7,FALSE
mscgenjs-inpage,1.10.0,1.11.0,28,2,33,21,54,4,FALSE
mscgenjs-inpage,1.2.5,1.2.6,1,4,1402,775,2177,7,FALSE
mscgenjs-inpage,1.4.0,1.4.1,9,7,389,268,657,17,TRUE
mscgenjs-inpage,1.9.1,1.9.2,24,2,10,14,24,6,TRUE
mscgenjs-inpage,1.9.11,1.10.0,27,2,1399,1098,2497,12,TRUE
mscgenjs-inpage,1.6.0,1.6.1,17,4,156,71,227,13,TRUE
mscgenjs-inpage,1.5.1,1.5.2,14,12,45,50,95,16,TRUE
mscgenjs-inpage,1.5.2,1.5.3,15,2,1597,1386,2983,7,TRUE
mscgenjs-inpage,1.4.2,1.4.3,11,7,523,656,1179,22,TRUE
mscgenjs-inpage,1.4.3,1.5.0,12,7,447,536,983,23,TRUE
gulp-debug-finder,1.0.0,2.0.0,1,11,159,41,200,16,FALSE
gulp-debug-finder,2.0.1,2.1.0,3,5,23,11,34,8,FALSE
gulp-debug-finder,2.0.0,2.0.1,2,4,6,1,7,4,FALSE
gulp-debug-finder,2.1.0,2.1.1,4,5,17,76,93,7,FALSE
gulp-debug-finder,2.1.1,2.2.0,5,10,19,7,26,10,FALSE
gulp-debug-finder,2.1.0,2.1.1,4,5,17,76,93,7,TRUE
eliq2graphite,0.2.7,0.2.8,22,4,126,46,172,12,FALSE
eliq2graphite,0.2.6,0.2.7,21,2,34,32,66,4,TRUE
eliq2graphite,0.2.5,0.2.6,20,3,4,5,9,3,FALSE
eliq2graphite,0.2.2,0.2.5,19,4,4,4,8,4,FALSE
eliq2graphite,0.0.12,0.1.0,12,3,7,19,26,6,FALSE
eliq2graphite,0.2.6,0.2.7,21,2,34,32,66,4,FALSE
eliq2graphite,0.0.11,0.0.12,11,6,15,13,28,6,FALSE
eliq2graphite,0.2.1,0.2.2,18,14,138,140,278,19,FALSE
eliq2graphite,0.2.0,0.2.1,17,1,2,2,4,1,FALSE
eliq2graphite,0.1.0,0.1.1,13,1,2,4,6,1,FALSE
eliq2graphite,0.1.1,0.1.2,14,2,2,2,4,2,FALSE
eliq2graphite,0.1.2,0.1.3,15,2,5,5,10,2,FALSE
eliq2graphite,0.1.3,0.2.0,16,3,133,77,210,9,FALSE
eliq2graphite,0.2.9,0.2.10,24,4,326,290,616,23,FALSE
eliq2graphite,0.2.8,0.2.9,23,4,19,29,48,7,FALSE
eliq2graphite,0.0.10,0.0.11,10,4,52,11,63,7,FALSE
eliq2graphite,0.2.8,0.2.9,23,4,19,29,48,7,TRUE
eliq2graphite,0.0.5,0.0.6,5,1,1,1,2,1,FALSE
eliq2graphite,0.0.4,0.0.5,4,17,177,112,289,39,FALSE
eliq2graphite,0.0.7,0.0.8,7,4,5,4,9,4,FALSE
eliq2graphite,0.0.6,0.0.7,6,4,5,16,21,4,FALSE
eliq2graphite,0.0.1,0.0.2,1,2,10,2,12,3,FALSE
eliq2graphite,0.0.3,0.0.4,3,2,144,43,187,16,FALSE
eliq2graphite,0.0.2,0.0.3,2,3,4,4,8,3,FALSE
eliq2graphite,0.0.9,0.0.10,9,2,3,3,6,2,FALSE
eliq2graphite,0.0.8,0.0.9,8,4,29,171,200,18,FALSE
eliq2graphite,0.2.9,0.2.10,24,4,326,290,616,23,TRUE
eliq2graphite,0.0.6,0.0.7,6,4,5,16,21,4,TRUE
eliq2graphite,0.2.1,0.2.2,18,14,138,140,278,19,TRUE
tap-summary,1.1.0,1.2.0,3,4,18,5,23,7,FALSE
tap-summary,1.0.0,1.0.1,1,2,2,1,3,2,FALSE
tap-summary,1.0.1,1.1.0,2,3,39,46,85,8,FALSE
tap-summary,2.1.2,2.1.3,8,4,56,16,72,8,FALSE
tap-summary,2.1.0,2.1.1,6,3,40,2,42,3,FALSE
tap-summary,2.1.1,2.1.2,7,3,213,17,230,11,FALSE
tap-summary,2.0.0,2.1.0,5,6,447,308,755,22,FALSE
tap-summary,1.2.0,2.0.0,4,7,522,364,886,24,FALSE
tap-summary,3.0.0,3.0.1,10,5,605,483,1088,21,FALSE
tap-summary,3.0.1,3.0.2,11,4,12,4,16,4,FALSE
tap-summary,2.1.3,3.0.0,9,7,1524,1288,2812,90,FALSE
tap-summary,1.2.0,2.0.0,4,7,522,364,886,24,TRUE
regexmatcher,1.1.1,1.1.2,4,1,28,30,58,3,FALSE
regexmatcher,1.1.0,1.1.1,3,2,12,9,21,3,FALSE
regexmatcher,1.1.3,1.1.4,6,2,12,7,19,3,FALSE
regexmatcher,1.1.2,1.1.3,5,3,43,15,58,5,FALSE
regexmatcher,1.0.0,1.0.1,1,1,28,30,58,3,FALSE
regexmatcher,1.0.1,1.1.0,2,4,18,9,27,5,FALSE
regexmatcher,1.1.7,1.1.8,10,1,38,27,65,4,TRUE
regexmatcher,1.1.6,1.1.7,9,1,21,136,157,4,FALSE
regexmatcher,1.1.8,1.1.9,11,1,28,30,58,3,FALSE
regexmatcher,1.1.5,1.1.6,8,2,442,11,453,12,FALSE
regexmatcher,1.1.4,1.1.5,7,1,4,4,8,2,FALSE
regexmatcher,1.1.7,1.1.8,10,1,38,27,65,4,FALSE
angular2-focus,1.0.4,1.1.0,5,14,120769,106772,227541,40,FALSE
angular2-focus,1.0.0,1.0.1,1,2,18,1,19,2,FALSE
angular2-focus,1.0.1,1.0.2,2,1,24,18,42,6,FALSE
angular2-focus,1.0.2,1.0.3,3,2,14,12,26,6,FALSE
angular2-focus,1.0.3,1.0.4,4,30,149277,71479,220756,129,FALSE
angular2-focus,1.0.4,1.1.0,5,14,120769,106772,227541,40,TRUE
angular2-focus,1.0.3,1.0.4,4,30,149277,71479,220756,129,TRUE
ms-socket.io-adapter-amqp,1.0.0,1.0.1,1,5,163,130,293,22,FALSE
ms-socket.io-adapter-amqp,1.0.1,2.0.0,2,1,14,9,23,1,FALSE
ms-socket.io-adapter-amqp,3.0.0,3.0.1,4,1,1,1,2,1,FALSE
ms-socket.io-adapter-amqp,2.0.0,3.0.0,3,2,121,99,220,7,FALSE
ms-socket.io-adapter-amqp,3.0.1,3.1.0,5,1,3166,27,3193,5,FALSE
ms-socket.io-adapter-amqp,2.0.0,3.0.0,3,2,121,99,220,7,TRUE
ms-socket.io-adapter-amqp,3.0.0,3.0.1,4,1,1,1,2,1,TRUE
ms-socket.io-adapter-amqp,1.0.0,1.0.1,1,5,163,130,293,22,TRUE
tpl.js,0.0.5,0.0.6,4,1,113,79,192,14,FALSE
tpl.js,0.0.4,0.0.5,3,1,12,199,211,5,FALSE
tpl.js,0.0.7,0.0.8,6,1,4,4,8,4,FALSE
tpl.js,0.0.6,0.0.7,5,1,16,15,31,7,FALSE
tpl.js,0.0.1,0.0.3,1,7,1664,1413,3077,70,FALSE
tpl.js,0.0.3,0.0.4,2,2,27,11,38,9,FALSE
tpl.js,0.0.9,0.0.10,8,2,420,206,626,16,FALSE
tpl.js,0.0.8,0.0.9,7,2,4226,612,4838,32,FALSE
tpl.js,0.0.10,0.0.12,9,10,7342,4851,12193,85,FALSE
tpl.js,0.0.13,0.0.14,11,4,1351,1619,2970,52,FALSE
tpl.js,0.0.12,0.0.13,10,3,1274,598,1872,36,FALSE
tpl.js,0.0.15,0.0.16,13,9,31742,26013,57755,326,FALSE
tpl.js,0.0.14,0.0.15,12,3,621,5391,6012,19,FALSE
tpl.js,0.0.16,0.1.0,14,3,1699,2215,3914,45,FALSE
tpl.js,0.0.7,0.0.8,6,1,4,4,8,4,TRUE
discord-graf,0.14.5,0.14.6,65,3,7691,5695,13386,10,FALSE
discord-graf,0.7.5,0.8.0,38,3,2353,2341,4694,8,FALSE
discord-graf,0.15.1,0.15.2,68,2,117,117,234,7,FALSE
discord-graf,0.7.2,0.7.3,35,2,1774,1411,3185,8,FALSE
discord-graf,0.7.3,0.7.4,36,2,593,593,1186,7,FALSE
discord-graf,0.2.7,0.2.8,18,2,2,1,3,2,FALSE
discord-graf,0.2.6,0.2.7,17,2,2,2,4,2,FALSE
discord-graf,0.2.5,0.2.6,16,2,2,2,4,2,FALSE
discord-graf,0.2.4,0.2.5,15,2,13,3,16,2,FALSE
discord-graf,0.2.3,0.2.4,14,2,2,3,5,2,FALSE
discord-graf,0.2.2,0.2.3,13,2,9,3,12,2,FALSE
discord-graf,0.2.1,0.2.2,12,5,33,26,59,7,FALSE
discord-graf,0.2.0,0.2.1,11,2,13,11,24,2,FALSE
discord-graf,0.1.0,0.1.1,1,2,3,1,4,2,FALSE
discord-graf,0.1.1,0.1.2,2,4,10,7,17,5,FALSE
discord-graf,0.1.2,0.1.3,3,2,3,3,6,2,FALSE
discord-graf,0.1.3,0.1.4,4,2,1,3,4,2,FALSE
discord-graf,0.1.4,0.1.5,5,2,3,2,5,2,FALSE
discord-graf,0.1.5,0.1.6,6,3,4,3,7,3,FALSE
discord-graf,0.2.9,0.2.10,20,2,4,3,7,2,FALSE
discord-graf,0.2.8,0.2.9,19,4,10,13,23,6,FALSE
discord-graf,0.10.1,0.10.2,47,4,4,5,9,5,FALSE
discord-graf,0.10.0,0.10.1,46,3,2730,2538,5268,8,FALSE
discord-graf,0.10.3,0.11.0,49,3,42,34,76,5,FALSE
discord-graf,0.10.2,0.10.3,48,7,18804,18372,37176,39,FALSE
discord-graf,0.3.2,0.3.3,24,2,2,1,3,2,FALSE
discord-graf,0.3.3,0.4.0,25,22,390817,22979,413796,347,FALSE
discord-graf,0.3.0,0.3.1,22,2,12,2,14,2,FALSE
discord-graf,0.6.0,0.6.1,31,18,16060,15669,31729,64,FALSE
discord-graf,0.11.0,0.11.1,50,2,1585,1486,3071,8,FALSE
discord-graf,0.11.1,0.11.2,51,3,7808,7530,15338,9,FALSE
discord-graf,0.11.2,0.12.0,52,12,9783,9215,18998,70,FALSE
discord-graf,0.7.1,0.7.2,34,3,416,276,692,8,FALSE
discord-graf,0.12.2,0.13.0,55,5,31163,24278,55441,31,FALSE
discord-graf,0.12.1,0.12.2,54,2,7309,6964,14273,8,FALSE
discord-graf,0.12.0,0.12.1,53,2,3614,3485,7099,7,FALSE
discord-graf,0.1.6,0.1.7,7,5,14,8,22,5,FALSE
discord-graf,0.4.1,0.4.2,27,3,33,9,42,7,FALSE
discord-graf,0.4.0,0.4.1,26,3,743,777,1520,10,FALSE
discord-graf,0.4.3,0.5.0,29,11,30554,27604,58158,139,FALSE
discord-graf,0.1.7,0.1.8,8,2,2,2,4,2,FALSE
discord-graf,0.5.0,0.6.0,30,12,62531,31069,93600,134,FALSE
discord-graf,0.13.3,0.14.0,59,3,21089,17060,38149,53,FALSE
discord-graf,0.13.0,0.13.1,56,2,1022,814,1836,7,FALSE
discord-graf,0.13.1,0.13.2,57,4,1357,515,1872,13,FALSE
discord-graf,0.9.0,0.9.1,44,6,1719,1382,3101,29,FALSE
discord-graf,0.9.1,0.10.0,45,2,17554,16040,33594,17,FALSE
discord-graf,0.15.2,0.15.3,69,2,4906,2662,7568,7,FALSE
discord-graf,0.14.4,0.14.5,64,2,3295,3295,6590,7,FALSE
discord-graf,0.14.1,0.14.2,61,4,367,268,635,12,FALSE
discord-graf,0.14.0,0.14.1,60,2,268,137,405,7,FALSE
discord-graf,0.14.3,0.14.4,63,2,1641,1525,3166,7,FALSE
discord-graf,0.14.2,0.14.3,62,2,194,194,388,7,FALSE
discord-graf,0.8.4,0.9.0,43,10,31817,23740,55557,130,FALSE
discord-graf,0.8.1,0.8.2,40,4,4973,4783,9756,10,FALSE
discord-graf,0.8.0,0.8.1,39,2,4,4,8,3,FALSE
discord-graf,0.8.3,0.8.4,42,2,3,3,6,3,FALSE
discord-graf,0.2.10,0.3.0,21,8,656,348,1004,65,FALSE
discord-graf,0.15.3,0.15.4,70,4,11988,13850,25838,16,FALSE
discord-graf,0.8.2,0.8.3,41,2,513,335,848,7,FALSE
discord-graf,0.3.1,0.3.2,23,2,4,3,7,2,FALSE
discord-graf,0.4.2,0.4.3,28,3,1426,909,2335,11,FALSE
discord-graf,0.1.9,0.2.0,10,5,38,25,63,7,FALSE
discord-graf,0.13.2,0.13.3,58,2,280,191,471,7,FALSE
discord-graf,0.1.8,0.1.9,9,2,6,5,11,2,FALSE
discord-graf,0.7.0,0.7.1,33,2,3,3,6,3,FALSE
discord-graf,0.14.6,0.15.0,66,4,7734,8303,16037,18,FALSE
discord-graf,0.15.0,0.15.1,67,3,2234,2089,4323,9,FALSE
discord-graf,0.6.1,0.7.0,32,7,17875,14412,32287,25,FALSE
discord-graf,0.7.4,0.7.5,37,2,4611,4609,9220,8,FALSE
discord-graf,0.14.5,0.14.6,65,3,7691,5695,13386,10,TRUE
discord-graf,0.8.0,0.8.1,39,2,4,4,8,3,TRUE
monarch-routes,1.0.0,1.0.1,1,4,54,555,609,13,FALSE
monarch-routes,1.0.1,1.0.2,2,2,18210,28,18238,5,FALSE
monarch-routes,1.0.0,1.0.1,1,4,54,555,609,13,TRUE
ic-datepicker,0.0.5,0.0.6,4,12,112414,112221,224635,118,FALSE
ic-datepicker,0.0.4,0.0.5,3,7,46989,47643,94632,45,FALSE
ic-datepicker,0.0.7,0.0.8,6,14,360,69,429,72,FALSE
ic-datepicker,0.0.6,0.0.7,5,10,1787,1699,3486,44,FALSE
ic-datepicker,0.0.3,0.0.4,2,5,33,29,62,17,FALSE
ic-datepicker,0.0.2,0.0.3,1,5,185,184,369,28,FALSE
ic-datepicker,0.0.8,0.0.9,7,6,37,63,100,52,FALSE
ic-datepicker,0.0.5,0.0.6,4,12,112414,112221,224635,118,TRUE
ic-datepicker,0.0.9,0.0.10,8,3,108,134,242,33,FALSE
ic-datepicker,0.0.10,0.0.11,9,10,140,47,187,44,FALSE
ic-datepicker,0.0.6,0.0.7,5,10,1787,1699,3486,44,TRUE
ic-datepicker,0.0.7,0.0.8,6,14,360,69,429,72,TRUE
ic-datepicker,0.0.3,0.0.4,2,5,33,29,62,17,TRUE
ic-datepicker,0.0.2,0.0.3,1,5,185,184,369,28,TRUE
ic-datepicker,0.0.9,0.0.10,8,3,108,134,242,33,TRUE
ic-datepicker,0.0.8,0.0.9,7,6,37,63,100,52,TRUE
ic-datepicker,0.0.10,0.0.11,9,10,140,47,187,44,TRUE
appcelerator,4.2.4-2,4.2.4,224,1,2,2,4,2,FALSE
appcelerator,4.2.4-1,4.2.4-2,223,3,5,9,14,5,FALSE
appcelerator,4.2.7-1,4.2.7-2,233,3,234,8,242,10,FALSE
appcelerator,4.2.7-2,4.2.7,234,2,10,1,11,2,FALSE
appcelerator,0.0.59,0.0.60,57,1,2,2,4,2,FALSE
appcelerator,0.0.58,0.0.59,56,1,2,2,4,2,FALSE
appcelerator,0.0.51,0.0.52,49,1,2,2,4,2,FALSE
appcelerator,0.0.50,0.0.51,48,1,2,2,4,2,FALSE
appcelerator,0.0.53,0.0.54,51,1,2,2,4,2,FALSE
appcelerator,0.0.52,0.0.53,50,1,2,2,4,2,FALSE
appcelerator,0.0.55,0.0.56,53,1,2,2,4,2,FALSE
appcelerator,0.0.54,0.0.55,52,1,2,2,4,2,FALSE
appcelerator,0.0.57,0.0.58,55,1,2,2,4,2,FALSE
appcelerator,0.0.56,0.0.57,54,1,2,2,4,2,FALSE
appcelerator,4.2.3-1,4.2.3-2,220,1,2,2,4,2,FALSE
appcelerator,4.0.0,4.0.1-rc,198,7,42,22,64,7,FALSE
appcelerator,4.2.3-2,4.2.3,221,1,2,2,4,2,FALSE
appcelerator,4.2.9-1,4.2.9-2,246,5,16,10,26,6,FALSE
appcelerator,0.0.64,0.0.65,62,1,2,2,4,2,FALSE
appcelerator,0.0.65,0.0.66,63,1,2,2,4,2,FALSE
appcelerator,0.0.66,0.0.67,64,1,2,2,4,2,FALSE
appcelerator,0.0.67,0.0.68,65,1,2,2,4,2,FALSE
appcelerator,0.0.60,0.0.61,58,1,2,2,4,2,FALSE
appcelerator,0.0.61,0.0.62,59,1,2,2,4,2,FALSE
appcelerator,0.0.62,0.0.63,60,1,2,2,4,2,FALSE
appcelerator,0.0.63,0.0.64,61,1,2,2,4,2,FALSE
appcelerator,4.2.8,4.2.9-1,245,2,4,4,8,4,FALSE
appcelerator,0.0.68,0.0.69,66,1,2,2,4,2,FALSE
appcelerator,0.0.69,0.0.70,67,1,2,2,4,2,FALSE
appcelerator,0.0.90,0.0.91,88,1,2,2,4,2,FALSE
appcelerator,4.0.3-0,4.1.0-1,202,1,2,2,4,2,FALSE
appcelerator,0.0.73,0.0.74,71,1,2,2,4,2,FALSE
appcelerator,0.0.72,0.0.73,70,1,2,2,4,2,FALSE
appcelerator,0.0.70,0.0.71,68,1,2,2,4,2,FALSE
appcelerator,0.0.77,0.0.78,75,1,2,2,4,2,FALSE
appcelerator,4.2.9-2,4.2.9-3,247,6,35,26,61,7,FALSE
appcelerator,0.0.75,0.0.76,73,1,2,2,4,2,FALSE
appcelerator,0.0.74,0.0.75,72,1,2,2,4,2,FALSE
appcelerator,0.0.79,0.0.80,77,1,2,2,4,2,FALSE
appcelerator,0.0.78,0.0.79,76,1,2,2,4,2,FALSE
appcelerator,0.0.34,0.0.35,33,1,2,2,4,2,FALSE
appcelerator,4.1.0,4.1.1,205,11,220,124,344,17,FALSE
appcelerator,4.2.1-6,4.2.1,215,1,2,2,4,2,FALSE
appcelerator,4.2.1-5,4.2.1-6,214,3,3,3,6,3,FALSE
appcelerator,4.2.1-4,4.2.1-5,213,3,4,2,6,4,FALSE
appcelerator,4.2.1-2,4.2.1-4,212,2,2,2,4,2,FALSE
appcelerator,4.2.1-1,4.2.1-2,211,3,49,22,71,8,FALSE
appcelerator,4.0.1,4.0.3-0,201,1,1,1,2,1,FALSE
appcelerator,0.0.88,0.0.89,86,1,2,2,4,2,FALSE
appcelerator,0.0.89,0.0.90,87,1,2,2,4,2,FALSE
appcelerator,0.0.86,0.0.87,84,1,2,2,4,2,FALSE
appcelerator,0.0.87,0.0.88,85,1,2,2,4,2,FALSE
appcelerator,0.0.84,0.0.85,82,1,2,2,4,2,FALSE
appcelerator,0.0.85,0.0.86,83,1,2,2,4,2,FALSE
appcelerator,0.0.82,0.0.83,80,1,2,2,4,2,FALSE
appcelerator,0.0.83,0.0.84,81,1,2,2,4,2,FALSE
appcelerator,0.0.80,0.0.81,78,1,2,2,4,2,FALSE
appcelerator,0.0.81,0.0.82,79,1,2,2,4,2,FALSE
appcelerator,0.3.56,4.0.0-rc,196,4,24,4,28,4,FALSE
appcelerator,4.2.6-1,4.2.6-2,230,1,2,2,4,2,FALSE
appcelerator,4.2.6-2,4.2.6,231,1,2,2,4,2,FALSE
appcelerator,0.0.99,0.0.100,97,1,2,2,4,2,FALSE
appcelerator,0.0.98,0.0.99,96,1,2,2,4,2,FALSE
appcelerator,0.0.95,0.0.96,93,1,2,2,4,2,FALSE
appcelerator,0.0.94,0.0.95,92,1,2,2,4,2,FALSE
appcelerator,0.0.97,0.0.98,95,1,2,2,4,2,FALSE
appcelerator,0.0.96,0.0.97,94,1,2,2,4,2,FALSE
appcelerator,0.0.91,0.0.92,89,1,2,2,4,2,FALSE
appcelerator,0.0.71,0.0.72,69,1,2,2,4,2,FALSE
appcelerator,0.0.93,0.0.94,91,1,2,2,4,2,FALSE
appcelerator,0.0.92,0.0.93,90,1,2,2,4,2,FALSE
appcelerator,0.0.15,0.0.16,15,1,2,2,4,2,FALSE
appcelerator,0.0.14,0.0.15,14,1,2,2,4,2,FALSE
appcelerator,0.0.17,0.0.18,17,1,2,2,4,2,FALSE
appcelerator,0.0.16,0.0.17,16,1,2,2,4,2,FALSE
appcelerator,0.0.11,0.0.12,11,1,2,2,4,2,FALSE
appcelerator,0.0.10,0.0.11,10,1,2,2,4,2,FALSE
appcelerator,0.0.13,0.0.14,13,1,2,2,4,2,FALSE
appcelerator,0.0.12,0.0.13,12,1,2,2,4,2,FALSE
appcelerator,4.2.9-3,4.2.9-5,248,5,138,127,265,10,FALSE
appcelerator,0.0.19,0.0.20,19,1,2,2,4,2,FALSE
appcelerator,0.0.18,0.0.19,18,1,2,2,4,2,FALSE
appcelerator,0.0.76,0.0.77,74,1,2,2,4,2,FALSE
appcelerator,4.2.2-1,4.2.2-3,217,14,1955,1456,3411,56,FALSE
appcelerator,4.2.5-3,4.2.5-5,228,5,206,18,224,8,FALSE
appcelerator,4.2.5-2,4.2.5-3,227,3,4,3,7,3,FALSE
appcelerator,4.2.5-1,4.2.5-2,226,3,151,9,160,9,FALSE
appcelerator,4.2.5-5,4.2.6-1,229,1,116,3,119,4,FALSE
appcelerator,4.0.1-rc,4.0.1-rc2,199,1,2,2,4,2,FALSE
appcelerator,4.0.1-rc2,4.0.1,200,1,2,2,4,2,FALSE
appcelerator,4.2.8-5,4.2.8-6,240,2,42,16,58,6,FALSE
appcelerator,0.0.20,0.0.21,20,1,2,2,4,2,FALSE
appcelerator,0.0.21,0.0.22,21,1,2,2,4,2,FALSE
appcelerator,0.0.22,0.0.23,22,1,2,2,4,2,FALSE
appcelerator,0.0.23,0.0.24,23,1,2,2,4,2,FALSE
appcelerator,0.0.24,0.0.25,24,1,2,2,4,2,FALSE
appcelerator,0.0.25,0.0.26,25,1,2,2,4,2,FALSE
appcelerator,0.0.26,0.0.28,26,1,2,2,4,2,FALSE
appcelerator,0.0.28,0.0.29,27,1,2,2,4,2,FALSE
appcelerator,0.0.29,0.0.30,28,1,2,2,4,2,FALSE
appcelerator,0.0.111,0.0.112,109,1,2,2,4,2,FALSE
appcelerator,0.0.110,0.0.111,108,1,2,2,4,2,FALSE
appcelerator,0.0.113,0.0.114,111,2,67,19,86,5,FALSE
appcelerator,0.0.112,0.0.113,110,1,2,2,4,2,FALSE
appcelerator,0.0.115,0.0.116,113,1,2,2,4,2,FALSE
appcelerator,0.0.114,0.0.115,112,5,17,13,30,7,FALSE
appcelerator,0.0.117,0.0.118,115,1,2,2,4,2,FALSE
appcelerator,0.0.116,0.0.117,114,6,503,48,551,21,FALSE
appcelerator,0.0.118,0.0.119,116,6,590,148,738,24,FALSE
appcelerator,4.2.0-8,4.2.0,209,1,2,2,4,2,FALSE
appcelerator,0.0.38,0.0.40,37,1,2,2,4,2,FALSE
appcelerator,0.0.37,0.0.38,36,1,2,2,4,2,FALSE
appcelerator,0.0.36,0.0.37,35,1,2,2,4,2,FALSE
appcelerator,0.0.35,0.0.36,34,1,2,2,4,2,FALSE
appcelerator,4.2.0-1,4.2.0-7,207,10,29,11,40,11,FALSE
appcelerator,4.1.0-1,4.1.0-2,203,7,197,119,316,12,FALSE
appcelerator,4.2.0-7,4.2.0-8,208,1,2,2,4,2,FALSE
appcelerator,0.0.31,0.0.32,30,1,2,2,4,2,FALSE
appcelerator,0.0.30,0.0.31,29,1,2,2,4,2,FALSE
appcelerator,0.0.5,0.0.6,5,1,2,2,4,2,FALSE
appcelerator,0.0.4,0.0.5,4,1,2,2,4,2,FALSE
appcelerator,0.0.7,0.0.8,7,1,2,2,4,2,FALSE
appcelerator,0.0.6,0.0.7,6,1,2,2,4,2,FALSE
appcelerator,0.0.1,0.0.2,1,1,2,2,4,2,FALSE
appcelerator,0.0.3,0.0.4,3,1,2,2,4,2,FALSE
appcelerator,0.0.2,0.0.3,2,1,2,2,4,2,FALSE
appcelerator,0.0.33,0.0.34,32,1,2,2,4,2,FALSE
appcelerator,0.0.9,0.0.10,9,1,2,2,4,2,FALSE
appcelerator,0.0.8,0.0.9,8,1,2,2,4,2,FALSE
appcelerator,0.0.32,0.0.33,31,1,2,2,4,2,FALSE
appcelerator,4.2.0,4.2.1-1,210,1,1,1,2,1,FALSE
appcelerator,4.2.7,4.2.8-1,235,2,2,2,4,2,FALSE
appcelerator,4.2.6,4.2.7-1,232,2,2010,2,2012,4,FALSE
appcelerator,4.2.3,4.2.4-1,222,1,1,1,2,1,FALSE
appcelerator,0.0.108,0.0.109,106,1,2,2,4,2,FALSE
appcelerator,0.0.109,0.0.110,107,1,2,2,4,2,FALSE
appcelerator,0.0.106,0.0.107,104,1,2,2,4,2,FALSE
appcelerator,0.0.107,0.0.108,105,1,2,2,4,2,FALSE
appcelerator,0.0.104,0.0.105,102,1,5,18,23,4,FALSE
appcelerator,0.0.105,0.0.106,103,2,114,45,159,8,FALSE
appcelerator,0.0.102,0.0.103,100,1,16604,0,16604,208,FALSE
appcelerator,0.0.103,0.0.104,101,1,62,5,67,4,FALSE
appcelerator,0.0.100,0.0.101,98,1,2,2,4,2,FALSE
appcelerator,0.0.101,0.0.102,99,1,2,2,4,2,FALSE
appcelerator,0.0.48,0.0.49,46,1,2,2,4,2,FALSE
appcelerator,0.0.49,0.0.50,47,1,2,2,4,2,FALSE
appcelerator,0.0.42,0.0.43,40,1,2,2,4,2,FALSE
appcelerator,0.0.43,0.0.44,41,1,2,2,4,2,FALSE
appcelerator,0.0.40,0.0.41,38,1,2,2,4,2,FALSE
appcelerator,0.0.41,0.0.42,39,1,2,2,4,2,FALSE
appcelerator,0.0.46,0.0.47,44,1,2,2,4,2,FALSE
appcelerator,0.0.47,0.0.48,45,1,2,2,4,2,FALSE
appcelerator,0.0.44,0.0.45,42,1,2,2,4,2,FALSE
appcelerator,0.0.45,0.0.46,43,1,2,2,4,2,FALSE
appcelerator,4.2.2,4.2.3-1,219,15,1956,1457,3413,57,FALSE
appcelerator,4.2.8-2,4.2.8-3,237,2,8,6,14,6,FALSE
appcelerator,4.2.8-3,4.2.8-4,238,4,6,22,28,8,FALSE
appcelerator,4.2.1,4.2.2-1,216,3,113,21,134,8,FALSE
appcelerator,4.2.8-1,4.2.8-2,236,3,12,3,15,4,FALSE
appcelerator,4.2.8-6,4.2.8-7,241,2,194,1018,1212,4,FALSE
appcelerator,4.2.8-7,4.2.8-8,242,5,6,8,14,8,FALSE
appcelerator,4.2.8-4,4.2.8-5,239,2,80,24,104,10,FALSE
appcelerator,4.2.4,4.2.5-1,225,1,1,1,2,1,FALSE
appcelerator,4.0.0-rc,4.0.0,197,1,1,1,2,1,FALSE
appcelerator,4.2.8-8,4.2.8-9,243,2,212,232,444,4,FALSE
appcelerator,4.2.8-9,4.2.8,244,1,2,2,4,2,FALSE
appcelerator,0.1.20,0.1.22,138,1,4,2,6,1,FALSE
appcelerator,0.3.8,0.3.9,149,1,3,3,6,3,FALSE
appcelerator,0.3.9,0.3.10,150,1,1,1,2,1,FALSE
appcelerator,0.3.2,0.3.3,143,1,86,53,139,4,FALSE
appcelerator,0.3.3,0.3.4,144,1,2,2,4,2,FALSE
appcelerator,0.3.0,0.3.1,141,1,2,2,4,2,FALSE
appcelerator,0.3.1,0.3.2,142,1,2,2,4,2,FALSE
appcelerator,0.3.6,0.3.7,147,1,3,3,6,2,FALSE
appcelerator,0.3.7,0.3.8,148,1,33,17,50,7,FALSE
appcelerator,0.3.4,0.3.5,145,1,12,7,19,2,FALSE
appcelerator,0.3.5,0.3.6,146,1,19,5,24,5,FALSE
appcelerator,0.3.18,0.3.19,159,2,2,2,4,2,FALSE
appcelerator,0.3.19,0.3.21,160,1,3,1,4,1,FALSE
appcelerator,0.3.14,0.3.15,155,4,4,4,8,4,FALSE
appcelerator,0.3.15,0.3.16,156,1,3,3,6,2,FALSE
appcelerator,0.3.16,0.3.17,157,3,5,4,9,3,FALSE
appcelerator,0.3.17,0.3.18,158,3,3,3,6,3,FALSE
appcelerator,0.3.10,0.3.11,151,1,14,5,19,2,FALSE
appcelerator,0.3.11,0.3.12,152,2,31,11,42,3,FALSE
appcelerator,0.3.12,0.3.13,153,3,3,13,16,3,FALSE
appcelerator,0.3.13,0.3.14,154,2,7,2,9,2,FALSE
appcelerator,0.3.39,0.3.40,179,6,52,50,102,46,FALSE
appcelerator,0.1.23,0.3.0,140,10,38,24,62,14,FALSE
appcelerator,0.1.22,0.1.23,139,5,8,4,12,6,FALSE
appcelerator,0.3.50,0.3.51,190,1,2,2,4,2,FALSE
appcelerator,0.3.53,0.3.54,193,1,2,2,4,2,FALSE
appcelerator,0.3.51,0.3.52,191,1,2,2,4,2,FALSE
appcelerator,0.3.52,0.3.53,192,2,81,19,100,10,FALSE
appcelerator,0.3.55,0.3.56,195,12,227,127,354,15,FALSE
appcelerator,0.3.47,0.3.48,187,1,2,2,4,2,FALSE
appcelerator,0.3.46,0.3.47,186,2,4,1,5,2,FALSE
appcelerator,0.3.45,0.3.46,185,1,3,0,3,1,FALSE
appcelerator,0.3.44,0.3.45,184,3,13,15,28,5,FALSE
appcelerator,0.3.43,0.3.44,183,1,2,2,4,2,FALSE
appcelerator,0.3.42,0.3.43,182,1,2,2,4,2,FALSE
appcelerator,0.3.41,0.3.42,181,1,2,2,4,2,FALSE
appcelerator,0.3.40,0.3.41,180,1,2,2,4,2,FALSE
appcelerator,0.3.49,0.3.50,189,6,131,21,152,16,FALSE
appcelerator,0.3.48,0.3.49,188,1,2,2,4,2,FALSE
appcelerator,0.3.32,0.3.33,172,1,3,2,5,2,FALSE
appcelerator,0.3.33,0.3.34,173,2,5,7,12,4,FALSE
appcelerator,0.3.30,0.3.31,170,1,2,2,4,2,FALSE
appcelerator,0.3.31,0.3.32,171,2,4,3,7,3,FALSE
appcelerator,0.3.36,0.3.37,176,3,22,16,38,4,FALSE
appcelerator,0.3.37,0.3.38,177,1,2,2,4,2,FALSE
appcelerator,0.3.34,0.3.35,174,3,57,29,86,3,FALSE
appcelerator,0.3.35,0.3.36,175,1,15,4,19,4,FALSE
appcelerator,0.3.38,0.3.39,178,1,2,2,4,2,FALSE
appcelerator,0.3.54,0.3.55,194,1,6,6,12,2,FALSE
appcelerator,0.1.12,0.1.13,130,2,27,4,31,4,FALSE
appcelerator,0.1.13,0.1.14,131,3,7,7,14,5,FALSE
appcelerator,0.1.16,0.1.17,134,2,140,11,151,15,FALSE
appcelerator,0.1.17,0.1.18,135,1,108,6,114,8,FALSE
appcelerator,0.1.14,0.1.15,132,2,42,26,68,5,FALSE
appcelerator,0.1.15,0.1.16,133,1,14,5,19,3,FALSE
appcelerator,0.1.18,0.1.19,136,1,5,9,14,2,FALSE
appcelerator,0.1.19,0.1.20,137,1,1,1,2,1,FALSE
appcelerator,0.3.21,0.3.22,161,1,9,4,13,1,FALSE
appcelerator,0.3.23,0.3.24,163,1,20,2,22,2,FALSE
appcelerator,0.3.22,0.3.23,162,1,2,2,4,2,FALSE
appcelerator,0.3.25,0.3.26,165,2,2,2,4,2,FALSE
appcelerator,0.3.24,0.3.25,164,2,9,5,14,4,FALSE
appcelerator,0.3.27,0.3.28,167,1,6,5,11,2,FALSE
appcelerator,0.3.26,0.3.27,166,1,1,1,2,1,FALSE
appcelerator,0.3.29,0.3.30,169,1,2,2,4,1,FALSE
appcelerator,0.3.28,0.3.29,168,1,2,2,4,1,FALSE
appcelerator,0.0.76,0.0.77,74,1,2,2,4,2,TRUE
appcelerator,0.0.108,0.0.109,106,1,2,2,4,2,TRUE
appcelerator,0.1.10,0.1.11,128,1,13,3,16,2,FALSE
appcelerator,0.1.9,0.1.10,127,1,26,27,53,3,FALSE
appcelerator,0.1.11,0.1.12,129,1,17,7,24,2,FALSE
appcelerator,0.0.55,0.0.56,53,1,2,2,4,2,TRUE
appcelerator,4.2.8-6,4.2.8-7,241,2,194,1018,1212,4,TRUE
appcelerator,0.0.66,0.0.67,64,1,2,2,4,2,TRUE
appcelerator,0.0.63,0.0.64,61,1,2,2,4,2,TRUE
appcelerator,4.0.1,4.0.3-0,201,1,1,1,2,1,TRUE
appcelerator,0.0.3,0.0.4,3,1,2,2,4,2,TRUE
appcelerator,4.2.0,4.2.1-1,210,1,1,1,2,1,TRUE
appcelerator,4.2.1,4.2.2-1,216,3,113,21,134,8,TRUE
appcelerator,0.0.8,0.0.9,8,1,2,2,4,2,TRUE
appcelerator,0.1.8,0.1.9,126,1,66,15835,15901,206,FALSE
appcelerator,0.1.3,0.1.4,121,1,4,3,7,3,FALSE
appcelerator,0.1.4,0.1.5,122,1,87,5,92,4,FALSE
appcelerator,0.1.6,0.1.7,124,1,2,2,4,2,FALSE
appcelerator,0.1.5,0.1.6,123,1,14,7,21,4,FALSE
appcelerator,0.1.7,0.1.8,125,1,5,5,10,2,FALSE
appcelerator,0.1.0,0.1.1,118,1,4,4,8,3,FALSE
appcelerator,0.0.119,0.1.0,117,9,411,323,734,30,FALSE
appcelerator,0.1.1,0.1.2,119,5,291,43,334,14,FALSE
appcelerator,0.1.2,0.1.3,120,1,3,3,6,3,FALSE
appcelerator,0.0.67,0.0.68,65,1,2,2,4,2,TRUE
appcelerator,0.0.34,0.0.35,33,1,2,2,4,2,TRUE
appcelerator,0.1.22,0.1.23,139,5,8,4,12,6,TRUE
appcelerator,0.0.10,0.0.11,10,1,2,2,4,2,TRUE
appcelerator,0.0.44,0.0.45,42,1,2,2,4,2,TRUE
appcelerator,0.0.56,0.0.57,54,1,2,2,4,2,TRUE
appcelerator,0.0.74,0.0.75,72,1,2,2,4,2,TRUE
appcelerator,0.1.16,0.1.17,134,2,140,11,151,15,TRUE
appcelerator,0.1.17,0.1.18,135,1,108,6,114,8,TRUE
appcelerator,0.1.15,0.1.16,133,1,14,5,19,3,TRUE
appcelerator,0.3.12,0.3.13,153,3,3,13,16,3,TRUE
parse-server,1.0.4,1.0.5,4,1,69,2,71,2,FALSE
parse-server,1.0.5,1.0.6,5,1,69,2,71,2,FALSE
parse-server,1.0.6,1.0.7,6,1,69,2,71,2,FALSE
parse-server,1.0.7,1.0.8,7,1,69,2,71,2,FALSE
parse-server,1.0.0,1.0.1,1,1,69,2,71,2,FALSE
parse-server,1.0.1,1.0.2,2,1,69,2,71,2,FALSE
parse-server,1.0.2,1.0.4,3,1,69,2,71,2,FALSE
parse-server,1.0.8,1.0.9,8,1,69,2,71,2,FALSE
parse-server,1.0.9,1.0.10,9,1,69,2,71,2,FALSE
parse-server,1.0.14,1.0.15,14,1,69,2,71,2,FALSE
parse-server,1.0.15,1.0.16,15,1,69,2,71,2,FALSE
parse-server,1.0.12,1.0.13,12,1,69,2,71,2,FALSE
parse-server,1.0.13,1.0.14,13,1,69,2,71,2,FALSE
parse-server,1.0.10,1.0.11,10,1,69,2,71,2,FALSE
parse-server,1.0.11,1.0.12,11,1,69,2,71,2,FALSE
parse-server,2.2.20,2.2.21,53,2,18,9,27,6,FALSE
parse-server,2.2.21,2.2.22,54,16,821,284,1105,52,FALSE
parse-server,2.2.22,2.2.23,55,20,444,57,501,32,FALSE
parse-server,2.2.23,2.2.24,56,23,658,87,745,38,FALSE
parse-server,2.2.24,2.2.25-beta.1,57,11,209,56,265,24,FALSE
parse-server,2.2.25-beta.1,2.2.25,58,44,5989,3861,9850,238,FALSE
parse-server,2.2.5,2.2.6,38,5,132,80,212,8,FALSE
parse-server,2.2.4,2.2.5,37,56,3211,869,4080,129,FALSE
parse-server,2.2.7,2.2.8,40,56,2782,1190,3972,148,FALSE
parse-server,2.2.6,2.2.7,39,38,1924,1220,3144,116,FALSE
parse-server,2.2.1,2.2.2,34,14,990,655,1645,24,FALSE
parse-server,2.2.0,2.2.1,33,21,1225,444,1669,42,FALSE
parse-server,2.2.3,2.2.4,36,11,285,54,339,20,FALSE
parse-server,2.2.2,2.2.3,35,50,1363,5416,6779,166,FALSE
parse-server,2.2.9,2.2.10,42,11,238,52,290,21,FALSE
parse-server,2.2.8,2.2.9,41,2,22,2,24,4,FALSE
parse-server,2.2.19,2.2.20,52,16,580,62,642,34,FALSE
parse-server,2.3.0-alpha1,2.3.0,60,182,13569,6352,19921,728,FALSE
parse-server,2.2.15,2.2.16,48,19,448,62,510,33,FALSE
parse-server,2.2.14,2.2.15,47,15,223,87,310,27,FALSE
parse-server,2.2.17,2.2.18,50,59,3464,1564,5028,199,FALSE
parse-server,2.2.16,2.2.17,49,55,2015,564,2579,139,FALSE
parse-server,2.2.11,2.2.12,44,12,401,117,518,32,FALSE
parse-server,2.2.10,2.2.11,43,72,3045,1826,4871,180,FALSE
parse-server,2.2.13,2.2.14,46,47,3188,2082,5270,197,FALSE
parse-server,2.2.12,2.2.13,45,5,1754,1534,3288,43,FALSE
parse-server,2.3.0,2.3.1,61,5,91,35,126,8,FALSE
parse-server,2.3.1,2.3.2,62,17,260,34,294,26,FALSE
parse-server,2.3.2,2.3.3,63,41,965,446,1411,117,FALSE
parse-server,2.3.3,2.3.4,64,17,247,148,395,29,FALSE
parse-server,2.3.4,2.3.5,65,1,3,3,6,2,FALSE
parse-server,2.2.18,2.2.19,51,36,2333,404,2737,111,FALSE
parse-server,2.3.6,2.3.7,67,29,489,71,560,36,FALSE
parse-server,2.3.7,2.3.8,68,24,276,58,334,43,FALSE
parse-server,2.4.1,2.4.2,71,14,504,97,601,29,FALSE
parse-server,2.4.0,2.4.1,70,8,185,46,231,15,FALSE
parse-server,2.3.8,2.4.0,69,41,1584,452,2036,96,FALSE
parse-server,2.3.5,2.3.6,66,14,183,27,210,20,FALSE
parse-server,2.1.2,2.1.3,28,83,6227,3472,9699,271,FALSE
parse-server,2.1.3,2.1.4,29,179,13514,3928,17442,603,FALSE
parse-server,2.1.0,2.1.1,26,25,4795,671,5466,115,FALSE
parse-server,2.1.1,2.1.2,27,17,1039,254,1293,50,FALSE
parse-server,2.1.6,2.2.0,32,60,12332,1645,13977,203,FALSE
parse-server,2.1.4,2.1.5,30,92,9526,4722,14248,330,FALSE
parse-server,2.1.5,2.1.6,31,44,6302,1842,8144,210,FALSE
parse-server,2.2.24,2.2.25-beta.1,57,11,209,56,265,24,TRUE
parse-server,2.0.7,2.0.8,24,120,11154,2530,13684,462,FALSE
parse-server,2.0.6,2.0.7,23,48,2935,704,3639,132,FALSE
parse-server,2.0.5,2.0.6,22,8,47,9,56,14,FALSE
parse-server,2.0.4,2.0.5,21,33,620,308,928,81,FALSE
parse-server,2.0.8,2.1.0,25,82,13798,4216,18014,384,FALSE
parse-server,2.0.3,2.0.4,20,32,516,144,660,54,FALSE
parse-server,2.0.2,2.0.3,19,5,7,3,10,5,FALSE
parse-server,2.0.1,2.0.2,18,11,81,23,104,24,FALSE
parse-server,2.0.0,2.0.1,17,11,26,8,34,11,FALSE
parse-server,2.0.8,2.1.0,25,82,13798,4216,18014,384,TRUE
parse-server,2.2.0,2.2.1,33,21,1225,444,1669,42,TRUE
parse-server,2.1.1,2.1.2,27,17,1039,254,1293,50,TRUE
parse-server,2.1.6,2.2.0,32,60,12332,1645,13977,203,TRUE
parse-server,2.1.4,2.1.5,30,92,9526,4722,14248,330,TRUE
parse-server,2.1.5,2.1.6,31,44,6302,1842,8144,210,TRUE
parse-server,2.3.0,2.3.1,61,5,91,35,126,8,TRUE
parse-server,2.2.1,2.2.2,34,14,990,655,1645,24,TRUE
parse-server,1.0.16,2.0.0,16,1,14974,0,14974,53,FALSE
parse-server,2.0.6,2.0.7,23,48,2935,704,3639,132,TRUE
parse-server,2.2.2,2.2.3,35,50,1363,5416,6779,166,TRUE
parse-server,2.2.17,2.2.18,50,59,3464,1564,5028,199,TRUE
parse-server,2.2.23,2.2.24,56,23,658,87,745,38,TRUE
parse-server,2.2.5,2.2.6,38,5,132,80,212,8,TRUE
parse-server,2.2.16,2.2.17,49,55,2015,564,2579,139,TRUE
parse-server,2.2.19,2.2.20,52,16,580,62,642,34,TRUE
parse-server,2.0.7,2.0.8,24,120,11154,2530,13684,462,TRUE
parse-server,2.3.7,2.3.8,68,24,276,58,334,43,TRUE
parse-server,2.1.3,2.1.4,29,179,13514,3928,17442,603,TRUE
parse-server,2.2.7,2.2.8,40,56,2782,1190,3972,148,TRUE
parse-server,2.2.21,2.2.22,54,16,821,284,1105,52,TRUE
metarhia-jstp,0.6.0,0.6.1,26,5,42,27,69,8,FALSE
metarhia-jstp,0.6.6,0.6.7,32,18,229,65,294,27,FALSE
metarhia-jstp,0.6.5,0.6.6,31,20,733,282,1015,34,FALSE
metarhia-jstp,0.3.5,0.3.7,10,3,7,6,13,3,FALSE
metarhia-jstp,0.3.8,0.3.9,12,20,538,68,606,38,FALSE
metarhia-jstp,0.6.3,0.6.4,29,4,16,2,18,5,FALSE
metarhia-jstp,0.3.3,0.3.4,8,1,14,12,26,2,FALSE
metarhia-jstp,0.3.0,0.3.1,5,7,70,95,165,23,FALSE
metarhia-jstp,0.3.1,0.3.2,6,2,6,4,10,2,FALSE
metarhia-jstp,0.6.7,0.6.8,33,7,238,45,283,10,FALSE
metarhia-jstp,0.3.7,0.3.8,11,2,2,1,3,2,FALSE
metarhia-jstp,0.3.4,0.3.5,9,2,7,8,15,3,FALSE
metarhia-jstp,0.6.4,0.6.5,30,3,28,32,60,4,FALSE
metarhia-jstp,0.4.1,0.4.2,18,2,9,4,13,2,FALSE
metarhia-jstp,0.4.0,0.4.1,17,5,107,98,205,21,FALSE
metarhia-jstp,0.4.3,0.4.4,20,2,12,17,29,3,FALSE
metarhia-jstp,0.4.2,0.4.3,19,11,144,134,278,18,FALSE
metarhia-jstp,0.5.0,0.5.1,23,7,378,245,623,14,TRUE
metarhia-jstp,0.5.1,0.5.2,24,89,3708,2933,6641,193,FALSE
metarhia-jstp,0.3.10,0.3.11,14,1,7,1,8,2,FALSE
metarhia-jstp,0.3.9,0.3.10,13,1,5,1,6,2,FALSE
metarhia-jstp,0.3.11,0.3.12,15,10,176,204,380,25,FALSE
metarhia-jstp,0.4.5,0.5.0,22,11,294,86,380,15,FALSE
metarhia-jstp,0.4.4,0.4.5,21,6,20,40,60,8,FALSE
metarhia-jstp,0.3.2,0.3.3,7,2,4,2,6,2,FALSE
metarhia-jstp,0.3.12,0.4.0,16,10,359,355,714,28,FALSE
metarhia-jstp,0.6.2,0.6.3,28,19,1536,1407,2943,42,FALSE
metarhia-jstp,0.6.1,0.6.2,27,3,16,7,23,5,FALSE
metarhia-jstp,0.2.0,0.3.0,4,17,1305,965,2270,53,FALSE
metarhia-jstp,0.5.0,0.5.1,23,7,378,245,623,14,FALSE
metarhia-jstp,0.1.4,0.1.5,2,91,5979,2365,8344,154,FALSE
metarhia-jstp,0.1.5,0.2.0,3,81,5719,3566,9285,221,FALSE
metarhia-jstp,0.6.7,0.6.8,33,7,238,45,283,10,TRUE
metarhia-jstp,0.6.6,0.6.7,32,18,229,65,294,27,TRUE
metarhia-jstp,0.6.5,0.6.6,31,20,733,282,1015,34,TRUE
metarhia-jstp,0.3.8,0.3.9,12,20,538,68,606,38,TRUE
metarhia-jstp,0.4.2,0.4.3,19,11,144,134,278,18,TRUE
metarhia-jstp,0.4.5,0.5.0,22,11,294,86,380,15,TRUE
metarhia-jstp,0.3.2,0.3.3,7,2,4,2,6,2,TRUE
metarhia-jstp,0.2.0,0.3.0,4,17,1305,965,2270,53,TRUE
onenoteapi,1.0.4,1.0.5,5,21,971,125,1096,76,FALSE
onenoteapi,1.0.5,1.0.6,6,2,124,72,196,12,FALSE
onenoteapi,1.0.6,1.1.0,7,1,261,13,274,11,FALSE
onenoteapi,1.0.0,1.0.1,1,7,3822,22,3844,38,FALSE
onenoteapi,1.0.1,1.0.2,2,2,4,4,8,2,FALSE
onenoteapi,1.0.2,1.0.3,3,2,2,18,20,6,FALSE
onenoteapi,1.0.3,1.0.4,4,3,180,158,338,14,FALSE
onenoteapi,1.0.2,1.0.3,3,2,2,18,20,6,TRUE
oakpubsub,0.1.8,0.2.0,12,2,47,29,76,4,FALSE
oakpubsub,0.2.2,0.3.0,15,4,166,165,331,11,FALSE
oakpubsub,0.2.1,0.2.2,14,6,301,48,349,10,FALSE
oakpubsub,0.2.0,0.2.1,13,3,3,4,7,4,FALSE
oakpubsub,0.1.5,0.1.6,9,3,57,58,115,4,FALSE
oakpubsub,0.1.6,0.1.7,10,2,37,45,82,4,FALSE
oakpubsub,0.1.7,0.1.8,11,2,2,2,4,2,FALSE
oakpubsub,0.3.0,0.3.1,16,2,171,64,235,6,FALSE
oakpubsub,0.3.1,0.4.0,17,2,22,23,45,5,FALSE
oakpubsub,0.4.9,0.4.10,26,2,9,7,16,4,FALSE
oakpubsub,0.4.8,0.4.9,25,2,191,55,246,5,FALSE
oakpubsub,0.4.1,0.4.3,19,4,20,6,26,5,FALSE
oakpubsub,0.4.0,0.4.1,18,2,65,17,82,3,FALSE
oakpubsub,0.4.3,0.4.4,20,2,77,29,106,4,FALSE
oakpubsub,0.5.0,0.5.1,32,2,2,2,4,2,FALSE
oakpubsub,0.5.1,0.5.2,33,2,2,2,4,2,FALSE
oakpubsub,0.5.2,0.5.3,34,2,112,136,248,5,FALSE
oakpubsub,0.5.3,0.7.0,35,6,89,68,157,18,FALSE
oakpubsub,0.4.11,0.4.12,28,2,34,12,46,4,FALSE
oakpubsub,0.4.10,0.4.11,27,3,78,23,101,9,FALSE
oakpubsub,0.4.13,0.4.14,30,1,1,1,2,1,FALSE
oakpubsub,0.4.12,0.4.13,29,2,99,130,229,4,FALSE
oakpubsub,0.4.14,0.5.0,31,3,7,42,49,5,FALSE
oakpubsub,0.4.5,0.4.6,22,3,6,6,12,4,FALSE
oakpubsub,0.4.4,0.4.5,21,1,1,1,2,1,FALSE
oakpubsub,0.4.7,0.4.8,24,3,20,17,37,5,FALSE
oakpubsub,0.4.6,0.4.7,23,2,95,72,167,5,FALSE
oakpubsub,0.1.0,0.1.1,4,2,2,2,4,2,FALSE
oakpubsub,0.1.1,0.1.2,5,2,2,2,4,2,FALSE
oakpubsub,0.1.2,0.1.3,6,2,3,3,6,3,FALSE
oakpubsub,0.1.3,0.1.4,7,2,2,1,3,2,FALSE
oakpubsub,0.1.4,0.1.5,8,3,58,18,76,9,FALSE
oakpubsub,0.4.12,0.4.13,29,2,99,130,229,4,TRUE
oakpubsub,0.3.1,0.4.0,17,2,22,23,45,5,TRUE
oakpubsub,0.4.11,0.4.12,28,2,34,12,46,4,TRUE
oakpubsub,0.0.4,0.1.0,3,2,243,23,266,6,FALSE
oakpubsub,0.0.1,0.0.2,1,2,3,3,6,2,FALSE
oakpubsub,0.0.2,0.0.4,2,4,30,9,39,4,FALSE
oakpubsub,0.1.8,0.2.0,12,2,47,29,76,4,TRUE
oakpubsub,0.0.4,0.1.0,3,2,243,23,266,6,TRUE
oakpubsub,0.4.1,0.4.3,19,4,20,6,26,5,TRUE
oakpubsub,0.1.0,0.1.1,4,2,2,2,4,2,TRUE
oakpubsub,0.2.2,0.3.0,15,4,166,165,331,11,TRUE
oakpubsub,0.5.3,0.7.0,35,6,89,68,157,18,TRUE
logger-app,1.0.0,1.0.1,16,2,4,4,8,4,FALSE
logger-app,1.0.1,1.0.2,17,2,13,7,20,4,FALSE
logger-app,1.0.2,1.0.3,18,2,15,15,30,9,FALSE
logger-app,1.0.3,1.0.4,19,9,108,67,175,14,FALSE
logger-app,0.3.0,0.3.1,6,3,7,5,12,4,FALSE
logger-app,0.3.1,0.4.0,7,14,161,164,325,51,FALSE
logger-app,0.8.1,0.8.2,14,5,8,218,226,15,FALSE
logger-app,0.8.0,0.8.1,13,1,2,2,4,2,FALSE
logger-app,0.7.0,0.8.0,12,33,914,208,1122,57,FALSE
logger-app,0.8.2,1.0.0,15,175,5659,2882,8541,471,FALSE
logger-app,0.2.0,0.3.0,5,5,66,24,90,11,FALSE
logger-app,0.4.0,0.5.0,8,9,736,359,1095,43,TRUE
logger-app,0.5.0,0.5.1,9,4,61,67,128,11,FALSE
logger-app,0.5.1,0.5.2,10,1,99,104,203,1,FALSE
logger-app,0.5.2,0.7.0,11,13,260,95,355,17,FALSE
logger-app,0.5.0,0.5.1,9,4,61,67,128,11,TRUE
logger-app,0.1.1,0.1.2,2,3,4,9,13,5,FALSE
logger-app,0.1.0,0.1.1,1,2,142,144,286,6,FALSE
logger-app,0.4.0,0.5.0,8,9,736,359,1095,43,FALSE
logger-app,0.1.2,0.1.3,3,1,1,2,3,1,FALSE
logger-app,0.1.3,0.2.0,4,18,456,173,629,82,FALSE
logger-app,1.0.2,1.0.3,18,2,15,15,30,9,TRUE
logger-app,0.8.1,0.8.2,14,5,8,218,226,15,TRUE
logger-app,0.1.2,0.1.3,3,1,1,2,3,1,TRUE
logger-app,0.3.1,0.4.0,7,14,161,164,325,51,TRUE
logger-app,0.1.3,0.2.0,4,18,456,173,629,82,TRUE
logger-app,0.5.2,0.7.0,11,13,260,95,355,17,TRUE
esri-loader-react,0.3.0,1.0.0,5,1,10,7,17,4,FALSE
esri-loader-react,0.2.2,0.3.0,4,1,1,1,2,1,FALSE
esri-loader-react,0.2.1,0.2.2,3,2,8,8,16,2,FALSE
esri-loader-react,0.1.0,0.1.1,1,1,192,1,193,6,FALSE
esri-loader-react,0.1.1,0.2.1,2,6,139,133,272,15,TRUE
esri-loader-react,0.2.2,0.3.0,4,1,1,1,2,1,TRUE
esri-loader-react,0.1.1,0.2.1,2,6,139,133,272,15,FALSE
react-stickies,0.0.4,0.0.5,4,1,4,4,8,2,FALSE
react-stickies,0.0.1,0.0.2,1,3,565,15,580,11,FALSE
react-stickies,0.0.3,0.0.4,3,1,24,5,29,3,FALSE
react-stickies,0.0.2,0.0.3,2,1,2,2,4,2,FALSE
react-stickies,0.0.5,0.0.6,5,1,85,21,106,6,FALSE
react-stickies,0.0.7,0.0.8,7,1,500,1,501,2,FALSE
react-stickies,0.0.6,0.0.7,6,2,14,504,518,5,FALSE
react-stickies,0.0.9,0.0.10,9,1,1,500,501,2,FALSE
react-stickies,0.0.8,0.0.9,8,1,159,1,160,2,FALSE
react-stickies,0.0.15,0.0.16,15,1,2,2,4,2,FALSE
react-stickies,0.0.14,0.0.15,14,1,19,5,24,2,FALSE
react-stickies,0.0.11,0.0.12,11,1,265,203,468,8,FALSE
react-stickies,0.0.10,0.0.11,10,1,7,161,168,3,FALSE
react-stickies,0.0.13,0.0.14,13,1,5,161,166,4,FALSE
react-stickies,0.0.12,0.0.13,12,2,679,10,689,6,FALSE
react-stickies,0.0.6,0.0.7,6,2,14,504,518,5,TRUE
react-stickies,0.0.2,0.0.3,2,1,2,2,4,2,TRUE
react-stickies,0.0.1,0.0.2,1,3,565,15,580,11,TRUE
react-stickies,0.0.11,0.0.12,11,1,265,203,468,8,TRUE
millwright,0.3.8,0.3.9,11,3,12,8,20,4,FALSE
millwright,0.3.9,0.3.10,12,2,721,2,723,22,FALSE
millwright,0.3.2,0.3.3,5,5,153,46,199,14,FALSE
millwright,0.3.0,0.3.1,3,3,91,95,186,27,FALSE
millwright,0.3.1,0.3.2,4,2,3,9,12,3,FALSE
millwright,0.3.6,0.3.7,9,2,276,40,316,4,FALSE
millwright,0.3.7,0.3.8,10,2,3,3,6,2,FALSE
millwright,0.3.4,0.3.5,7,2,2,2,4,2,FALSE
millwright,0.3.5,0.3.6,8,7,1567,163,1730,66,FALSE
millwright,0.3.18,0.3.19,21,2,24,3,27,5,FALSE
millwright,0.3.19,0.4.0,22,2,135,33,168,5,FALSE
millwright,0.4.1,0.4.2,24,2,86,34,120,5,FALSE
millwright,0.3.15,0.3.16,18,4,100,300,400,7,FALSE
millwright,0.3.16,0.3.17,19,3,11,11,22,6,FALSE
millwright,0.4.2,0.4.3,25,2,5,7,12,5,FALSE
millwright,0.3.10,0.3.11,13,1,1,1,2,1,FALSE
millwright,0.3.12,0.3.13,15,2,2,2,4,2,FALSE
millwright,0.3.13,0.3.14,16,2,4,4,8,3,FALSE
millwright,0.3.14,0.3.15,17,2,8,5,13,2,FALSE
millwright,0.4.0,0.4.1,23,2,54,56,110,3,FALSE
millwright,0.4.3,0.4.4,26,5,763,822,1585,42,FALSE
millwright,0.3.17,0.3.18,20,2,60,29,89,7,FALSE
millwright,0.3.11,0.3.12,14,4,61,37,98,6,FALSE
millwright,0.2.6,0.2.7,1,1,245,0,245,7,FALSE
millwright,0.2.7,0.3.0,2,157,11529,5595,17124,598,FALSE
millwright,0.4.3,0.4.4,26,5,763,822,1585,42,TRUE
millwright,0.3.19,0.4.0,22,2,135,33,168,5,TRUE
millwright,0.3.0,0.3.1,3,3,91,95,186,27,TRUE
millwright,0.3.5,0.3.6,8,7,1567,163,1730,66,TRUE
millwright,0.4.2,0.4.3,25,2,5,7,12,5,TRUE
meetup-web-platform,0.11.588-beta,0.11.589,417,2,326,108,434,19,FALSE
meetup-web-platform,0.9.366-beta,0.9.367-beta,228,1,1,0,1,1,FALSE
meetup-web-platform,0.10.417-beta,0.10.418-beta,275,1,16,12,28,1,FALSE
meetup-web-platform,0.8.310-beta,0.8.311-beta,177,1,4,1,5,1,FALSE
meetup-web-platform,0.11.605-beta,0.11.606-beta,432,2,3,3,6,2,FALSE
meetup-web-platform,0.6.257-beta,0.6.258-beta,133,2,11,0,11,2,FALSE
meetup-web-platform,0.5.202-beta,0.5.203-beta,73,1,2,1,3,1,FALSE
meetup-web-platform,0.10.503-beta,0.10.504-beta,341,2,6,1,7,2,FALSE
meetup-web-platform,0.11.548-beta,0.11.549-beta,382,1,18,9,27,2,FALSE
meetup-web-platform,0.5.184-beta,0.5.185-beta,57,1,4,1,5,1,FALSE
meetup-web-platform,0.9.351,0.9.352-beta,215,2,106,3,109,2,FALSE
meetup-web-platform,0.5.192-beta,0.5.193-beta,65,2,78,46,124,5,FALSE
meetup-web-platform,0.10.381,0.10.382-beta,243,2,7,3,10,2,FALSE
meetup-web-platform,0.3.78,0.3.87,22,10,741,244,985,30,FALSE
meetup-web-platform,0.3.76,0.3.78,21,4,184,36,220,8,FALSE
meetup-web-platform,0.3.74,0.3.75,19,2,69,34,103,7,FALSE
meetup-web-platform,0.3.75,0.3.76,20,1,4,1,5,1,FALSE
meetup-web-platform,0.10.389,0.10.390-beta,251,1,4,1,5,1,FALSE
meetup-web-platform,0.6.274-beta,0.6.275-beta,145,1,25,28,53,1,FALSE
meetup-web-platform,0.10.379,0.10.380-beta,241,2,1030,754,1784,7,FALSE
meetup-web-platform,0.10.378,0.10.379,240,1,4,1,5,1,FALSE
meetup-web-platform,0.10.371,0.10.373,234,2,11,6,17,3,FALSE
meetup-web-platform,0.10.373,0.10.374-beta,235,5,999,820,1819,14,FALSE
meetup-web-platform,0.5.148,0.5.150,41,3,2,2,4,2,FALSE
meetup-web-platform,0.5.246-beta,0.5.247-beta,113,1,4,1,5,1,FALSE
meetup-web-platform,0.5.215-beta,0.5.216-beta,85,1,4,1,5,1,FALSE
meetup-web-platform,0.11.530-beta,0.11.531-beta,368,1,6,0,6,1,FALSE
meetup-web-platform,0.10.498,0.10.503-beta,340,7,392,108,500,23,FALSE
meetup-web-platform,0.7.300-beta,0.7.301-beta,164,1,33,2,35,2,FALSE
meetup-web-platform,0.10.494,0.10.495,336,1,4,1,5,1,FALSE
meetup-web-platform,0.10.495,0.10.496-beta,337,1,348,24,372,9,FALSE
meetup-web-platform,0.11.561-beta,0.11.562-beta,392,1,4,1,5,1,FALSE
meetup-web-platform,0.11.538-beta,0.11.539-beta,372,1,4,5,9,1,FALSE
meetup-web-platform,0.10.450-beta,0.10.453,305,4,113,16,129,9,FALSE
meetup-web-platform,0.10.521,0.10.522-beta,357,2,13,22,35,3,FALSE
meetup-web-platform,0.7.298-beta,0.7.299-beta,162,2,105,71,176,5,FALSE
meetup-web-platform,0.10.484-beta,0.10.486-beta,328,2,192,42,234,9,FALSE
meetup-web-platform,0.10.446-beta,0.10.447-beta,301,1,5,8,13,1,FALSE
meetup-web-platform,0.6.267,0.6.268-beta,139,1,2,2,4,1,FALSE
meetup-web-platform,0.10.504-beta,0.10.506,342,1,5,0,5,1,FALSE
meetup-web-platform,0.5.205-beta,0.5.206-beta,76,1,4,1,5,1,FALSE
meetup-web-platform,0.5.249,0.5.250-beta,115,1,13,0,13,1,FALSE
meetup-web-platform,0.8.342-beta,0.8.343-beta,206,4,211,42,253,11,FALSE
meetup-web-platform,0.5.158-beta,0.5.159,46,1,11,8,19,1,FALSE
meetup-web-platform,0.8.340,0.8.341,204,2,100,9,109,5,FALSE
meetup-web-platform,0.8.341,0.8.342-beta,205,1,19,54,73,4,FALSE
meetup-web-platform,0.5.226-beta,0.5.227-beta,96,5,125,46,171,6,FALSE
meetup-web-platform,0.5.234-beta,0.5.235-beta,103,1,4,1,5,1,FALSE
meetup-web-platform,0.5.222-beta,0.5.223,92,1,25,0,25,1,FALSE
meetup-web-platform,0.11.576,0.11.577,406,1,4,1,5,1,FALSE
meetup-web-platform,0.11.577,0.11.578,407,1,4,1,5,1,FALSE
meetup-web-platform,0.10.477-beta,0.10.478-beta,322,1,1,1,2,1,FALSE
meetup-web-platform,0.5.247-beta,0.5.249,114,3,8,4,12,4,FALSE
meetup-web-platform,0.9.349-beta,0.9.350-beta,213,1,4,1,5,1,FALSE
meetup-web-platform,0.5.183-beta,0.5.184-beta,56,1,4,1,5,1,FALSE
meetup-web-platform,0.5.225-beta,0.5.226-beta,95,1,14,17,31,1,FALSE
meetup-web-platform,0.6.261-beta,0.6.265-beta,137,14,332,265,597,25,FALSE
meetup-web-platform,0.6.172-beta,0.6.173-beta,131,1,4,1,5,1,FALSE
meetup-web-platform,0.10.413-beta,0.10.414-beta,271,1,1,1,2,1,FALSE
meetup-web-platform,0.10.490-beta,0.10.491-beta,332,2,18,2,20,3,FALSE
meetup-web-platform,0.5.254-beta,0.5.255,120,1,427,74,501,12,FALSE
meetup-web-platform,0.9.352-beta,0.9.353-beta,216,1,4,1,5,1,FALSE
meetup-web-platform,0.10.414-beta,0.10.415,272,1,1,1,2,1,FALSE
meetup-web-platform,0.8.318-beta,0.8.319-beta,183,1,1615,1034,2649,39,FALSE
meetup-web-platform,0.7.297-beta,0.7.298-beta,161,1,16,23,39,4,FALSE
meetup-web-platform,0.6.258-beta,0.6.259-beta,134,1,4,1,5,1,FALSE
meetup-web-platform,0.6.290,0.6.291-beta,153,1,4,1,5,1,FALSE
meetup-web-platform,0.10.427-beta,0.10.428,284,1,58,29,87,2,FALSE
meetup-web-platform,0.8.326-beta,0.8.327-beta,191,1,42,304,346,14,FALSE
meetup-web-platform,0.11.608-beta,0.11.609,435,1,1,1,2,1,FALSE
meetup-web-platform,0.11.616,0.11.617-beta,443,1,18,15,33,2,FALSE
meetup-web-platform,0.11.610,0.11.611-beta,437,1,4,1,5,1,FALSE
meetup-web-platform,0.10.522-beta,0.10.523-beta,358,1,4,1,5,1,FALSE
meetup-web-platform,0.9.368,0.9.369,230,1,82,26,108,4,FALSE
meetup-web-platform,0.5.211-beta,0.5.212-beta,82,1,6,2,8,1,FALSE
meetup-web-platform,0.9.353-beta,0.9.355-beta,217,9,181,58,239,16,FALSE
meetup-web-platform,0.11.597-beta,0.11.599-beta,425,3,56,35,91,7,FALSE
meetup-web-platform,0.8.319-beta,0.8.320-beta,184,5,132,73,205,16,FALSE
meetup-web-platform,0.10.440-beta,0.10.441-beta,295,1,57,13,70,2,FALSE
meetup-web-platform,0.11.554-beta,0.11.555,387,1,39,20,59,3,FALSE
meetup-web-platform,0.10.422-beta,0.10.423,280,1,10,3,13,4,FALSE
meetup-web-platform,0.11.617-beta,0.11.618-beta,444,1,1,1,2,1,FALSE
meetup-web-platform,0.9.369,0.9.370,231,1,212,112,324,4,FALSE
meetup-web-platform,0.11.618-beta,0.11.619,445,1,69,0,69,3,FALSE
meetup-web-platform,0.9.362,0.9.363,224,1,70,25,95,4,FALSE
meetup-web-platform,0.9.363,0.9.364-beta,225,1,246,47,293,9,FALSE
meetup-web-platform,0.9.356,0.9.358-beta,219,2,108,3,111,3,FALSE
meetup-web-platform,0.9.361,0.9.362,223,1,4,1,5,1,FALSE
meetup-web-platform,0.10.429,0.10.431-beta,286,4,959,420,1379,42,FALSE
meetup-web-platform,0.10.428,0.10.429,285,2,271,141,412,13,FALSE
meetup-web-platform,0.5.242-beta,0.5.243-beta,110,1,8,3,11,2,FALSE
meetup-web-platform,0.10.423,0.10.424,281,2,163,1,164,4,FALSE
meetup-web-platform,0.5.219-beta,0.5.220-beta,89,1,7,7,14,3,FALSE
meetup-web-platform,0.10.424,0.10.426,282,3,20,8,28,8,FALSE
meetup-web-platform,0.10.511-beta,0.10.512-beta,348,2,22,28,50,2,FALSE
meetup-web-platform,0.5.232-beta,0.5.233-beta,101,1,4,1,5,1,FALSE
meetup-web-platform,0.11.543-beta,0.11.544-beta,377,1,1,1,2,1,FALSE
meetup-web-platform,0.11.580-beta,0.11.581,410,3,449,115,564,28,FALSE
meetup-web-platform,0.3.73,0.3.74,18,2,12,8,20,2,FALSE
meetup-web-platform,0.11.591-beta,0.11.592-beta,420,1,1,1,2,1,FALSE
meetup-web-platform,0.11.535-beta,0.11.537-beta,370,3,78,7,85,8,FALSE
meetup-web-platform,0.7.283-beta,0.7.284-beta,158,1,6,1,7,2,FALSE
meetup-web-platform,0.10.382-beta,0.10.383-beta,244,4,102,45,147,4,FALSE
meetup-web-platform,0.10.421,0.10.422-beta,279,2,10,3,13,5,FALSE
meetup-web-platform,0.10.419-beta,0.10.420-beta,277,1,4,1,5,1,FALSE
meetup-web-platform,0.5.237,0.5.238,106,1,4,3,7,2,FALSE
meetup-web-platform,0.5.236,0.5.237,105,1,93,11,104,3,FALSE
meetup-web-platform,0.10.514,0.10.515-beta,351,1,4,1,5,1,FALSE
meetup-web-platform,0.10.516,0.10.518-beta,353,4,187,54,241,15,FALSE
meetup-web-platform,0.11.569-beta,0.11.570-beta,399,4,80,96,176,4,FALSE
meetup-web-platform,0.10.466-beta,0.10.470-beta,316,5,259,46,305,13,FALSE
meetup-web-platform,0.6.292-beta,0.6.293-beta,155,1,4,1,5,1,FALSE
meetup-web-platform,0.8.333,0.8.334-beta,198,1,4,1,5,1,FALSE
meetup-web-platform,0.8.335,0.8.336-beta,200,1,4,1,5,1,FALSE
meetup-web-platform,0.8.339,0.8.340,203,1,90,0,90,2,FALSE
meetup-web-platform,0.5.201-beta,0.5.202-beta,72,1,5,4,9,1,FALSE
meetup-web-platform,0.5.217-beta,0.5.218-beta,87,1,11,11,22,1,FALSE
meetup-web-platform,0.10.461-beta,0.10.462,312,1,4,1,5,1,FALSE
meetup-web-platform,0.10.426,0.10.427-beta,283,1,20,13,33,4,FALSE
meetup-web-platform,0.10.374-beta,0.10.375-beta,236,1,89,5,94,2,FALSE
meetup-web-platform,0.10.411-beta,0.10.412-beta,269,2,129,112,241,7,FALSE
meetup-web-platform,0.11.527-beta,0.11.528,365,1,19,170,189,8,FALSE
meetup-web-platform,0.8.316-beta,0.8.318-beta,182,3,15,8,23,3,FALSE
meetup-web-platform,0.11.565-beta,0.11.566,396,1,4,1,5,1,FALSE
meetup-web-platform,0.5.142,0.5.148,40,9,43,52,95,11,FALSE
meetup-web-platform,0.10.434-beta,0.10.435-beta,289,2,23,11,34,6,FALSE
meetup-web-platform,0.8.313-beta,0.8.315-beta,180,7,199,106,305,18,FALSE
meetup-web-platform,0.10.487-beta,0.10.489-beta,330,2,28,26,54,2,FALSE
meetup-web-platform,0.10.397,0.10.398-beta,256,1,4,1,5,1,FALSE
meetup-web-platform,0.10.396,0.10.397,255,2,4,4,8,4,FALSE
meetup-web-platform,0.3.64,0.3.73,17,7,80,35,115,11,FALSE
meetup-web-platform,0.5.253-beta,0.5.254-beta,119,1,2,2,4,2,FALSE
meetup-web-platform,0.10.409-beta,0.10.410,267,1,5,9,14,1,FALSE
meetup-web-platform,0.11.551-beta,0.11.552-beta,385,2,39,20,59,3,FALSE
meetup-web-platform,0.3.62,0.3.64,16,1,14,9,23,1,FALSE
meetup-web-platform,0.10.474-beta,0.10.475-beta,319,1,28,1,29,2,FALSE
meetup-web-platform,0.10.387-beta,0.10.388-beta,249,1,4,1,5,1,FALSE
meetup-web-platform,0.5.150,0.5.151,42,1,4,1,5,1,FALSE
meetup-web-platform,0.5.151,0.5.153,43,3,93,71,164,8,FALSE
meetup-web-platform,0.5.153,0.5.157,44,4,21,23,44,4,FALSE
meetup-web-platform,0.10.462,0.10.463-beta,313,1,6,3,9,1,FALSE
meetup-web-platform,0.5.159,0.5.160,47,1,20,0,20,1,FALSE
meetup-web-platform,0.11.451-beta,0.11.452-beta,362,1,8,6,14,3,FALSE
meetup-web-platform,0.11.567-beta,0.11.569-beta,398,6,343,84,427,12,FALSE
meetup-web-platform,0.9.364-beta,0.9.365-beta,226,2,241,128,369,11,FALSE
meetup-web-platform,0.8.286-beta,0.8.295-beta,173,7,818,870,1688,41,FALSE
meetup-web-platform,0.10.525,0.10.526,360,1,4,1,5,1,FALSE
meetup-web-platform,0.11.574-beta,0.11.575-beta,404,1,1,1,2,1,FALSE
meetup-web-platform,0.10.482-beta,0.10.483-beta,326,1,14,15,29,1,FALSE
meetup-web-platform,0.7.305-beta,0.7.306-beta,169,1,4,1,5,1,FALSE
meetup-web-platform,0.10.420-beta,0.10.421,278,1,7,3,10,1,FALSE
meetup-web-platform,0.11.562-beta,0.11.563,393,1,10,10,20,1,FALSE
meetup-web-platform,0.6.276,0.6.277,147,1,210,129,339,9,FALSE
meetup-web-platform,0.6.277,0.6.278-beta,148,2,150,52,202,4,FALSE
meetup-web-platform,0.11.571-beta,0.11.572-beta,401,1,1,1,2,1,FALSE
meetup-web-platform,0.5.220-beta,0.5.221-beta,90,1,4,2,6,1,FALSE
meetup-web-platform,0.6.270,0.6.271-beta,141,2,603,221,824,23,FALSE
meetup-web-platform,0.10.410,0.10.411-beta,268,1,115,57,172,5,FALSE
meetup-web-platform,0.10.415,0.10.416-beta,273,1,55,0,55,2,FALSE
meetup-web-platform,0.10.392-beta,0.10.395-beta,253,6,89,22,111,7,FALSE
meetup-web-platform,0.10.388-beta,0.10.389,250,1,167,22,189,1,FALSE
meetup-web-platform,0.10.515-beta,0.10.516,352,1,72,23,95,2,FALSE
meetup-web-platform,0.11.560,0.11.561-beta,391,1,1,1,2,1,FALSE
meetup-web-platform,0.11.563,0.11.564,394,1,2,3,5,2,FALSE
meetup-web-platform,0.11.564,0.11.565-beta,395,4,83,18,101,7,FALSE
meetup-web-platform,0.11.566,0.11.567-beta,397,1,1,24,25,1,FALSE
meetup-web-platform,0.11.599-beta,0.11.600-beta,426,1,4,1,5,1,FALSE
meetup-web-platform,0.10.508-beta,0.10.509-beta,345,1,4,1,5,1,FALSE
meetup-web-platform,0.5.209-beta,0.5.210-beta,80,1,2,2,4,2,FALSE
meetup-web-platform,0.11.539-beta,0.11.540,373,1,18,1,19,2,FALSE
meetup-web-platform,0.5.206-beta,0.5.207-beta,77,1,4,1,5,1,FALSE
meetup-web-platform,0.10.507-beta,0.10.508-beta,344,2,22,43,65,4,FALSE
meetup-web-platform,0.10.520-beta,0.10.521,356,1,107,23,130,11,FALSE
meetup-web-platform,0.8.324-beta,0.8.325,189,1,108,0,108,2,FALSE
meetup-web-platform,0.10.448-beta,0.10.449-beta,303,1,20,21,41,2,FALSE
meetup-web-platform,0.9.346-beta,0.9.347,210,1,35,57,92,6,FALSE
meetup-web-platform,0.11.573-beta,0.11.574-beta,403,1,1,1,2,1,FALSE
meetup-web-platform,0.7.299-beta,0.7.300-beta,163,1,7,5,12,1,FALSE
meetup-web-platform,0.2.13,0.2.20,2,5,17,23,40,6,FALSE
meetup-web-platform,0.5.212-beta,0.5.213-beta,83,1,5,4,9,1,FALSE
meetup-web-platform,0.5.208-beta,0.5.209-beta,79,1,73,44,117,5,FALSE
meetup-web-platform,0.10.509-beta,0.10.510-beta,346,1,11,55,66,4,FALSE
meetup-web-platform,0.10.496-beta,0.10.497-beta,338,2,34,15,49,4,FALSE
meetup-web-platform,0.8.329-beta,0.8.330-beta,194,1,4,1,5,1,FALSE
meetup-web-platform,0.10.459-beta,0.10.460-beta,310,1,4,0,4,1,FALSE
meetup-web-platform,0.5.221-beta,0.5.222-beta,91,1,13,16,29,1,FALSE
meetup-web-platform,0.8.334-beta,0.8.335,199,2,173,131,304,4,FALSE
meetup-web-platform,0.10.442-beta,0.10.443-beta,297,1,54,70,124,1,FALSE
meetup-web-platform,0.8.331-beta,0.8.332-beta,196,3,269,504,773,27,FALSE
meetup-web-platform,0.10.493-beta,0.10.494,335,2,290,24,314,9,FALSE
meetup-web-platform,0.10.489-beta,0.10.490-beta,331,1,21,21,42,2,FALSE
meetup-web-platform,0.4.133,0.4.134,36,2,9,6,15,2,FALSE
meetup-web-platform,0.10.445-beta,0.10.446-beta,300,1,22,10,32,2,FALSE
meetup-web-platform,0.4.135,0.5.139,38,9,181,13,194,108,FALSE
meetup-web-platform,0.8.337-beta,0.8.339,202,2,57,73,130,13,FALSE
meetup-web-platform,0.11.592-beta,0.11.594-beta,421,5,1166,568,1734,61,FALSE
meetup-web-platform,0.6.273-beta,0.6.274-beta,144,1,4,1,5,1,FALSE
meetup-web-platform,0.7.281-beta,0.7.283-beta,157,2,10,8,18,2,FALSE
meetup-web-platform,0.10.481-beta,0.10.482-beta,325,2,29,28,57,3,FALSE
meetup-web-platform,0.11.586-beta,0.11.587,415,1,1,1,2,1,FALSE
meetup-web-platform,0.5.241-beta,0.5.242-beta,109,1,11,0,11,1,FALSE
meetup-web-platform,0.10.401-beta,0.10.402-beta,259,1,4,1,5,1,FALSE
meetup-web-platform,0.5.190-beta,0.5.191-beta,63,1,4,1,5,1,FALSE
meetup-web-platform,0.8.327-beta,0.8.328,192,1,42,304,346,14,FALSE
meetup-web-platform,0.6.169-beta,0.6.170-beta,128,1,4,1,5,1,FALSE
meetup-web-platform,0.10.380-beta,0.10.381,242,1,1,0,1,1,FALSE
meetup-web-platform,0.9.359-beta,0.9.360-beta,221,1,4,1,5,1,FALSE
meetup-web-platform,0.11.537-beta,0.11.538-beta,371,1,3,3,6,1,FALSE
meetup-web-platform,0.8.320-beta,0.8.321,185,5,116,91,207,18,FALSE
meetup-web-platform,0.3.94,0.3.98,24,10,479,360,839,24,FALSE
meetup-web-platform,0.10.404-beta,0.10.405,262,2,96,48,144,3,FALSE
meetup-web-platform,0.3.98,0.3.102,25,5,70,74,144,25,FALSE
meetup-web-platform,0.2.12,0.2.13,1,1,4,1,5,1,FALSE
meetup-web-platform,0.5.238,0.5.239-beta,107,1,4,1,5,1,FALSE
meetup-web-platform,0.11.612-beta,0.11.613-beta,439,2,24,5,29,2,FALSE
meetup-web-platform,0.6.278-beta,0.6.282-beta,149,6,79,31,110,14,FALSE
meetup-web-platform,0.10.457,0.10.459-beta,309,2,7,14,21,3,FALSE
meetup-web-platform,0.10.453,0.10.455-beta,306,2,23,30,53,2,FALSE
meetup-web-platform,0.10.386-beta,0.10.387-beta,248,1,5,5,10,1,FALSE
meetup-web-platform,0.10.475-beta,0.10.476-beta,320,1,2,2,4,1,FALSE
meetup-web-platform,0.6.168-beta,0.6.169-beta,127,1,4,1,5,1,FALSE
meetup-web-platform,0.5.196-beta,0.5.197-beta,69,1,24,17,41,3,FALSE
meetup-web-platform,0.11.528,0.11.529-beta,366,2,172,40,212,7,FALSE
meetup-web-platform,0.10.470-beta,0.10.472-beta,317,2,7,4,11,4,FALSE
meetup-web-platform,0.3.87,0.3.94,23,9,539,518,1057,37,FALSE
meetup-web-platform,0.10.390-beta,0.10.392-beta,252,2,71,23,94,3,FALSE
meetup-web-platform,0.8.344-beta,0.8.345-beta,208,2,72,49,121,3,FALSE
meetup-web-platform,0.10.357-beta,0.10.371,233,12,1091,400,1491,52,FALSE
meetup-web-platform,0.5.224-beta,0.5.225-beta,94,1,4,3,7,1,FALSE
meetup-web-platform,0.10.512-beta,0.10.513-beta,349,1,4,1,5,1,FALSE
meetup-web-platform,0.5.223,0.5.224-beta,93,1,34,0,34,1,FALSE
meetup-web-platform,0.6.165-beta,0.6.167-beta,125,1,4,1,5,1,FALSE
meetup-web-platform,0.5.185-beta,0.5.186,58,1,25,23,48,2,FALSE
meetup-web-platform,0.8.328,0.8.329-beta,193,3,319,618,937,33,FALSE
meetup-web-platform,0.8.325,0.8.326-beta,190,1,108,0,108,2,FALSE
meetup-web-platform,0.8.322,0.8.323,187,1,4,1,5,1,FALSE
meetup-web-platform,0.8.323,0.8.324-beta,188,1,4,1,5,1,FALSE
meetup-web-platform,0.8.321,0.8.322,186,4,365,162,527,36,FALSE
meetup-web-platform,0.5.193-beta,0.5.194-beta,66,1,4,1,5,1,FALSE
meetup-web-platform,0.11.555,0.11.556,388,1,37,7,44,4,FALSE
meetup-web-platform,0.11.556,0.11.558-beta,389,2,42,9,51,2,FALSE
meetup-web-platform,0.11.452-beta,0.11.458-beta,363,8,199,46,245,10,FALSE
meetup-web-platform,0.5.182-beta,0.5.183-beta,55,1,4,1,5,1,FALSE
meetup-web-platform,0.10.416-beta,0.10.417-beta,274,2,5,4,9,2,FALSE
meetup-web-platform,0.5.187-beta,0.5.188-beta,60,3,19,19,38,3,FALSE
meetup-web-platform,0.10.513-beta,0.10.514,350,1,584,223,807,13,FALSE
meetup-web-platform,0.5.230-beta,0.5.231-beta,99,1,4,1,5,1,FALSE
meetup-web-platform,0.6.291-beta,0.6.292-beta,154,1,4,1,5,1,FALSE
meetup-web-platform,0.7.302-beta,0.7.303-beta,166,1,31,19,50,2,FALSE
meetup-web-platform,0.5.181-beta,0.5.182-beta,54,1,4,1,5,1,FALSE
meetup-web-platform,0.2.21,0.2.31,4,13,120,76,196,17,TRUE
meetup-web-platform,0.7.306-beta,0.7.307-beta,170,1,2,2,4,1,FALSE
meetup-web-platform,0.5.235-beta,0.5.236,104,1,32,0,32,1,FALSE
meetup-web-platform,0.10.377-beta,0.10.378,239,2,1003,740,1743,6,FALSE
meetup-web-platform,0.10.436,0.10.437-beta,291,1,4,1,5,1,FALSE
meetup-web-platform,0.6.167-beta,0.6.168-beta,126,1,4,1,5,1,FALSE
meetup-web-platform,0.3.58,0.3.60,14,1,2,2,4,1,FALSE
meetup-web-platform,0.3.54,0.3.55,12,1,4,1,5,1,FALSE
meetup-web-platform,0.3.55,0.3.58,13,1,4,4,8,1,FALSE
meetup-web-platform,0.6.275-beta,0.6.276,146,1,149,41,190,3,FALSE
meetup-web-platform,0.10.523-beta,0.10.525,359,4,31,191,222,11,FALSE
meetup-web-platform,0.11.595-beta,0.11.596-beta,423,1,27,31,58,5,FALSE
meetup-web-platform,0.10.398-beta,0.10.400-beta,257,2,178,126,304,7,FALSE
meetup-web-platform,0.10.412-beta,0.10.413-beta,270,1,4,1,5,1,FALSE
meetup-web-platform,0.8.296-beta,0.8.309,175,16,653,237,890,44,FALSE
meetup-web-platform,0.10.438-beta,0.10.439,293,1,12,1,13,2,FALSE
meetup-web-platform,0.6.171-beta,0.6.172-beta,130,1,4,1,5,1,FALSE
meetup-web-platform,0.5.160,0.5.175,48,1,10,1,11,1,FALSE
meetup-web-platform,0.5.186,0.5.187-beta,59,1,4,1,5,1,FALSE
meetup-web-platform,0.5.239-beta,0.5.241-beta,108,2,330,17,347,8,FALSE
meetup-web-platform,0.5.189,0.5.190-beta,62,1,4,1,5,1,FALSE
meetup-web-platform,0.11.596-beta,0.11.597-beta,424,1,9,2,11,2,FALSE
meetup-web-platform,0.3.103,0.3.105,27,3,397,287,684,17,FALSE
meetup-web-platform,0.3.102,0.3.103,26,1,2,3,5,3,FALSE
meetup-web-platform,0.3.105,0.3.110,28,4,73,66,139,4,FALSE
meetup-web-platform,0.10.403,0.10.404-beta,261,1,28,28,56,1,FALSE
meetup-web-platform,0.10.418-beta,0.10.419-beta,276,2,8,4,12,2,FALSE
meetup-web-platform,0.10.407,0.10.408,265,1,4,4,8,1,FALSE
meetup-web-platform,0.10.406,0.10.407,264,1,5,1,6,1,FALSE
meetup-web-platform,0.10.405,0.10.406,263,1,4,1,5,1,FALSE
meetup-web-platform,0.8.343-beta,0.8.344-beta,207,2,148,128,276,5,FALSE
meetup-web-platform,0.10.408,0.10.409-beta,266,1,4,1,5,1,FALSE
meetup-web-platform,0.10.478-beta,0.10.480-beta,323,3,184,90,274,5,FALSE
meetup-web-platform,0.11.529-beta,0.11.530-beta,367,1,2,2,4,1,FALSE
meetup-web-platform,0.11.570-beta,0.11.571-beta,400,1,18,4,22,2,FALSE
meetup-web-platform,0.5.203-beta,0.5.204-beta,74,2,26,14,40,2,FALSE
meetup-web-platform,0.11.552-beta,0.11.554-beta,386,2,38,8,46,5,FALSE
meetup-web-platform,0.11.547-beta,0.11.548-beta,381,1,7,1,8,2,FALSE
meetup-web-platform,0.6.173-beta,0.6.257-beta,132,82,3116,1116,4232,188,FALSE
meetup-web-platform,0.10.463-beta,0.10.464,314,1,6,3,9,1,FALSE
meetup-web-platform,0.10.476-beta,0.10.477-beta,321,2,77,3,80,4,FALSE
meetup-web-platform,0.10.383-beta,0.10.384-beta,245,1,4,1,5,1,FALSE
meetup-web-platform,0.5.251-beta,0.5.252-beta,117,3,57,65,122,13,FALSE
meetup-web-platform,0.11.579-beta,0.11.580-beta,409,1,1,1,2,1,FALSE
meetup-web-platform,0.8.345-beta,0.9.346-beta,209,1,16,3,19,2,FALSE
meetup-web-platform,0.5.210-beta,0.5.211-beta,81,1,1,1,2,1,FALSE
meetup-web-platform,0.10.431-beta,0.10.433-beta,287,2,7,8,15,3,FALSE
meetup-web-platform,0.11.611-beta,0.11.612-beta,438,1,9,16,25,3,FALSE
meetup-web-platform,0.8.336-beta,0.8.337-beta,201,2,52,30,82,5,FALSE
meetup-web-platform,0.11.587,0.11.588-beta,416,1,256,64,320,15,FALSE
meetup-web-platform,0.11.585,0.11.586-beta,414,1,1,1,2,1,FALSE
meetup-web-platform,0.11.584,0.11.585,413,1,4,1,5,1,FALSE
meetup-web-platform,0.11.583,0.11.584,412,2,2,2,4,2,FALSE
meetup-web-platform,0.11.581,0.11.583,411,1,4,1,5,1,FALSE
meetup-web-platform,0.11.589,0.11.590-beta,418,1,4,1,5,1,FALSE
meetup-web-platform,0.4.129,0.4.133,35,2,4,0,4,2,FALSE
meetup-web-platform,0.10.447-beta,0.10.448-beta,302,1,8,5,13,1,FALSE
meetup-web-platform,0.5.228-beta,0.5.230-beta,98,3,4,4,8,4,FALSE
meetup-web-platform,0.4.125,0.4.126,32,1,4,1,5,1,FALSE
meetup-web-platform,0.4.126,0.4.127,33,1,25,7,32,2,FALSE
meetup-web-platform,0.4.127,0.4.129,34,2,91,73,164,3,FALSE
meetup-web-platform,0.8.315-beta,0.8.316-beta,181,1,6,6,12,1,FALSE
meetup-web-platform,0.5.204-beta,0.5.205-beta,75,1,4,1,5,1,FALSE
meetup-web-platform,0.7.301-beta,0.7.302-beta,165,1,23,3,26,2,FALSE
meetup-web-platform,0.8.312-beta,0.8.313-beta,179,1,4,1,5,1,FALSE
meetup-web-platform,0.5.250-beta,0.5.251-beta,116,5,659,178,837,29,FALSE
meetup-web-platform,0.10.402-beta,0.10.403,260,1,20,3,23,3,FALSE
meetup-web-platform,0.5.233-beta,0.5.234-beta,102,1,2,1,3,1,FALSE
meetup-web-platform,0.10.510-beta,0.10.511-beta,347,1,7,7,14,2,FALSE
meetup-web-platform,0.7.307-beta,0.7.308,171,1,178,82,260,5,FALSE
meetup-web-platform,0.11.458-beta,0.11.527-beta,364,79,3547,1353,4900,208,FALSE
meetup-web-platform,0.9.347,0.9.348,211,1,72,49,121,3,FALSE
meetup-web-platform,0.8.311-beta,0.8.312-beta,178,4,266,103,369,20,FALSE
meetup-web-platform,0.6.271-beta,0.6.272-beta,142,1,61,261,322,12,FALSE
meetup-web-platform,0.9.348,0.9.349-beta,212,2,214,212,426,18,FALSE
meetup-web-platform,0.6.259-beta,0.6.260-beta,135,7,146,119,265,15,FALSE
meetup-web-platform,0.5.218-beta,0.5.219-beta,88,1,2,2,4,1,FALSE
meetup-web-platform,0.10.375-beta,0.10.376-beta,237,1,67,0,67,1,FALSE
meetup-web-platform,0.5.227-beta,0.5.228-beta,97,1,7,3,10,1,FALSE
meetup-web-platform,0.5.194-beta,0.5.195-beta,67,2,29,0,29,2,FALSE
meetup-web-platform,0.10.519-beta,0.10.520-beta,355,1,4,1,5,1,FALSE
meetup-web-platform,0.10.480-beta,0.10.481-beta,324,1,34,5,39,1,FALSE
meetup-web-platform,0.9.367-beta,0.9.368,229,2,85,28,113,5,FALSE
meetup-web-platform,0.5.139,0.5.142,39,1,2,0,2,1,FALSE
meetup-web-platform,0.11.603-beta,0.11.604,430,1,1,1,2,1,FALSE
meetup-web-platform,0.9.360-beta,0.9.361,222,2,70,19,89,6,FALSE
meetup-web-platform,0.11.542-beta,0.11.543-beta,376,1,13,13,26,7,FALSE
meetup-web-platform,0.5.244-beta,0.5.246-beta,112,3,167,128,295,6,FALSE
meetup-web-platform,0.11.590-beta,0.11.591-beta,419,1,3,3,6,1,FALSE
meetup-web-platform,0.6.260-beta,0.6.261-beta,136,1,4,1,5,1,FALSE
meetup-web-platform,0.10.443-beta,0.10.444-beta,298,1,14,6,20,2,FALSE
meetup-web-platform,0.10.456-beta,0.10.457,308,1,70,0,70,2,FALSE
meetup-web-platform,0.10.384-beta,0.10.385-beta,246,1,4,1,5,1,FALSE
meetup-web-platform,0.5.243-beta,0.5.244-beta,111,1,8,9,17,2,FALSE
meetup-web-platform,0.5.195-beta,0.5.196-beta,68,1,23,23,46,2,FALSE
meetup-web-platform,0.5.255,0.5.256-beta,121,1,4,1,5,1,FALSE
meetup-web-platform,0.10.486-beta,0.10.487-beta,329,1,13,1,14,2,FALSE
meetup-web-platform,0.5.262-beta,0.5.263,123,6,90,103,193,11,FALSE
meetup-web-platform,0.6.265-beta,0.6.267,138,4,187,238,425,22,FALSE
meetup-web-platform,0.10.472-beta,0.10.474-beta,318,2,71,63,134,7,FALSE
meetup-web-platform,0.10.435-beta,0.10.436,290,1,166,3,169,6,FALSE
meetup-web-platform,0.5.180-beta,0.5.181-beta,53,1,4,1,5,1,FALSE
meetup-web-platform,0.11.546,0.11.547-beta,380,1,63,26,89,2,FALSE
meetup-web-platform,0.10.460-beta,0.10.461-beta,311,2,6,4,10,2,FALSE
meetup-web-platform,0.6.282-beta,0.6.287-beta,150,6,819,870,1689,41,FALSE
meetup-web-platform,0.6.272-beta,0.6.273-beta,143,4,52,16,68,7,FALSE
meetup-web-platform,0.2.34,0.2.36,7,3,7,13,20,3,FALSE
meetup-web-platform,0.2.37,0.3.46,9,5,728,910,1638,27,FALSE
meetup-web-platform,0.2.31,0.2.32,5,1,3,0,3,1,FALSE
meetup-web-platform,0.2.32,0.2.34,6,4,12,18,30,4,FALSE
meetup-web-platform,0.10.483-beta,0.10.484-beta,327,1,41,31,72,1,FALSE
meetup-web-platform,0.8.295-beta,0.8.296-beta,174,1,9,0,9,1,FALSE
meetup-web-platform,0.10.441-beta,0.10.442-beta,296,1,132,11,143,2,FALSE
meetup-web-platform,0.10.400-beta,0.10.401-beta,258,1,31,29,60,3,FALSE
meetup-web-platform,0.10.492-beta,0.10.493-beta,334,1,13,4,17,2,FALSE
meetup-web-platform,0.5.252-beta,0.5.253-beta,118,1,4,1,5,1,FALSE
meetup-web-platform,0.11.558-beta,0.11.560,390,2,79,13,92,5,FALSE
meetup-web-platform,0.10.497-beta,0.10.498,339,1,335,86,421,15,FALSE
meetup-web-platform,0.10.455-beta,0.10.456-beta,307,2,5,5,10,2,FALSE
meetup-web-platform,0.6.287-beta,0.6.288,151,2,5,2,7,2,FALSE
meetup-web-platform,0.5.216-beta,0.5.217-beta,86,1,4,4,8,1,FALSE
meetup-web-platform,0.5.207-beta,0.5.208-beta,78,1,1,1,2,1,FALSE
meetup-web-platform,0.11.578,0.11.579-beta,408,1,1,1,2,1,FALSE
meetup-web-platform,0.9.350-beta,0.9.351,214,1,3,3,6,2,FALSE
meetup-web-platform,0.11.545-beta,0.11.546,379,1,1,1,2,1,FALSE
meetup-web-platform,0.11.541-beta,0.11.542-beta,375,1,79,20,99,5,FALSE
meetup-web-platform,0.10.491-beta,0.10.492-beta,333,1,4,1,5,1,FALSE
meetup-web-platform,0.11.572-beta,0.11.573-beta,402,1,4,1,5,1,FALSE
meetup-web-platform,0.10.444-beta,0.10.445-beta,299,2,510,169,679,19,FALSE
meetup-web-platform,0.6.288,0.6.290,152,1,1,1,2,1,FALSE
meetup-web-platform,0.11.615-beta,0.11.616,442,1,13,11,24,1,FALSE
meetup-web-platform,0.5.213-beta,0.5.215-beta,84,4,93,81,174,13,FALSE
meetup-web-platform,0.11.531-beta,0.11.535-beta,369,8,187,89,276,17,FALSE
meetup-web-platform,0.11.604,0.11.605-beta,431,1,1,1,2,1,FALSE
meetup-web-platform,0.5.178,0.5.180-beta,52,2,25,23,48,2,FALSE
meetup-web-platform,0.11.607,0.11.608-beta,434,1,4,1,5,1,FALSE
meetup-web-platform,0.11.601,0.11.602,428,1,1,1,2,1,FALSE
meetup-web-platform,0.11.602,0.11.603-beta,429,1,4,1,5,1,FALSE
meetup-web-platform,0.11.544-beta,0.11.545-beta,378,1,1,1,2,1,FALSE
meetup-web-platform,0.11.609,0.11.610,436,1,1,1,2,1,FALSE
meetup-web-platform,0.5.175,0.5.176-beta,49,1,4,1,5,1,FALSE
meetup-web-platform,0.9.358-beta,0.9.359-beta,220,1,4,1,5,1,FALSE
meetup-web-platform,0.8.332-beta,0.8.333,197,2,62,15,77,7,FALSE
meetup-web-platform,0.6.170-beta,0.6.171-beta,129,1,4,1,5,1,FALSE
meetup-web-platform,0.3.112,0.4.118,30,7,186,143,329,18,FALSE
meetup-web-platform,0.3.110,0.3.112,29,3,47,32,79,4,FALSE
meetup-web-platform,0.9.365-beta,0.9.366-beta,227,1,4,1,5,1,FALSE
meetup-web-platform,0.3.60,0.3.62,15,1,10,10,20,1,FALSE
meetup-web-platform,0.6.268-beta,0.6.270,140,2,26,1,27,3,FALSE
meetup-web-platform,0.9.355-beta,0.9.356,218,1,106,3,109,2,FALSE
meetup-web-platform,0.11.606-beta,0.11.607,433,1,2,1,3,1,FALSE
meetup-web-platform,0.5.177-beta,0.5.178,51,1,18,8,26,1,FALSE
meetup-web-platform,0.7.304-beta,0.7.305-beta,168,3,144,17,161,8,FALSE
meetup-web-platform,0.5.256-beta,0.5.262-beta,122,13,705,283,988,38,FALSE
meetup-web-platform,0.7.284-beta,0.7.294,159,8,949,1267,2216,59,FALSE
meetup-web-platform,0.10.518-beta,0.10.519-beta,354,2,2,2,4,2,FALSE
meetup-web-platform,0.11.549-beta,0.11.550-beta,383,1,5,3,8,2,FALSE
meetup-web-platform,0.3.47,0.3.54,11,4,541,605,1146,22,FALSE
meetup-web-platform,0.3.46,0.3.47,10,1,4,1,5,1,FALSE
meetup-web-platform,0.11.540,0.11.541-beta,374,1,63,13,76,6,FALSE
meetup-web-platform,0.7.303-beta,0.7.304-beta,167,1,1,0,1,1,FALSE
meetup-web-platform,0.5.176-beta,0.5.177-beta,50,1,4,1,5,1,FALSE
meetup-web-platform,0.10.439,0.10.440-beta,294,1,25,14,39,4,FALSE
meetup-web-platform,0.11.594-beta,0.11.595-beta,422,1,4,1,5,1,FALSE
meetup-web-platform,0.5.231-beta,0.5.232-beta,100,2,10,2,12,3,FALSE
meetup-web-platform,0.10.376-beta,0.10.377-beta,238,1,4,1,5,1,FALSE
meetup-web-platform,0.11.600-beta,0.11.601,427,1,1,1,2,1,FALSE
meetup-web-platform,0.5.198-beta,0.5.201-beta,71,3,42,27,69,7,FALSE
meetup-web-platform,0.5.188-beta,0.5.189,61,1,13,13,26,1,FALSE
meetup-web-platform,0.10.437-beta,0.10.438-beta,292,1,10,6,16,2,FALSE
meetup-web-platform,0.7.294,0.7.297-beta,160,4,46,4,50,5,FALSE
meetup-web-platform,0.8.330-beta,0.8.331-beta,195,2,29,7,36,3,FALSE
meetup-web-platform,0.10.506,0.10.507-beta,343,1,4,1,5,1,FALSE
meetup-web-platform,0.10.385-beta,0.10.386-beta,247,2,56,35,91,2,FALSE
meetup-web-platform,0.10.464,0.10.466-beta,315,2,8,5,13,3,FALSE
meetup-web-platform,0.10.395-beta,0.10.396,254,1,4,1,5,1,FALSE
meetup-web-platform,0.8.309,0.8.310-beta,176,10,662,266,928,60,FALSE
meetup-web-platform,0.10.449-beta,0.10.450-beta,304,1,10,12,22,2,FALSE
meetup-web-platform,0.10.433-beta,0.10.434-beta,288,1,2,5,7,1,FALSE
meetup-web-platform,0.5.157,0.5.158-beta,45,1,1,1,2,1,FALSE
meetup-web-platform,0.4.118,0.4.125,31,7,332,68,400,28,FALSE
meetup-web-platform,0.11.575-beta,0.11.576,405,3,3,3,6,3,FALSE
meetup-web-platform,0.11.550-beta,0.11.551-beta,384,1,4,1,5,1,FALSE
meetup-web-platform,0.5.197-beta,0.5.198-beta,70,1,2,0,2,1,FALSE
meetup-web-platform,2.0.915-beta,2.0.920-beta,655,5,127,117,244,15,FALSE
meetup-web-platform,3.2.1378-beta,3.2.1379-beta,926,1,4,7,11,1,FALSE
meetup-web-platform,0.11.663,0.11.664-beta,475,2,30,7,37,7,FALSE
meetup-web-platform,0.11.677-beta,0.11.678,487,1,1,0,1,1,FALSE
meetup-web-platform,1.0.779,1.0.780-beta,556,1,13,30,43,3,FALSE
meetup-web-platform,2.0.962-beta,2.0.963,692,1,14,1,15,3,FALSE
meetup-web-platform,1.0.773,1.0.774-beta,551,1,50,98,148,2,FALSE
meetup-web-platform,2.4.1232-beta,2.4.1233-beta,819,1,8,4,12,1,FALSE
meetup-web-platform,2.0.947-beta,2.0.948,677,2,10,6,16,2,FALSE
meetup-web-platform,0.11.637-beta,0.11.638-beta,460,2,4126,4,4130,3,FALSE
meetup-web-platform,2.0.1017-beta,2.0.1022,707,3,17,13,30,14,FALSE
meetup-web-platform,1.0.862-beta,1.0.867-beta,590,2,242,277,519,4,FALSE
meetup-web-platform,1.0.818-beta,1.0.819-beta,575,1,26,9,35,1,FALSE
meetup-web-platform,2.0.1076-beta,2.0.1080-beta,719,1,4,1,5,1,FALSE
meetup-web-platform,2.4.1315-beta,2.4.1316-beta,861,1,3,1,4,1,FALSE
meetup-web-platform,0.11.681-beta,0.11.682,491,1,5,11,16,2,FALSE
meetup-web-platform,1.0.884-beta,1.0.885,600,1,4,4,8,2,FALSE
meetup-web-platform,2.0.952,2.0.953-beta,682,1,4,1,5,1,FALSE
meetup-web-platform,1.0.868-beta,1.0.869,592,2,352,410,762,6,FALSE
meetup-web-platform,0.11.630-beta,0.11.631-beta,453,3,56,12,68,6,FALSE
meetup-web-platform,0.11.613-beta,0.11.614-beta,440,1,4,1,5,1,FALSE
meetup-web-platform,1.0.869,1.0.870-beta,593,1,4,1,5,1,FALSE
meetup-web-platform,2.0.1032-beta,2.0.1034-beta,712,1,4,1,5,1,FALSE
meetup-web-platform,2.1.1146-beta,2.1.1147,742,1,11,4,15,4,FALSE
meetup-web-platform,2.4.1298-beta,2.4.1299,854,1,307,11,318,2,FALSE
meetup-web-platform,0.11.658,0.11.660,472,1,64,49,113,3,FALSE
meetup-web-platform,2.0.857-beta,2.0.858-beta,630,1,4,1,5,1,FALSE
meetup-web-platform,0.11.655,0.11.657-beta,470,3,64,49,113,4,FALSE
meetup-web-platform,3.1.1334-beta,3.1.1335-beta,892,1,4,1,5,1,FALSE
meetup-web-platform,2.2.1190-beta,2.2.1192-beta,783,1,4,1,5,1,FALSE
meetup-web-platform,2.2.1149-beta,2.2.1153-beta,763,5,132,103,235,12,FALSE
meetup-web-platform,2.4.1233-beta,2.4.1234,820,1,128,18,146,9,FALSE
meetup-web-platform,3.2.1358-beta,3.2.1359-beta,912,1,8,9,17,2,FALSE
meetup-web-platform,2.2.1211-beta,2.2.1212-beta,803,1,32,24,56,5,FALSE
meetup-web-platform,2.0.968-beta,2.0.969-beta,698,1,25,0,25,1,FALSE
meetup-web-platform,2.5.1264-beta,2.5.1265-beta,869,1,3,1,4,1,FALSE
meetup-web-platform,1.0.893-beta,1.0.895,604,3,96,35,131,9,FALSE
meetup-web-platform,2.5.1314-beta,2.5.1317-beta,879,3,74,303,377,9,FALSE
meetup-web-platform,1.0.852-beta,1.0.853,585,1,5,5,10,2,FALSE
meetup-web-platform,0.11.622-beta,0.11.623-beta,449,3,129,32,161,7,FALSE
meetup-web-platform,2.0.1083-beta,2.0.1102-beta,721,11,320,210,530,28,FALSE
meetup-web-platform,1.0.777,1.0.778,554,2,26,77,103,5,FALSE
meetup-web-platform,1.0.787-beta,1.0.788,560,1,1,1,2,1,FALSE
meetup-web-platform,2.2.1228-beta,2.2.1229,815,1,57,3,60,5,FALSE
meetup-web-platform,2.4.1245-beta,2.4.1249-beta,826,4,119,91,210,7,FALSE
meetup-web-platform,2.4.1254-beta,2.4.1255-beta,832,2,57,10,67,4,FALSE
meetup-web-platform,2.4.1294-beta,2.4.1296,851,3,2308,2227,4535,125,FALSE
meetup-web-platform,1.0.812-beta,1.0.813-beta,572,1,4,1,5,1,FALSE
meetup-web-platform,2.2.1096-beta,2.2.1099-beta,751,2,43,43,86,8,FALSE
meetup-web-platform,2.2.1229,2.4.1230-beta,816,1,46,16,62,5,FALSE
meetup-web-platform,2.0.817-beta,2.0.831-beta,626,6,499,323,822,15,FALSE
meetup-web-platform,3.2.1380-beta,3.2.1381-beta,928,1,3,3,6,2,FALSE
meetup-web-platform,2.4.1293,2.4.1294-beta,850,2,1243,1102,2345,75,FALSE
meetup-web-platform,1.0.731-beta,1.0.732-beta,525,1,27,2,29,1,FALSE
meetup-web-platform,2.2.1159,2.2.1160-beta,767,2,135,154,289,12,FALSE
meetup-web-platform,2.0.925-beta,2.0.927-beta,659,2,111,61,172,5,FALSE
meetup-web-platform,2.0.898-beta,2.0.899-beta,644,6,3112,2280,5392,103,FALSE
meetup-web-platform,1.0.854,1.0.856-beta,587,2,152,56,208,10,FALSE
meetup-web-platform,2.4.1243-beta,2.4.1244-beta,824,1,4,1,5,1,FALSE
meetup-web-platform,0.11.664-beta,0.11.665,476,1,25,2,27,4,FALSE
meetup-web-platform,1.0.853,1.0.854,586,1,1,1,2,1,FALSE
meetup-web-platform,1.0.746-beta,1.0.747,531,1,2,2,4,1,FALSE
meetup-web-platform,2.4.1300,2.4.1308,856,11,853,510,1363,37,FALSE
meetup-web-platform,0.11.684,0.11.690-beta,494,7,98,79,177,27,FALSE
meetup-web-platform,0.11.680,0.11.681-beta,490,1,5,11,16,2,FALSE
meetup-web-platform,2.0.808-beta,2.0.809-beta,621,1,1,1,2,1,FALSE
meetup-web-platform,0.11.682,0.11.683-beta,492,1,9,1,10,1,FALSE
meetup-web-platform,2.1.1150-beta,2.1.1151-beta,744,1,3,0,3,1,FALSE
meetup-web-platform,3.2.1359-beta,3.2.1360,913,1,141,111,252,6,FALSE
meetup-web-platform,2.0.1102-beta,2.0.1104,722,1,8,2,10,1,FALSE
meetup-web-platform,2.4.1262-beta,2.4.1263-beta,839,1,68,27,95,4,FALSE
meetup-web-platform,1.0.840-beta,1.0.846-beta,582,3,6,4,10,4,FALSE
meetup-web-platform,2.2.1200-beta,2.2.1201-beta,792,1,167,105,272,23,FALSE
meetup-web-platform,2.2.1193-beta,2.2.1194,785,1,83,45,128,15,FALSE
meetup-web-platform,2.0.923-beta,2.0.924-beta,657,1,4,1,5,1,FALSE
meetup-web-platform,2.0.735-beta,2.0.736-beta,608,1,6,4,10,4,FALSE
meetup-web-platform,1.0.726-beta,1.0.727,521,1,17,1,18,2,FALSE
meetup-web-platform,2.0.1107-beta,2.0.1109,724,1,6,2,8,1,FALSE
meetup-web-platform,2.0.967-beta,2.0.968-beta,697,3,503,113,616,23,FALSE
meetup-web-platform,1.0.701,1.0.702-beta,505,1,79,58,137,19,FALSE
meetup-web-platform,1.0.708,1.0.711-beta,510,3,29,8,37,3,FALSE
meetup-web-platform,0.11.670-beta,0.11.671-beta,480,2,30,17,47,5,FALSE
meetup-web-platform,0.11.619,0.11.620-beta,446,1,4,1,5,1,FALSE
meetup-web-platform,3.2.1387-beta,3.2.1388-beta,935,2,3,4,7,3,FALSE
meetup-web-platform,2.6.1330-beta,3.0.1331-beta,886,1,4,1,5,1,FALSE
meetup-web-platform,1.0.728-beta,1.0.729,523,1,9,5,14,2,FALSE
meetup-web-platform,1.0.897,1.0.1368,606,424,82290,23166,105456,2223,FALSE
meetup-web-platform,2.0.908,2.0.909-beta,649,1,0,80,80,2,FALSE
meetup-web-platform,1.0.803-beta,1.0.804,570,1,65,19,84,6,FALSE
meetup-web-platform,2.4.1285-beta,2.4.1288-beta,845,2,10,14,24,3,FALSE
meetup-web-platform,2.2.1207-beta,2.2.1208-beta,799,3,104,9,113,6,FALSE
meetup-web-platform,2.4.1277,2.4.1279,842,3,1105,1199,2304,39,FALSE
meetup-web-platform,2.2.1192-beta,2.2.1193-beta,784,1,4,1,5,1,FALSE
meetup-web-platform,2.4.1279,2.4.1284-beta,843,4,64,46,110,5,FALSE
meetup-web-platform,2.5.1304-beta,2.5.1305-beta,875,1,23,13,36,3,FALSE
meetup-web-platform,2.0.1034-beta,2.0.1046-beta,713,3,25,10,35,5,FALSE
meetup-web-platform,2.0.1104,2.0.1107-beta,723,1,6,2,8,1,FALSE
meetup-web-platform,2.0.999,2.0.1006-beta,702,5,952,1100,2052,36,FALSE
meetup-web-platform,2.0.1109,2.0.1111,725,1,1,11,12,1,FALSE
meetup-web-platform,2.2.1144-beta,2.2.1145-beta,760,1,7,4,11,4,FALSE
meetup-web-platform,2.0.1071-beta,2.0.1074-beta,717,3,257,392,649,15,FALSE
meetup-web-platform,1.0.766-beta,1.0.768-beta,547,2,168,115,283,23,FALSE
meetup-web-platform,2.4.1251-beta,2.4.1252,829,2,2,2,4,2,FALSE
meetup-web-platform,2.2.1157-beta,2.2.1158,765,1,4,1,5,1,FALSE
meetup-web-platform,2.0.936-beta,2.0.937-beta,667,1,6,2,8,2,FALSE
meetup-web-platform,2.1.1147,2.1.1150-beta,743,4,68,20,88,11,FALSE
meetup-web-platform,2.1.1140,2.1.1141-beta,740,1,4,1,5,1,FALSE
meetup-web-platform,2.0.860-beta,2.0.876-beta,632,15,1639,1400,3039,63,FALSE
meetup-web-platform,1.0.794-beta,1.0.795,565,1,106,75,181,12,FALSE
meetup-web-platform,1.0.689-beta,1.0.701,504,12,188,179,367,55,FALSE
meetup-web-platform,2.0.910-beta,2.0.911-beta,651,4,295,166,461,16,FALSE
meetup-web-platform,1.0.813-beta,1.0.815-beta,573,1,9,5,14,2,FALSE
meetup-web-platform,2.0.959-beta,2.0.960,689,3,21,5,26,5,FALSE
meetup-web-platform,2.5.1321-beta,2.5.1322-beta,881,1,6,0,6,2,FALSE
meetup-web-platform,2.2.1194,2.2.1195-beta,786,1,193,138,331,28,FALSE
meetup-web-platform,0.11.623-beta,0.11.624,450,1,10,2,12,2,FALSE
meetup-web-platform,2.2.1196,2.2.1197,788,3,51,10,61,9,FALSE
meetup-web-platform,1.0.774-beta,1.0.775-beta,552,1,37,39,76,2,FALSE
meetup-web-platform,3.2.1376-beta,3.2.1377-beta,924,6,504,339,843,22,FALSE
meetup-web-platform,3.2.1402-beta,3.2.1403,949,1,108,114,222,4,FALSE
meetup-web-platform,2.1.1043-beta,2.1.1051-beta,731,3,70,69,139,8,FALSE
meetup-web-platform,1.0.740-beta,1.0.741,529,1,14,14,28,2,FALSE
meetup-web-platform,0.11.690-beta,0.11.691-beta,495,1,16,9,25,5,FALSE
meetup-web-platform,3.2.1357-beta,3.2.1358-beta,911,1,0,1,1,1,FALSE
meetup-web-platform,3.1.1337-beta,3.1.1338-beta,895,1,5,20,25,1,FALSE
meetup-web-platform,2.0.879-beta,2.0.880-beta,635,1,21,1,22,3,FALSE
meetup-web-platform,1.0.804,1.0.812-beta,571,9,248,145,393,25,FALSE
meetup-web-platform,2.4.1255-beta,2.4.1256-beta,833,1,4,1,5,1,FALSE
meetup-web-platform,2.1.1139-beta,2.1.1140,739,3,60,97,157,9,FALSE
meetup-web-platform,0.11.614-beta,0.11.615-beta,441,1,13,11,24,1,FALSE
meetup-web-platform,2.2.1198-beta,2.2.1199-beta,790,1,4,1,5,1,FALSE
meetup-web-platform,1.0.747,1.0.748-beta,532,1,4,1,5,1,FALSE
meetup-web-platform,1.0.867-beta,1.0.868-beta,591,1,9,3,12,2,FALSE
meetup-web-platform,1.0.741,1.0.746-beta,530,3,14,14,28,5,FALSE
meetup-web-platform,1.0.761-beta,1.0.764-beta,544,3,283,250,533,24,FALSE
meetup-web-platform,0.11.638-beta,0.11.639,461,1,4126,4,4130,3,FALSE
meetup-web-platform,2.1.1060-beta,2.1.1065-beta,735,1,2,1,3,2,FALSE
meetup-web-platform,2.0.801-beta,2.0.805-beta,617,6,187,55,242,20,FALSE
meetup-web-platform,0.11.696,0.11.697-beta,498,6,73,90,163,23,FALSE
meetup-web-platform,2.4.1316-beta,2.4.1318-beta,862,1,0,17,17,2,FALSE
meetup-web-platform,2.1.1141-beta,2.1.1146-beta,741,4,25,21,46,11,FALSE
meetup-web-platform,3.1.1339-beta,3.1.1340-beta,897,1,1,2,3,2,FALSE
meetup-web-platform,2.0.806-beta,2.0.807-beta,619,2,6,3,9,3,FALSE
meetup-web-platform,0.11.653,0.11.654-beta,468,1,16,15,31,2,FALSE
meetup-web-platform,0.11.691-beta,0.11.695-beta,496,2,2,2,4,2,FALSE
meetup-web-platform,2.1.1134-beta,2.1.1139-beta,738,4,172,276,448,9,FALSE
meetup-web-platform,0.11.651,0.11.653,467,1,5,2,7,2,FALSE
meetup-web-platform,2.0.1046-beta,2.0.1053,714,4,75,74,149,11,FALSE
meetup-web-platform,2.0.948,2.0.949-beta,678,1,4,1,5,1,FALSE
meetup-web-platform,2.5.1302-beta,2.5.1303-beta,873,1,10,21,31,1,FALSE
meetup-web-platform,2.4.1234,2.4.1235-beta,821,1,4,1,5,1,FALSE
meetup-web-platform,2.0.941,2.0.942-beta,672,2,8,4,12,2,FALSE
meetup-web-platform,2.0.945,2.0.946,675,3,111,2,113,6,FALSE
meetup-web-platform,1.0.891,1.0.893-beta,603,3,346,332,678,7,FALSE
meetup-web-platform,2.0.1137,2.0.1138,728,1,163,267,430,6,FALSE
meetup-web-platform,3.2.1373-beta,3.2.1374-beta,921,1,5,3,8,1,FALSE
meetup-web-platform,2.2.1142-beta,2.2.1143-beta,758,1,8,9,17,4,FALSE
meetup-web-platform,3.2.1370,3.2.1371,918,3,1043,192,1235,53,FALSE
meetup-web-platform,0.11.665,0.11.668,477,5,10039,447,10486,64,FALSE
meetup-web-platform,1.0.704-beta,1.0.707-beta,508,3,289,289,578,34,FALSE
meetup-web-platform,0.11.660,0.11.662-beta,473,3,499,201,700,14,FALSE
meetup-web-platform,3.1.1345,3.1.1350-beta,901,6,1798,382,2180,53,FALSE
meetup-web-platform,2.0.1022,2.0.1024-beta,708,1,4,1,5,1,FALSE
meetup-web-platform,2.0.1027,2.0.1029,710,1,1,1,2,1,FALSE
meetup-web-platform,2.0.909-beta,2.0.910-beta,650,1,4,1,5,1,FALSE
meetup-web-platform,2.0.1029,2.0.1032-beta,711,2,158,77,235,14,FALSE
meetup-web-platform,0.11.650-beta,0.11.651,466,1,4,1,5,1,FALSE
meetup-web-platform,3.2.1390,3.2.1391,938,1,2,2,4,1,FALSE
meetup-web-platform,3.2.1391,3.2.1392,939,1,26,1,27,2,FALSE
meetup-web-platform,3.2.1392,3.2.1394,940,3,367,372,739,6,FALSE
meetup-web-platform,2.0.899-beta,2.0.905-beta,645,9,547,379,926,44,FALSE
meetup-web-platform,3.2.1394,3.2.1395-beta,941,2,38,60,98,6,FALSE
meetup-web-platform,3.2.1396,3.2.1397,943,1,1,1,2,1,FALSE
meetup-web-platform,3.2.1397,3.2.1398-beta,944,1,108,114,222,4,FALSE
meetup-web-platform,1.0.703-beta,1.0.704-beta,507,1,68,60,128,3,FALSE
meetup-web-platform,2.2.1121-beta,2.2.1126-beta,755,2,39,32,71,4,FALSE
meetup-web-platform,2.2.1185-beta,2.2.1186,779,1,3,14,17,2,FALSE
meetup-web-platform,1.0.757-beta,1.0.758-beta,540,1,9,5,14,2,FALSE
meetup-web-platform,2.4.1308,2.4.1310-beta,857,5,413,77,490,13,FALSE
meetup-web-platform,2.0.892-beta,2.0.894-beta,641,2,279,279,558,5,FALSE
meetup-web-platform,1.0.780-beta,1.0.781,557,1,13,30,43,3,FALSE
meetup-web-platform,0.11.679-beta,0.11.680,489,1,5,5,10,2,FALSE
meetup-web-platform,1.0.723-beta,1.0.725,519,1,4,1,5,1,FALSE
meetup-web-platform,2.0.942-beta,2.0.943-beta,673,1,4,1,5,1,FALSE
meetup-web-platform,2.2.1206-beta,2.2.1207-beta,798,1,4,1,5,1,FALSE
meetup-web-platform,2.0.920-beta,2.0.923-beta,656,4,21,12,33,5,FALSE
meetup-web-platform,3.0.1332,3.0.1343-beta,888,9,796,328,1124,47,FALSE
meetup-web-platform,2.0.958-beta,2.0.959-beta,688,1,11,1,12,1,FALSE
meetup-web-platform,1.0.830,1.0.840-beta,581,5,142,48,190,7,FALSE
meetup-web-platform,2.2.1203-beta,2.2.1204,795,1,15563,19,15582,57,FALSE
meetup-web-platform,1.0.756,1.0.757-beta,539,3,168,110,278,29,FALSE
meetup-web-platform,1.0.829-beta,1.0.830,580,1,6,2,8,2,FALSE
meetup-web-platform,2.0.957-beta,2.0.958-beta,687,3,62,51,113,7,FALSE
meetup-web-platform,3.2.1382-beta,3.2.1383-beta,930,1,6,4,10,2,FALSE
meetup-web-platform,2.0.785-beta,2.0.789-beta,614,8,252,216,468,35,FALSE
meetup-web-platform,2.2.1216,2.2.1218-beta,808,2,11,11,22,3,FALSE
meetup-web-platform,3.2.1379-beta,3.2.1380-beta,927,4,212,174,386,11,FALSE
meetup-web-platform,2.0.858-beta,2.0.860-beta,631,1,5,2,7,1,FALSE
meetup-web-platform,2.2.1213,2.2.1214-beta,805,1,15727,142,15869,74,FALSE
meetup-web-platform,3.1.1342-beta,3.1.1345,900,3,512,58,570,14,FALSE
meetup-web-platform,1.0.847,1.0.852-beta,584,2,48,39,87,7,FALSE
meetup-web-platform,2.0.911-beta,2.0.912-beta,652,3,132,75,207,10,FALSE
meetup-web-platform,1.0.788,1.0.791-beta,561,4,56,47,103,9,FALSE
meetup-web-platform,1.0.781,1.0.782,558,1,1,1,2,1,FALSE
meetup-web-platform,1.0.782,1.0.787-beta,559,10,1279,1180,2459,83,FALSE
meetup-web-platform,1.0.856-beta,1.0.861-beta,588,5,743,464,1207,31,FALSE
meetup-web-platform,0.11.635-beta,0.11.636,458,1,14,14,28,7,FALSE
meetup-web-platform,2.2.1208-beta,2.2.1209-beta,800,1,4,1,5,1,FALSE
meetup-web-platform,2.2.1219,2.2.1220-beta,810,2,65,19,84,4,FALSE
meetup-web-platform,3.2.1356-beta,3.2.1357-beta,910,2,21,31,52,4,FALSE
meetup-web-platform,3.1.1333-beta,3.1.1334-beta,891,1,4,1,5,1,FALSE
meetup-web-platform,1.0.775-beta,1.0.777,553,2,23,75,98,3,FALSE
meetup-web-platform,1.0.796-beta,1.0.798,567,2,89,68,157,4,FALSE
meetup-web-platform,1.0.718,1.0.719,516,1,4,1,5,1,FALSE
meetup-web-platform,1.0.719,1.0.722-beta,517,3,52,3,55,4,FALSE
meetup-web-platform,1.0.716,1.0.718,515,1,4,1,5,1,FALSE
meetup-web-platform,1.0.714,1.0.716,514,1,4,1,5,1,FALSE
meetup-web-platform,0.11.621,0.11.622-beta,448,1,9,2,11,1,FALSE
meetup-web-platform,1.0.712,1.0.713-beta,512,2,234,221,455,33,FALSE
meetup-web-platform,0.11.624,0.11.626-beta,451,1,33,23,56,2,FALSE
meetup-web-platform,2.0.931-beta,2.0.932,664,3,1481,697,2178,55,FALSE
meetup-web-platform,2.0.1068-beta,2.0.1071-beta,716,1,4,1,5,1,FALSE
meetup-web-platform,1.0.748-beta,1.0.751-beta,533,1,151,23,174,9,FALSE
meetup-web-platform,2.0.932,2.0.935-beta,665,4,85,2,87,6,FALSE
meetup-web-platform,2.4.1261,2.4.1262-beta,838,3,181,114,295,6,FALSE
meetup-web-platform,2.4.1325-beta,2.4.1326,867,1,2,1,3,1,FALSE
meetup-web-platform,2.0.877-beta,2.0.879-beta,634,2,194,223,417,10,FALSE
meetup-web-platform,2.0.894-beta,2.0.896-beta,642,2,76,24,100,6,FALSE
meetup-web-platform,2.4.1320-beta,2.4.1324-beta,865,3,221,32,253,6,FALSE
meetup-web-platform,0.11.662-beta,0.11.663,474,1,152,18,170,3,FALSE
meetup-web-platform,3.2.1355-beta,3.2.1356-beta,909,1,4,1,5,1,FALSE
meetup-web-platform,1.0.819-beta,1.0.821,576,1,83,30,113,7,FALSE
meetup-web-platform,2.0.955-beta,2.0.956-beta,685,1,27,19,46,1,FALSE
meetup-web-platform,1.0.872-beta,1.0.873-beta,596,1,3,2,5,1,FALSE
meetup-web-platform,2.2.1182-beta,2.2.1184-beta,777,1,4,1,5,1,FALSE
meetup-web-platform,2.0.1111,2.0.1136-beta,726,13,199,162,361,28,FALSE
meetup-web-platform,2.0.956-beta,2.0.957-beta,686,1,18,2,20,3,FALSE
meetup-web-platform,2.0.930-beta,2.0.931-beta,663,1,4,1,5,1,FALSE
meetup-web-platform,3.2.1375,3.2.1376-beta,923,1,46,16,62,1,FALSE
meetup-web-platform,1.0.772-beta,1.0.773,550,1,220,132,352,14,FALSE
meetup-web-platform,0.11.671-beta,0.11.672-beta,481,1,4,1,5,1,FALSE
meetup-web-platform,0.11.631-beta,0.11.632-beta,454,1,4,1,5,1,FALSE
meetup-web-platform,1.0.768-beta,1.0.770,548,3,484,609,1093,45,FALSE
meetup-web-platform,2.0.940-beta,2.0.941,671,1,88,2,90,4,FALSE
meetup-web-platform,2.2.1129-beta,2.2.1142-beta,757,11,257,398,655,25,FALSE
meetup-web-platform,2.4.1296,2.4.1297-beta,852,2,32,23,55,10,FALSE
meetup-web-platform,2.4.1290,2.4.1292,848,2,2,3,5,2,FALSE
meetup-web-platform,2.2.1189-beta,2.2.1190-beta,782,1,8,8,16,4,FALSE
meetup-web-platform,2.2.1158,2.2.1159,766,1,6,6,12,1,FALSE
meetup-web-platform,2.0.929,2.0.930-beta,662,1,4,1,5,1,FALSE
meetup-web-platform,2.4.1299,2.4.1300,855,1,9,2,11,3,FALSE
meetup-web-platform,2.4.1230-beta,2.4.1231-beta,817,1,24,0,24,2,FALSE
meetup-web-platform,2.2.1162-beta,2.2.1163,769,1,32,48,80,3,FALSE
meetup-web-platform,2.2.1220-beta,2.2.1221-beta,811,1,43,37,80,3,FALSE
meetup-web-platform,0.11.633-beta,0.11.634-beta,456,1,1,1,2,1,FALSE
meetup-web-platform,3.2.1372-beta,3.2.1373-beta,920,1,4,1,5,1,FALSE
meetup-web-platform,2.0.1024-beta,2.0.1027,709,1,3,3,6,2,FALSE
meetup-web-platform,3.2.1385-beta,3.2.1386,933,1,3,3,6,2,FALSE
meetup-web-platform,3.2.1381-beta,3.2.1382-beta,929,2,304,188,492,4,FALSE
meetup-web-platform,2.1.1086-beta,2.1.1134-beta,737,25,515,382,897,55,FALSE
meetup-web-platform,3.2.1384-beta,3.2.1385-beta,932,1,3,3,6,2,FALSE
meetup-web-platform,2.0.938-beta,2.0.939-beta,669,1,4,1,5,1,FALSE
meetup-web-platform,2.2.1160-beta,2.2.1162-beta,768,1,1,7,8,1,FALSE
meetup-web-platform,0.11.632-beta,0.11.633-beta,455,1,17,3,20,3,FALSE
meetup-web-platform,1.0.874,1.0.878-beta,598,5,510,463,973,20,FALSE
meetup-web-platform,1.0.764-beta,1.0.765,545,2,148,88,236,20,FALSE
meetup-web-platform,1.0.752,1.0.753,535,2,569,560,1129,19,FALSE
meetup-web-platform,1.0.753,1.0.754-beta,536,2,12,9,21,3,FALSE
meetup-web-platform,2.0.1006-beta,2.0.1008,703,1,1,1,2,1,FALSE
meetup-web-platform,2.4.1310-beta,2.4.1311-beta,858,1,4,1,5,1,FALSE
meetup-web-platform,3.1.1341-beta,3.1.1342-beta,899,1,8,13,21,2,FALSE
meetup-web-platform,1.0.759,1.0.760-beta,542,3,13,14,27,7,FALSE
meetup-web-platform,2.1.1065-beta,2.1.1086-beta,736,5,279,396,675,19,FALSE
meetup-web-platform,2.0.1016-beta,2.0.1017-beta,706,1,4,1,5,1,FALSE
meetup-web-platform,2.2.1184-beta,2.2.1185-beta,778,1,4,1,5,1,FALSE
meetup-web-platform,0.11.683-beta,0.11.684,493,1,1,1,2,1,FALSE
meetup-web-platform,2.0.881-beta,2.0.882-beta,637,1,4,1,5,1,FALSE
meetup-web-platform,2.0.995-beta,2.0.999,701,2,26,103,129,6,FALSE
meetup-web-platform,2.4.1249-beta,2.4.1250-beta,827,1,4,1,5,1,FALSE
meetup-web-platform,2.0.736-beta,2.0.739-beta,609,5,43,34,77,11,FALSE
meetup-web-platform,0.11.657-beta,0.11.658,471,1,1,1,2,1,FALSE
meetup-web-platform,2.5.1329,2.6.1330-beta,885,1,4,1,5,1,FALSE
meetup-web-platform,0.11.672-beta,0.11.673,482,1,27,14,41,4,FALSE
meetup-web-platform,2.2.1186,2.2.1188,780,1,22,1,23,2,FALSE
meetup-web-platform,0.11.649,0.11.650-beta,465,1,72,41,113,3,FALSE
meetup-web-platform,2.2.1188,2.2.1189-beta,781,4,47,45,92,11,FALSE
meetup-web-platform,1.0.793-beta,1.0.794-beta,564,1,2,1,3,1,FALSE
meetup-web-platform,1.0.727,1.0.728-beta,522,1,9,5,14,2,FALSE
meetup-web-platform,1.0.725,1.0.726-beta,520,1,17,1,18,2,FALSE
meetup-web-platform,2.5.1328-beta,2.5.1329,884,1,683,213,896,26,FALSE
meetup-web-platform,2.4.1238-beta,2.4.1243-beta,823,4,239,88,327,26,FALSE
meetup-web-platform,1.0.729,1.0.731-beta,524,2,38,5,43,3,FALSE
meetup-web-platform,0.11.673,0.11.674-beta,483,1,272,14,286,8,FALSE
meetup-web-platform,3.2.1361,3.2.1362,915,1,24,3,27,5,FALSE
meetup-web-platform,3.2.1360,3.2.1361,914,1,6,4,10,1,FALSE
meetup-web-platform,0.11.676,0.11.677-beta,486,1,1,0,1,1,FALSE
meetup-web-platform,3.1.1335-beta,3.1.1336-beta,893,1,694,230,924,28,FALSE
meetup-web-platform,3.1.1351,3.1.1352,903,1,4,1,5,1,FALSE
meetup-web-platform,3.2.1354,3.2.1355-beta,908,4,200,158,358,9,FALSE
meetup-web-platform,2.1.1056-beta,2.1.1058-beta,733,1,4,1,5,1,FALSE
meetup-web-platform,2.0.1012,2.0.1016-beta,705,2,7,5,12,6,FALSE
meetup-web-platform,1.0.707-beta,1.0.708,509,1,7,38,45,6,FALSE
meetup-web-platform,3.2.1389,3.2.1390,937,1,46,3,49,2,FALSE
meetup-web-platform,2.5.1295-beta,2.5.1301-beta,871,10,1057,433,1490,40,FALSE
meetup-web-platform,3.0.1343-beta,3.0.1344,889,1,1,1,2,1,FALSE
meetup-web-platform,3.2.1386,3.2.1387-beta,934,2,1233,328,1561,57,FALSE
meetup-web-platform,2.0.816-beta,2.0.817-beta,625,2,16,6,22,2,FALSE
meetup-web-platform,2.4.1252,2.4.1253,830,1,4,1,5,1,FALSE
meetup-web-platform,1.0.755-beta,1.0.756,538,1,11,2,13,2,FALSE
meetup-web-platform,2.0.966-beta,2.0.967-beta,696,2,169,37,206,16,FALSE
meetup-web-platform,2.0.961-beta,2.0.962-beta,691,3,607,325,932,27,FALSE
meetup-web-platform,0.11.695-beta,0.11.696,497,1,4,4,8,2,FALSE
meetup-web-platform,3.2.1404-beta,3.2.1405,951,1,1,1,2,1,FALSE
meetup-web-platform,2.2.1115-beta,2.2.1118-beta,753,1,4,1,5,1,FALSE
meetup-web-platform,2.0.811-beta,2.0.814-beta,623,3,172,118,290,13,FALSE
meetup-web-platform,1.0.722-beta,1.0.723-beta,518,2,51,2,53,4,FALSE
meetup-web-platform,3.2.1395-beta,3.2.1396,942,2,6,22,28,4,FALSE
meetup-web-platform,2.0.739-beta,2.0.743-beta,610,8,40,41,81,11,FALSE
meetup-web-platform,2.4.1250-beta,2.4.1251-beta,828,1,4,1,5,1,FALSE
meetup-web-platform,2.0.1080-beta,2.0.1083-beta,720,1,4,1,5,1,FALSE
meetup-web-platform,3.2.1362,3.2.1369-beta,916,1,18,2,20,1,FALSE
meetup-web-platform,0.11.654-beta,0.11.655,469,1,16,15,31,2,FALSE
meetup-web-platform,1.0.827,1.0.829-beta,579,1,4,1,5,1,FALSE
meetup-web-platform,1.0.821,1.0.826-beta,577,1,5,5,10,1,FALSE
meetup-web-platform,2.0.882-beta,2.0.883-beta,638,1,1,1,2,1,FALSE
meetup-web-platform,0.11.675,0.11.676,485,1,71,11,82,4,FALSE
meetup-web-platform,2.0.953-beta,2.0.954-beta,683,1,3,2,5,2,FALSE
meetup-web-platform,2.0.743-beta,2.0.783-beta,611,44,4234,4030,8264,300,FALSE
meetup-web-platform,2.2.1212-beta,2.2.1213,804,1,127,108,235,7,FALSE
meetup-web-platform,2.2.1202,2.2.1203-beta,794,1,4,4,8,1,FALSE
meetup-web-platform,2.2.1205,2.2.1206-beta,797,5,123,80,203,10,FALSE
meetup-web-platform,2.2.1204,2.2.1205,796,1,1,0,1,1,FALSE
meetup-web-platform,0.11.642-beta,0.11.649,464,10,5270,359,5629,42,FALSE
meetup-web-platform,2.2.1163,2.2.1170,770,2,92,69,161,7,FALSE
meetup-web-platform,1.0.815-beta,1.0.818-beta,574,3,22,9,31,4,FALSE
meetup-web-platform,0.11.678,0.11.679-beta,488,1,5,5,10,2,FALSE
meetup-web-platform,2.0.924-beta,2.0.925-beta,658,1,160,0,160,1,FALSE
meetup-web-platform,3.2.1400,3.2.1401,947,2,423,223,646,17,FALSE
meetup-web-platform,2.2.1201-beta,2.2.1202,793,1,36,15,51,13,FALSE
meetup-web-platform,1.0.895,1.0.897,605,2,209,246,455,2,FALSE
meetup-web-platform,2.5.1309-beta,2.5.1313-beta,877,5,528,70,598,12,FALSE
meetup-web-platform,2.1.1151-beta,2.1.1152,745,1,79,92,171,5,FALSE
meetup-web-platform,3.2.1403,3.2.1404-beta,950,1,4,1,5,1,FALSE
meetup-web-platform,2.5.1317-beta,2.5.1321-beta,880,1,6,6,12,2,FALSE
meetup-web-platform,1.0.878-beta,1.0.884-beta,599,5,39,13,52,9,FALSE
meetup-web-platform,2.0.807-beta,2.0.808-beta,620,1,4,1,5,1,FALSE
meetup-web-platform,2.2.1195-beta,2.2.1196,787,1,61,47,108,8,FALSE
meetup-web-platform,2.0.855-beta,2.0.857-beta,629,3,111,45,156,5,FALSE
meetup-web-platform,3.2.1369-beta,3.2.1370,917,5,1775,926,2701,64,FALSE
meetup-web-platform,2.0.949-beta,2.0.950,679,2,30,18,48,2,FALSE
meetup-web-platform,2.0.907-beta,2.0.908,648,2,1133,529,1662,35,FALSE
meetup-web-platform,1.0.861-beta,1.0.862-beta,589,1,31,18,49,4,FALSE
meetup-web-platform,2.0.937-beta,2.0.938-beta,668,2,36,15,51,3,FALSE
meetup-web-platform,1.0.871,1.0.872-beta,595,1,38,12,50,3,FALSE
meetup-web-platform,3.1.1350-beta,3.1.1351,902,2,113,284,397,8,FALSE
meetup-web-platform,1.0.846-beta,1.0.847,583,1,6,3,9,2,FALSE
meetup-web-platform,1.0.758-beta,1.0.759,541,2,478,421,899,22,FALSE
meetup-web-platform,0.11.639,0.11.640,462,1,9,2,11,1,FALSE
meetup-web-platform,0.11.626-beta,0.11.630-beta,452,4,45,17,62,4,FALSE
meetup-web-platform,2.2.1210-beta,2.2.1211-beta,802,1,2,34,36,2,FALSE
meetup-web-platform,0.11.636,0.11.637-beta,459,4,119,28,147,8,FALSE
meetup-web-platform,1.0.765,1.0.766-beta,546,1,4,1,5,1,FALSE
meetup-web-platform,3.2.1388-beta,3.2.1389,936,1,27,17,44,1,FALSE
meetup-web-platform,2.0.1053,2.0.1068-beta,715,4,29,58,87,6,FALSE
meetup-web-platform,2.0.913-beta,2.0.915-beta,654,4,49,20,69,6,FALSE
meetup-web-platform,2.0.831-beta,2.0.834-beta,627,3,43,2,45,3,FALSE
meetup-web-platform,3.2.1398-beta,3.2.1399-beta,945,2,2,1,3,2,FALSE
meetup-web-platform,1.0.795,1.0.796-beta,566,1,65,64,129,2,FALSE
meetup-web-platform,1.0.792,1.0.793-beta,563,2,10,11,21,5,FALSE
meetup-web-platform,3.2.1405,3.2.1408-beta,952,7,285,97,382,17,FALSE
meetup-web-platform,2.0.880-beta,2.0.881-beta,636,2,10,8,18,2,FALSE
meetup-web-platform,2.2.1171,2.2.1172,772,4,153,106,259,14,FALSE
meetup-web-platform,1.0.798,1.0.802-beta,568,7,872,734,1606,40,FALSE
meetup-web-platform,2.4.1256-beta,2.4.1257-beta,834,1,4,1,5,1,FALSE
meetup-web-platform,2.2.1170,2.2.1171,771,1,17,17,34,2,FALSE
meetup-web-platform,1.0.713-beta,1.0.714,513,9,380,452,832,48,FALSE
meetup-web-platform,2.2.1215-beta,2.2.1216,807,1,120,8,128,4,FALSE
meetup-web-platform,2.2.1126-beta,2.2.1129-beta,756,1,2,3,5,2,FALSE
meetup-web-platform,2.0.834-beta,2.0.855-beta,628,11,220,110,330,27,FALSE
meetup-web-platform,2.2.1225-beta,2.2.1228-beta,814,2,46,10,56,7,FALSE
meetup-web-platform,0.11.640,0.11.642-beta,463,3,4161,24,4185,15,FALSE
meetup-web-platform,2.2.1093-beta,2.2.1096-beta,750,2,31,6,37,3,FALSE
meetup-web-platform,2.0.814-beta,2.0.816-beta,624,2,15,8,23,4,FALSE
meetup-web-platform,3.2.1353,3.2.1354,907,1,4,1,5,1,FALSE
meetup-web-platform,2.4.1257-beta,2.4.1258-beta,835,2,29,6,35,3,FALSE
meetup-web-platform,2.0.927-beta,2.0.928-beta,660,1,2,0,2,1,FALSE
meetup-web-platform,1.0.826-beta,1.0.827,578,1,282,233,515,1,FALSE
meetup-web-platform,2.0.905-beta,2.0.906-beta,646,2,24,64,88,3,FALSE
meetup-web-platform,2.2.1199-beta,2.2.1200-beta,791,1,36,15,51,13,FALSE
meetup-web-platform,1.0.760-beta,1.0.761-beta,543,1,6,30,36,5,FALSE
meetup-web-platform,2.0.970,2.0.995-beta,700,23,2892,968,3860,141,FALSE
meetup-web-platform,2.2.1153-beta,2.2.1157-beta,764,5,721,378,1099,32,FALSE
meetup-web-platform,2.5.1265-beta,2.5.1295-beta,870,36,7749,7308,15057,420,FALSE
meetup-web-platform,0.11.674-beta,0.11.675,484,1,8,2,10,2,FALSE
meetup-web-platform,0.11.698-beta,0.11.699-beta,500,1,4,1,5,1,FALSE
meetup-web-platform,2.4.1231-beta,2.4.1232-beta,818,1,6,6,12,1,FALSE
meetup-web-platform,2.5.1323-beta,2.5.1328-beta,883,4,21,10,31,7,FALSE
meetup-web-platform,2.4.1244-beta,2.4.1245-beta,825,1,313,37,350,16,FALSE
meetup-web-platform,0.11.620-beta,0.11.621,447,1,21,18,39,1,FALSE
meetup-web-platform,2.4.1289,2.4.1290,847,1,9,13,22,2,FALSE
meetup-web-platform,3.1.1336-beta,3.1.1337-beta,894,2,84,59,143,10,FALSE
meetup-web-platform,2.4.1253,2.4.1254-beta,831,1,4,1,5,1,FALSE
meetup-web-platform,2.0.876-beta,2.0.877-beta,633,1,4,1,5,1,FALSE
meetup-web-platform,1.0.732-beta,1.0.733,526,1,62,4,66,2,FALSE
meetup-web-platform,2.4.1235-beta,2.4.1238-beta,822,1,78,21,99,8,FALSE
meetup-web-platform,0.11.699-beta,0.11.700-beta,501,1,4,1,5,1,FALSE
meetup-web-platform,2.4.1297-beta,2.4.1298-beta,853,1,15,27,42,1,FALSE
meetup-web-platform,2.0.954-beta,2.0.955-beta,684,1,1,0,1,1,FALSE
meetup-web-platform,2.0.888-beta,2.0.892-beta,640,3,159,114,273,7,FALSE
meetup-web-platform,1.0.702-beta,1.0.703-beta,506,2,108,115,223,26,FALSE
meetup-web-platform,3.2.1383-beta,3.2.1384-beta,931,3,119,94,213,5,FALSE
meetup-web-platform,2.4.1292,2.4.1293,849,1,1972,1744,3716,94,FALSE
meetup-web-platform,2.4.1263-beta,2.4.1276-beta,840,17,485,267,752,42,FALSE
meetup-web-platform,2.2.1143-beta,2.2.1144-beta,759,1,4,2,6,1,FALSE
meetup-web-platform,2.2.1214-beta,2.2.1215-beta,806,2,147,111,258,10,FALSE
meetup-web-platform,2.0.969-beta,2.0.970,699,1,4,1,5,1,FALSE
meetup-web-platform,2.0.912-beta,2.0.913-beta,653,2,2,2,4,2,FALSE
meetup-web-platform,2.5.1305-beta,2.5.1309-beta,876,5,90,59,149,11,FALSE
meetup-web-platform,1.0.711-beta,1.0.712,511,1,27,6,33,1,FALSE
meetup-web-platform,2.2.1221-beta,2.2.1223-beta,812,4,243,191,434,13,FALSE
meetup-web-platform,1.0.751-beta,1.0.752,534,1,321,332,653,2,FALSE
meetup-web-platform,2.5.1322-beta,2.5.1323-beta,882,1,209,26,235,2,FALSE
meetup-web-platform,2.0.789-beta,2.0.799-beta,615,12,805,659,1464,52,FALSE
meetup-web-platform,2.0.943-beta,2.0.945,674,2,10,5,15,2,FALSE
meetup-web-platform,2.4.1258-beta,2.4.1259-beta,836,1,4,3,7,4,FALSE
meetup-web-platform,2.2.1218-beta,2.2.1219,809,1,8,8,16,2,FALSE
meetup-web-platform,2.0.809-beta,2.0.811-beta,622,1,2,2,4,1,FALSE
meetup-web-platform,2.2.1118-beta,2.2.1121-beta,754,2,43,58,101,9,FALSE
meetup-web-platform,2.2.1223-beta,2.2.1225-beta,813,3,64,22,86,13,FALSE
meetup-web-platform,3.1.1338-beta,3.1.1339-beta,896,1,1,0,1,1,FALSE
meetup-web-platform,2.2.1197,2.2.1198-beta,789,4,15517,14,15531,55,FALSE
meetup-web-platform,1.0.791-beta,1.0.792,562,3,97,63,160,8,FALSE
meetup-web-platform,2.0.783-beta,2.0.784-beta,612,2,19,3,22,2,FALSE
meetup-web-platform,1.0.734,1.0.740-beta,528,16,529,320,849,54,FALSE
meetup-web-platform,1.0.873-beta,1.0.874,597,1,3,2,5,1,FALSE
meetup-web-platform,2.4.1259-beta,2.4.1261,837,2,59,31,90,5,FALSE
meetup-web-platform,1.0.733,1.0.734,527,1,4,0,4,1,FALSE
meetup-web-platform,1.0.870-beta,1.0.871,594,1,11,16,27,4,FALSE
meetup-web-platform,2.2.1099-beta,2.2.1115-beta,752,9,122,66,188,12,FALSE
meetup-web-platform,2.0.1008,2.0.1012,704,4,377,343,720,8,FALSE
meetup-web-platform,2.4.1276-beta,2.4.1277,841,2,594,695,1289,35,FALSE
meetup-web-platform,2.0.1136-beta,2.0.1137,727,1,3,3,6,1,FALSE
meetup-web-platform,1.0.890-beta,1.0.891,602,1,72,50,122,2,FALSE
meetup-web-platform,3.2.1399-beta,3.2.1400,946,1,27,49,76,4,FALSE
meetup-web-platform,2.4.1288-beta,2.4.1289,846,1,5,1,6,1,FALSE
meetup-web-platform,2.2.1145-beta,2.2.1148-beta,761,3,30,14,44,10,FALSE
meetup-web-platform,2.1.1051-beta,2.1.1056-beta,732,4,32,62,94,7,FALSE
meetup-web-platform,2.0.951-beta,2.0.952,681,3,19,27,46,5,FALSE
meetup-web-platform,1.0.802-beta,1.0.803-beta,569,1,10,1,11,2,FALSE
meetup-web-platform,2.4.1312-beta,2.4.1315-beta,860,3,82,288,370,9,FALSE
meetup-web-platform,2.5.1301-beta,2.5.1302-beta,872,1,102,89,191,4,FALSE
meetup-web-platform,3.2.1349-beta,3.2.1353,906,5,971,833,1804,47,FALSE
meetup-web-platform,2.0.896-beta,2.0.898-beta,643,2,209,246,455,2,FALSE
meetup-web-platform,2.4.1311-beta,2.4.1312-beta,859,1,175,37,212,3,FALSE
meetup-web-platform,2.0.963,2.0.964-beta,693,2,25,14,39,8,FALSE
meetup-web-platform,2.0.960,2.0.961-beta,690,1,4,1,5,1,FALSE
meetup-web-platform,2.0.964-beta,2.0.965,694,1,25,14,39,8,FALSE
meetup-web-platform,2.0.965,2.0.966-beta,695,1,7,6,13,4,FALSE
meetup-web-platform,2.4.1284-beta,2.4.1285-beta,844,1,6,2,8,2,FALSE
meetup-web-platform,2.1.1038-beta,2.1.1043-beta,730,2,17,9,26,3,FALSE
meetup-web-platform,2.0.928-beta,2.0.929,661,3,763,445,1208,29,FALSE
meetup-web-platform,2.4.1324-beta,2.4.1325-beta,866,1,4,1,5,1,FALSE
meetup-web-platform,2.1.1058-beta,2.1.1060-beta,734,1,4,1,5,1,FALSE
meetup-web-platform,2.0.799-beta,2.0.801-beta,616,4,434,377,811,21,FALSE
meetup-web-platform,3.2.1377-beta,3.2.1378-beta,925,1,4,1,5,1,FALSE
meetup-web-platform,2.0.883-beta,2.0.888-beta,639,5,21,91,112,6,FALSE
meetup-web-platform,2.1.1154,2.1.1155,747,1,0,2,2,1,FALSE
meetup-web-platform,2.1.1155,2.1.1156-beta,748,1,4,1,5,1,FALSE
meetup-web-platform,2.1.1152,2.1.1154,746,3,88,99,187,8,FALSE
meetup-web-platform,2.2.1173,2.2.1174,774,1,21,3,24,2,FALSE
meetup-web-platform,2.2.1172,2.2.1173,773,1,1,1,2,1,FALSE
meetup-web-platform,2.4.1319-beta,2.4.1320-beta,864,1,4,1,5,1,FALSE
meetup-web-platform,2.2.1175,2.2.1182-beta,776,11,233,451,684,43,FALSE
meetup-web-platform,2.2.1174,2.2.1175,775,1,1,1,2,1,FALSE
meetup-web-platform,2.2.1209-beta,2.2.1210-beta,801,1,4,1,5,1,FALSE
meetup-web-platform,1.0.688-beta,1.0.689-beta,503,1,4,0,4,1,FALSE
meetup-web-platform,3.2.1371,3.2.1372-beta,919,3,32,22,54,6,FALSE
meetup-web-platform,3.1.1340-beta,3.1.1341-beta,898,1,2,3,5,2,FALSE
meetup-web-platform,2.5.1303-beta,2.5.1304-beta,874,1,4,6,10,1,FALSE
meetup-web-platform,2.0.939-beta,2.0.940-beta,670,1,55,17,72,4,FALSE
meetup-web-platform,1.0.885,1.0.890-beta,601,4,17,87,104,4,FALSE
meetup-web-platform,2.2.1148-beta,2.2.1149-beta,762,1,4,1,5,1,FALSE
meetup-web-platform,3.2.1374-beta,3.2.1375,922,1,115,71,186,3,FALSE
meetup-web-platform,3.2.1348-beta,3.2.1349-beta,905,2,1270,308,1578,36,FALSE
meetup-web-platform,2.5.1313-beta,2.5.1314-beta,878,1,2,2,4,1,FALSE
meetup-web-platform,1.0.778,1.0.779,555,1,3,1,4,3,FALSE
meetup-web-platform,0.11.634-beta,0.11.635-beta,457,1,13,13,26,6,FALSE
meetup-web-platform,3.0.1331-beta,3.0.1332,887,1,11,18,29,4,FALSE
meetup-web-platform,2.4.1318-beta,2.4.1319-beta,863,1,4,1,5,1,FALSE
meetup-web-platform,0.2.21,0.2.31,4,13,120,76,196,17,FALSE
meetup-web-platform,0.10.371,0.10.373,234,2,11,6,17,3,TRUE
meetup-web-platform,0.10.521,0.10.522-beta,357,2,13,22,35,3,TRUE
meetup-web-platform,0.10.523-beta,0.10.525,359,4,31,191,222,11,TRUE
meetup-web-platform,0.5.234-beta,0.5.235-beta,103,1,4,1,5,1,TRUE
meetup-web-platform,0.5.235-beta,0.5.236,104,1,32,0,32,1,TRUE
meetup-web-platform,0.5.239-beta,0.5.241-beta,108,2,330,17,347,8,TRUE
meetup-web-platform,0.11.585,0.11.586-beta,414,1,1,1,2,1,TRUE
meetup-web-platform,0.11.583,0.11.584,412,2,2,2,4,2,TRUE
meetup-web-platform,0.10.375-beta,0.10.376-beta,237,1,67,0,67,1,TRUE
meetup-web-platform,0.11.578,0.11.579-beta,408,1,1,1,2,1,TRUE
meetup-web-platform,0.10.498,0.10.503-beta,340,7,392,108,500,23,TRUE
meetup-web-platform,0.11.571-beta,0.11.572-beta,401,1,1,1,2,1,TRUE
meetup-web-platform,0.10.508-beta,0.10.509-beta,345,1,4,1,5,1,TRUE
meetup-web-platform,0.10.472-beta,0.10.474-beta,318,2,71,63,134,7,TRUE
meetup-web-platform,0.9.353-beta,0.9.355-beta,217,9,181,58,239,16,TRUE
meetup-web-platform,1.0.867-beta,1.0.868-beta,591,1,9,3,12,2,TRUE
meetup-web-platform,0.11.573-beta,0.11.574-beta,403,1,1,1,2,1,TRUE
meetup-web-platform,0.11.584,0.11.585,413,1,4,1,5,1,TRUE
meetup-web-platform,0.11.579-beta,0.11.580-beta,409,1,1,1,2,1,TRUE
meetup-web-platform,0.3.64,0.3.73,17,7,80,35,115,11,TRUE
meetup-web-platform,0.10.403,0.10.404-beta,261,1,28,28,56,1,TRUE
meetup-web-platform,0.11.607,0.11.608-beta,434,1,4,1,5,1,TRUE
meetup-web-platform,0.11.572-beta,0.11.573-beta,402,1,4,1,5,1,TRUE
meetup-web-platform,0.10.396,0.10.397,255,2,4,4,8,4,TRUE
meetup-web-platform,0.3.98,0.3.102,25,5,70,74,144,25,TRUE
meetup-web-platform,0.6.272-beta,0.6.273-beta,143,4,52,16,68,7,TRUE
meetup-web-platform,0.8.309,0.8.310-beta,176,10,662,266,928,60,TRUE
meetup-web-platform,0.11.577,0.11.578,407,1,4,1,5,1,TRUE
meetup-web-platform,0.11.574-beta,0.11.575-beta,404,1,1,1,2,1,TRUE
meetup-web-platform,2.0.817-beta,2.0.831-beta,626,6,499,323,822,15,TRUE
meetup-web-platform,1.0.827,1.0.829-beta,579,1,4,1,5,1,TRUE
meetup-web-platform,0.11.591-beta,0.11.592-beta,420,1,1,1,2,1,TRUE
meetup-web-platform,0.11.562-beta,0.11.563,393,1,10,10,20,1,TRUE
meetup-web-platform,0.11.560,0.11.561-beta,391,1,1,1,2,1,TRUE
meetup-web-platform,0.11.601,0.11.602,428,1,1,1,2,1,TRUE
meetup-web-platform,1.0.766-beta,1.0.768-beta,547,2,168,115,283,23,TRUE
meetup-web-platform,2.0.970,2.0.995-beta,700,23,2892,968,3860,141,TRUE
meetup-web-platform,1.0.862-beta,1.0.867-beta,590,2,242,277,519,4,TRUE
meetup-web-platform,1.0.748-beta,1.0.751-beta,533,1,151,23,174,9,TRUE
meetup-web-platform,1.0.734,1.0.740-beta,528,16,529,320,849,54,TRUE
meetup-web-platform,0.11.676,0.11.677-beta,486,1,1,0,1,1,TRUE
meetup-web-platform,1.0.821,1.0.826-beta,577,1,5,5,10,1,TRUE
meetup-web-platform,0.11.642-beta,0.11.649,464,10,5270,359,5629,42,TRUE
fs-readfile-promise,0.1.0,1.0.0,2,8,47,25,72,11,FALSE
fs-readfile-promise,1.0.0,1.0.1,3,5,22,17,39,5,FALSE
fs-readfile-promise,0.0.0,0.1.0,1,1,219,0,219,10,FALSE
fs-readfile-promise,1.0.1,1.1.0,4,8,72,51,123,13,FALSE
fs-readfile-promise,1.1.0,2.0.0,5,10,65,94,159,17,FALSE
fs-readfile-promise,2.0.1,3.0.0,7,7,65,72,137,11,FALSE
fs-readfile-promise,2.0.0,2.0.1,6,4,14,29,43,5,FALSE
fs-readfile-promise,1.0.1,1.1.0,4,8,72,51,123,13,TRUE
http-measuring-client,0.3.2,0.3.3,6,4,78,30,108,5,FALSE
http-measuring-client,0.3.3,0.3.4,7,5,14,2,16,5,FALSE
http-measuring-client,0.3.0,0.3.1,4,2,37,7,44,3,FALSE
http-measuring-client,0.3.1,0.3.2,5,2,31,3,34,3,FALSE
http-measuring-client,0.3.6,0.3.7,10,2,2,2,4,2,FALSE
http-measuring-client,0.3.4,0.3.5,8,2,2,2,4,2,FALSE
http-measuring-client,0.3.5,0.3.6,9,2,2,1,3,2,FALSE
http-measuring-client,0.2.0,0.3.0,3,5,119,30,149,7,FALSE
http-measuring-client,0.1.1,0.2.0,2,24,290,54,344,36,FALSE
http-measuring-client,0.3.1,0.3.2,5,2,31,3,34,3,TRUE
http-measuring-client,0.1.0,0.1.1,1,4,12,2,14,4,FALSE
http-measuring-client,0.3.6,0.3.7,10,2,2,2,4,2,TRUE
local-fake,1.0.0,1.0.1,1,3,328,243,571,12,FALSE
local-fake,1.0.1,1.0.2,2,9,174,60,234,26,FALSE
local-fake,1.0.1,1.0.2,2,9,174,60,234,26,TRUE
local-fake,1.0.0,1.0.1,1,3,328,243,571,12,TRUE
observer.js,0.3.2,0.3.3,23,2,507,676,1183,35,FALSE
observer.js,0.3.3,0.3.4,24,1,3,3,6,3,FALSE
observer.js,0.3.0,0.3.1,21,2,3083,2772,5855,23,FALSE
observer.js,0.3.1,0.3.2,22,1,8,4,12,3,FALSE
observer.js,0.3.6,0.4.0,27,2,29,67,96,13,FALSE
observer.js,0.3.4,0.3.5,25,2,250,185,435,15,FALSE
observer.js,0.3.5,0.3.6,26,1,8,4,12,3,FALSE
observer.js,0.2.7,0.3.0,20,10,7157,7892,15049,135,FALSE
observer.js,0.2.6,0.2.7,19,1,17,11,28,7,FALSE
observer.js,0.2.5,0.2.6,18,1,4,1,5,2,FALSE
observer.js,0.2.4,0.2.5,17,2,2136,949,3085,20,FALSE
observer.js,0.2.3,0.2.4,16,3,1781,2441,4222,31,FALSE
observer.js,0.0.10,0.0.11,10,1,75,55,130,9,FALSE
observer.js,0.2.1,0.2.2,14,1,2484,2089,4573,30,FALSE
observer.js,0.2.0,0.2.1,13,3,110,1926,2036,22,FALSE
observer.js,0.0.11,0.0.12,11,1,14,11,25,6,FALSE
observer.js,0.0.9,0.0.10,9,1,7,4,11,4,FALSE
observer.js,0.0.12,0.2.0,12,11,6023,3663,9686,72,FALSE
observer.js,0.2.2,0.2.3,15,2,87,102,189,12,FALSE
observer.js,0.0.5,0.0.6,5,1,1,1,2,1,FALSE
observer.js,0.0.4,0.0.5,4,2,239,238,477,15,FALSE
observer.js,0.0.7,0.0.8,7,1,381,251,632,8,FALSE
observer.js,0.0.6,0.0.7,6,2,47,32,79,10,FALSE
observer.js,0.0.1,0.0.2,1,1,5,6,11,1,FALSE
observer.js,0.0.3,0.0.4,3,3,1483,969,2452,28,FALSE
observer.js,0.0.2,0.0.3,2,5,1367,1643,3010,49,FALSE
observer.js,0.0.8,0.0.9,8,26,667,563,1230,83,FALSE
observer.js,0.0.10,0.0.11,10,1,75,55,130,9,TRUE
observer.js,0.2.7,0.3.0,20,10,7157,7892,15049,135,TRUE
alfrid,0.0.9,0.0.10,9,2,956,181,1137,18,FALSE
alfrid,0.0.8,0.0.9,8,9,375,184,559,74,FALSE
alfrid,0.0.15,0.0.16,15,1,63,36,99,10,FALSE
alfrid,0.0.14,0.0.15,14,4,1795,437,2232,43,FALSE
alfrid,0.0.17,0.0.18,17,1,22,10,32,10,FALSE
alfrid,0.0.16,0.0.17,16,1,137,18,155,11,FALSE
alfrid,0.0.11,0.0.12,11,1,162,37,199,10,FALSE
alfrid,0.0.10,0.0.11,10,1,39,29,68,14,FALSE
alfrid,0.0.13,0.0.14,13,1,95,18,113,13,FALSE
alfrid,0.0.12,0.0.13,12,2,1925,211,2136,30,FALSE
alfrid,0.1.0,0.1.1,19,5,3708,103470,107178,235,FALSE
alfrid,0.1.1,0.1.2,20,1,15,10,25,3,FALSE
alfrid,0.1.2,0.1.3,21,1,162,37,199,10,FALSE
alfrid,0.1.3,0.1.4,22,1,162,37,199,10,FALSE
alfrid,0.1.4,0.1.5,23,1,162,37,199,10,FALSE
alfrid,0.0.18,0.1.0,18,8,21851,10113,31964,255,FALSE
alfrid,0.1.6,0.1.7,25,1,162,37,199,10,FALSE
alfrid,0.1.7,0.1.8,26,3,30,17,47,7,FALSE
alfrid,0.0.5,0.0.6,5,4,934,998,1932,37,FALSE
alfrid,0.0.4,0.0.5,4,1,2,2,4,1,FALSE
alfrid,0.0.7,0.0.8,7,1,2,2,4,1,FALSE
alfrid,0.0.6,0.0.7,6,3,10,3,13,3,FALSE
alfrid,0.1.23,0.1.24,42,1,72,43,115,15,FALSE
alfrid,0.1.22,0.1.23,41,1,162,37,199,10,FALSE
alfrid,0.1.21,0.1.22,40,1,20,17,37,6,FALSE
alfrid,0.1.20,0.1.21,39,1,89,12,101,7,FALSE
alfrid,0.1.27,0.1.28,46,9,4994,160,5154,58,FALSE
alfrid,0.1.26,0.1.27,45,1,162,37,199,10,FALSE
alfrid,0.1.25,0.1.26,44,36,2955,1241,4196,157,FALSE
alfrid,0.1.24,0.1.25,43,12,1101,972,2073,52,FALSE
alfrid,0.1.9,0.1.10,28,5,550,95,645,107,FALSE
alfrid,0.1.12,0.1.13,31,8,1126,139,1265,42,FALSE
alfrid,0.1.13,0.1.14,32,1,162,37,199,10,FALSE
alfrid,0.1.10,0.1.11,29,3,144,33,177,16,FALSE
alfrid,0.1.11,0.1.12,30,2,55524,84,55608,29,FALSE
alfrid,0.1.16,0.1.17,35,1,162,37,199,10,FALSE
alfrid,0.1.17,0.1.18,36,1,7,6,13,2,FALSE
alfrid,0.1.14,0.1.15,33,1,10,10,20,3,FALSE
alfrid,0.1.15,0.1.16,34,5,25584,22131,47715,31,FALSE
alfrid,0.1.18,0.1.19,37,1,162,37,199,10,FALSE
alfrid,0.1.19,0.1.20,38,1,321,21,342,15,FALSE
alfrid,0.1.8,0.1.9,27,2,67,26,93,5,FALSE
alfrid,0.1.5,0.1.6,24,11,11228,36312,47540,180,FALSE
alfrid,0.0.1,0.0.2,1,1,2,1,3,2,FALSE
alfrid,0.0.3,0.0.4,3,1,4,2,6,1,FALSE
alfrid,0.0.2,0.0.3,2,1,16817,3,16820,34,FALSE
alfrid,0.0.11,0.0.12,11,1,162,37,199,10,TRUE
alfrid,0.1.10,0.1.11,29,3,144,33,177,16,TRUE
alfrid,0.0.8,0.0.9,8,9,375,184,559,74,TRUE
alfrid,0.0.14,0.0.15,14,4,1795,437,2232,43,TRUE
alfrid,0.1.15,0.1.16,34,5,25584,22131,47715,31,TRUE
react-native-navigation,1.0.4,1.0.5,26,5,693,193,886,35,FALSE
react-native-navigation,1.0.5,1.0.6,27,4,159,26,185,16,FALSE
react-native-navigation,1.0.6,1.0.7,28,6,166,77,243,23,FALSE
react-native-navigation,1.0.7,1.0.8,29,4,104,56,160,14,FALSE
react-native-navigation,1.0.0,1.0.1,22,2,9,2,11,5,FALSE
react-native-navigation,1.0.1,1.0.2,23,2,8,8,16,3,FALSE
react-native-navigation,1.0.2,1.0.3,24,12,1000,116,1116,36,FALSE
react-native-navigation,1.0.3,1.0.4,25,2,7,1,8,3,FALSE
react-native-navigation,1.0.8,1.0.9,30,2,42,16,58,6,FALSE
react-native-navigation,1.0.9,1.0.10,31,3,6,3,9,3,FALSE
react-native-navigation,2.0.0-experimental.68,2.0.0-experimental.69,203,2,3,1,4,2,FALSE
react-native-navigation,2.0.0-experimental.69,2.0.0-experimental.70,204,3,7215,4575,11790,165,FALSE
react-native-navigation,2.0.0-legacy.20,2.0.0-legacy.21,456,9,164,37,201,21,FALSE
react-native-navigation,2.0.0-experimental.67,2.0.0-experimental.68,202,2,17,9,26,5,FALSE
react-native-navigation,2.0.0-experimental.62,2.0.0-experimental.63,197,2,61,19,80,10,FALSE
react-native-navigation,2.0.0-experimental.83,2.0.0-experimental.84,218,2,5,2,7,2,FALSE
react-native-navigation,2.0.0-experimental.63,2.0.0-experimental.64,198,2,4,10,14,2,FALSE
react-native-navigation,2.0.0-experimental.135,2.0.0-experimental.136,268,2,64,1,65,4,FALSE
react-native-navigation,2.0.0-experimental.137,2.0.0-experimental.138,270,2,9,7,16,4,FALSE
react-native-navigation,2.0.0-experimental.136,2.0.0-experimental.137,269,3,6,6,12,5,FALSE
react-native-navigation,2.0.0-experimental.131,2.0.0-experimental.132,264,4,90,10,100,14,FALSE
react-native-navigation,2.0.0-experimental.60,2.0.0-experimental.61,195,3,145,104,249,5,FALSE
react-native-navigation,2.0.0-experimental.133,2.0.0-experimental.134,266,5,117,75,192,11,FALSE
react-native-navigation,2.0.0-experimental.132,2.0.0-experimental.133,265,2,73,27,100,12,FALSE
react-native-navigation,2.0.0-experimental.61,2.0.0-experimental.62,196,2,13,2,15,2,FALSE
react-native-navigation,2.0.0-experimental.139,2.0.0-experimental.140,272,1,1,1,2,1,FALSE
react-native-navigation,2.0.0-experimental.138,2.0.0-experimental.139,271,13,47,53,100,21,FALSE
react-native-navigation,1.0.16,1.0.17,38,8,516,205,721,32,FALSE
react-native-navigation,1.0.17,1.0.18,39,5,289,20,309,24,FALSE
react-native-navigation,2.0.0-experimental.244,2.0.0-experimental.245,376,1,15,1,16,4,FALSE
react-native-navigation,2.0.0-experimental.243,2.0.0-experimental.244,375,1,40,16,56,8,FALSE
react-native-navigation,1.0.13,1.0.14,35,6,189,10,199,16,FALSE
react-native-navigation,2.0.0-experimental.241,2.0.0-experimental.242,373,1,1,1,2,1,FALSE
react-native-navigation,2.0.0-experimental.240,2.0.0-experimental.241,372,1,0,2,2,1,FALSE
react-native-navigation,2.0.0-experimental.7,2.0.0-experimental.8,144,3,173,69,242,12,FALSE
react-native-navigation,1.0.18,1.0.19,40,3,165,13,178,12,FALSE
react-native-navigation,1.0.19,1.0.20,41,5,54,157,211,9,FALSE
react-native-navigation,2.0.0-legacy.10,2.0.0-legacy.11,446,9,352,45,397,24,FALSE
react-native-navigation,2.0.0-legacy.11,2.0.0-legacy.12,447,2,121,59,180,3,FALSE
react-native-navigation,2.0.0-experimental.51,2.0.0-experimental.52,186,24,1813,524,2337,127,FALSE
react-native-navigation,2.0.0-experimental.50,2.0.0-experimental.51,185,5,39,18,57,10,FALSE
react-native-navigation,2.0.0-legacy.14,2.0.0-legacy.15,450,1,1,1,2,1,FALSE
react-native-navigation,2.0.0-experimental.56,2.0.0-experimental.57,191,2,18,9,27,3,TRUE
react-native-navigation,2.0.0-experimental.55,2.0.0-experimental.56,190,3,6,7,13,3,FALSE
react-native-navigation,2.0.0-experimental.54,2.0.0-experimental.55,189,2,63,6,69,7,FALSE
react-native-navigation,2.0.0-legacy.18,2.0.0-legacy.19,454,1,1,1,2,1,FALSE
react-native-navigation,2.0.0-legacy.19,2.0.0-legacy.20,455,1,1,1,2,1,FALSE
react-native-navigation,2.0.0-experimental.59,2.0.0-experimental.60,194,2,2,1,3,2,FALSE
react-native-navigation,2.0.0-experimental.58,2.0.0-experimental.59,193,2,69,42,111,15,FALSE
react-native-navigation,2.0.0-experimental.65,2.0.0-experimental.66,200,4,42,21,63,5,FALSE
react-native-navigation,2.0.0-experimental.210,2.0.0-experimental.211,342,1,50,1,51,10,FALSE
react-native-navigation,2.0.0-experimental.213,2.0.0-experimental.214,345,1,43,13,56,3,FALSE
react-native-navigation,2.0.0-experimental.100,2.0.0-experimental.101,233,5,36,13,49,5,FALSE
react-native-navigation,2.0.0-experimental.101,2.0.0-experimental.102,234,2,5,2,7,2,FALSE
react-native-navigation,2.0.0-experimental.102,2.0.0-experimental.103,235,3,8,4,12,4,FALSE
react-native-navigation,2.0.0-experimental.103,2.0.0-experimental.104,236,3,68,37,105,3,FALSE
react-native-navigation,2.0.0-experimental.104,2.0.0-experimental.105,237,2,2,2,4,2,FALSE
react-native-navigation,2.0.0-experimental.105,2.0.0-experimental.106,238,7,158,96,254,14,FALSE
react-native-navigation,2.0.0-experimental.106,2.0.0-experimental.107,239,4,92,95,187,19,FALSE
react-native-navigation,2.0.0-experimental.107,2.0.0-experimental.108,240,4,48,108,156,7,FALSE
react-native-navigation,2.0.0-experimental.108,2.0.0-experimental.109,241,2,2,4,6,2,FALSE
react-native-navigation,2.0.0-experimental.109,2.0.0-experimental.110,242,2,8,2,10,3,FALSE
react-native-navigation,2.0.0-experimental.125,2.0.0-experimental.126,258,2,2,3,5,2,FALSE
react-native-navigation,2.0.0-experimental.188,2.0.0-experimental.189,320,1,33,12,45,5,FALSE
react-native-navigation,2.0.0-experimental.189,2.0.0-experimental.190,321,1,39,20,59,7,FALSE
react-native-navigation,2.0.0-experimental.230,2.0.0-experimental.231,362,1,3,3,6,3,FALSE
react-native-navigation,2.0.0-experimental.231,2.0.0-experimental.232,363,1,49,2,51,3,FALSE
react-native-navigation,2.0.0-experimental.236,2.0.0-experimental.237,368,1,39,7,46,5,FALSE
react-native-navigation,2.0.0-experimental.237,2.0.0-experimental.238,369,1,124,3,127,8,FALSE
react-native-navigation,2.0.0-experimental.234,2.0.0-experimental.235,366,1,81,18,99,5,FALSE
react-native-navigation,2.0.0-experimental.235,2.0.0-experimental.236,367,1,44,54,98,5,FALSE
react-native-navigation,2.0.0-experimental.180,2.0.0-experimental.181,312,1,4,1,5,1,FALSE
react-native-navigation,2.0.0-experimental.181,2.0.0-experimental.182,313,1,1,1,2,1,FALSE
react-native-navigation,2.0.0-experimental.182,2.0.0-experimental.183,314,1,139,22,161,12,FALSE
react-native-navigation,2.0.0-experimental.183,2.0.0-experimental.184,315,1,3,1,4,1,FALSE
react-native-navigation,2.0.0-experimental.184,2.0.0-experimental.185,316,1,6,4,10,1,FALSE
react-native-navigation,2.0.0-experimental.185,2.0.0-experimental.186,317,1,10,1,11,1,FALSE
react-native-navigation,2.0.0-experimental.186,2.0.0-experimental.187,318,1,2,2,4,1,FALSE
react-native-navigation,2.0.0-experimental.187,2.0.0-experimental.188,319,1,166,27,193,12,FALSE
react-native-navigation,2.0.0-experimental.197,2.0.0-experimental.198,329,1,2,3,5,1,FALSE
react-native-navigation,2.0.0-experimental.196,2.0.0-experimental.197,328,1,1,1,2,1,FALSE
react-native-navigation,2.0.0-experimental.195,2.0.0-experimental.196,327,1,42,21,63,4,FALSE
react-native-navigation,2.0.0-experimental.194,2.0.0-experimental.195,326,1,1,0,1,1,FALSE
react-native-navigation,2.0.0-experimental.48,2.0.0-experimental.49,183,3,10,4,14,3,FALSE
react-native-navigation,2.0.0-experimental.49,2.0.0-experimental.50,184,2,20,7,27,6,FALSE
react-native-navigation,2.0.0-experimental.191,2.0.0-experimental.192,323,1,5,0,5,1,FALSE
react-native-navigation,2.0.0-experimental.190,2.0.0-experimental.191,322,1,1,0,1,1,FALSE
react-native-navigation,2.0.0-experimental.44,2.0.0-experimental.45,179,6,162,123,285,29,FALSE
react-native-navigation,2.0.0-experimental.45,2.0.0-experimental.46,180,2,67,16,83,3,FALSE
react-native-navigation,2.0.0-experimental.46,2.0.0-experimental.47,181,2,125,6,131,4,FALSE
react-native-navigation,2.0.0-experimental.47,2.0.0-experimental.48,182,3,129,77,206,12,FALSE
react-native-navigation,2.0.0-experimental.40,2.0.0-experimental.41,175,2,61,59,120,5,FALSE
react-native-navigation,2.0.0-experimental.41,2.0.0-experimental.42,176,2,4,3,7,4,FALSE
react-native-navigation,2.0.0-experimental.42,2.0.0-experimental.43,177,2,195,157,352,9,FALSE
react-native-navigation,2.0.0-experimental.43,2.0.0-experimental.44,178,6,36,32,68,9,FALSE
react-native-navigation,2.0.0-experimental.212,2.0.0-experimental.213,344,1,467,250,717,12,FALSE
react-native-navigation,2.0.0-experimental.2,2.0.0-experimental.3,140,3,188,77,265,22,FALSE
react-native-navigation,2.0.0-experimental.232,2.0.0-experimental.233,364,1,1,1,2,1,FALSE
react-native-navigation,2.0.0-experimental.119,2.0.0-experimental.120,252,2,2,4,6,2,FALSE
react-native-navigation,2.0.0-experimental.233,2.0.0-experimental.234,365,1,1,0,1,1,FALSE
react-native-navigation,2.0.0-experimental.117,2.0.0-experimental.118,250,8,84,42,126,14,FALSE
react-native-navigation,2.0.0-experimental.116,2.0.0-experimental.117,249,4,25,6,31,9,FALSE
react-native-navigation,2.0.0-experimental.115,2.0.0-experimental.116,248,3,163,228,391,24,FALSE
react-native-navigation,2.0.0-experimental.114,2.0.0-experimental.115,247,3,28,3,31,5,FALSE
react-native-navigation,2.0.0-experimental.113,2.0.0-experimental.114,246,6,158,10,168,10,FALSE
react-native-navigation,2.0.0-experimental.112,2.0.0-experimental.113,245,12,174,308,482,133,FALSE
react-native-navigation,2.0.0-experimental.111,2.0.0-experimental.112,244,3,37,7,44,9,FALSE
react-native-navigation,2.0.0-experimental.110,2.0.0-experimental.111,243,3,31,24,55,8,FALSE
react-native-navigation,2.0.0-experimental.221,2.0.0-experimental.222,353,1,1,1,2,1,FALSE
react-native-navigation,2.0.0-experimental.220,2.0.0-experimental.221,352,1,3,1,4,1,FALSE
react-native-navigation,2.0.0-experimental.223,2.0.0-experimental.224,355,1,64,51,115,6,FALSE
react-native-navigation,2.0.0-experimental.222,2.0.0-experimental.223,354,1,76,4,80,5,FALSE
react-native-navigation,2.0.0-experimental.225,2.0.0-experimental.226,357,3,836,1880,2716,30,FALSE
react-native-navigation,2.0.0-experimental.224,2.0.0-experimental.225,356,1,1,1,2,1,FALSE
react-native-navigation,2.0.0-experimental.227,2.0.0-experimental.228,359,1,1,1,2,1,FALSE
react-native-navigation,2.0.0-experimental.4,2.0.0-experimental.5,142,5,136,10,146,12,FALSE
react-native-navigation,2.0.0-experimental.229,2.0.0-experimental.230,361,1,7,2,9,3,FALSE
react-native-navigation,2.0.0-experimental.228,2.0.0-experimental.229,360,1,2,2,4,1,FALSE
react-native-navigation,2.0.0-experimental.9,2.0.0-experimental.10,146,2,2,2,4,2,FALSE
react-native-navigation,2.0.0-experimental.8,2.0.0-experimental.9,145,3,172,70,242,12,FALSE
react-native-navigation,2.0.0-experimental.38,2.0.0-experimental.40,174,5,64,535,599,14,FALSE
react-native-navigation,2.0.0-legacy.21,2.0.0-legacy.22,457,1,1,1,2,1,FALSE
react-native-navigation,2.0.0-experimental.134,2.0.0-experimental.135,267,7,2412,424,2836,84,FALSE
react-native-navigation,2.0.0-experimental.31,2.0.0-experimental.32,167,2,27,10,37,6,FALSE
react-native-navigation,2.0.0-experimental.30,2.0.0-experimental.31,166,3,81,13,94,12,FALSE
react-native-navigation,2.0.0-experimental.33,2.0.0-experimental.34,169,2,20,3,23,3,FALSE
react-native-navigation,2.0.0-experimental.32,2.0.0-experimental.33,168,4,116,167,283,13,FALSE
react-native-navigation,2.0.0-experimental.35,2.0.0-experimental.36,171,4,259,119,378,14,FALSE
react-native-navigation,2.0.0-experimental.34,2.0.0-experimental.35,170,4,68,44,112,9,FALSE
react-native-navigation,2.0.0-experimental.37,2.0.0-experimental.38,173,2,21,2,23,2,FALSE
react-native-navigation,2.0.0-experimental.36,2.0.0-experimental.37,172,3,13,3,16,6,FALSE
react-native-navigation,2.0.0-experimental.211,2.0.0-experimental.212,343,1,1,1,2,1,FALSE
react-native-navigation,2.0.0-experimental.3,2.0.0-experimental.4,141,2,10,2,12,4,FALSE
react-native-navigation,2.0.0-experimental.238,2.0.0-experimental.239,370,1,110,107,217,14,FALSE
react-native-navigation,2.0.0-experimental.130,2.0.0-experimental.131,263,2,2,2,4,2,FALSE
react-native-navigation,2.0.0-experimental.168,2.0.0-experimental.169,300,1,1,1,2,1,FALSE
react-native-navigation,2.0.0-experimental.169,2.0.0-experimental.170,301,1,1,1,2,1,FALSE
react-native-navigation,2.0.0-experimental.162,2.0.0-experimental.163,294,3,6,8,14,4,FALSE
react-native-navigation,2.0.0-experimental.163,2.0.0-experimental.164,295,2,71,14,85,14,FALSE
react-native-navigation,2.0.0-experimental.160,2.0.0-experimental.161,292,4,178,136,314,6,FALSE
react-native-navigation,2.0.0-experimental.161,2.0.0-experimental.162,293,5,284,235,519,8,FALSE
react-native-navigation,2.0.0-experimental.166,2.0.0-experimental.167,298,1,1,1,2,1,FALSE
react-native-navigation,2.0.0-experimental.167,2.0.0-experimental.168,299,1,1,1,2,1,FALSE
react-native-navigation,2.0.0-experimental.164,2.0.0-experimental.165,296,2,3,2,5,2,FALSE
react-native-navigation,2.0.0-experimental.165,2.0.0-experimental.166,297,3,270,214,484,7,FALSE
react-native-navigation,2.0.0-experimental.75,2.0.0-experimental.76,210,2,43,12,55,5,FALSE
react-native-navigation,2.0.0-experimental.218,2.0.0-experimental.219,350,1,67,19,86,4,FALSE
react-native-navigation,2.0.0-experimental.219,2.0.0-experimental.220,351,1,5,1,6,1,FALSE
react-native-navigation,1.0.29,1.0.30,51,36,1692,582,2274,182,FALSE
react-native-navigation,1.0.28,1.0.29,50,122,7641,7807,15448,532,FALSE
react-native-navigation,1.0.27,1.0.28,49,15,955,650,1605,49,FALSE
react-native-navigation,1.0.25,1.0.26,47,2,1,10,11,4,FALSE
react-native-navigation,1.0.24,1.0.25,46,4,13,5,18,4,FALSE
react-native-navigation,1.0.23,1.0.24,45,3,5,1,6,3,FALSE
react-native-navigation,1.0.22,1.0.23,44,2,29,4,33,3,FALSE
react-native-navigation,2.0.0-legacy.23,2.0.0-legacy.24,459,9,4844,5257,10101,208,FALSE
react-native-navigation,2.0.0-legacy.22,2.0.0-legacy.23,458,1,1,1,2,1,FALSE
react-native-navigation,2.0.0-experimental.28,2.0.0-experimental.30,165,3,22,9,31,4,FALSE
react-native-navigation,2.0.0-experimental.22,2.0.0-experimental.23,159,2,7,1,8,2,FALSE
react-native-navigation,2.0.0-experimental.23,2.0.0-experimental.24,160,2,8,4,12,2,FALSE
react-native-navigation,2.0.0-experimental.20,2.0.0-experimental.21,157,2,27,3,30,3,FALSE
react-native-navigation,2.0.0-legacy.9,2.0.0-legacy.10,445,6,104,99,203,25,FALSE
react-native-navigation,2.0.0-experimental.26,2.0.0-experimental.27,163,2,114,33,147,7,FALSE
react-native-navigation,2.0.0-experimental.27,2.0.0-experimental.28,164,2,1,8,9,4,FALSE
react-native-navigation,2.0.0-experimental.24,2.0.0-experimental.25,161,2,39,19,58,7,FALSE
react-native-navigation,2.0.0-experimental.25,2.0.0-experimental.26,162,2,11,1,12,2,FALSE
react-native-navigation,2.0.0-legacy.8,2.0.0-legacy.9,444,6,22,4,26,5,FALSE
react-native-navigation,2.0.0-experimental.239,2.0.0-experimental.240,371,1,2,39,41,5,FALSE
react-native-navigation,2.0.0-experimental.1,2.0.0-experimental.2,139,2,6,3,9,2,FALSE
react-native-navigation,2.0.0-legacy.2,2.0.0-legacy.3,438,3,126,72,198,11,FALSE
react-native-navigation,2.0.0-legacy.3,2.0.0-legacy.4,439,3,273,117,390,27,FALSE
react-native-navigation,2.0.0-legacy.1,2.0.0-legacy.2,437,2,50,3,53,4,FALSE
react-native-navigation,2.0.0-legacy.6,2.0.0-legacy.7,442,1,5,1,6,1,FALSE
react-native-navigation,2.0.0-legacy.7,2.0.0-legacy.8,443,2,30,2,32,4,FALSE
react-native-navigation,2.0.0-legacy.4,2.0.0-legacy.5,440,5,44,59,103,16,FALSE
react-native-navigation,2.0.0-legacy.5,2.0.0-legacy.6,441,10,1666,510,2176,37,FALSE
react-native-navigation,2.0.0-experimental.179,2.0.0-experimental.180,311,1,70,29,99,7,FALSE
react-native-navigation,2.0.0-experimental.178,2.0.0-experimental.179,310,1,1,1,2,1,FALSE
react-native-navigation,2.0.0-experimental.171,2.0.0-experimental.172,303,1,2,0,2,1,FALSE
react-native-navigation,2.0.0-experimental.170,2.0.0-experimental.171,302,1,1,1,2,1,FALSE
react-native-navigation,2.0.0-experimental.173,2.0.0-experimental.174,305,1,10,31,41,4,FALSE
react-native-navigation,2.0.0-experimental.172,2.0.0-experimental.173,304,1,31,10,41,4,FALSE
react-native-navigation,2.0.0-experimental.175,2.0.0-experimental.176,307,1,342,11,353,17,FALSE
react-native-navigation,2.0.0-experimental.174,2.0.0-experimental.175,306,1,1,1,2,1,FALSE
react-native-navigation,2.0.0-experimental.177,2.0.0-experimental.178,309,1,82,80,162,1,FALSE
react-native-navigation,2.0.0-experimental.176,2.0.0-experimental.177,308,1,49,15,64,3,FALSE
react-native-navigation,2.0.0-experimental.209,2.0.0-experimental.210,341,1,17,0,17,4,FALSE
react-native-navigation,2.0.0-experimental.208,2.0.0-experimental.209,340,1,5,0,5,2,FALSE
react-native-navigation,2.0.0-experimental.0,2.0.0-experimental.1,138,1,0,1,1,1,FALSE
react-native-navigation,2.0.0-experimental.203,2.0.0-experimental.204,335,1,84,29,113,6,FALSE
react-native-navigation,2.0.0-experimental.202,2.0.0-experimental.203,334,1,13,37,50,7,FALSE
react-native-navigation,2.0.0-experimental.201,2.0.0-experimental.202,333,1,27,13,40,2,FALSE
react-native-navigation,2.0.0-experimental.200,2.0.0-experimental.201,332,1,37,13,50,7,FALSE
react-native-navigation,2.0.0-experimental.207,2.0.0-experimental.208,339,1,8,4,12,3,FALSE
react-native-navigation,2.0.0-experimental.206,2.0.0-experimental.207,338,1,48,7,55,7,FALSE
react-native-navigation,2.0.0-experimental.205,2.0.0-experimental.206,337,1,16,1,17,5,FALSE
react-native-navigation,2.0.0-experimental.242,2.0.0-experimental.243,374,1,1,1,2,1,FALSE
react-native-navigation,2.0.0-experimental.126,2.0.0-experimental.127,259,2,4,3,7,3,FALSE
react-native-navigation,1.0.10,1.0.11,32,19,408,123,531,53,FALSE
react-native-navigation,2.0.0-experimental.127,2.0.0-experimental.128,260,6,912,102,1014,67,FALSE
react-native-navigation,2.0.0-experimental.128,2.0.0-experimental.129,261,3,23,16,39,6,FALSE
react-native-navigation,1.0.11,1.0.12,33,3,25,7,32,5,FALSE
react-native-navigation,2.0.0-legacy.13,2.0.0-legacy.14,449,48,1218,328,1546,115,FALSE
react-native-navigation,2.0.0-experimental.17,2.0.0-experimental.18,154,4,27,19,46,4,FALSE
react-native-navigation,2.0.0-experimental.16,2.0.0-experimental.17,153,3,3,3,6,3,FALSE
react-native-navigation,2.0.0-experimental.15,2.0.0-experimental.16,152,2,7,1,8,2,FALSE
react-native-navigation,2.0.0-experimental.14,2.0.0-experimental.15,151,2,5,2,7,2,FALSE
react-native-navigation,2.0.0-experimental.13,2.0.0-experimental.14,150,2,7,2,9,3,FALSE
react-native-navigation,2.0.0-experimental.199,2.0.0-experimental.200,331,2,13,2,15,4,FALSE
react-native-navigation,2.0.0-experimental.11,2.0.0-experimental.12,148,2,2,2,4,2,FALSE
react-native-navigation,2.0.0-experimental.10,2.0.0-experimental.11,147,2,6,2,8,3,FALSE
react-native-navigation,2.0.0-experimental.215,2.0.0-experimental.216,347,1,12,0,12,2,FALSE
react-native-navigation,2.0.0-experimental.198,2.0.0-experimental.199,330,14,570,172,742,59,FALSE
react-native-navigation,2.0.0-experimental.124,2.0.0-experimental.125,257,2,4,3,7,2,FALSE
react-native-navigation,2.0.0-experimental.19,2.0.0-experimental.20,156,2,4,2,6,2,FALSE
react-native-navigation,2.0.0-experimental.18,2.0.0-experimental.19,155,2,5,1,6,2,FALSE
react-native-navigation,2.0.0-experimental.144,2.0.0-experimental.145,277,5,39,36,75,12,FALSE
react-native-navigation,2.0.0-experimental.145,2.0.0-experimental.146,278,5,159,8,167,9,FALSE
react-native-navigation,2.0.0-experimental.146,2.0.0-experimental.147,279,3,9,0,9,3,FALSE
react-native-navigation,2.0.0-experimental.147,2.0.0-experimental.148,280,3,4,6,10,3,FALSE
react-native-navigation,2.0.0-experimental.140,2.0.0-experimental.141,273,4,4,7,11,4,FALSE
react-native-navigation,2.0.0-experimental.141,2.0.0-experimental.142,274,53,8813,2226,11039,149,FALSE
react-native-navigation,2.0.0-experimental.142,2.0.0-experimental.143,275,28,102,76,178,34,FALSE
react-native-navigation,2.0.0-experimental.143,2.0.0-experimental.144,276,4,10,8,18,4,FALSE
react-native-navigation,2.0.0-experimental.204,2.0.0-experimental.205,336,1,9,4,13,1,FALSE
react-native-navigation,2.0.0-experimental.148,2.0.0-experimental.149,281,3,5,5,10,3,TRUE
react-native-navigation,2.0.0-experimental.149,2.0.0-experimental.150,282,5,431,300,731,8,FALSE
react-native-navigation,2.0.0-experimental.53,2.0.0-experimental.54,188,4,129,19,148,21,FALSE
react-native-navigation,1.0.14,1.0.15,36,5,47,31,78,7,FALSE
react-native-navigation,2.0.0-experimental.52,2.0.0-experimental.53,187,2,70,17,87,12,FALSE
react-native-navigation,2.0.0-experimental.21,2.0.0-experimental.22,158,3,37,114,151,8,FALSE
react-native-navigation,2.0.0-legacy.12,2.0.0-legacy.13,448,32,3472,757,4229,121,FALSE
react-native-navigation,2.0.0-experimental.5,2.0.0-experimental.7,143,4,28,37,65,9,FALSE
react-native-navigation,0.1.8,0.1.9,14,5,124,135,259,16,FALSE
react-native-navigation,0.1.9,0.1.10,15,2,21,21,42,5,FALSE
react-native-navigation,0.2.5,1.0.0,21,9,268,104,372,43,FALSE
react-native-navigation,0.2.4,0.2.5,20,3,5,2,7,3,FALSE
react-native-navigation,0.2.3,0.2.4,19,3,48,5,53,6,FALSE
react-native-navigation,0.2.2,0.2.3,18,7,1430,188,1618,71,FALSE
react-native-navigation,0.2.1,0.2.2,17,1,5,2,7,2,FALSE
react-native-navigation,0.1.1,0.1.2,7,1,3,1,4,2,FALSE
react-native-navigation,0.1.0,0.1.1,6,8,155,25,180,10,FALSE
react-native-navigation,2.0.0-experimental.57,2.0.0-experimental.58,192,4,6,4,10,4,FALSE
react-native-navigation,0.1.2,0.1.3,8,1,2,2,4,1,FALSE
react-native-navigation,2.0.0-experimental.129,2.0.0-experimental.130,262,1,1,1,2,1,FALSE
react-native-navigation,0.1.4,0.1.5,10,5,176,12,188,16,FALSE
react-native-navigation,0.1.5,0.1.6,11,6,183,25,208,18,FALSE
react-native-navigation,0.1.6,0.1.7,12,10,2682,290,2972,85,FALSE
react-native-navigation,2.0.0-legacy.15,2.0.0-legacy.16,451,18,636,142,778,58,FALSE
react-native-navigation,1.0.15,1.0.16,37,18,906,461,1367,54,FALSE
react-native-navigation,2.0.0-experimental.193,2.0.0-experimental.194,325,1,4,0,4,1,FALSE
react-native-navigation,0.1.3,0.1.4,9,1,1,1,2,1,FALSE
react-native-navigation,2.0.0-legacy.16,2.0.0-legacy.17,452,1,15,94,109,11,FALSE
react-native-navigation,2.0.0-experimental.99,2.0.0-experimental.100,232,4,93,79,172,6,FALSE
react-native-navigation,2.0.0-experimental.226,2.0.0-experimental.227,358,1,43,47,90,8,TRUE
react-native-navigation,2.0.0-experimental.97,2.0.0-experimental.99,231,9,9149,170,9319,105,FALSE
react-native-navigation,2.0.0-experimental.96,2.0.0-experimental.97,230,10,173,216,389,38,FALSE
react-native-navigation,2.0.0-experimental.95,2.0.0-experimental.96,229,2,7,5,12,4,FALSE
react-native-navigation,2.0.0-experimental.94,2.0.0-experimental.95,228,3,43,16,59,11,FALSE
react-native-navigation,2.0.0-experimental.93,2.0.0-experimental.94,227,12,1003,475,1478,75,FALSE
react-native-navigation,2.0.0-experimental.91,2.0.0-experimental.93,226,4,111,45,156,4,FALSE
react-native-navigation,2.0.0-experimental.90,2.0.0-experimental.91,225,5,122,137,259,21,FALSE
react-native-navigation,2.0.0-experimental.153,2.0.0-experimental.154,286,3,7,3,10,3,TRUE
react-native-navigation,2.0.0-experimental.152,2.0.0-experimental.153,285,15,1363,731,2094,67,FALSE
react-native-navigation,2.0.0-experimental.151,2.0.0-experimental.152,284,5,30,6,36,5,FALSE
react-native-navigation,2.0.0-experimental.150,2.0.0-experimental.151,283,2,3,1,4,2,FALSE
react-native-navigation,2.0.0-experimental.157,2.0.0-experimental.159,290,7,285,89,374,28,FALSE
react-native-navigation,2.0.0-experimental.156,2.0.0-experimental.157,289,3,4,1,5,3,FALSE
react-native-navigation,2.0.0-experimental.155,2.0.0-experimental.156,288,3,17,3,20,7,FALSE
react-native-navigation,2.0.0-experimental.154,2.0.0-experimental.155,287,3,6,2,8,5,FALSE
react-native-navigation,2.0.0-experimental.159,2.0.0-experimental.160,291,3,18,3,21,4,FALSE
react-native-navigation,0.1.7,0.1.8,13,6,329,32,361,19,FALSE
react-native-navigation,1.0.12,1.0.13,34,4,42,15,57,6,FALSE
react-native-navigation,2.0.0-experimental.192,2.0.0-experimental.193,324,1,32,9,41,4,FALSE
react-native-navigation,2.0.0-experimental.74,2.0.0-experimental.75,209,3,18,5,23,6,FALSE
react-native-navigation,2.0.0-experimental.77,2.0.0-experimental.78,212,2,11,6,17,2,FALSE
react-native-navigation,2.0.0-experimental.76,2.0.0-experimental.77,211,2,4,1,5,2,FALSE
react-native-navigation,2.0.0-experimental.71,2.0.0-experimental.72,206,7,361,261,622,31,FALSE
react-native-navigation,2.0.0-experimental.70,2.0.0-experimental.71,205,3,24,34,58,3,FALSE
react-native-navigation,2.0.0-experimental.73,2.0.0-experimental.74,208,3,30,1,31,6,FALSE
react-native-navigation,2.0.0-experimental.72,2.0.0-experimental.73,207,5,84,9,93,10,FALSE
react-native-navigation,2.0.0-experimental.64,2.0.0-experimental.65,199,2,9,4,13,3,FALSE
react-native-navigation,2.0.0-experimental.79,2.0.0-experimental.80,214,3,3,3,6,3,FALSE
react-native-navigation,2.0.0-experimental.78,2.0.0-experimental.79,213,1,1,1,2,1,FALSE
react-native-navigation,2.0.0-experimental.214,2.0.0-experimental.215,346,1,4,4,8,1,FALSE
react-native-navigation,1.0.26,1.0.27,48,9,700,76,776,30,FALSE
react-native-navigation,2.0.0-experimental.216,2.0.0-experimental.217,348,1,3,0,3,1,FALSE
react-native-navigation,2.0.0-experimental.88,2.0.0-experimental.89,223,9,248,193,441,31,FALSE
react-native-navigation,2.0.0-experimental.89,2.0.0-experimental.90,224,2,3,3,6,2,FALSE
react-native-navigation,0.1.10,0.2.1,16,29,3330,1618,4948,184,FALSE
react-native-navigation,2.0.0-experimental.217,2.0.0-experimental.218,349,1,2,2,4,1,FALSE
react-native-navigation,2.0.0-experimental.122,2.0.0-experimental.123,255,2,1,2,3,2,FALSE
react-native-navigation,2.0.0-experimental.123,2.0.0-experimental.124,256,2,8,1,9,2,FALSE
react-native-navigation,2.0.0-experimental.120,2.0.0-experimental.121,253,3,68,47,115,13,FALSE
react-native-navigation,2.0.0-experimental.121,2.0.0-experimental.122,254,6,109,63,172,19,FALSE
react-native-navigation,2.0.0-experimental.80,2.0.0-experimental.81,215,1,1,1,2,1,FALSE
react-native-navigation,2.0.0-experimental.81,2.0.0-experimental.82,216,3,3,2,5,3,FALSE
react-native-navigation,2.0.0-experimental.82,2.0.0-experimental.83,217,10,115,156,271,24,FALSE
react-native-navigation,2.0.0-experimental.118,2.0.0-experimental.119,251,13,105,78,183,30,FALSE
react-native-navigation,2.0.0-experimental.84,2.0.0-experimental.85,219,2,22,41,63,3,FALSE
react-native-navigation,2.0.0-experimental.85,2.0.0-experimental.86,220,2,26,6,32,2,FALSE
react-native-navigation,2.0.0-experimental.86,2.0.0-experimental.87,221,2,2,1,3,2,FALSE
react-native-navigation,2.0.0-experimental.87,2.0.0-experimental.88,222,18,834,847,1681,79,FALSE
react-native-navigation,2.0.0-legacy.17,2.0.0-legacy.18,453,1,1,1,2,1,FALSE
react-native-navigation,1.0.21,1.0.22,43,4,5,10,15,6,FALSE
react-native-navigation,2.0.0-experimental.66,2.0.0-experimental.67,201,3,37,22,59,8,FALSE
react-native-navigation,1.0.20,1.0.21,42,2,4,0,4,2,FALSE
react-native-navigation,2.0.0-experimental.12,2.0.0-experimental.13,149,4,85,50,135,11,FALSE
react-native-navigation,1.1.40,1.1.41,92,1,4,2,6,1,FALSE
react-native-navigation,1.1.41,1.1.42,93,1,164,14,178,18,FALSE
react-native-navigation,1.1.43,1.1.44,95,1,15,0,15,1,FALSE
react-native-navigation,2.0.0-experimental.56,2.0.0-experimental.57,191,2,18,9,27,3,FALSE
react-native-navigation,1.1.78,1.1.79,130,1,1,0,1,1,FALSE
react-native-navigation,1.1.55,1.1.56,107,1,10,0,10,1,FALSE
react-native-navigation,1.1.54,1.1.55,106,1,20,9,29,3,FALSE
react-native-navigation,1.1.57,1.1.58,109,1,11,0,11,1,FALSE
react-native-navigation,1.1.56,1.1.57,108,1,27,6,33,2,FALSE
react-native-navigation,1.1.53,1.1.54,105,1,2,2,4,2,FALSE
react-native-navigation,1.1.52,1.1.53,104,1,162,0,162,11,FALSE
react-native-navigation,1.1.59,1.1.60,111,1,199,79,278,10,FALSE
react-native-navigation,1.1.58,1.1.59,110,1,1,1,2,1,FALSE
react-native-navigation,2.0.7,2.0.8,468,1,1,1,2,1,FALSE
react-native-navigation,2.0.6,2.0.7,467,1,1,1,2,1,FALSE
react-native-navigation,2.0.5,2.0.6,466,1,1,1,2,1,FALSE
react-native-navigation,2.0.4,2.0.5,465,7,36,18,54,9,FALSE
react-native-navigation,2.0.3,2.0.4,464,1,1,1,2,1,FALSE
react-native-navigation,2.0.2,2.0.3,463,1,1,1,2,1,FALSE
react-native-navigation,2.0.1,2.0.2,462,1,1,1,2,1,FALSE
react-native-navigation,2.0.0,2.0.1,461,1,1,1,2,1,FALSE
react-native-navigation,2.0.9,2.0.10,470,1,1,1,2,1,FALSE
react-native-navigation,2.0.8,2.0.9,469,9,4844,5257,10101,208,FALSE
react-native-navigation,2.0.0-experimental.283,2.0.0-experimental.284,415,2,3,2,5,2,FALSE
react-native-navigation,2.0.0-experimental.282,2.0.0-experimental.283,414,1,2,1,3,1,FALSE
react-native-navigation,2.0.0-experimental.281,2.0.0-experimental.282,413,2,32,4,36,4,FALSE
react-native-navigation,2.0.0-experimental.280,2.0.0-experimental.281,412,1,1,1,2,1,FALSE
react-native-navigation,2.0.0-experimental.287,2.0.0-experimental.288,419,1,71,7,78,7,FALSE
react-native-navigation,2.0.0-experimental.286,2.0.0-experimental.287,418,1,1,1,2,1,FALSE
react-native-navigation,2.0.0-experimental.285,2.0.0-experimental.286,417,1,13,9,22,1,FALSE
react-native-navigation,2.0.0-experimental.284,2.0.0-experimental.285,416,1,6,6,12,4,FALSE
react-native-navigation,2.0.0-experimental.289,2.0.0-experimental.290,421,1,1,3,4,1,FALSE
react-native-navigation,2.0.0-experimental.288,2.0.0-experimental.289,420,1,6,1,7,1,FALSE
react-native-navigation,2.0.0-experimental.148,2.0.0-experimental.149,281,3,5,5,10,3,FALSE
react-native-navigation,1.1.82,1.1.83,134,1,1,1,2,1,FALSE
react-native-navigation,1.1.83,1.1.84,135,1,21,9,30,2,FALSE
react-native-navigation,1.1.80,1.1.81,132,1,7,0,7,2,FALSE
react-native-navigation,1.1.81,1.1.82,133,1,1,1,2,1,FALSE
react-native-navigation,1.1.84,1.1.85,136,1,1,1,2,1,FALSE
react-native-navigation,1.1.19,1.1.20,71,1,1,1,2,1,FALSE
react-native-navigation,1.1.18,1.1.19,70,1,2,2,4,1,FALSE
react-native-navigation,2.0.19,2.0.26,480,1,1,1,2,1,FALSE
react-native-navigation,2.0.18,2.0.19,479,1,1,1,2,1,FALSE
react-native-navigation,2.0.17,2.0.18,478,1,1,1,2,1,FALSE
react-native-navigation,2.0.16,2.0.17,477,1,1,1,2,1,FALSE
react-native-navigation,2.0.15,2.0.16,476,3,23,11,34,4,FALSE
react-native-navigation,1.1.12,1.1.13,64,1,26,8,34,5,FALSE
react-native-navigation,2.0.13,2.0.14,474,1,1,1,2,1,FALSE
react-native-navigation,2.0.12,2.0.13,473,1,1,1,2,1,FALSE
react-native-navigation,2.0.11,2.0.12,472,1,19,3,22,2,FALSE
react-native-navigation,2.0.10,2.0.11,471,1,1,1,2,1,FALSE
react-native-navigation,2.0.0-experimental.226,2.0.0-experimental.227,358,1,43,47,90,8,FALSE
react-native-navigation,2.0.0-experimental.247,2.0.0-experimental.248,379,2,1,2,3,2,FALSE
react-native-navigation,2.0.0-experimental.246,2.0.0-experimental.247,378,2,1150,2,1152,24,FALSE
react-native-navigation,2.0.0-experimental.245,2.0.0-experimental.246,377,1,0,3,3,1,FALSE
react-native-navigation,2.0.0-experimental.249,2.0.0-experimental.250,381,1,6,3,9,2,FALSE
react-native-navigation,2.0.0-experimental.248,2.0.0-experimental.249,380,1,1,1,2,1,FALSE
react-native-navigation,2.0.0-experimental.42,2.0.0-experimental.43,177,2,195,157,352,9,TRUE
react-native-navigation,2.0.0-experimental.118,2.0.0-experimental.119,251,13,105,78,183,30,TRUE
react-native-navigation,1.1.63,1.1.64,115,1,1,1,2,1,FALSE
react-native-navigation,2.0.26,2.0.27,481,1,1,1,2,1,FALSE
react-native-navigation,2.0.27,2.0.31,482,1,1,1,2,1,FALSE
react-native-navigation,1.1.60,1.1.61,112,1,0,1,1,1,FALSE
react-native-navigation,1.1.61,1.1.62,113,1,94,15,109,11,FALSE
react-native-navigation,1.1.62,1.1.63,114,1,15,94,109,11,FALSE
react-native-navigation,1.1.64,1.1.65,116,1,127,18,145,11,FALSE
react-native-navigation,1.1.65,1.1.66,117,1,2,2,4,1,FALSE
react-native-navigation,1.1.66,1.1.67,118,1,2,2,4,2,FALSE
react-native-navigation,1.1.67,1.1.68,119,1,2,2,4,1,FALSE
react-native-navigation,1.1.69,1.1.70,121,1,1,1,2,1,FALSE
react-native-navigation,1.1.68,1.1.69,120,1,18,0,18,2,FALSE
react-native-navigation,2.0.0-experimental.278,2.0.0-experimental.279,410,1,1,1,2,1,FALSE
react-native-navigation,2.0.0-experimental.279,2.0.0-experimental.280,411,1,13,3,16,2,FALSE
react-native-navigation,2.0.0-experimental.276,2.0.0-experimental.277,408,1,53,20,73,1,FALSE
react-native-navigation,2.0.0-experimental.277,2.0.0-experimental.278,409,2,2346,20,2366,58,FALSE
react-native-navigation,2.0.0-experimental.274,2.0.0-experimental.275,406,1,6,8,14,3,FALSE
react-native-navigation,2.0.0-experimental.275,2.0.0-experimental.276,407,1,68,39,107,2,FALSE
react-native-navigation,2.0.0-experimental.272,2.0.0-experimental.273,404,1,2,1,3,1,FALSE
react-native-navigation,2.0.0-experimental.273,2.0.0-experimental.274,405,1,3,1,4,1,FALSE
react-native-navigation,2.0.0-experimental.270,2.0.0-experimental.271,402,1,1,1,2,1,FALSE
react-native-navigation,2.0.0-experimental.271,2.0.0-experimental.272,403,1,319,3,322,14,FALSE
react-native-navigation,2.0.0-experimental.153,2.0.0-experimental.154,286,3,7,3,10,3,FALSE
react-native-navigation,1.1.11,1.1.12,63,1,19,9,28,3,FALSE
react-native-navigation,1.1.10,1.1.11,62,1,5,1,6,1,FALSE
react-native-navigation,1.1.13,1.1.14,65,1,2,2,4,1,FALSE
react-native-navigation,2.0.14,2.0.15,475,1,7,0,7,2,FALSE
react-native-navigation,1.1.15,1.1.16,67,1,67,10,77,1,FALSE
react-native-navigation,1.1.14,1.1.15,66,4,19,9,28,5,FALSE
react-native-navigation,1.1.17,1.1.18,69,1,16,25,41,1,FALSE
react-native-navigation,1.1.16,1.1.17,68,1,84,12,96,1,FALSE
react-native-navigation,1.1.24,1.1.25,76,1,168,5,173,14,FALSE
react-native-navigation,1.1.25,1.1.26,77,1,2,2,4,1,FALSE
react-native-navigation,1.1.26,1.1.27,78,1,224,14,238,9,FALSE
react-native-navigation,1.1.27,1.1.28,79,1,32,18,50,4,FALSE
react-native-navigation,1.1.20,1.1.21,72,1,7,6,13,1,FALSE
react-native-navigation,1.1.21,1.1.22,73,1,0,5,5,1,FALSE
react-native-navigation,1.1.22,1.1.23,74,1,1,1,2,1,FALSE
react-native-navigation,1.1.23,1.1.24,75,1,12,4,16,3,FALSE
react-native-navigation,1.1.28,1.1.29,80,1,6,2,8,1,FALSE
react-native-navigation,1.1.29,1.1.30,81,1,3,2,5,1,FALSE
react-native-navigation,2.0.0-experimental.164,2.0.0-experimental.165,296,2,3,2,5,2,TRUE
react-native-navigation,2.0.31,2.0.32,483,1,1,1,2,1,FALSE
react-native-navigation,1.1.79,1.1.80,131,1,19,3,22,2,FALSE
react-native-navigation,1.1.77,1.1.78,129,2,0,26,26,3,FALSE
react-native-navigation,1.1.76,1.1.77,128,1,35,8,43,6,FALSE
react-native-navigation,1.1.75,1.1.76,127,1,21,13,34,2,FALSE
react-native-navigation,1.1.74,1.1.75,126,2,1456,1879,3335,66,FALSE
react-native-navigation,1.1.73,1.1.74,125,1,1877,1454,3331,65,FALSE
react-native-navigation,1.1.72,1.1.73,124,1,1454,1877,3331,65,FALSE
react-native-navigation,1.1.71,1.1.72,123,1,2,4,6,1,FALSE
react-native-navigation,1.1.70,1.1.71,122,1,9,7,16,1,FALSE
react-native-navigation,2.0.0-experimental.269,2.0.0-experimental.270,401,1,2,6,8,1,FALSE
react-native-navigation,2.0.0-experimental.268,2.0.0-experimental.269,400,1,9,23,32,1,FALSE
react-native-navigation,2.0.0-experimental.265,2.0.0-experimental.266,397,1,42,0,42,5,FALSE
react-native-navigation,2.0.0-experimental.264,2.0.0-experimental.265,396,1,29,67,96,11,FALSE
react-native-navigation,2.0.0-experimental.267,2.0.0-experimental.268,399,1,0,0,0,1,FALSE
react-native-navigation,2.0.0-experimental.266,2.0.0-experimental.267,398,1,10,2,12,1,FALSE
react-native-navigation,2.0.0-experimental.261,2.0.0-experimental.262,393,1,0,0,0,0,FALSE
react-native-navigation,2.0.0-experimental.260,2.0.0-experimental.261,392,1,1,1,2,1,FALSE
react-native-navigation,2.0.0-experimental.263,2.0.0-experimental.264,395,1,19,3,22,2,FALSE
react-native-navigation,2.0.0-experimental.262,2.0.0-experimental.263,394,3,14,29,43,7,FALSE
react-native-navigation,2.0.0-experimental.302,2.0.0-experimental.303,434,1,9,0,9,1,FALSE
react-native-navigation,2.0.0-experimental.303,2.0.0-experimental.304,435,1,1,2,3,1,FALSE
react-native-navigation,2.0.0-experimental.300,2.0.0-experimental.301,432,1,1,0,1,1,FALSE
react-native-navigation,2.0.0-experimental.301,2.0.0-experimental.302,433,1,7,1,8,1,FALSE
react-native-navigation,1.1.51,1.1.52,103,1,38,6,44,6,FALSE
react-native-navigation,1.1.50,1.1.51,102,1,2,2,4,1,FALSE
react-native-navigation,2.0.0-experimental.135,2.0.0-experimental.136,268,2,64,1,65,4,TRUE
react-native-navigation,1.1.33,1.1.34,85,1,2,3,5,1,FALSE
react-native-navigation,1.1.32,1.1.33,84,1,7,3,10,1,FALSE
react-native-navigation,1.1.31,1.1.32,83,1,0,1,1,1,FALSE
react-native-navigation,1.1.30,1.1.31,82,1,91,36,127,3,FALSE
react-native-navigation,1.1.37,1.1.38,89,1,1,1,2,1,FALSE
react-native-navigation,1.1.36,1.1.37,88,2,11,7,18,2,FALSE
react-native-navigation,1.1.35,1.1.36,87,1,13,4,17,2,FALSE
react-native-navigation,1.1.34,1.1.35,86,1,23,1,24,2,FALSE
react-native-navigation,1.1.39,1.1.40,91,1,1,1,2,1,FALSE
react-native-navigation,1.1.38,1.1.39,90,1,2,4,6,1,FALSE
react-native-navigation,1.1.48,1.1.49,100,1,11,2,13,1,FALSE
react-native-navigation,1.1.49,1.1.50,101,1,4,1,5,1,FALSE
react-native-navigation,2.0.0-experimental.294,2.0.0-experimental.295,426,1,1,1,2,1,FALSE
react-native-navigation,2.0.0-experimental.295,2.0.0-experimental.296,427,1,6,6,12,1,FALSE
react-native-navigation,2.0.0-experimental.296,2.0.0-experimental.297,428,1,40,2,42,2,FALSE
react-native-navigation,2.0.0-experimental.297,2.0.0-experimental.298,429,1,2,1,3,1,FALSE
react-native-navigation,2.0.0-experimental.290,2.0.0-experimental.291,422,1,5,3,8,2,FALSE
react-native-navigation,2.0.0-experimental.291,2.0.0-experimental.292,423,3,228,98,326,16,FALSE
react-native-navigation,2.0.0-experimental.292,2.0.0-experimental.293,424,1,11,1,12,1,FALSE
react-native-navigation,2.0.0-experimental.293,2.0.0-experimental.294,425,1,10,2,12,2,FALSE
react-native-navigation,2.0.0-experimental.298,2.0.0-experimental.299,430,1,22,4,26,4,FALSE
react-native-navigation,2.0.0-experimental.299,2.0.0-experimental.300,431,3,635,580,1215,5,FALSE
react-native-navigation,1.1.46,1.1.47,98,1,31,1,32,1,FALSE
react-native-navigation,1.1.47,1.1.48,99,1,11,10,21,1,FALSE
react-native-navigation,1.1.1,1.1.2,53,1,1,1,2,1,FALSE
react-native-navigation,1.1.3,1.1.4,55,1,10,2,12,1,FALSE
react-native-navigation,1.1.2,1.1.3,54,1,13,19,32,4,FALSE
react-native-navigation,1.1.5,1.1.6,57,1,72,56,128,6,FALSE
react-native-navigation,1.1.4,1.1.5,56,1,41,4,45,4,FALSE
react-native-navigation,1.1.7,1.1.8,59,1,14,9,23,1,FALSE
react-native-navigation,1.1.6,1.1.7,58,1,6,4,10,1,FALSE
react-native-navigation,1.1.9,1.1.10,61,1,1,1,2,1,FALSE
react-native-navigation,1.1.8,1.1.9,60,1,7,7,14,2,FALSE
react-native-navigation,1.1.44,1.1.45,96,1,9,6,15,3,FALSE
react-native-navigation,1.1.45,1.1.46,97,1,4,1,5,1,FALSE
react-native-navigation,1.1.42,1.1.43,94,1,10,1,11,1,FALSE
react-native-navigation,2.0.0-experimental.258,2.0.0-experimental.259,390,1,4,0,4,1,FALSE
react-native-navigation,2.0.0-experimental.259,2.0.0-experimental.260,391,1,3,1,4,1,FALSE
react-native-navigation,2.0.0-experimental.250,2.0.0-experimental.251,382,1,7,0,7,1,FALSE
react-native-navigation,2.0.0-experimental.251,2.0.0-experimental.252,383,1,486,477,963,2,FALSE
react-native-navigation,2.0.0-experimental.252,2.0.0-experimental.253,384,1,1,22,23,1,FALSE
react-native-navigation,2.0.0-experimental.253,2.0.0-experimental.254,385,1,5,1,6,1,FALSE
react-native-navigation,2.0.0-experimental.254,2.0.0-experimental.255,386,1,29,1,30,3,FALSE
react-native-navigation,2.0.0-experimental.255,2.0.0-experimental.256,387,1,1,1,2,1,FALSE
react-native-navigation,2.0.0-experimental.256,2.0.0-experimental.257,388,1,1,2,3,1,FALSE
react-native-navigation,2.0.0-experimental.257,2.0.0-experimental.258,389,1,13,0,13,1,FALSE
react-native-navigation,2.0.0-experimental.283,2.0.0-experimental.284,415,2,3,2,5,2,TRUE
react-native-navigation,2.0.0-experimental.240,2.0.0-experimental.241,372,1,0,2,2,1,TRUE
react-native-navigation,2.0.0-experimental.180,2.0.0-experimental.181,312,1,4,1,5,1,TRUE
react-native-navigation,2.0.0-experimental.209,2.0.0-experimental.210,341,1,17,0,17,4,TRUE
react-native-navigation,2.0.0-experimental.72,2.0.0-experimental.73,207,5,84,9,93,10,TRUE
react-native-navigation,1.1.12,1.1.13,64,1,26,8,34,5,TRUE
react-native-navigation,2.0.9,2.0.10,470,1,1,1,2,1,TRUE
react-native-navigation,2.0.0-legacy.2,2.0.0-legacy.3,438,3,126,72,198,11,TRUE
react-native-navigation,2.0.0-experimental.236,2.0.0-experimental.237,368,1,39,7,46,5,TRUE
react-native-navigation,2.0.0-experimental.300,2.0.0-experimental.301,432,1,1,0,1,1,TRUE
react-native-navigation,2.0.0-experimental.28,2.0.0-experimental.30,165,3,22,9,31,4,TRUE
react-native-navigation,2.0.0-experimental.214,2.0.0-experimental.215,346,1,4,4,8,1,TRUE
react-native-navigation,2.0.0-legacy.6,2.0.0-legacy.7,442,1,5,1,6,1,TRUE
react-native-navigation,2.0.0-experimental.253,2.0.0-experimental.254,385,1,5,1,6,1,TRUE
react-native-navigation,2.0.0-experimental.254,2.0.0-experimental.255,386,1,29,1,30,3,TRUE
react-native-navigation,2.0.0-experimental.101,2.0.0-experimental.102,234,2,5,2,7,2,TRUE
react-native-navigation,2.0.0-experimental.34,2.0.0-experimental.35,170,4,68,44,112,9,TRUE
react-native-navigation,2.0.0-experimental.136,2.0.0-experimental.137,269,3,6,6,12,5,TRUE
react-native-navigation,1.1.70,1.1.71,122,1,9,7,16,1,TRUE
react-native-navigation,2.0.0-experimental.102,2.0.0-experimental.103,235,3,8,4,12,4,TRUE
react-native-navigation,2.0.0-experimental.113,2.0.0-experimental.114,246,6,158,10,168,10,TRUE
react-native-navigation,2.0.0-experimental.219,2.0.0-experimental.220,351,1,5,1,6,1,TRUE
react-native-navigation,2.0.0-experimental.185,2.0.0-experimental.186,317,1,10,1,11,1,TRUE
react-native-navigation,2.0.0-experimental.224,2.0.0-experimental.225,356,1,1,1,2,1,TRUE
react-native-navigation,2.0.0-experimental.171,2.0.0-experimental.172,303,1,2,0,2,1,TRUE
react-native-navigation,2.0.0-experimental.250,2.0.0-experimental.251,382,1,7,0,7,1,TRUE
meshblu-core-task-publish-broadcast-received,3.1.0,3.2.0,4,1,2,1,3,2,FALSE
meshblu-core-task-publish-broadcast-received,1.0.0,2.0.1,1,3,68,21,89,6,FALSE
meshblu-core-task-publish-broadcast-received,2.0.1,3.0.0,2,1,6,6,12,3,FALSE
meshblu-core-task-publish-broadcast-received,3.0.0,3.1.0,3,1,5,2,7,3,FALSE
meshblu-core-task-publish-broadcast-received,3.2.0,4.0.0,5,1,7,4,11,3,FALSE
meshblu-core-task-publish-broadcast-received,1.0.0,2.0.1,1,3,68,21,89,6,TRUE
smart-encoding-convert,0.0.4,0.0.5,4,2,34,126,160,6,FALSE
smart-encoding-convert,0.0.1,0.0.2,1,2,6,5,11,2,FALSE
smart-encoding-convert,0.0.3,0.0.4,3,2,15,9,24,3,FALSE
smart-encoding-convert,0.0.2,0.0.3,2,1,2,2,4,1,FALSE
smart-encoding-convert,0.0.3,0.0.4,3,2,15,9,24,3,TRUE
cpr-select,1.0.4,1.0.5,5,1,4,6,10,5,FALSE
cpr-select,1.0.5,1.0.6,6,1,19,5,24,4,FALSE
cpr-select,1.0.6,1.1.0,7,1,25,20,45,8,FALSE
cpr-select,1.0.0,1.0.1,1,3,5,5,10,4,FALSE
cpr-select,1.0.1,1.0.2,2,1,3,3,6,2,FALSE
cpr-select,1.0.2,1.0.3,3,1,3,3,6,2,FALSE
cpr-select,1.0.3,1.0.4,4,1,409,4,413,4,FALSE
cpr-select,1.1.0,1.1.1,8,4,6,6,12,4,FALSE
cpr-select,1.1.6,1.2.0,13,2,33,46,79,7,FALSE
cpr-select,1.1.3,1.1.4,10,1,7728,10,7738,3,FALSE
cpr-select,1.1.1,1.1.3,9,4,73,73,146,8,FALSE
cpr-select,1.2.3,1.2.4,17,2,7,5,12,4,FALSE
cpr-select,1.2.0,1.2.1,14,3,13,11,24,7,FALSE
cpr-select,1.2.1,1.2.2,15,2,3,3,6,2,FALSE
cpr-select,1.1.5,1.1.6,12,12,16,11,27,12,FALSE
cpr-select,1.2.2,1.2.3,16,3,21,13,34,9,FALSE
cpr-select,1.1.4,1.1.5,11,1,33,8,41,4,FALSE
cpr-select,1.4.0,1.4.1,21,2,2,2,4,2,TRUE
cpr-select,1.4.1,1.4.2,22,1,45,10,55,2,FALSE
cpr-select,1.4.2,1.4.3,23,3,3,5,8,3,FALSE
cpr-select,1.2.4,1.3.0,18,7,49,895,944,21,FALSE
cpr-select,1.3.0,1.3.1,19,2,4,3,7,2,FALSE
cpr-select,1.3.1,1.4.0,20,14,22,16,38,15,FALSE
cpr-select,2.2.2,2.2.3,32,1,1,1,2,1,FALSE
cpr-select,2.2.1,2.2.2,31,2,2,1,3,2,FALSE
cpr-select,2.2.0,2.2.1,30,1,5,2,7,2,FALSE
cpr-select,2.0.0-alpha.1,2.0.0,25,1,1,1,2,1,FALSE
cpr-select,2.1.0,2.1.1,28,2,2,2,4,2,FALSE
cpr-select,2.1.1,2.2.0,29,2,23,17,40,3,FALSE
cpr-select,2.0.1,2.1.0,27,2,14,3,17,4,FALSE
cpr-select,2.0.0,2.0.1,26,2,9,3,12,2,FALSE
cpr-select,1.4.0,1.4.1,21,2,2,2,4,2,FALSE
cpr-select,1.4.3,2.0.0-alpha.1,24,2,13,10,23,3,FALSE
cpr-select,1.1.0,1.1.1,8,4,6,6,12,4,TRUE
cpr-select,2.1.1,2.2.0,29,2,23,17,40,3,TRUE
cpr-select,1.2.4,1.3.0,18,7,49,895,944,21,TRUE
cycle-snabbdom,1.1.1,1.2.0,10,15,640,1012,1652,25,FALSE
cycle-snabbdom,1.1.0,1.1.1,9,4,469,37,506,7,FALSE
cycle-snabbdom,1.0.0,1.0.1,5,3,54,73,127,3,FALSE
cycle-snabbdom,1.0.1,1.0.2,6,8,9200,44,9244,13,FALSE
cycle-snabbdom,1.0.2,1.0.3,7,5,60,10,70,9,FALSE
cycle-snabbdom,1.0.3,1.1.0,8,8,909,925,1834,13,FALSE
cycle-snabbdom,1.3.0,3.0.0,13,9,35510,9843,45353,136,FALSE
cycle-snabbdom,1.2.0,1.2.1,11,6,35,4,39,9,FALSE
cycle-snabbdom,1.2.1,1.3.0,12,9,785,879,1664,43,FALSE
cycle-snabbdom,0.2.0,0.4.0,1,6,863,472,1335,19,FALSE
cycle-snabbdom,1.2.0,1.2.1,11,6,35,4,39,9,TRUE
cycle-snabbdom,0.4.1,0.4.2,3,5,5,5,10,5,FALSE
cycle-snabbdom,0.4.0,0.4.1,2,5,217,3,220,9,FALSE
cycle-snabbdom,0.4.2,1.0.0,4,14,5097,1219,6316,70,FALSE
cycle-snabbdom,1.0.0,1.0.1,5,3,54,73,127,3,TRUE
cycle-snabbdom,1.0.1,1.0.2,6,8,9200,44,9244,13,TRUE
cycle-snabbdom,0.2.0,0.4.0,1,6,863,472,1335,19,TRUE
cycle-snabbdom,1.3.0,3.0.0,13,9,35510,9843,45353,136,TRUE
cycle-snabbdom,0.4.0,0.4.1,2,5,217,3,220,9,TRUE
typescript-dotnet,4.3.1,4.3.2,139,2,182,262,444,68,FALSE
typescript-dotnet,4.8.1,4.9.0,170,8,6378,2551,8929,1848,TRUE
typescript-dotnet,4.8.0,4.8.1,169,1,1223,1068,2291,288,TRUE
typescript-dotnet,4.7.8,4.7.9,160,1,56,45,101,20,FALSE
typescript-dotnet,4.0.1,4.1.0,134,3,1202,1113,2315,760,TRUE
typescript-dotnet,4.0.0,4.0.1,133,6,1136,393,1529,181,TRUE
typescript-dotnet,4.1.0,4.1.1,135,1,3887,3456,7343,190,TRUE
typescript-dotnet,4.6.3,4.7.0,151,1,7015,4523,11538,888,TRUE
typescript-dotnet,4.6.2,4.6.3,150,2,1182,998,2180,654,TRUE
typescript-dotnet,4.7.14,4.7.15,166,2,454,68,522,61,TRUE
typescript-dotnet,4.7.15,4.7.16,167,1,138,26,164,28,TRUE
typescript-dotnet,4.7.16,4.8.0,168,4,1253,1061,2314,891,TRUE
typescript-dotnet,4.2.0,4.3.0,137,3,5555,5833,11388,434,TRUE
typescript-dotnet,4.7.10,4.7.11,162,1,53,46,99,25,FALSE
typescript-dotnet,4.7.11,4.7.12,163,4,653,468,1121,76,TRUE
typescript-dotnet,4.7.12,4.7.13,164,1,833,280,1113,77,FALSE
typescript-dotnet,4.7.13,4.7.14,165,1,1114,404,1518,87,TRUE
typescript-dotnet,4.3.2,4.4.0,140,2,6691,6876,13567,330,FALSE
typescript-dotnet,4.9.2,4.9.3,173,1,221,15,236,25,FALSE
typescript-dotnet,4.9.3,4.9.4,174,2,0,24,24,2,TRUE
typescript-dotnet,4.5.1,4.5.2,143,2,3124,3334,6458,166,FALSE
typescript-dotnet,4.7.2,4.7.3,154,2,24,26,50,28,TRUE
typescript-dotnet,4.7.3,4.7.4,155,1,74,49,123,38,FALSE
typescript-dotnet,4.7.0,4.7.1,152,2,1974,129,2103,154,TRUE
typescript-dotnet,4.7.1,4.7.2,153,1,73,17,90,3,FALSE
typescript-dotnet,4.7.6,4.7.7,158,1,31,23,54,21,FALSE
typescript-dotnet,4.7.7,4.7.8,159,1,20,21,41,21,TRUE
typescript-dotnet,4.7.4,4.7.5,156,1,416,19,435,25,FALSE
typescript-dotnet,4.7.5,4.7.6,157,1,464,463,927,83,FALSE
typescript-dotnet,4.9.4,4.9.5,175,2,223,56,279,68,FALSE
typescript-dotnet,4.9.5,4.9.6,176,1,61,73,134,31,TRUE
typescript-dotnet,4.7.9,4.7.10,161,1,288,267,555,29,TRUE
typescript-dotnet,4.9.0,4.9.1,171,1,284,191,475,126,TRUE
typescript-dotnet,4.9.1,4.9.2,172,1,93,34,127,41,TRUE
typescript-dotnet,4.6.1,4.6.2,149,1,73,17,90,3,FALSE
typescript-dotnet,4.6.0,4.6.1,148,2,1217,731,1948,443,TRUE
typescript-dotnet,4.5.0,4.5.1,142,1,199,146,345,49,FALSE
typescript-dotnet,4.1.1,4.2.0,136,3,14007,6925,20932,487,TRUE
typescript-dotnet,4.5.2,4.5.4,144,1,73,17,90,3,TRUE
typescript-dotnet,4.5.4,4.5.5,145,3,38038,1613,39651,1450,FALSE
typescript-dotnet,4.5.5,4.5.6,146,1,404,191,595,50,FALSE
typescript-dotnet,4.5.6,4.6.0,147,2,1582,1411,2993,220,TRUE
typescript-dotnet,4.4.0,4.5.0,141,14,25577,31746,57323,4033,TRUE
typescript-dotnet,4.3.0,4.3.1,138,1,49,82,131,56,FALSE
typescript-dotnet,2.18.10,2.19.0,99,1,1402,688,2090,709,FALSE
typescript-dotnet,2.18.7,2.18.8,96,2,4,2,6,3,FALSE
typescript-dotnet,2.18.9,2.18.10,98,1,136,48,184,20,FALSE
typescript-dotnet,2.18.8,2.18.9,97,2,2,14,16,8,FALSE
typescript-dotnet,2.19.0,2.20.0,100,2,10591,12917,23508,428,FALSE
typescript-dotnet,2.18.8,2.18.9,97,2,2,14,16,8,TRUE
typescript-dotnet,3.1.3,3.1.4,121,1,88,50,138,15,FALSE
typescript-dotnet,3.1.2,3.1.3,120,2,114,925,1039,41,FALSE
typescript-dotnet,3.1.1,3.1.2,119,1,77,30,107,33,FALSE
typescript-dotnet,3.1.0,3.1.1,118,3,714,453,1167,82,FALSE
typescript-dotnet,3.1.7,3.2.0,125,4,282,107,389,52,FALSE
typescript-dotnet,3.1.6,3.1.7,124,1,13,10,23,9,FALSE
typescript-dotnet,3.1.5,3.1.6,123,1,135,97,232,51,FALSE
typescript-dotnet,3.1.4,3.1.5,122,1,71,51,122,19,FALSE
typescript-dotnet,2.18.3,2.18.4,92,8,1025,308,1333,123,FALSE
typescript-dotnet,2.18.2,2.18.3,91,10,107,44,151,19,FALSE
typescript-dotnet,2.18.1,2.18.2,90,4,2087,1246,3333,71,FALSE
typescript-dotnet,2.18.0,2.18.1,89,1,73,17,90,3,FALSE
typescript-dotnet,2.18.6,2.18.7,95,1,264,675,939,150,FALSE
typescript-dotnet,2.18.5,2.18.6,94,1,5,5,10,3,FALSE
typescript-dotnet,2.18.4,2.18.5,93,2,1200,625,1825,153,FALSE
typescript-dotnet,4.0.1,4.1.0,134,3,1202,1113,2315,760,FALSE
typescript-dotnet,4.0.0,4.0.1,133,6,1136,393,1529,181,FALSE
typescript-dotnet,2.10.6,2.10.7,53,1,47,4,51,7,FALSE
typescript-dotnet,2.5.18,2.5.19,17,1,1041,16,1057,55,FALSE
typescript-dotnet,2.5.19,2.6.0,18,23,23593,22967,46560,1918,FALSE
typescript-dotnet,2.5.10,2.5.11,11,4,1086,709,1795,113,FALSE
typescript-dotnet,2.5.11,2.5.14,12,3,14,17,31,5,FALSE
typescript-dotnet,2.5.14,2.5.15,13,1,6,7,13,3,FALSE
typescript-dotnet,2.5.15,2.5.16,14,1,462,156,618,54,FALSE
typescript-dotnet,2.5.16,2.5.17,15,8,1975,2227,4202,487,FALSE
typescript-dotnet,2.5.17,2.5.18,16,2,8,12,20,10,FALSE
typescript-dotnet,2.7.20,2.8.1,44,7,2019,1286,3305,192,FALSE
typescript-dotnet,4.7.2,4.7.3,154,2,24,26,50,28,FALSE
typescript-dotnet,4.7.0,4.7.1,152,2,1974,129,2103,154,FALSE
typescript-dotnet,4.7.7,4.7.8,159,1,20,21,41,21,FALSE
typescript-dotnet,4.7.9,4.7.10,161,1,288,267,555,29,FALSE
typescript-dotnet,4.5.2,4.5.4,144,1,73,17,90,3,FALSE
typescript-dotnet,4.5.6,4.6.0,147,2,1582,1411,2993,220,FALSE
typescript-dotnet,2.14.0,2.14.1,77,1,56,82,138,56,FALSE
typescript-dotnet,2.8.1,2.9.0,45,2,18037,76,18113,595,FALSE
typescript-dotnet,3.0.6,3.0.7,114,1,91,7,98,11,FALSE
typescript-dotnet,3.0.7,3.0.8,115,2,605,165,770,49,FALSE
typescript-dotnet,3.0.4,3.0.5,112,1,7,7,14,1,FALSE
typescript-dotnet,3.0.5,3.0.6,113,4,10,6,16,5,FALSE
typescript-dotnet,3.0.2,3.0.3,110,2,12,10,22,5,FALSE
typescript-dotnet,3.0.3,3.0.4,111,1,12,8,20,3,FALSE
typescript-dotnet,3.0.0,3.0.1,108,4,207,400,607,25,FALSE
typescript-dotnet,3.0.1,3.0.2,109,3,403,507,910,60,FALSE
typescript-dotnet,3.0.8,3.0.9,116,1,18,18,36,15,FALSE
typescript-dotnet,3.0.9,3.1.0,117,4,1600,1491,3091,692,FALSE
typescript-dotnet,2.7.0,2.7.1,26,1,37,37,74,15,FALSE
typescript-dotnet,4.1.0,4.1.1,135,1,3887,3456,7343,190,FALSE
typescript-dotnet,4.1.1,4.2.0,136,3,14007,6925,20932,487,FALSE
typescript-dotnet,4.7.14,4.7.15,166,2,454,68,522,61,FALSE
typescript-dotnet,4.7.15,4.7.16,167,1,138,26,164,28,FALSE
typescript-dotnet,4.7.16,4.8.0,168,4,1253,1061,2314,891,FALSE
typescript-dotnet,4.7.11,4.7.12,163,4,653,468,1121,76,FALSE
typescript-dotnet,4.7.13,4.7.14,165,1,1114,404,1518,87,FALSE
typescript-dotnet,4.8.1,4.9.0,170,8,6378,2551,8929,1848,FALSE
typescript-dotnet,4.8.0,4.8.1,169,1,1223,1068,2291,288,FALSE
typescript-dotnet,2.9.2,2.10.0,48,5,891,251,1142,180,FALSE
typescript-dotnet,2.9.0,2.9.1,46,2,9757,143,9900,206,FALSE
typescript-dotnet,2.9.1,2.9.2,47,1,31,31,62,11,FALSE
typescript-dotnet,2.10.13,2.11.0,60,2,612,87,699,71,FALSE
typescript-dotnet,2.10.12,2.10.13,59,1,31,31,62,25,FALSE
typescript-dotnet,2.10.11,2.10.12,58,1,89,66,155,63,FALSE
typescript-dotnet,2.10.10,2.10.11,57,1,162,158,320,75,FALSE
typescript-dotnet,2.15.0,2.16.0,79,1,1265,80,1345,58,FALSE
typescript-dotnet,2.13.4,2.13.5,75,4,651,481,1132,164,FALSE
typescript-dotnet,2.13.5,2.14.0,76,4,1543,3993,5536,41,FALSE
typescript-dotnet,2.13.0,2.13.1,71,1,9,9,18,3,FALSE
typescript-dotnet,2.13.1,2.13.2,72,2,96,90,186,76,FALSE
typescript-dotnet,2.13.2,2.13.3,73,1,24,28,52,25,FALSE
typescript-dotnet,2.13.3,2.13.4,74,5,5264,711,5975,227,FALSE
typescript-dotnet,2.5.2,2.5.3,3,1,11,14,25,3,FALSE
typescript-dotnet,2.5.3,2.5.4,4,1,73,17,90,3,FALSE
typescript-dotnet,2.11.6,2.11.7,67,1,18938,34,18972,645,FALSE
typescript-dotnet,2.11.7,2.12.0,68,5,15535,6328,21863,1011,FALSE
typescript-dotnet,2.11.4,2.11.5,65,1,63,82,145,56,FALSE
typescript-dotnet,2.11.5,2.11.6,66,1,92,54,146,57,FALSE
typescript-dotnet,2.11.2,2.11.3,63,1,245,18760,19005,666,FALSE
typescript-dotnet,2.11.3,2.11.4,64,3,72,8,80,11,FALSE
typescript-dotnet,2.11.0,2.11.1,61,5,1509,165,1674,167,FALSE
typescript-dotnet,2.11.1,2.11.2,62,1,661,246,907,103,FALSE
typescript-dotnet,2.5.1,2.5.2,2,1,7,8,15,3,FALSE
typescript-dotnet,2.20.2,2.20.3,103,2,1349,83,1432,133,FALSE
typescript-dotnet,2.20.3,2.21.0,104,2,862,395,1257,79,FALSE
typescript-dotnet,2.20.0,2.20.1,101,1,73,135,208,66,FALSE
typescript-dotnet,2.20.1,2.20.2,102,11,10061,7607,17668,850,FALSE
typescript-dotnet,2.7.10,2.7.11,34,1,22,7,29,10,FALSE
typescript-dotnet,4.9.5,4.9.6,176,1,61,73,134,31,FALSE
typescript-dotnet,2.7.11,2.7.12,35,2,231,97,328,72,FALSE
typescript-dotnet,4.9.0,4.9.1,171,1,284,191,475,126,FALSE
typescript-dotnet,4.9.1,4.9.2,172,1,93,34,127,41,FALSE
typescript-dotnet,4.9.3,4.9.4,174,2,0,24,24,2,FALSE
typescript-dotnet,2.6.1,2.6.2,20,2,1987,738,2725,426,FALSE
typescript-dotnet,2.6.0,2.6.1,19,2,9304,12202,21506,1460,FALSE
typescript-dotnet,2.6.3,2.6.4,22,2,197,92,289,43,FALSE
typescript-dotnet,2.6.2,2.6.3,21,1,2722,2112,4834,851,FALSE
typescript-dotnet,2.6.5,2.6.6,24,2,1054,143,1197,179,FALSE
typescript-dotnet,2.6.4,2.6.5,23,8,7821,6815,14636,697,FALSE
typescript-dotnet,2.6.6,2.7.0,25,13,4511,2927,7438,778,FALSE
typescript-dotnet,2.17.0,2.17.1,86,1,167,89,256,51,FALSE
typescript-dotnet,2.17.1,2.17.2,87,3,280,74,354,10,FALSE
typescript-dotnet,2.17.2,2.18.0,88,3,7651,86,7737,309,FALSE
typescript-dotnet,2.10.1,2.10.4,50,6,7112,5833,12945,145,FALSE
typescript-dotnet,2.5.0,2.5.1,1,1,50,21,71,4,FALSE
typescript-dotnet,2.7.18,2.7.19,42,1,5,4,9,4,FALSE
typescript-dotnet,2.7.19,2.7.20,43,2,152,123,275,50,FALSE
typescript-dotnet,2.7.16,2.7.17,40,1,49,68,117,41,FALSE
typescript-dotnet,2.7.17,2.7.18,41,2,197,41,238,42,FALSE
typescript-dotnet,2.7.14,2.7.15,38,4,1483,1049,2532,131,FALSE
typescript-dotnet,2.7.15,2.7.16,39,2,5,5,10,4,FALSE
typescript-dotnet,2.7.12,2.7.13,36,1,222,118,340,19,FALSE
typescript-dotnet,2.7.13,2.7.14,37,1,73,17,90,3,FALSE
typescript-dotnet,2.14.1,2.15.0,78,2,1705,771,2476,135,FALSE
typescript-dotnet,4.4.0,4.5.0,141,14,25577,31746,57323,4033,FALSE
typescript-dotnet,2.10.5,2.10.6,52,2,82,57,139,57,FALSE
typescript-dotnet,4.2.0,4.3.0,137,3,5555,5833,11388,434,FALSE
typescript-dotnet,2.12.1,2.13.0,70,4,6177,5792,11969,1861,FALSE
typescript-dotnet,2.12.0,2.12.1,69,1,73,17,90,3,FALSE
typescript-dotnet,2.21.2,3.0.0,107,3,437,67,504,57,FALSE
typescript-dotnet,2.21.1,2.21.2,106,1,4017,3773,7790,84,FALSE
typescript-dotnet,2.21.0,2.21.1,105,6,4208,4364,8572,262,FALSE
typescript-dotnet,2.5.8,2.5.9,9,2,4,4,8,4,FALSE
typescript-dotnet,2.5.9,2.5.10,10,1,5,5,10,3,FALSE
typescript-dotnet,2.5.6,2.5.7,7,4,71,19,90,18,FALSE
typescript-dotnet,2.5.7,2.5.8,8,1,1,1,2,1,FALSE
typescript-dotnet,2.5.4,2.5.5,5,1,2,2,4,2,FALSE
typescript-dotnet,2.5.5,2.5.6,6,2,4,4,8,4,FALSE
typescript-dotnet,4.6.3,4.7.0,151,1,7015,4523,11538,888,FALSE
typescript-dotnet,4.6.2,4.6.3,150,2,1182,998,2180,654,FALSE
typescript-dotnet,4.6.0,4.6.1,148,2,1217,731,1948,443,FALSE
typescript-dotnet,2.10.9,2.10.10,56,1,166,119,285,84,FALSE
typescript-dotnet,2.10.8,2.10.9,55,1,144,45,189,18,FALSE
typescript-dotnet,2.7.8,2.7.9,32,1,15,15,30,10,FALSE
typescript-dotnet,2.7.9,2.7.10,33,2,38,20,58,9,FALSE
typescript-dotnet,2.7.4,2.7.5,29,2,190,13,203,13,FALSE
typescript-dotnet,2.7.5,2.7.6,30,1,2,2,4,2,FALSE
typescript-dotnet,2.7.6,2.7.8,31,6,296,21841,22137,608,FALSE
typescript-dotnet,2.10.0,2.10.1,49,2,654,272,926,81,FALSE
typescript-dotnet,2.10.7,2.10.8,54,1,384,150,534,69,FALSE
typescript-dotnet,2.7.1,2.7.2,27,9,2802,1843,4645,293,FALSE
typescript-dotnet,2.7.2,2.7.4,28,16,1944,1777,3721,302,FALSE
typescript-dotnet,2.10.4,2.10.5,51,8,3806,2611,6417,157,FALSE
typescript-dotnet,3.2.4,3.2.5,129,1,560,243,803,55,FALSE
typescript-dotnet,3.2.5,3.2.6,130,4,445,161,606,79,FALSE
typescript-dotnet,3.2.6,3.2.7,131,4,2532,1852,4384,947,FALSE
typescript-dotnet,3.2.7,4.0.0,132,4,17446,16730,34176,1263,FALSE
typescript-dotnet,3.2.0,3.2.1,126,2,135,85,220,49,TRUE
typescript-dotnet,3.2.1,3.2.3,127,5,300,120,420,46,FALSE
typescript-dotnet,3.2.3,3.2.4,128,1,19,3,22,3,FALSE
typescript-dotnet,2.16.5,2.17.0,85,4,4444,729,5173,209,FALSE
typescript-dotnet,2.16.4,2.16.5,84,2,1668,3649,5317,212,FALSE
typescript-dotnet,2.16.1,2.16.2,81,1,21,26,47,14,FALSE
typescript-dotnet,2.16.0,2.16.1,80,1,4,4,8,3,FALSE
typescript-dotnet,2.16.3,2.16.4,83,2,4637,244,4881,114,FALSE
typescript-dotnet,2.16.2,2.16.3,82,1,306,19,325,8,FALSE
typescript-dotnet,3.1.4,3.1.5,122,1,71,51,122,19,TRUE
typescript-dotnet,3.2.0,3.2.1,126,2,135,85,220,49,FALSE
typescript-dotnet,2.14.1,2.15.0,78,2,1705,771,2476,135,TRUE
typescript-dotnet,2.16.3,2.16.4,83,2,4637,244,4881,114,TRUE
typescript-dotnet,2.16.2,2.16.3,82,1,306,19,325,8,TRUE
typescript-dotnet,2.5.18,2.5.19,17,1,1041,16,1057,55,TRUE
typescript-dotnet,2.5.19,2.6.0,18,23,23593,22967,46560,1918,TRUE
typescript-dotnet,2.5.16,2.5.17,15,8,1975,2227,4202,487,TRUE
typescript-dotnet,2.7.20,2.8.1,44,7,2019,1286,3305,192,TRUE
typescript-dotnet,2.7.0,2.7.1,26,1,37,37,74,15,TRUE
typescript-dotnet,2.7.11,2.7.12,35,2,231,97,328,72,TRUE
typescript-dotnet,2.6.0,2.6.1,19,2,9304,12202,21506,1460,TRUE
typescript-dotnet,2.6.3,2.6.4,22,2,197,92,289,43,TRUE
typescript-dotnet,2.6.4,2.6.5,23,8,7821,6815,14636,697,TRUE
typescript-dotnet,2.6.6,2.7.0,25,13,4511,2927,7438,778,TRUE
typescript-dotnet,2.7.19,2.7.20,43,2,152,123,275,50,TRUE
typescript-dotnet,2.7.16,2.7.17,40,1,49,68,117,41,TRUE
typescript-dotnet,2.7.15,2.7.16,39,2,5,5,10,4,TRUE
typescript-dotnet,2.7.4,2.7.5,29,2,190,13,203,13,TRUE
typescript-dotnet,2.7.5,2.7.6,30,1,2,2,4,2,TRUE
typescript-dotnet,2.7.6,2.7.8,31,6,296,21841,22137,608,TRUE
typescript-dotnet,2.10.0,2.10.1,49,2,654,272,926,81,TRUE
typescript-dotnet,2.7.1,2.7.2,27,9,2802,1843,4645,293,TRUE
typescript-dotnet,2.7.2,2.7.4,28,16,1944,1777,3721,302,TRUE
typescript-dotnet,2.11.7,2.12.0,68,5,15535,6328,21863,1011,TRUE
typescript-dotnet,2.12.1,2.13.0,70,4,6177,5792,11969,1861,TRUE
typescript-dotnet,2.10.7,2.10.8,54,1,384,150,534,69,TRUE
typescript-dotnet,2.10.6,2.10.7,53,1,47,4,51,7,TRUE
typescript-dotnet,2.16.5,2.17.0,85,4,4444,729,5173,209,TRUE
concurrently,3.3.0,3.4.0,16,6,103,58,161,9,FALSE
concurrently,3.2.0,3.3.0,15,2,4,4,8,3,FALSE
concurrently,0.0.5,0.1.0,4,11,171,143,314,14,FALSE
concurrently,0.0.4,0.0.5,3,3,3,4,7,4,FALSE
concurrently,3.1.0,3.2.0,14,15,35,22,57,23,FALSE
concurrently,1.0.0,2.0.0,7,8,213,189,402,14,FALSE
concurrently,0.0.3,0.0.4,2,10,153,70,223,12,FALSE
concurrently,3.0.0,3.1.0,13,4,19,277,296,6,FALSE
concurrently,0.0.2,0.0.3,1,1,1,1,2,1,FALSE
concurrently,3.0.0-dev,3.0.0-rc1,11,7,110,88,198,17,FALSE
concurrently,2.0.0,2.1.0,8,9,165,75,240,15,FALSE
concurrently,3.0.0-rc1,3.0.0,12,1,1,3,4,2,FALSE
concurrently,2.2.0,3.0.0-dev,10,17,327,181,508,24,FALSE
concurrently,0.1.0,0.1.1,5,8,222,106,328,12,FALSE
concurrently,0.1.1,1.0.0,6,11,241,73,314,14,FALSE
concurrently,2.1.0,2.2.0,9,8,29,11,40,11,FALSE
concurrently,3.0.0-dev,3.0.0-rc1,11,7,110,88,198,17,TRUE
concurrently,3.0.0-rc1,3.0.0,12,1,1,3,4,2,TRUE
cfn-include,0.3.1,0.3.2,5,8,66,53,119,14,FALSE
cfn-include,0.3.2,0.3.3,6,1,22,18,40,3,FALSE
cfn-include,0.3.3,0.4.1,7,10,628,51,679,21,FALSE
cfn-include,0.3.0,0.3.1,4,6,196,35,231,12,FALSE
cfn-include,0.6.0,0.6.1,10,6,52,11,63,10,FALSE
cfn-include,0.8.1,0.8.2,18,2,2,2,4,2,TRUE
cfn-include,0.8.0,0.8.1,17,2,8,1,9,2,TRUE
cfn-include,0.7.0,0.7.1,15,3,16,2,18,4,FALSE
cfn-include,0.6.4,0.7.0,14,15,258,71,329,35,FALSE
cfn-include,0.4.1,0.5.0,8,20,529,88,617,45,FALSE
cfn-include,0.8.2,0.8.3,19,5,55,2,57,10,FALSE
cfn-include,0.6.1,0.6.2,11,5,12,6,18,5,FALSE
cfn-include,0.8.3,0.9.0,20,8,225,85,310,17,FALSE
cfn-include,0.2.0,0.3.0,3,4,274,35,309,13,FALSE
cfn-include,0.1.0,0.1.1,1,2,12,10,22,3,FALSE
cfn-include,0.1.1,0.2.0,2,4,229,12,241,13,FALSE
cfn-include,0.7.1,0.8.0,16,12,262,137,399,28,FALSE
cfn-include,0.5.0,0.6.0,9,10,313,84,397,20,FALSE
cfn-include,0.6.2,0.6.3,12,5,28,9,37,7,FALSE
cfn-include,0.6.3,0.6.4,13,4,34,4,38,6,FALSE
cfn-include,0.8.1,0.8.2,18,2,2,2,4,2,FALSE
cfn-include,0.8.0,0.8.1,17,2,8,1,9,2,FALSE
cfn-include,0.1.1,0.2.0,2,4,229,12,241,13,TRUE
cfn-include,0.7.1,0.8.0,16,12,262,137,399,28,TRUE
cfn-include,0.7.0,0.7.1,15,3,16,2,18,4,TRUE
cfn-include,0.2.0,0.3.0,3,4,274,35,309,13,TRUE
cfn-include,0.1.0,0.1.1,1,2,12,10,22,3,TRUE
react-page-object,1.0.4,1.0.5,5,1,1824,1528,3352,43,FALSE
react-page-object,1.0.5,1.0.6,6,3,103,15,118,11,FALSE
react-page-object,1.0.6,1.0.7,7,7,659,301,960,57,FALSE
react-page-object,1.0.7,1.0.8,8,3,17,17,34,7,FALSE
react-page-object,1.0.0,1.0.1,1,1,1824,1528,3352,43,FALSE
react-page-object,1.0.1,1.0.2,2,1,1824,1528,3352,43,FALSE
react-page-object,1.0.2,1.0.3,3,1,1824,1528,3352,43,FALSE
react-page-object,1.0.3,1.0.4,4,1,1824,1528,3352,43,FALSE
react-page-object,1.0.8,1.0.9,9,9,2145,163,2308,72,FALSE
react-page-object,1.0.9,1.0.10,10,2,6,6,12,6,FALSE
react-page-object,1.0.10,1.0.11,11,9,359,159,518,41,FALSE
react-page-object,1.0.11,1.0.12,12,5,2649,21,2670,61,FALSE
react-page-object,1.0.12,1.1.0,13,2,3648,3056,6704,86,FALSE
react-page-object,1.0.11,1.0.12,12,5,2649,21,2670,61,TRUE
react-page-object,1.0.6,1.0.7,7,7,659,301,960,57,TRUE
slate-plugins,1.1.1,1.2.0,6,1,8,9,17,3,FALSE
slate-plugins,1.1.0,1.1.1,5,1,3,3,6,2,FALSE
slate-plugins,1.0.0,1.1.0,4,7,13,12,25,11,FALSE
slate-plugins,1.4.0,1.5.0,9,3,234,52,286,24,FALSE
slate-plugins,1.5.5,1.6.0,14,1,11,2,13,2,FALSE
slate-plugins,1.5.4,1.5.5,13,1,2,2,4,2,FALSE
slate-plugins,1.5.1,1.5.3,11,5,205,43,248,13,FALSE
slate-plugins,1.5.0,1.5.1,10,1,5,6,11,2,FALSE
slate-plugins,1.5.3,1.5.4,12,1,5,3,8,2,FALSE
slate-plugins,1.6.0,1.7.0,15,3,24,13,37,6,FALSE
slate-plugins,1.3.0,1.4.0,8,2,10,22,32,12,FALSE
slate-plugins,1.2.0,1.3.0,7,2,596,21,617,62,FALSE
slate-plugins,1.7.1,1.7.2,17,1,2,2,4,2,FALSE
slate-plugins,1.7.0,1.7.1,16,2,2,2,4,2,FALSE
slate-plugins,0.1.0,0.1.1,2,3,2389,49,2438,10,FALSE
slate-plugins,0.1.1,1.0.0,3,9,949,2697,3646,93,FALSE
slate-plugins,0.0.0,0.1.0,1,2,790,1,791,36,FALSE
slate-plugins,1.5.3,1.5.4,12,1,5,3,8,2,TRUE
slate-plugins,1.2.0,1.3.0,7,2,596,21,617,62,TRUE
slate-plugins,1.0.0,1.1.0,4,7,13,12,25,11,TRUE
slate-plugins,1.6.0,1.7.0,15,3,24,13,37,6,TRUE
slate-plugins,1.7.0,1.7.1,16,2,2,2,4,2,TRUE
slate-plugins,1.5.0,1.5.1,10,1,5,6,11,2,TRUE
dropbox,0.9.1-beta2,0.9.1,21,1,38,4,42,2,FALSE
dropbox,0.10.0,0.10.1,24,1,38,4,42,2,FALSE
dropbox,0.9.1-beta1,0.9.1-beta2,20,1,38,4,42,2,TRUE
dropbox,0.9.1,0.9.2,22,1,38,4,42,2,FALSE
dropbox,0.10.1,0.10.2,25,1,38,4,42,2,FALSE
dropbox,0.9.2,0.10.0,23,1,38,4,42,2,FALSE
dropbox,0.10.2,0.10.3,26,1,38,4,42,2,FALSE
dropbox,2.0.0,2.1.0,28,36,2098,124,2222,74,FALSE
dropbox,2.3.0,2.4.0,31,4,226,201,427,17,FALSE
dropbox,2.5.3,2.5.4,36,13,39766,1141,40907,44,FALSE
dropbox,2.2.1,2.3.0,30,3,232,38,270,6,FALSE
dropbox,2.1.0,2.2.1,29,9,5912,948,6860,45,TRUE
dropbox,2.4.0,2.5.0,32,2,344,20,364,5,FALSE
dropbox,2.5.2,2.5.3,35,17,26391,118,26509,176,FALSE
dropbox,2.5.0,2.5.1,33,2,29,3,32,6,FALSE
dropbox,2.5.1,2.5.2,34,9,1522,304,1826,20,FALSE
dropbox,0.6.3,0.7.0,12,1,38,4,42,2,FALSE
dropbox,0.8.1,0.8.2,17,1,38,4,42,2,FALSE
dropbox,0.6.1,0.6.2,10,1,38,4,42,2,FALSE
dropbox,0.6.0,0.6.1,9,1,38,4,42,2,FALSE
dropbox,0.7.2,0.8.0,15,1,38,4,42,2,FALSE
dropbox,0.8.0,0.8.1,16,1,38,4,42,2,FALSE
dropbox,0.7.0,0.7.1,13,1,38,4,42,2,FALSE
dropbox,0.8.2,0.9.0,18,1,38,4,42,2,FALSE
dropbox,0.6.2,0.6.3,11,1,38,4,42,2,FALSE
dropbox,0.7.1,0.7.2,14,1,38,4,42,2,FALSE
dropbox,0.5.0,0.6.0,8,1,38,4,42,2,FALSE
dropbox,2.1.0,2.2.1,29,9,5912,948,6860,45,FALSE
dropbox,0.3.2,0.3.3,3,1,38,4,42,2,FALSE
dropbox,0.3.3,0.3.4,4,1,38,4,42,2,FALSE
dropbox,0.3.0,0.3.1,1,1,38,4,42,2,FALSE
dropbox,0.3.1,0.3.2,2,1,38,4,42,2,FALSE
dropbox,0.3.4,0.3.5,5,1,38,4,42,2,FALSE
dropbox,0.9.1-beta1,0.9.1-beta2,20,1,38,4,42,2,FALSE
dropbox,0.9.0,0.9.1-beta1,19,1,38,4,42,2,FALSE
dropbox,0.10.3,2.0.0,27,113,36000,30796,66796,325,FALSE
dropbox,0.6.1,0.6.2,10,1,38,4,42,2,TRUE
dropbox,0.7.0,0.7.1,13,1,38,4,42,2,TRUE
dropbox,0.10.2,0.10.3,26,1,38,4,42,2,TRUE
squeezebox,1.0.0,1.0.1,1,7,134,31,165,7,FALSE
squeezebox,1.0.1,1.0.2,2,4,5,3,8,4,FALSE
squeezebox,1.0.2,1.0.3,3,3,49,35,84,8,FALSE
squeezebox,1.0.4,1.0.5,5,1,3,3,6,1,FALSE
squeezebox,1.0.5,1.0.6,6,3,18,18,36,4,FALSE
squeezebox,1.0.6,1.0.7,7,6,91,60,151,12,FALSE
squeezebox,1.0.7,1.0.8,8,3,22,3,25,4,FALSE
squeezebox,1.0.3,1.0.4,4,6,13,14,27,6,FALSE
squeezebox,1.1.9,1.1.10,21,1,2,2,4,2,TRUE
squeezebox,1.1.8,1.1.9,20,1,28,6,34,4,FALSE
squeezebox,1.0.8,1.0.9,9,2,25,24,49,3,FALSE
squeezebox,1.0.9,1.0.10,10,1,2,2,4,2,FALSE
squeezebox,1.1.2,1.1.3,14,3,4,3,7,4,FALSE
squeezebox,1.1.5,1.1.6,17,1,2,2,4,1,FALSE
squeezebox,1.1.4,1.1.5,16,3,105,64,169,5,TRUE
squeezebox,1.1.7,1.1.8,19,1,13,13,26,1,FALSE
squeezebox,1.1.6,1.1.7,18,1,3,3,6,1,FALSE
squeezebox,1.0.10,1.1.0,11,5,6714,127,6841,22,FALSE
squeezebox,1.1.1,1.1.2,13,5,69,50,119,5,FALSE
squeezebox,1.1.0,1.1.1,12,2,2,2,4,2,FALSE
squeezebox,1.1.10,1.1.11,22,1,4,4,8,1,FALSE
squeezebox,1.1.3,1.1.4,15,3,14,6561,6575,12,TRUE
squeezebox,1.1.3,1.1.4,15,3,14,6561,6575,12,FALSE
squeezebox,1.1.9,1.1.10,21,1,2,2,4,2,FALSE
squeezebox,1.1.4,1.1.5,16,3,105,64,169,5,FALSE
squeezebox,1.0.4,1.0.5,5,1,3,3,6,1,TRUE
squeezebox,1.0.2,1.0.3,3,3,49,35,84,8,TRUE
squeezebox,1.0.8,1.0.9,9,2,25,24,49,3,TRUE
squeezebox,1.0.5,1.0.6,6,3,18,18,36,4,TRUE
squeezebox,1.0.1,1.0.2,2,4,5,3,8,4,TRUE
squeezebox,1.0.3,1.0.4,4,6,13,14,27,6,TRUE
squeezebox,1.1.7,1.1.8,19,1,13,13,26,1,TRUE
squeezebox,1.1.11,1.1.12,23,3,28,24,52,3,FALSE
tplant,1.0.1,1.0.2,1,1,54,18,72,4,FALSE
tplant,1.0.2,1.0.3,2,1,119,24,143,8,FALSE
tplant,1.0.3,1.0.4,3,1,41,70,111,8,FALSE
tplant,1.0.2,1.0.3,2,1,119,24,143,8,TRUE
tplant,1.0.3,1.0.4,3,1,41,70,111,8,TRUE
beanstalkify,0.0.1,0.0.2,1,1,3,4,7,3,FALSE
beanstalkify,0.0.2,0.0.3,2,2,53,40,93,6,FALSE
beanstalkify,1.4.0,1.5.0,16,2,3,3,6,2,FALSE
beanstalkify,2.0.1,2.1.0,19,2,5,1,6,3,FALSE
beanstalkify,2.0.0,2.0.1,18,2,2,2,4,2,FALSE
beanstalkify,1.5.0,2.0.0,17,4,11,14,25,11,FALSE
beanstalkify,1.3.0,1.4.0,15,2,4,1,5,2,FALSE
beanstalkify,1.2.0,1.3.0,14,3,3,8,11,6,FALSE
beanstalkify,1.1.0,1.2.0,13,6,277,9,286,21,FALSE
beanstalkify,1.0.0,1.1.0,12,3,142,4,146,10,FALSE
beanstalkify,0.0.5,0.0.6,5,8,30,13,43,10,FALSE
beanstalkify,0.0.4,0.0.5,4,1,8,3,11,3,FALSE
beanstalkify,0.0.7,0.0.8,7,3,43,8,51,6,FALSE
beanstalkify,0.0.6,0.0.7,6,4,1055,915,1970,38,FALSE
beanstalkify,0.0.3,0.0.4,3,1,19,35,54,4,FALSE
beanstalkify,0.0.9,0.0.10,9,2,14,6,20,6,FALSE
beanstalkify,0.0.8,0.0.9,8,1,3,2,5,2,FALSE
beanstalkify,0.0.11,1.0.0,11,20,1483,1232,2715,69,FALSE
beanstalkify,0.0.10,0.0.11,10,1,8,3,11,3,FALSE
beanstalkify,0.0.5,0.0.6,5,8,30,13,43,10,TRUE
beanstalkify,0.0.1,0.0.2,1,1,3,4,7,3,TRUE
beanstalkify,1.1.0,1.2.0,13,6,277,9,286,21,TRUE
beanstalkify,2.0.0,2.0.1,18,2,2,2,4,2,TRUE
beanstalkify,0.0.9,0.0.10,9,2,14,6,20,6,TRUE
beanstalkify,1.5.0,2.0.0,17,4,11,14,25,11,TRUE
beanstalkify,0.0.4,0.0.5,4,1,8,3,11,3,TRUE
beanstalkify,0.0.11,1.0.0,11,20,1483,1232,2715,69,TRUE
beanstalkify,0.0.7,0.0.8,7,3,43,8,51,6,TRUE
react-pagination-status,1.0.4,1.0.5,5,1,5,5,10,1,FALSE
react-pagination-status,1.0.5,1.0.6,6,1,5,5,10,1,FALSE
react-pagination-status,1.0.6,1.0.7,7,1,5,5,10,1,FALSE
react-pagination-status,1.0.7,1.0.8,8,1,5,5,10,1,FALSE
react-pagination-status,1.0.0,1.0.1,1,1,12,10,22,2,FALSE
react-pagination-status,1.0.1,1.0.2,2,1,5,5,10,1,FALSE
react-pagination-status,1.0.2,1.0.3,3,2,109,16,125,4,FALSE
react-pagination-status,1.0.3,1.0.4,4,1,5,5,10,1,FALSE
react-pagination-status,1.1.0,1.1.1,11,1,110,1,111,6,FALSE
react-pagination-status,1.0.8,1.0.9,9,2,157,23,180,8,FALSE
react-pagination-status,1.0.9,1.1.0,10,1,5,5,10,1,FALSE
react-pagination-status,1.1.2,1.1.3,13,7,12834,115,12949,60,FALSE
react-pagination-status,1.1.1,1.1.2,12,8,4951,517,5468,18,FALSE
react-pagination-status,1.0.9,1.1.0,10,1,5,5,10,1,TRUE
sandcrawler,0.0.1,0.1.0-rc1,1,147,9935,8064,17999,466,FALSE
sandcrawler,0.0.1,0.1.0-rc1,1,147,9935,8064,17999,466,TRUE
react-dom-stylesheet,0.8.6,0.8.7,20,2,14,4,18,4,FALSE
react-dom-stylesheet,0.8.5,0.8.6,19,2,9,1,10,2,FALSE
react-dom-stylesheet,0.8.4,0.8.5,18,2,2,1,3,2,TRUE
react-dom-stylesheet,0.8.7,0.8.8,21,2,3,3,6,2,FALSE
react-dom-stylesheet,0.6.0,0.7.0,12,3,7,3,10,3,FALSE
react-dom-stylesheet,0.8.1,0.8.2,15,4,6,14,20,4,FALSE
react-dom-stylesheet,0.8.0,0.8.1,14,2,2,2,4,2,FALSE
react-dom-stylesheet,0.7.0,0.8.0,13,7,442,194,636,21,FALSE
react-dom-stylesheet,0.8.2,0.8.3,16,2,2,1,3,2,FALSE
react-dom-stylesheet,0.8.3,0.8.4,17,2,2,2,4,2,FALSE
react-dom-stylesheet,0.5.0,0.5.1,9,2,2,2,4,2,FALSE
react-dom-stylesheet,0.5.1,0.5.2,10,2,25,7,32,3,FALSE
react-dom-stylesheet,0.5.2,0.6.0,11,2,4,88,92,3,FALSE
react-dom-stylesheet,0.2.1,0.3.0,5,3,35,1,36,3,FALSE
react-dom-stylesheet,0.2.0,0.2.1,4,2,2,2,4,2,FALSE
react-dom-stylesheet,0.1.0,0.1.1,1,2,2,1,3,2,FALSE
react-dom-stylesheet,0.1.1,0.1.2,2,2,6,2,8,2,FALSE
react-dom-stylesheet,0.1.2,0.2.0,3,4,172,182,354,9,FALSE
react-dom-stylesheet,0.3.0,0.3.1,6,2,68,28,96,3,FALSE
react-dom-stylesheet,0.3.1,0.4.0,7,2,5,1,6,2,FALSE
react-dom-stylesheet,0.4.0,0.5.0,8,4,35,41,76,10,FALSE
react-dom-stylesheet,0.8.4,0.8.5,18,2,2,1,3,2,FALSE
react-dom-stylesheet,0.1.0,0.1.1,1,2,2,1,3,2,TRUE
react-dom-stylesheet,0.6.0,0.7.0,12,3,7,3,10,3,TRUE
react-dom-stylesheet,0.4.0,0.5.0,8,4,35,41,76,10,TRUE
react-dom-stylesheet,0.1.2,0.2.0,3,4,172,182,354,9,TRUE
uikit-react,0.0.7,0.0.8,7,5,70,169,239,11,FALSE
uikit-react,0.0.9,0.0.10,9,1,6,6,12,2,FALSE
uikit-react,0.0.8,0.0.9,8,2,2,2,4,2,FALSE
uikit-react,1.0.0,2.0.0,36,26,834,454,1288,45,FALSE
uikit-react,2.0.0,2.1.0,37,30,297,306,603,43,FALSE
uikit-react,3.0.0-beta.4,3.0.0-beta.5,48,1,4,2,6,2,FALSE
uikit-react,3.0.0-beta.0,3.0.0-beta.1,44,5,872,869,1741,11,FALSE
uikit-react,3.0.0-beta.1,3.0.0-beta.2,45,1,4,2,6,2,FALSE
uikit-react,3.0.0-beta.2,3.0.0-beta.3,46,2,3,1,4,2,FALSE
uikit-react,0.0.10,0.1.0-alpha.0,10,97,1954,8924,10878,376,FALSE
uikit-react,0.2.0,0.3.0,17,5,10,26,36,9,FALSE
uikit-react,0.1.0,0.1.1,14,2,5,2,7,2,FALSE
uikit-react,0.1.1,0.1.2,15,1,3,3,6,3,FALSE
uikit-react,0.1.2,0.2.0,16,3,129,126,255,8,FALSE
uikit-react,2.1.1,2.2.0,39,20,539,264,803,26,FALSE
uikit-react,2.1.0,2.1.1,38,30,1046,752,1798,37,FALSE
uikit-react,0.0.5,0.0.6,5,6,133,37,170,17,FALSE
uikit-react,0.0.4,0.0.5,4,24,613,698,1311,64,FALSE
uikit-react,0.6.9,0.6.10,31,1,4,2,6,2,FALSE
uikit-react,0.6.8,0.6.9,30,1,4,2,6,2,FALSE
uikit-react,0.0.1,0.0.2,1,17,4294,79,4373,86,FALSE
uikit-react,0.0.3,0.0.4,3,4,18,18,36,7,FALSE
uikit-react,0.0.2,0.0.3,2,1,11,11,22,3,FALSE
uikit-react,0.6.3,0.6.4,25,6,19,18,37,9,FALSE
uikit-react,0.6.2,0.6.3,24,4,4,4,8,4,FALSE
uikit-react,0.3.0,0.4.0,18,11,1063,69,1132,29,FALSE
uikit-react,0.6.0,0.6.1,22,2,63,9,72,9,FALSE
uikit-react,0.6.7,0.6.8,29,1,4,2,6,2,FALSE
uikit-react,0.6.6,0.6.7,28,1,4,2,6,2,FALSE
uikit-react,0.6.5,0.6.6,27,1,1,1,2,1,FALSE
uikit-react,0.6.4,0.6.5,26,2,2,2,4,2,FALSE
uikit-react,3.0.0-beta.5,3.0.0-beta.6,49,1,7,2,9,2,FALSE
uikit-react,0.4.1,0.5.0,20,2,37,159,196,9,FALSE
uikit-react,0.4.0,0.4.1,19,5,386,156,542,13,FALSE
uikit-react,0.5.0,0.6.0,21,7,268,11,279,18,FALSE
uikit-react,2.3.0,2.3.1,41,21,637,518,1155,64,FALSE
uikit-react,2.3.1,2.3.2,42,96,1974,1849,3823,172,FALSE
uikit-react,0.0.6,0.0.7,6,46,1557,2051,3608,165,FALSE
uikit-react,0.1.0-alpha.1,0.1.0-alpha.2,12,1,1,1,2,1,FALSE
uikit-react,0.1.0-alpha.0,0.1.0-alpha.1,11,10,45,35,80,14,FALSE
uikit-react,0.1.0-alpha.2,0.1.0,13,18,2372,488,2860,66,FALSE
uikit-react,3.0.0-beta.3,3.0.0-beta.4,47,78,399,273,672,88,FALSE
uikit-react,0.6.13,1.0.0,35,102,6608,1664,8272,139,FALSE
uikit-react,0.6.12,0.6.13,34,5,5,5,10,5,FALSE
uikit-react,0.6.11,0.6.12,33,10,13,11,24,11,FALSE
uikit-react,0.6.10,0.6.11,32,2,2,2,4,2,FALSE
uikit-react,0.6.1,0.6.2,23,2,16,7,23,5,FALSE
uikit-react,2.2.0,2.3.0,40,13,1106,1015,2121,40,FALSE
uikit-react,0.6.2,0.6.3,24,4,4,4,8,4,TRUE
uikit-react,0.1.0-alpha.2,0.1.0,13,18,2372,488,2860,66,TRUE
uikit-react,0.6.11,0.6.12,33,10,13,11,24,11,TRUE
uikit-react,0.3.0,0.4.0,18,11,1063,69,1132,29,TRUE
uikit-react,0.6.4,0.6.5,26,2,2,2,4,2,TRUE
uikit-react,3.0.0-beta.2,3.0.0-beta.3,46,2,3,1,4,2,TRUE
uikit-react,0.2.0,0.3.0,17,5,10,26,36,9,TRUE
uikit-react,0.6.1,0.6.2,23,2,16,7,23,5,TRUE
uikit-react,0.1.2,0.2.0,16,3,129,126,255,8,TRUE
uikit-react,0.6.12,0.6.13,34,5,5,5,10,5,TRUE
uikit-react,0.6.13,1.0.0,35,102,6608,1664,8272,139,TRUE
uikit-react,2.1.0,2.1.1,38,30,1046,752,1798,37,TRUE
uikit-react,0.5.0,0.6.0,21,7,268,11,279,18,TRUE
react-split-pane,0.1.20,0.1.22,25,7,57,7,64,9,FALSE
react-split-pane,0.1.16,0.1.17,21,3,236,210,446,6,FALSE
react-split-pane,0.1.17,0.1.18,22,2,7,8,15,2,FALSE
react-split-pane,0.1.14,0.1.15,19,5,34,48,82,6,FALSE
react-split-pane,0.1.15,0.1.16,20,5,13,17,30,5,FALSE
react-split-pane,0.1.18,0.1.19,23,3,7,7,14,3,FALSE
react-split-pane,0.1.19,0.1.20,24,4,11,14,25,4,FALSE
react-split-pane,0.1.8,0.1.9,14,10,1312,1069,2381,29,FALSE
react-split-pane,0.1.9,0.1.10,15,7,329,537,866,16,FALSE
react-split-pane,0.1.0,0.1.1,7,2,2,2,4,2,FALSE
react-split-pane,0.1.1,0.1.2,8,2,3,2,5,2,FALSE
react-split-pane,0.1.2,0.1.4,9,2,2,2,4,2,FALSE
react-split-pane,0.1.4,0.1.5,10,12,165,139,304,13,FALSE
react-split-pane,0.1.5,0.1.6,11,2,5,2,7,3,FALSE
react-split-pane,0.1.6,0.1.7,12,3,267,296,563,5,FALSE
react-split-pane,0.1.7,0.1.8,13,2,139,103,242,3,FALSE
react-split-pane,0.0.5,0.0.6,3,2,2,2,4,2,FALSE
react-split-pane,0.0.4,0.0.5,2,4,3551,786,4337,13,FALSE
react-split-pane,0.0.7,0.0.8,5,2,1,10,11,2,FALSE
react-split-pane,0.0.6,0.0.7,4,2,1,4,5,4,FALSE
react-split-pane,0.0.3,0.0.4,1,4,183,166,349,6,FALSE
react-split-pane,0.0.8,0.1.0,6,2,208,3179,3387,9,FALSE
react-split-pane,0.1.13,0.1.14,18,6,7122,7841,14963,14,FALSE
react-split-pane,0.1.10,0.1.11,16,4,11,14,25,6,FALSE
react-split-pane,0.1.11,0.1.13,17,7,117,49,166,9,FALSE
react-split-pane,0.1.62,0.1.63,62,3,6,7,13,4,FALSE
react-split-pane,0.1.61,0.1.62,61,3,1133,755,1888,7,FALSE
react-split-pane,0.1.60,0.1.61,60,5,212,171,383,4,FALSE
react-split-pane,0.1.58,0.1.59,58,3,4,1,5,3,FALSE
react-split-pane,0.1.59,0.1.60,59,2,146,172,318,5,FALSE
react-split-pane,0.1.56,0.1.57,56,3,7,7,14,3,FALSE
react-split-pane,0.1.57,0.1.58,57,4,1541,1325,2866,5,FALSE
react-split-pane,0.1.54,0.1.55,54,2,5,2,7,2,FALSE
react-split-pane,0.1.55,0.1.56,55,3,9,6,15,3,FALSE
react-split-pane,0.1.52,0.1.53,52,3,16877,16987,33864,4,FALSE
react-split-pane,0.1.53,0.1.54,53,2,6,6,12,3,FALSE
react-split-pane,0.1.51,0.1.52,51,4,264,269,533,8,FALSE
react-split-pane,0.1.29,0.1.30,33,11,1188,709,1897,28,FALSE
react-split-pane,0.1.28,0.1.29,32,3,46,48,94,4,FALSE
react-split-pane,0.1.49,0.1.50,49,11,1173,480,1653,27,FALSE
react-split-pane,0.1.48,0.1.49,48,3,196,250,446,3,FALSE
react-split-pane,0.1.45,0.1.46,45,5,3,5,8,5,FALSE
react-split-pane,0.1.44,0.1.45,44,24,48357,48121,96478,41,FALSE
react-split-pane,0.1.47,0.1.48,47,3,1327,869,2196,19,FALSE
react-split-pane,0.1.46,0.1.47,46,4,93,105,198,6,FALSE
react-split-pane,0.1.40,0.1.42,41,5,5,5,10,5,FALSE
react-split-pane,0.1.43,0.1.44,43,17,3164,2348,5512,34,FALSE
react-split-pane,0.1.42,0.1.43,42,4,2744,1825,4569,8,FALSE
react-split-pane,0.1.38,0.1.40,40,8,30,28,58,12,FALSE
react-split-pane,0.1.35,0.1.36,37,10,5466,4813,10279,28,FALSE
react-split-pane,0.1.36,0.1.37,38,5,112,4,116,11,FALSE
react-split-pane,0.1.37,0.1.38,39,5,8,12,20,5,FALSE
react-split-pane,0.1.30,0.1.31,34,14,8845,8667,17512,38,FALSE
react-split-pane,0.1.31,0.1.33,35,3,65,11,76,7,FALSE
react-split-pane,0.1.33,0.1.35,36,5,15549,15180,30729,26,FALSE
react-split-pane,0.1.50,0.1.51,50,4,7799,1093,8892,19,FALSE
react-split-pane,0.1.8,0.1.9,14,10,1312,1069,2381,29,TRUE
react-split-pane,0.1.9,0.1.10,15,7,329,537,866,16,TRUE
react-split-pane,0.1.2,0.1.4,9,2,2,2,4,2,TRUE
react-split-pane,0.1.29,0.1.30,33,11,1188,709,1897,28,TRUE
react-split-pane,0.1.23,0.1.24,27,13,15391,15357,30748,15,FALSE
react-split-pane,0.1.22,0.1.23,26,9,67,25,92,12,FALSE
react-split-pane,0.1.27,0.1.28,31,17,1107,937,2044,36,FALSE
react-split-pane,0.1.26,0.1.27,30,2,61,13,74,7,FALSE
react-split-pane,0.1.25,0.1.26,29,10,27,28,55,10,FALSE
react-split-pane,0.1.24,0.1.25,28,8,488,50,538,18,FALSE
react-split-pane,0.1.30,0.1.31,34,14,8845,8667,17512,38,TRUE
react-split-pane,0.1.49,0.1.50,49,11,1173,480,1653,27,TRUE
react-split-pane,0.1.26,0.1.27,30,2,61,13,74,7,TRUE
react-split-pane,0.1.47,0.1.48,47,3,1327,869,2196,19,TRUE
react-split-pane,0.1.46,0.1.47,46,4,93,105,198,6,TRUE
react-split-pane,0.1.40,0.1.42,41,5,5,5,10,5,TRUE
react-split-pane,0.1.37,0.1.38,39,5,8,12,20,5,TRUE
react-split-pane,0.1.33,0.1.35,36,5,15549,15180,30729,26,TRUE
react-split-pane,0.1.58,0.1.59,58,3,4,1,5,3,TRUE
react-split-pane,0.1.24,0.1.25,28,8,488,50,538,18,TRUE
react-split-pane,0.1.35,0.1.36,37,10,5466,4813,10279,28,TRUE
react-split-pane,0.1.23,0.1.24,27,13,15391,15357,30748,15,TRUE
react-split-pane,0.1.5,0.1.6,11,2,5,2,7,3,TRUE
react-split-pane,0.1.45,0.1.46,45,5,3,5,8,5,TRUE
relayr-browser-sdk,2.0.2,2.0.10,3,80,12337,13547,25884,140,FALSE
relayr-browser-sdk,2.0.1,2.0.2,2,2,1,2,3,2,FALSE
relayr-browser-sdk,2.0.0,2.0.1,1,8,108,40,148,8,FALSE
relayr-browser-sdk,2.0.40,2.0.41,21,7,2383,2184,4567,25,FALSE
relayr-browser-sdk,2.0.41,2.0.42,22,4,46,21,67,8,FALSE
relayr-browser-sdk,2.0.27,2.0.29,13,12,1997,107,2104,31,FALSE
relayr-browser-sdk,2.0.25,2.0.27,12,11,274,95,369,24,FALSE
relayr-browser-sdk,2.0.23,2.0.25,11,17,1446,510,1956,42,FALSE
relayr-browser-sdk,2.0.21,2.0.23,10,8,127,28,155,25,FALSE
relayr-browser-sdk,2.0.29,2.0.30,14,1,24,26,50,3,FALSE
relayr-browser-sdk,2.0.35,2.0.36,18,5,4064,2309,6373,40,FALSE
relayr-browser-sdk,2.0.36,2.0.38,19,24,5965,2145,8110,94,FALSE
relayr-browser-sdk,2.0.31,2.0.33,16,4,901,5636,6537,36,FALSE
relayr-browser-sdk,2.0.30,2.0.31,15,9,10902,11711,22613,57,FALSE
relayr-browser-sdk,2.0.33,2.0.35,17,8,5650,21,5671,13,FALSE
relayr-browser-sdk,2.0.18,2.0.21,9,6,98,46,144,14,FALSE
relayr-browser-sdk,2.0.17,2.0.18,8,5,104,79,183,11,FALSE
relayr-browser-sdk,2.0.15,2.0.17,7,7,526,303,829,22,FALSE
relayr-browser-sdk,2.0.14,2.0.15,6,2,241,428,669,3,FALSE
relayr-browser-sdk,2.0.38,2.0.40,20,6,2174,333,2507,20,FALSE
relayr-browser-sdk,2.0.11,2.0.14,5,12,1146,508,1654,36,FALSE
relayr-browser-sdk,2.0.10,2.0.11,4,17,1267,618,1885,58,FALSE
relayr-browser-sdk,2.0.38,2.0.40,20,6,2174,333,2507,20,TRUE
relayr-browser-sdk,2.0.40,2.0.41,21,7,2383,2184,4567,25,TRUE
relayr-browser-sdk,2.0.2,2.0.10,3,80,12337,13547,25884,140,TRUE
react-injectables,4.0.1,4.0.2,10,3,47,47,94,5,FALSE
react-injectables,4.0.0,4.0.1,9,2,21,16,37,2,FALSE
react-injectables,3.1.1,4.0.0,8,3,967,433,1400,21,FALSE
react-injectables,3.1.0,3.1.1,7,1,141,57,198,6,FALSE
react-injectables,1.0.0,1.0.1,2,1,273,3,276,15,FALSE
react-injectables,0.0.0,1.0.0,1,4,1050,6,1056,22,FALSE
react-injectables,3.0.0,3.0.1,5,2,20,11,31,2,FALSE
react-injectables,3.0.1,3.1.0,6,3,34,9,43,5,FALSE
react-injectables,2.0.0,3.0.0,4,1,145,89,234,11,FALSE
react-injectables,1.0.1,2.0.0,3,16,575,409,984,32,FALSE
react-injectables,3.1.1,4.0.0,8,3,967,433,1400,21,TRUE
resilient,0.2.26,0.2.27,45,8,26,28,54,17,TRUE
resilient,0.2.27,0.2.28,46,9,43,35,78,19,FALSE
resilient,0.2.24,0.2.25,43,9,480,480,960,24,FALSE
resilient,0.2.25,0.2.26,44,15,452,427,879,43,FALSE
resilient,0.2.22,0.2.23,41,7,81,47,128,26,FALSE
resilient,0.2.23,0.2.24,42,17,101,105,206,37,FALSE
resilient,0.2.20,0.2.21,39,15,767,498,1265,41,FALSE
resilient,0.2.21,0.2.22,40,11,255,142,397,36,TRUE
resilient,0.3.0-rc.0,0.3.0,48,13,246,88,334,39,FALSE
resilient,0.2.28,0.3.0-rc.0,47,28,1604,979,2583,93,FALSE
resilient,0.1.8,0.1.9,14,3,114,44,158,20,FALSE
resilient,0.1.9,0.1.10,15,8,99,54,153,38,FALSE
resilient,0.2.5,0.2.6,24,12,162,127,289,36,TRUE
resilient,0.2.4,0.2.5,23,4,286,91,377,22,FALSE
resilient,0.2.3,0.2.4,22,7,43,39,82,21,FALSE
resilient,0.2.2,0.2.3,21,8,69,54,123,23,FALSE
resilient,0.2.1,0.2.2,20,10,131,43,174,25,FALSE
resilient,0.2.0,0.2.1,19,8,28,32,60,23,FALSE
resilient,0.1.0,0.1.1,6,6,393,108,501,33,FALSE
resilient,0.1.1,0.1.2,7,8,20,21,41,18,FALSE
resilient,0.1.2,0.1.3,8,2,41,11,52,13,FALSE
resilient,0.1.3,0.1.4,9,3,10,10,20,10,FALSE
resilient,0.1.4,0.1.5,10,17,96,97,193,30,FALSE
resilient,0.1.5,0.1.6,11,9,278,28,306,29,FALSE
resilient,0.1.6,0.1.7,12,13,384,147,531,54,TRUE
resilient,0.1.7,0.1.8,13,16,256,137,393,52,TRUE
resilient,0.3.2,0.3.3,51,15,68,25,93,25,FALSE
resilient,0.3.3,0.3.4,52,5,171,94,265,29,FALSE
resilient,0.3.0,0.3.1,49,37,367,211,578,63,FALSE
resilient,0.3.1,0.3.2,50,20,695,652,1347,56,FALSE
resilient,0.2.9,0.2.10,28,5,160,56,216,19,FALSE
resilient,0.2.8,0.2.9,27,18,290,88,378,44,FALSE
resilient,0.2.19,0.2.20,38,12,254,110,364,35,FALSE
resilient,0.2.18,0.2.19,37,7,138,20,158,14,FALSE
resilient,0.2.17,0.2.18,36,7,190,136,326,22,TRUE
resilient,0.2.16,0.2.17,35,4,407,62,469,23,FALSE
resilient,0.2.15,0.2.16,34,4,159,28,187,22,FALSE
resilient,0.2.14,0.2.15,33,16,709,160,869,39,FALSE
resilient,0.2.13,0.2.14,32,9,40,32,72,19,FALSE
resilient,0.2.12,0.2.13,31,7,526,203,729,48,FALSE
resilient,0.2.11,0.2.12,30,1,30,24,54,9,FALSE
resilient,0.2.10,0.2.11,29,6,36,24,60,16,FALSE
resilient,0.1.0-beta.2,0.1.0-beta.3,3,6,423,163,586,26,FALSE
resilient,0.1.0-beta.3,0.1.0-beta.4,4,7,181,104,285,23,FALSE
resilient,0.1.0-beta.0,0.1.0-beta.1,1,9,263,31,294,28,TRUE
resilient,0.1.0-beta.1,0.1.0-beta.2,2,5,51,38,89,23,FALSE
resilient,0.1.0-beta.4,0.1.0,5,12,458,119,577,56,FALSE
resilient,0.1.12,0.2.0,18,29,3002,1422,4424,166,FALSE
resilient,0.2.7,0.2.8,26,2,25,30,55,10,FALSE
resilient,0.1.10,0.1.11,16,3,42,22,64,13,FALSE
resilient,0.1.11,0.1.12,17,18,483,240,723,75,FALSE
resilient,0.2.6,0.2.7,25,3,120,84,204,17,FALSE
resilient,0.2.26,0.2.27,45,8,26,28,54,17,FALSE
resilient,0.2.21,0.2.22,40,11,255,142,397,36,FALSE
resilient,0.2.17,0.2.18,36,7,190,136,326,22,FALSE
resilient,0.2.5,0.2.6,24,12,162,127,289,36,FALSE
resilient,0.2.3,0.2.4,22,7,43,39,82,21,TRUE
resilient,0.1.6,0.1.7,12,13,384,147,531,54,FALSE
resilient,0.1.7,0.1.8,13,16,256,137,393,52,FALSE
resilient,0.1.0-beta.0,0.1.0-beta.1,1,9,263,31,294,28,FALSE
resilient,0.1.0-beta.4,0.1.0,5,12,458,119,577,56,TRUE
resilient,0.1.5,0.1.6,11,9,278,28,306,29,TRUE
resilient,0.2.20,0.2.21,39,15,767,498,1265,41,TRUE
cezerin-client,0.3.0,0.4.1,82,1,26,1,27,3,FALSE
cezerin-client,0.1.38,0.1.39,39,1,84,30,114,6,FALSE
cezerin-client,0.1.39,0.1.40,40,1,84,30,114,6,FALSE
cezerin-client,0.1.34,0.1.35,35,1,84,30,114,6,FALSE
cezerin-client,0.1.35,0.1.36,36,1,84,30,114,6,FALSE
cezerin-client,0.1.36,0.1.37,37,1,84,30,114,6,FALSE
cezerin-client,0.1.37,0.1.38,38,1,84,30,114,6,FALSE
cezerin-client,0.1.30,0.1.31,31,1,84,30,114,6,FALSE
cezerin-client,0.1.31,0.1.32,32,1,84,30,114,6,FALSE
cezerin-client,0.1.32,0.1.33,33,1,84,30,114,6,FALSE
cezerin-client,0.1.33,0.1.34,34,1,84,30,114,6,FALSE
cezerin-client,0.1.29,0.1.30,30,1,84,30,114,6,FALSE
cezerin-client,0.1.28,0.1.29,29,1,7,7,14,2,FALSE
cezerin-client,0.1.23,0.1.24,24,2,22,20,42,4,FALSE
cezerin-client,0.1.22,0.1.23,23,2,34,10,44,5,FALSE
cezerin-client,0.1.21,0.1.22,22,1,84,30,114,6,FALSE
cezerin-client,0.1.20,0.1.21,21,1,6,9,15,3,FALSE
cezerin-client,0.1.27,0.1.28,28,1,84,30,114,6,FALSE
cezerin-client,0.1.26,0.1.27,27,1,84,30,114,6,FALSE
cezerin-client,0.1.25,0.1.26,26,1,84,30,114,6,FALSE
cezerin-client,0.1.24,0.1.25,25,1,6,5,11,2,FALSE
cezerin-client,0.4.10,0.4.12,91,1,84,30,114,6,FALSE
cezerin-client,0.4.13,0.4.14,93,1,10,6,16,3,FALSE
cezerin-client,0.4.12,0.4.13,92,1,66,4,70,6,FALSE
cezerin-client,0.4.15,0.4.16,95,3,56,2,58,8,FALSE
cezerin-client,0.4.14,0.4.15,94,1,1,1,2,1,FALSE
cezerin-client,0.4.17,0.4.18,97,2,7,7,14,4,FALSE
cezerin-client,0.4.16,0.4.17,96,1,84,30,114,6,FALSE
cezerin-client,0.4.19,0.4.20,99,1,17,17,34,4,FALSE
cezerin-client,0.4.18,0.4.19,98,1,84,30,114,6,FALSE
cezerin-client,0.1.73,0.1.74,73,1,28,30,58,8,FALSE
cezerin-client,0.1.58,0.1.59,59,1,84,30,114,6,FALSE
cezerin-client,0.1.41,0.1.42,42,1,84,30,114,6,FALSE
cezerin-client,0.1.56,0.1.57,57,1,84,30,114,6,FALSE
cezerin-client,0.1.57,0.1.58,58,1,84,30,114,6,FALSE
cezerin-client,0.1.54,0.1.55,55,1,84,30,114,6,FALSE
cezerin-client,0.1.55,0.1.56,56,1,84,30,114,6,FALSE
cezerin-client,0.1.52,0.1.53,53,1,84,30,114,6,FALSE
cezerin-client,0.1.53,0.1.54,54,1,84,30,114,6,FALSE
cezerin-client,0.1.50,0.1.51,51,1,84,30,114,6,FALSE
cezerin-client,0.1.51,0.1.52,52,1,84,30,114,6,FALSE
cezerin-client,0.4.28,0.4.29,108,1,35,2,37,4,FALSE
cezerin-client,0.4.29,0.4.30,109,1,2,1,3,2,FALSE
cezerin-client,0.4.24,0.4.25,104,2,41,4,45,5,FALSE
cezerin-client,0.4.25,0.4.26,105,1,11,1,12,3,FALSE
cezerin-client,0.4.26,0.4.27,106,1,84,30,114,6,FALSE
cezerin-client,0.4.27,0.4.28,107,1,26,11,37,5,FALSE
cezerin-client,0.4.20,0.4.21,100,1,84,30,114,6,FALSE
cezerin-client,0.4.21,0.4.22,101,2,19,4,23,5,FALSE
cezerin-client,0.4.22,0.4.23,102,1,1,2,3,2,FALSE
cezerin-client,0.4.23,0.4.24,103,1,4,1,5,1,FALSE
cezerin-client,0.1.40,0.1.41,41,1,84,30,114,6,FALSE
cezerin-client,0.4.9,0.4.10,90,1,84,30,114,6,FALSE
cezerin-client,0.1.49,0.1.50,50,1,84,30,114,6,FALSE
cezerin-client,0.1.48,0.1.49,49,1,84,30,114,6,FALSE
cezerin-client,0.4.1,0.4.2,83,1,198,5,203,8,FALSE
cezerin-client,0.1.44,0.1.45,45,1,84,30,114,6,FALSE
cezerin-client,0.1.47,0.1.48,48,1,84,30,114,6,FALSE
cezerin-client,0.1.46,0.1.47,47,1,84,30,114,6,FALSE
cezerin-client,0.13.2,0.13.3,125,1,84,30,114,6,FALSE
cezerin-client,0.4.4,0.4.5,86,1,84,30,114,6,FALSE
cezerin-client,0.1.43,0.1.44,44,1,84,30,114,6,FALSE
cezerin-client,0.1.42,0.1.43,43,1,90,21,111,7,FALSE
cezerin-client,0.4.39,0.4.40,119,1,84,30,114,6,FALSE
cezerin-client,0.4.38,0.4.39,118,1,11,1,12,3,FALSE
cezerin-client,0.14.1,0.14.2,128,1,3,4,7,3,FALSE
cezerin-client,0.14.0,0.14.1,127,4,27,8,35,5,FALSE
cezerin-client,0.4.33,0.4.34,113,3,6,16,22,3,FALSE
cezerin-client,0.4.32,0.4.33,112,1,84,30,114,6,FALSE
cezerin-client,0.4.31,0.4.32,111,3,43,10,53,5,FALSE
cezerin-client,0.4.30,0.4.31,110,1,1,1,2,1,FALSE
cezerin-client,0.4.37,0.4.38,117,1,84,30,114,6,FALSE
cezerin-client,0.4.36,0.4.37,116,1,7,7,14,3,FALSE
cezerin-client,0.4.35,0.4.36,115,1,84,30,114,6,FALSE
cezerin-client,0.4.34,0.4.35,114,1,84,30,114,6,FALSE
cezerin-client,0.1.45,0.1.46,46,1,84,30,114,6,FALSE
cezerin-client,0.4.3,0.4.4,85,1,84,30,114,6,FALSE
cezerin-client,0.4.2,0.4.3,84,1,10,6,16,3,FALSE
cezerin-client,0.4.5,0.4.6,87,1,84,30,114,6,FALSE
cezerin-client,0.13.3,0.14.0,126,1,7,9,16,4,FALSE
cezerin-client,0.4.7,0.4.9,89,1,84,30,114,6,FALSE
cezerin-client,0.1.70,0.1.71,70,1,84,30,114,6,FALSE
cezerin-client,0.1.71,0.1.72,71,1,84,30,114,6,FALSE
cezerin-client,0.1.72,0.1.73,72,1,84,30,114,6,FALSE
cezerin-client,0.13.1,0.13.2,124,2,13,1,14,5,FALSE
cezerin-client,0.1.74,0.1.75,74,1,84,30,114,6,FALSE
cezerin-client,0.1.75,0.1.76,75,1,84,30,114,6,FALSE
cezerin-client,0.1.76,0.1.77,76,1,42,7,49,6,FALSE
cezerin-client,0.1.8,0.1.9,9,1,84,30,114,6,FALSE
cezerin-client,0.1.9,0.1.10,10,1,84,30,114,6,FALSE
cezerin-client,0.2.3,0.3.0,81,11,354,161,515,45,FALSE
cezerin-client,0.2.2,0.2.3,80,1,48,1,49,4,FALSE
cezerin-client,0.2.1,0.2.2,79,1,84,30,114,6,FALSE
cezerin-client,0.2.0,0.2.1,78,1,84,30,114,6,FALSE
cezerin-client,0.1.0,0.1.1,1,1,84,30,114,6,FALSE
cezerin-client,0.1.1,0.1.2,2,1,84,30,114,6,FALSE
cezerin-client,0.1.2,0.1.3,3,1,84,30,114,6,FALSE
cezerin-client,0.1.3,0.1.4,4,1,84,30,114,6,FALSE
cezerin-client,0.1.4,0.1.5,5,1,84,30,114,6,FALSE
cezerin-client,0.1.5,0.1.6,6,1,84,30,114,6,FALSE
cezerin-client,0.1.6,0.1.7,7,1,84,30,114,6,FALSE
cezerin-client,0.1.7,0.1.8,8,1,84,30,114,6,FALSE
cezerin-client,0.1.67,0.1.68,67,1,84,30,114,6,FALSE
cezerin-client,0.1.66,0.1.67,66,1,84,30,114,6,FALSE
cezerin-client,0.1.65,0.1.66,65,1,84,30,114,6,FALSE
cezerin-client,0.1.64,0.1.65,64,1,84,30,114,6,FALSE
cezerin-client,0.1.63,0.1.64,63,1,84,30,114,6,FALSE
cezerin-client,0.1.62,0.1.63,62,1,84,30,114,6,FALSE
cezerin-client,0.1.61,0.1.62,61,1,84,30,114,6,FALSE
cezerin-client,0.4.42,0.13.0,122,1,84,30,114,6,FALSE
cezerin-client,0.1.69,0.1.70,69,1,84,30,114,6,FALSE
cezerin-client,0.1.68,0.1.69,68,1,84,30,114,6,FALSE
cezerin-client,0.4.40,0.4.41,120,1,26,12,38,4,FALSE
cezerin-client,0.4.41,0.4.42,121,1,10,1,11,2,FALSE
cezerin-client,0.1.59,0.1.61,60,1,84,30,114,6,FALSE
cezerin-client,0.4.6,0.4.7,88,1,84,30,114,6,FALSE
cezerin-client,0.1.12,0.1.13,13,1,84,30,114,6,FALSE
cezerin-client,0.1.13,0.1.14,14,1,84,30,114,6,FALSE
cezerin-client,0.1.10,0.1.11,11,1,84,30,114,6,FALSE
cezerin-client,0.1.11,0.1.12,12,1,84,30,114,6,FALSE
cezerin-client,0.1.16,0.1.17,17,1,84,30,114,6,FALSE
cezerin-client,0.1.17,0.1.18,18,1,84,30,114,6,FALSE
cezerin-client,0.1.14,0.1.15,15,1,84,30,114,6,FALSE
cezerin-client,0.1.15,0.1.16,16,1,84,30,114,6,FALSE
cezerin-client,0.1.18,0.1.19,19,11,433,69,502,25,FALSE
cezerin-client,0.1.19,0.1.20,20,1,84,30,114,6,FALSE
cezerin-client,0.13.0,0.13.1,123,1,301,160,461,22,FALSE
cezerin-client,0.4.29,0.4.30,109,1,2,1,3,2,TRUE
cezerin-client,0.4.24,0.4.25,104,2,41,4,45,5,TRUE
cezerin-client,0.4.31,0.4.32,111,3,43,10,53,5,TRUE
cezerin-client,0.4.36,0.4.37,116,1,7,7,14,3,TRUE
cezerin-client,0.1.23,0.1.24,24,2,22,20,42,4,TRUE
cezerin-client,0.1.22,0.1.23,23,2,34,10,44,5,TRUE
cezerin-client,0.4.1,0.4.2,83,1,198,5,203,8,TRUE
cezerin-client,0.1.73,0.1.74,73,1,28,30,58,8,TRUE
cezerin-client,0.1.74,0.1.75,74,1,84,30,114,6,TRUE
heritagebot,1.0.4,1.0.5,5,9,117,328,445,24,FALSE
heritagebot,1.0.5,1.1.0,6,2,35,116,151,10,FALSE
heritagebot,1.0.0,1.0.1,1,5,268,257,525,8,FALSE
heritagebot,1.0.1,1.0.2,2,2,4,4,8,2,FALSE
heritagebot,1.0.2,1.0.3,3,3,6,10,16,4,FALSE
heritagebot,1.0.3,1.0.4,4,32,1356,965,2321,62,FALSE
heritagebot,1.1.0,1.2.0,7,2,28,24,52,4,FALSE
heritagebot,1.5.0,1.6.0,15,4,2161,16,2177,15,FALSE
heritagebot,1.3.0,1.4.0,13,1,1,13,14,2,FALSE
heritagebot,1.2.2,1.2.3,10,14,207,204,411,27,FALSE
heritagebot,1.2.4,1.3.0,12,24,238,604,842,44,FALSE
heritagebot,1.2.0,1.2.1,8,2,104,103,207,1,FALSE
heritagebot,1.2.1,1.2.2,9,1,103,104,207,1,FALSE
heritagebot,1.4.0,1.5.0,14,4,339,7,346,15,FALSE
heritagebot,1.2.3,1.2.4,11,2,2,2,4,2,FALSE
heritagebot,1.0.0,1.0.1,1,5,268,257,525,8,TRUE
heritagebot,1.0.3,1.0.4,4,32,1356,965,2321,62,TRUE
heritagebot,1.2.0,1.2.1,8,2,104,103,207,1,TRUE
heritagebot,1.0.4,1.0.5,5,9,117,328,445,24,TRUE
heritagebot,1.4.0,1.5.0,14,4,339,7,346,15,TRUE
heritagebot,1.3.0,1.4.0,13,1,1,13,14,2,TRUE
heritagebot,1.0.5,1.1.0,6,2,35,116,151,10,TRUE
heritagebot,1.0.2,1.0.3,3,3,6,10,16,4,TRUE
ui-elements,0.1.9,0.1.10,10,1,35,49,84,31,FALSE
ui-elements,0.1.0,0.1.1,1,1,85,1,86,7,FALSE
ui-elements,0.1.1,0.1.2,2,1,35,49,84,31,FALSE
ui-elements,1.1.0,1.1.2,30,7,324,387,711,22,FALSE
ui-elements,1.1.2,1.1.5,31,3,8,6,14,6,FALSE
ui-elements,1.1.5,1.1.6,32,2,6,4,10,6,FALSE
ui-elements,0.6.0,1.0.0,28,7,1045,3957,5002,145,FALSE
ui-elements,1.0.0,1.1.0,29,2,2,2,4,2,FALSE
ui-elements,0.1.8,0.1.9,9,1,614,198,812,27,FALSE
ui-elements,0.2.6,0.2.7,20,12,903,716,1619,66,FALSE
ui-elements,0.2.5,0.2.6,19,2,66,84,150,10,FALSE
ui-elements,0.2.4,0.2.5,18,14,2698,318,3016,84,FALSE
ui-elements,0.2.3,0.2.4,17,1,35,49,84,31,FALSE
ui-elements,0.2.2,0.2.3,16,1,3,3,6,1,FALSE
ui-elements,0.2.1,0.2.2,15,1,3,3,6,1,FALSE
ui-elements,0.2.0,0.2.1,14,2,31,24,55,9,FALSE
ui-elements,0.1.2,0.1.3,3,1,12,9,21,3,FALSE
ui-elements,0.1.3,0.1.4,4,2,690,56,746,29,FALSE
ui-elements,0.1.4,0.1.5,5,1,4,5,9,3,FALSE
ui-elements,0.1.5,0.1.6,6,1,10,1,11,2,FALSE
ui-elements,0.1.6,0.1.7,7,1,2,1,3,2,FALSE
ui-elements,0.1.7,0.1.8,8,1,35,49,84,31,FALSE
ui-elements,0.3.2,0.4.0,24,10,1034,650,1684,82,FALSE
ui-elements,0.3.0,0.3.1,22,2,58,24,82,6,FALSE
ui-elements,0.3.1,0.3.2,23,3,32,20,52,6,FALSE
ui-elements,0.4.0,0.5.0,25,7,1455,213,1668,98,FALSE
ui-elements,0.5.0,0.5.1,26,2,8,8,16,4,FALSE
ui-elements,0.5.1,0.6.0,27,3,140,766,906,29,FALSE
ui-elements,0.1.12,0.2.0,13,3,64,5856,5920,24,FALSE
ui-elements,0.2.7,0.3.0,21,5,47,21,68,9,FALSE
ui-elements,0.1.10,0.1.11,11,4,6312,1012,7324,59,FALSE
ui-elements,0.1.11,0.1.12,12,1,3,5,8,3,FALSE
ui-elements,0.1.12,0.2.0,13,3,64,5856,5920,24,TRUE
ui-elements,0.2.6,0.2.7,20,12,903,716,1619,66,TRUE
ui-elements,0.4.0,0.5.0,25,7,1455,213,1668,98,TRUE
ui-elements,0.2.1,0.2.2,15,1,3,3,6,1,TRUE
ui-elements,0.1.3,0.1.4,4,2,690,56,746,29,TRUE
ui-elements,0.1.8,0.1.9,9,1,614,198,812,27,TRUE
ui-elements,0.2.4,0.2.5,18,14,2698,318,3016,84,TRUE
ui-elements,0.5.1,0.6.0,27,3,140,766,906,29,TRUE
winston-viewer,1.0.4,1.0.5,1,3,87,24,111,7,FALSE
winston-viewer,1.0.5,1.0.6,2,2,61,2,63,3,FALSE
winston-viewer,1.0.6,1.0.7,3,3,31,5,36,5,FALSE
winston-viewer,1.0.7,1.0.8,4,4,15,179,194,9,FALSE
winston-viewer,1.0.8,1.0.9,5,1,2,2,4,1,FALSE
winston-viewer,1.0.9,1.0.10,6,1,2,2,4,1,FALSE
winston-viewer,1.0.5,1.0.6,2,2,61,2,63,3,TRUE
winston-viewer,1.0.7,1.0.8,4,4,15,179,194,9,TRUE
winston-viewer,1.0.9,1.0.10,6,1,2,2,4,1,TRUE
aurelia-oauth,0.2.0,0.3.0,8,1,329,260,589,18,FALSE
aurelia-oauth,0.1.0,0.1.1,1,1,2,0,2,1,FALSE
aurelia-oauth,0.1.1,0.1.2,2,6,221,67,288,11,FALSE
aurelia-oauth,0.1.2,0.1.3,3,2,6,4,10,3,FALSE
aurelia-oauth,0.1.3,0.1.4,4,1,73,37,110,9,FALSE
aurelia-oauth,0.1.4,0.1.5,5,4,191,111,302,118,FALSE
aurelia-oauth,0.1.5,0.1.6,6,4,998,887,1885,113,FALSE
aurelia-oauth,0.1.6,0.2.0,7,1,1,1,2,1,FALSE
aurelia-oauth,0.2.0,0.3.0,8,1,329,260,589,18,TRUE
aurelia-oauth,0.1.1,0.1.2,2,6,221,67,288,11,TRUE
aurelia-oauth,0.1.2,0.1.3,3,2,6,4,10,3,TRUE
aurelia-oauth,0.1.3,0.1.4,4,1,73,37,110,9,TRUE
aurelia-oauth,0.1.4,0.1.5,5,4,191,111,302,118,TRUE
aurelia-oauth,0.1.5,0.1.6,6,4,998,887,1885,113,TRUE
nsq-publisher,0.0.5,0.0.6,5,2,7,7,14,2,FALSE
nsq-publisher,0.0.4,0.0.5,4,2,3,3,6,2,FALSE
nsq-publisher,0.0.7,0.0.8,7,4,18,28,46,4,FALSE
nsq-publisher,0.0.6,0.0.7,6,1,14,24,38,1,FALSE
nsq-publisher,1.0.0,1.0.1,11,4,67,19,86,11,FALSE
nsq-publisher,0.0.3,0.0.4,3,2,16,1,17,2,FALSE
nsq-publisher,1.0.2,1.0.3,13,2,29,9,38,5,FALSE
nsq-publisher,0.0.2,0.0.3,2,2,39,87,126,7,FALSE
nsq-publisher,0.0.9,0.0.10,9,2,3,3,6,3,FALSE
nsq-publisher,0.0.8,0.0.9,8,2,3,5,8,2,FALSE
nsq-publisher,0.0.10,1.0.0,10,19,1491,258,1749,45,FALSE
nsq-publisher,1.0.0,1.0.1,11,4,67,19,86,11,TRUE
nsq-publisher,1.0.2,1.0.3,13,2,29,9,38,5,TRUE
nsq-publisher,0.0.10,1.0.0,10,19,1491,258,1749,45,TRUE
id-builder,1.1.0,1.2.0,3,14,5280,4571,9851,384,FALSE
id-builder,1.4.2,1.5.0,10,5,430,200,630,57,FALSE
id-builder,0.0.0,1.0.0-12,1,72,9930,8633,18563,1017,FALSE
id-builder,1.4.1,1.4.2,9,11,1123,1501,2624,182,FALSE
id-builder,1.8.0,1.8.1,15,4,1077,804,1881,106,FALSE
id-builder,1.5.1,1.6.0,12,5,801,349,1150,97,FALSE
id-builder,1.5.0,1.5.1,11,3,108,93,201,18,FALSE
id-builder,1.3.3,1.4.1,8,7,510,512,1022,93,FALSE
id-builder,1.3.2,1.3.3,7,2,3,3,6,3,FALSE
id-builder,1.6.0,1.7.0,13,31,1584,1093,2677,120,FALSE
id-builder,1.3.0,1.3.1,5,7,66,15,81,8,FALSE
id-builder,1.2.0,1.3.0,4,4,1429,877,2306,86,FALSE
id-builder,1.9.0,2.0.2,17,62,690927,495955,1186882,2613,FALSE
id-builder,1.7.0,1.8.0,14,19,1953,1635,3588,194,FALSE
id-builder,1.3.1,1.3.2,6,2,9,29,38,3,FALSE
id-builder,1.8.1,1.9.0,16,27,10229,3329,13558,507,FALSE
id-builder,3.4.0,3.5.0,24,17,2342,214681,217023,416,FALSE
id-builder,3.1.0,3.2.0,20,6,462,225,687,37,FALSE
id-builder,3.0.0,3.1.0,19,9,453,448,901,79,FALSE
id-builder,3.6.1,3.7.0,26,1,7,7,14,3,FALSE
id-builder,3.5.0,3.6.1,25,12,130,38,168,22,FALSE
id-builder,3.3.1,3.4.0,23,6,83,168,251,25,TRUE
id-builder,3.3.0,3.3.1,22,2,12,4,16,2,FALSE
id-builder,3.2.0,3.3.0,21,2,21,3,24,2,FALSE
id-builder,3.8.2,3.9.0,29,1,7,7,14,3,FALSE
id-builder,3.7.0,3.8.0,27,1,7,7,14,3,FALSE
id-builder,3.8.0,3.8.2,28,1,7,7,14,3,FALSE
id-builder,3.3.1,3.4.0,23,6,83,168,251,25,FALSE
id-builder,3.8.2,3.9.0,29,1,7,7,14,3,TRUE
id-builder,2.0.2,3.0.0,18,4,138,424,562,38,FALSE
id-builder,1.5.1,1.6.0,12,5,801,349,1150,97,TRUE
id-builder,1.3.3,1.4.1,8,7,510,512,1022,93,TRUE
id-builder,1.6.0,1.7.0,13,31,1584,1093,2677,120,TRUE
id-builder,1.8.1,1.9.0,16,27,10229,3329,13558,507,TRUE
id-builder,1.4.2,1.5.0,10,5,430,200,630,57,TRUE
id-builder,1.5.0,1.5.1,11,3,108,93,201,18,TRUE
id-builder,3.4.0,3.5.0,24,17,2342,214681,217023,416,TRUE
id-builder,1.8.0,1.8.1,15,4,1077,804,1881,106,TRUE
id-builder,3.6.1,3.7.0,26,1,7,7,14,3,TRUE
aden,0.2.0-alpha.6,0.2.0-alpha.7,23,4,577,316,893,36,FALSE
aden,0.2.0-alpha.7,0.2.0-alpha.8,24,1,39,34,73,2,FALSE
aden,0.2.0-alpha.4,0.2.0-alpha.5,21,4,206,109,315,25,FALSE
aden,0.2.0-alpha.5,0.2.0-alpha.6,22,11,1035,708,1743,44,FALSE
aden,0.2.0-alpha.2,0.2.0-alpha.3,19,1,11,11,22,3,FALSE
aden,0.2.0-alpha.3,0.2.0-alpha.4,20,2,53,44,97,12,FALSE
aden,0.2.0-alpha.1,0.2.0-alpha.2,18,2,59,29,88,8,FALSE
aden,0.2.0-alpha.8,0.2.0-alpha.9,25,6,929,487,1416,103,FALSE
aden,0.2.0-alpha.9,0.2.0-alpha.10,26,29,1975,1076,3051,159,FALSE
aden,0.2.0-alpha.10,0.2.0-alpha.11,27,15,1539,462,2001,81,FALSE
aden,0.1.2-alpha.13,0.1.2-alpha.14,14,9,279,175,454,83,FALSE
aden,0.1.2-alpha.12,0.1.2-alpha.13,13,2,7,4,11,3,FALSE
aden,0.1.2-alpha.11,0.1.2-alpha.12,12,2,8,5,13,3,FALSE
aden,0.1.2-alpha.10,0.1.2-alpha.11,11,2,17,7,24,6,FALSE
aden,0.1.2-alpha.16,0.2.0-alpha.1,17,64,3387,1243,4630,344,FALSE
aden,0.1.2-alpha.15,0.1.2-alpha.16,16,7,101,37,138,14,FALSE
aden,0.1.2-alpha.14,0.1.2-alpha.15,15,19,472,194,666,69,FALSE
aden,0.1.2-alpha.3,0.1.2-alpha.4,4,3,23,23,46,12,FALSE
aden,0.1.2-alpha.2,0.1.2-alpha.3,3,5,14,13,27,6,FALSE
aden,0.1.2-alpha.1,0.1.2-alpha.2,2,3,80,74,154,10,FALSE
aden,0.1.2-alpha.0,0.1.2-alpha.1,1,3,19,19,38,4,FALSE
aden,0.1.2-alpha.7,0.1.2-alpha.8,8,1,3,3,6,2,FALSE
aden,0.1.2-alpha.6,0.1.2-alpha.7,7,12,425,295,720,42,FALSE
aden,0.1.2-alpha.5,0.1.2-alpha.6,6,3,9,8,17,5,FALSE
aden,0.1.2-alpha.4,0.1.2-alpha.5,5,2,13,8,21,4,FALSE
aden,0.1.2-alpha.9,0.1.2-alpha.10,10,4,44,30,74,6,FALSE
aden,0.1.2-alpha.8,0.1.2-alpha.9,9,41,2223,2031,4254,224,FALSE
aden,0.2.0-alpha.10,0.2.0-alpha.11,27,15,1539,462,2001,81,TRUE
aden,0.2.0-alpha.8,0.2.0-alpha.9,25,6,929,487,1416,103,TRUE
aden,0.2.0-alpha.9,0.2.0-alpha.10,26,29,1975,1076,3051,159,TRUE
aden,0.2.0-alpha.5,0.2.0-alpha.6,22,11,1035,708,1743,44,TRUE
jquery-focus-exit,0.1.1,0.1.2,1,2,3,2,5,3,FALSE
jquery-focus-exit,0.1.2,0.1.3,2,2,2,3,5,3,FALSE
jquery-focus-exit,0.3.0,0.3.1,5,5,62,45,107,9,FALSE
jquery-focus-exit,0.2.0,0.3.0,4,3,128,42,170,8,FALSE
jquery-focus-exit,0.1.3,0.2.0,3,3,92,44,136,12,FALSE
jquery-focus-exit,0.2.0,0.3.0,4,3,128,42,170,8,TRUE
do-when,0.0.2,1.0.0,1,6,329,11358,11687,28,TRUE
point-one,0.4.11,0.4.12,29,1,557,242,799,40,FALSE
point-one,0.4.10,0.4.11,28,1,557,242,799,40,FALSE
point-one,0.4.12,0.4.13,30,1,557,242,799,40,FALSE
point-one,0.3.2,0.4.0-beta.1,15,6,214,142,356,21,FALSE
point-one,0.3.0,0.3.1,13,5,68,46,114,11,FALSE
point-one,0.3.1,0.3.2,14,1,6,3,9,3,FALSE
point-one,0.4.9,0.4.10,27,1,557,242,799,40,FALSE
point-one,0.4.0-beta.1,0.4.0-beta.2,16,1,7,6,13,2,FALSE
point-one,0.4.8,0.4.9,26,1,557,242,799,40,FALSE
point-one,0.4.0-beta.2,0.4.0,17,9,985,428,1413,79,FALSE
point-one,0.2.1,0.3.0,12,4,186,72,258,12,FALSE
point-one,0.2.0,0.2.1,11,1,5,5,10,4,FALSE
point-one,0.4.1,0.4.2,19,1,557,242,799,40,FALSE
point-one,0.4.0,0.4.1,18,1,557,242,799,40,FALSE
point-one,0.4.3,0.4.4,21,1,557,242,799,40,FALSE
point-one,0.4.2,0.4.3,20,1,557,242,799,40,FALSE
point-one,0.4.5,0.4.6,23,1,557,242,799,40,FALSE
point-one,0.4.4,0.4.5,22,1,557,242,799,40,FALSE
point-one,0.4.7,0.4.8,25,1,557,242,799,40,FALSE
point-one,0.4.6,0.4.7,24,1,557,242,799,40,FALSE
point-one,0.0.99,0.0.100,1,1,557,242,799,40,FALSE
point-one,0.1.108,0.2.0,10,12,1282,1978,3260,74,FALSE
point-one,0.1.107,0.1.108,9,1,3,3,6,3,FALSE
point-one,0.1.106,0.1.107,8,1,4,1,5,3,FALSE
point-one,0.1.105,0.1.106,7,1,1,23,24,3,FALSE
point-one,0.1.104,0.1.105,6,3,265,122,387,18,FALSE
point-one,0.0.102,0.0.103,4,8,928,661,1589,67,FALSE
point-one,0.0.103,0.1.104,5,3,571,531,1102,36,FALSE
point-one,0.0.100,0.0.101,2,1,557,242,799,40,FALSE
point-one,0.0.101,0.0.102,3,1,557,242,799,40,FALSE
point-one,0.4.3,0.4.4,21,1,557,242,799,40,TRUE
point-one,0.3.2,0.4.0-beta.1,15,6,214,142,356,21,TRUE
point-one,0.4.7,0.4.8,25,1,557,242,799,40,TRUE
point-one,0.1.104,0.1.105,6,3,265,122,387,18,TRUE
point-one,0.4.8,0.4.9,26,1,557,242,799,40,TRUE
grimoirejs-gltf,1.1.1,1.1.2,12,1,3,2,5,1,FALSE
grimoirejs-gltf,1.1.0,1.1.1,11,3,997,967,1964,15,FALSE
grimoirejs-gltf,0.0.7-development,0.0.8-development,8,2,13,2,15,4,FALSE
grimoirejs-gltf,1.1.2,1.2.0,13,5,791,231,1022,40,FALSE
grimoirejs-gltf,0.0.5-development,0.0.6-development,6,3,114,29,143,10,FALSE
grimoirejs-gltf,0.0.6-development,0.0.7-development,7,3,39,21,60,4,FALSE
grimoirejs-gltf,1.8.0-beta3,1.8.0,31,6,126,33,159,16,FALSE
grimoirejs-gltf,1.8.0-beta2,1.8.0-beta3,30,1,1,1,2,1,FALSE
grimoirejs-gltf,1.8.0-beta1,1.8.0-beta2,29,5,1062,741,1803,18,FALSE
grimoirejs-gltf,1.8.12,1.8.13,44,8,160,53,213,17,FALSE
grimoirejs-gltf,1.8.13,1.8.14,45,4,85,56,141,13,FALSE
grimoirejs-gltf,1.8.10,1.8.11,42,7,877,529,1406,29,FALSE
grimoirejs-gltf,1.8.11,1.8.12,43,5,5,4,9,5,FALSE
grimoirejs-gltf,0.0.2-development,0.0.3-development,3,1,0,0,0,0,FALSE
grimoirejs-gltf,1.8.8,1.8.9,40,4,28,24,52,7,FALSE
grimoirejs-gltf,1.8.9,1.8.10,41,4,186,102,288,17,FALSE
grimoirejs-gltf,1.8.4,1.8.5,36,1,128,122,250,9,FALSE
grimoirejs-gltf,0.0.4-development,0.0.5-development,5,1,0,0,0,0,FALSE
grimoirejs-gltf,1.8.6,1.8.7,38,1,5,18,23,4,FALSE
grimoirejs-gltf,1.8.7,1.8.8,39,2,49,52,101,6,FALSE
grimoirejs-gltf,1.8.0,1.8.1,32,2,6,75,81,3,FALSE
grimoirejs-gltf,1.8.1,1.8.2,33,2,864,4749,5613,22,FALSE
grimoirejs-gltf,1.7.1,1.8.0-beta1,28,11,5028,4758,9786,54,FALSE
grimoirejs-gltf,1.7.0,1.7.1,27,1,3,3,6,1,FALSE
grimoirejs-gltf,1.2.10,1.3.0-beta,24,1,2,2,4,1,FALSE
grimoirejs-gltf,1.3.0-beta,1.3.1,25,3,116,58,174,10,FALSE
grimoirejs-gltf,1.2.6,1.2.7,20,3,228,25,253,9,FALSE
grimoirejs-gltf,1.2.7,1.2.8,21,1,1,1,2,1,FALSE
grimoirejs-gltf,1.3.1,1.7.0,26,5,710,882,1592,30,FALSE
grimoirejs-gltf,1.2.5,1.2.6,19,3,560,222,782,43,FALSE
grimoirejs-gltf,1.2.2,1.2.3,16,3,18,20,38,4,FALSE
grimoirejs-gltf,1.2.3,1.2.4,17,1,4,5,9,3,FALSE
grimoirejs-gltf,1.2.0,1.2.1,14,2,106,20,126,7,FALSE
grimoirejs-gltf,1.2.1,1.2.2,15,1,1,1,2,1,FALSE
grimoirejs-gltf,0.0.0-development,0.0.1-development,1,5,10,6,16,6,FALSE
grimoirejs-gltf,1.2.8,1.2.9,22,3,20,41,61,7,FALSE
grimoirejs-gltf,1.2.9,1.2.10,23,1,1,1,2,1,FALSE
grimoirejs-gltf,0.0.3-development,0.0.4-development,4,1,0,0,0,0,FALSE
grimoirejs-gltf,1.2.4,1.2.5,18,2,169,115,284,10,FALSE
grimoirejs-gltf,1.8.5,1.8.6,37,1,1,1,2,1,FALSE
grimoirejs-gltf,1.8.2,1.8.3,34,2,6,6,12,2,FALSE
grimoirejs-gltf,0.0.1-development,0.0.2-development,2,1,0,0,0,0,FALSE
grimoirejs-gltf,1.8.3,1.8.4,35,3,73,72,145,6,FALSE
grimoirejs-gltf,1.1.0,1.1.1,11,3,997,967,1964,15,TRUE
grimoirejs-gltf,1.2.5,1.2.6,19,3,560,222,782,43,TRUE
grimoirejs-gltf,1.2.8,1.2.9,22,3,20,41,61,7,TRUE
grimoirejs-gltf,0.0.7-development,0.0.8-development,8,2,13,2,15,4,TRUE
grimoirejs-gltf,1.8.0-beta3,1.8.0,31,6,126,33,159,16,TRUE
grimoirejs-gltf,1.8.0-beta2,1.8.0-beta3,30,1,1,1,2,1,TRUE
grimoirejs-gltf,1.8.0-beta1,1.8.0-beta2,29,5,1062,741,1803,18,TRUE
grimoirejs-gltf,1.8.12,1.8.13,44,8,160,53,213,17,TRUE
grimoirejs-gltf,1.8.13,1.8.14,45,4,85,56,141,13,TRUE
grimoirejs-gltf,1.8.11,1.8.12,43,5,5,4,9,5,TRUE
grimoirejs-gltf,1.8.8,1.8.9,40,4,28,24,52,7,TRUE
grimoirejs-gltf,1.8.4,1.8.5,36,1,128,122,250,9,TRUE
grimoirejs-gltf,1.8.7,1.8.8,39,2,49,52,101,6,TRUE
grimoirejs-gltf,1.8.2,1.8.3,34,2,6,6,12,2,TRUE
grimoirejs-gltf,1.2.10,1.3.0-beta,24,1,2,2,4,1,TRUE
grimoirejs-gltf,1.2.6,1.2.7,20,3,228,25,253,9,TRUE
grimoirejs-gltf,1.3.1,1.7.0,26,5,710,882,1592,30,TRUE
grimoirejs-gltf,1.2.3,1.2.4,17,1,4,5,9,3,TRUE
grimoirejs-gltf,0.0.0-development,0.0.1-development,1,5,10,6,16,6,TRUE
grimoirejs-gltf,1.2.4,1.2.5,18,2,169,115,284,10,TRUE
grimoirejs-gltf,1.7.1,1.8.0-beta1,28,11,5028,4758,9786,54,TRUE
grimoirejs-gltf,0.0.1-development,0.0.2-development,2,1,0,0,0,0,TRUE
grimoirejs-gltf,1.8.9,1.8.10,41,4,186,102,288,17,TRUE
grimoirejs-gltf,1.1.2,1.2.0,13,5,791,231,1022,40,TRUE
focus-devtools,0.4.0-rc3,0.4.0-rc5,21,1,2,2,4,1,FALSE
focus-devtools,0.4.0-rc5,0.4.0-rc6,22,1,2,2,4,1,FALSE
focus-devtools,0.4.0-rc7,0.4.0-rc8,24,1,2,2,4,1,FALSE
focus-devtools,0.4.0-rc6,0.4.0-rc7,23,1,2,2,4,1,FALSE
focus-devtools,0.4.0-rc9,0.4.0,26,1,39,42,81,7,FALSE
focus-devtools,0.4.0-rc8,0.4.0-rc9,25,1,2,2,4,1,FALSE
focus-devtools,0.2.1,0.3.0,8,1,33,7,40,5,FALSE
focus-devtools,0.2.0,0.2.1,7,1,2,2,4,1,FALSE
focus-devtools,0.1.0,0.1.1,1,1,2,2,4,1,FALSE
focus-devtools,0.1.1,0.1.2,2,1,2,2,4,1,FALSE
focus-devtools,0.1.2,0.1.3,3,1,2,2,4,1,FALSE
focus-devtools,0.1.3,0.1.4,4,1,2,2,4,1,FALSE
focus-devtools,0.1.4,0.1.5,5,1,2,2,4,1,FALSE
focus-devtools,0.1.5,0.2.0,6,1,2,2,4,1,FALSE
focus-devtools,0.3.2,0.3.3,11,2,41,21,62,4,FALSE
focus-devtools,0.3.3,0.3.4-beta0,12,1,2,2,4,1,FALSE
focus-devtools,0.3.0,0.3.1,9,1,2,2,4,1,FALSE
focus-devtools,0.3.1,0.3.2,10,1,28,22,50,4,FALSE
focus-devtools,0.3.4,0.3.5-beta0,15,1,2,2,4,1,FALSE
focus-devtools,0.3.5,0.4.0-rc1,17,3,25,14,39,4,FALSE
focus-devtools,0.4.0-rc1,0.4.0-rc10,18,1,2,2,4,1,FALSE
focus-devtools,0.4.0-rc2,0.4.0-rc3,20,1,2,2,4,1,FALSE
focus-devtools,0.3.4-beta1,0.3.4,14,1,6,6,12,2,FALSE
focus-devtools,0.3.4-beta0,0.3.4-beta1,13,1,2,2,4,1,FALSE
focus-devtools,0.3.5-beta0,0.3.5,16,1,2,2,4,1,FALSE
focus-devtools,0.3.2,0.3.3,11,2,41,21,62,4,TRUE
focus-devtools,0.3.1,0.3.2,10,1,28,22,50,4,TRUE
focus-devtools,0.1.1,0.1.2,2,1,2,2,4,1,TRUE
focus-devtools,0.3.5,0.4.0-rc1,17,3,25,14,39,4,TRUE
focus-devtools,0.4.0-rc1,0.4.0-rc10,18,1,2,2,4,1,TRUE
focus-devtools,0.4.0-rc2,0.4.0-rc3,20,1,2,2,4,1,TRUE
swagg,3.1.3,3.1.4,7,2,3,3,6,3,FALSE
swagg,3.1.2,3.1.3,6,2,4,7,11,3,FALSE
swagg,3.1.1,3.1.2,5,2,3,2,5,2,FALSE
swagg,3.1.0,3.1.1,4,4,63,4,67,6,FALSE
swagg,3.0.2,3.0.3,1,3,127,113,240,12,FALSE
swagg,3.0.3,3.0.4,2,2,2,2,4,2,FALSE
swagg,3.1.5,4.0.0,9,1,1,1,2,1,FALSE
swagg,3.1.4,3.1.5,8,2,25,12,37,2,FALSE
swagg,3.0.4,3.1.0,3,3,8,53,61,3,FALSE
swagg,4.0.0,4.1.0,10,5,166,94,260,14,FALSE
swagg,4.1.0,4.1.1,11,2,2,13,15,3,FALSE
swagg,5.0.0,5.0.1,13,2,1,1,2,2,FALSE
swagg,4.1.1,5.0.0,12,6,285,187,472,25,FALSE
swagg,4.0.0,4.1.0,10,5,166,94,260,14,TRUE
swagg,3.1.4,3.1.5,8,2,25,12,37,2,TRUE
redux-crud-async,0.7.5,0.7.6,26,1,4,2,6,3,FALSE
redux-crud-async,0.2.3,0.3.0,11,2,28,28,56,8,FALSE
redux-crud-async,0.2.2,0.2.3,10,1,46,40,86,5,FALSE
redux-crud-async,0.2.1,0.2.2,9,1,1,5,6,3,FALSE
redux-crud-async,0.2.0,0.2.1,8,1,8,3,11,4,FALSE
redux-crud-async,0.1.0,0.1.1,2,2,19,14,33,6,FALSE
redux-crud-async,0.1.1,0.1.2,3,1,19,19,38,3,FALSE
redux-crud-async,0.1.2,0.1.3,4,5,43,43,86,5,FALSE
redux-crud-async,0.1.3,0.1.4,5,17,1469,197,1666,50,FALSE
redux-crud-async,0.1.4,0.1.5,6,2,49,14,63,6,FALSE
redux-crud-async,0.1.5,0.2.0,7,1,30,2,32,5,FALSE
redux-crud-async,0.6.3,0.7.0,20,3,52,27,79,12,FALSE
redux-crud-async,0.6.2,0.6.3,19,1,168,4,172,5,FALSE
redux-crud-async,0.3.0,0.4.0,12,13,1579,873,2452,51,FALSE
redux-crud-async,0.6.0,0.6.1,17,1,7,6,13,4,FALSE
redux-crud-async,0.7.2,0.7.3,23,1,56,23,79,5,FALSE
redux-crud-async,0.7.3,0.7.4,24,1,10,2,12,3,FALSE
redux-crud-async,0.7.0,0.7.1,21,1,8,5,13,2,FALSE
redux-crud-async,0.7.1,0.7.2,22,2,2,4,6,3,FALSE
redux-crud-async,0.4.1,0.4.2,14,1,154,34,188,24,FALSE
redux-crud-async,0.4.0,0.4.1,13,1,18,51,69,5,FALSE
redux-crud-async,0.4.2,0.5.0,15,3,1902,754,2656,141,FALSE
redux-crud-async,0.5.0,0.6.0,16,4,2100,492,2592,46,FALSE
redux-crud-async,0.8.0,0.8.1,29,2,14,15,29,7,FALSE
redux-crud-async,0.7.6,0.7.7,27,1,5,3,8,4,FALSE
redux-crud-async,0.7.7,0.8.0,28,4,72,70,142,9,FALSE
redux-crud-async,0.6.1,0.6.2,18,1,3,3,6,3,FALSE
redux-crud-async,0.7.4,0.7.5,25,1,18,6,24,4,FALSE
redux-crud-async,0.0.8,0.1.0,1,5,392,124,516,20,FALSE
redux-crud-async,0.1.4,0.1.5,6,2,49,14,63,6,TRUE
redux-crud-async,0.2.0,0.2.1,8,1,8,3,11,4,TRUE
smithers-battery,0.1.0,0.2.0,1,2,53,1,54,3,FALSE
smithers-battery,0.2.3,0.2.4,5,1,3,3,6,3,TRUE
smithers-battery,0.2.2,0.2.3,4,1,103,83,186,5,FALSE
smithers-battery,0.2.1,0.2.2,3,1,6,1,7,1,FALSE
smithers-battery,0.2.0,0.2.1,2,1,11,21,32,3,FALSE
smithers-battery,0.2.3,0.2.4,5,1,3,3,6,3,FALSE
react-visit,1.0.0,1.0.1,3,2,38,11,49,6,FALSE
react-visit,1.0.1,1.0.2,4,2,2489,2396,4885,9,FALSE
react-visit,0.0.2,1.0.0,2,2,7721,6468,14189,9,FALSE
react-visit,0.0.1,0.0.2,1,8,14722,14086,28808,17,FALSE
react-visit,1.0.1,1.0.2,4,2,2489,2396,4885,9,TRUE
typestore-plugin-cloudsearch,0.1.12,0.1.14,6,10,3972,2233,6205,87,FALSE
typestore-plugin-cloudsearch,0.2.26,0.2.27,20,1,2,2,4,2,FALSE
typestore-plugin-cloudsearch,0.2.24,0.2.26,19,9,817,3342,4159,96,FALSE
typestore-plugin-cloudsearch,0.1.11,0.1.12,5,1,39,15,54,4,FALSE
typestore-plugin-cloudsearch,0.2.22,0.2.23,17,1,23,13,36,1,FALSE
typestore-plugin-cloudsearch,0.1.14,0.2.5,7,28,10900,12688,23588,385,FALSE
typestore-plugin-cloudsearch,0.2.19,0.2.20,14,2,6,2,8,2,FALSE
typestore-plugin-cloudsearch,0.2.18,0.2.19,13,3,9,17,26,5,FALSE
typestore-plugin-cloudsearch,0.2.23,0.2.24,18,1,18,9,27,4,FALSE
typestore-plugin-cloudsearch,0.2.21,0.2.22,16,1,1,1,2,1,FALSE
typestore-plugin-cloudsearch,0.2.11,0.2.18,12,8,84,21,105,12,TRUE
typestore-plugin-cloudsearch,0.2.10,0.2.11,11,3,16,12,28,7,FALSE
typestore-plugin-cloudsearch,0.2.7,0.2.9,9,3,82,76,158,15,FALSE
typestore-plugin-cloudsearch,0.2.5,0.2.7,8,2,22,13,35,3,FALSE
typestore-plugin-cloudsearch,0.1.6,0.1.7,3,22,29862,421451,451313,1456,FALSE
typestore-plugin-cloudsearch,0.1.3,0.1.5,1,3,524,242,766,67,FALSE
typestore-plugin-cloudsearch,0.2.20,0.2.21,15,2,15,3,18,2,FALSE
typestore-plugin-cloudsearch,0.1.5,0.1.6,2,9,490,198,688,90,FALSE
typestore-plugin-cloudsearch,0.2.9,0.2.10,10,1,3,3,6,2,FALSE
typestore-plugin-cloudsearch,0.1.7,0.1.11,4,33,19537,35531,55068,1102,FALSE
typestore-plugin-cloudsearch,0.2.5,0.2.7,8,2,22,13,35,3,TRUE
typestore-plugin-cloudsearch,0.1.14,0.2.5,7,28,10900,12688,23588,385,TRUE
typestore-plugin-cloudsearch,0.2.23,0.2.24,18,1,18,9,27,4,TRUE
typestore-plugin-cloudsearch,0.2.11,0.2.18,12,8,84,21,105,12,FALSE
typestore-plugin-cloudsearch,0.1.12,0.1.14,6,10,3972,2233,6205,87,TRUE
typestore-plugin-cloudsearch,0.2.26,0.2.27,20,1,2,2,4,2,TRUE
typestore-plugin-cloudsearch,0.2.24,0.2.26,19,9,817,3342,4159,96,TRUE
typestore-plugin-cloudsearch,0.2.22,0.2.23,17,1,23,13,36,1,TRUE
typestore-plugin-cloudsearch,0.2.18,0.2.19,13,3,9,17,26,5,TRUE
typestore-plugin-cloudsearch,0.2.7,0.2.9,9,3,82,76,158,15,TRUE
typestore-plugin-cloudsearch,0.1.3,0.1.5,1,3,524,242,766,67,TRUE
typestore-plugin-cloudsearch,0.1.7,0.1.11,4,33,19537,35531,55068,1102,TRUE
typestore-plugin-cloudsearch,0.2.19,0.2.20,14,2,6,2,8,2,TRUE
typestore-plugin-cloudsearch,0.2.21,0.2.22,16,1,1,1,2,1,TRUE
typestore-plugin-cloudsearch,0.2.20,0.2.21,15,2,15,3,18,2,TRUE
node-red-contrib-icreate-upnp,1.1.0,1.2.0,4,2,1051,3,1054,4,FALSE
node-red-contrib-icreate-upnp,1.0.0,1.0.1,1,1,5,5,10,1,FALSE
node-red-contrib-icreate-upnp,1.0.1,1.0.2,2,2,12,6,18,2,FALSE
node-red-contrib-icreate-upnp,2.0.1,2.1.0,9,2,924,905,1829,3,FALSE
node-red-contrib-icreate-upnp,2.0.0,2.0.1,8,2,2,2,4,2,FALSE
node-red-contrib-icreate-upnp,1.3.0,2.0.0,7,2,144,111,255,3,FALSE
node-red-contrib-icreate-upnp,2.2.0,2.2.1,11,3,601,383,984,25,FALSE
node-red-contrib-icreate-upnp,1.2.0,1.2.1,5,2,1,2,3,2,FALSE
node-red-contrib-icreate-upnp,1.2.1,1.3.0,6,2,196,1,197,6,FALSE
node-red-contrib-icreate-upnp,1.0.2,1.1.0,3,2,32,6,38,3,FALSE
node-red-contrib-icreate-upnp,2.1.0,2.2.0,10,3,667,449,1116,25,TRUE
node-red-contrib-icreate-upnp,2.1.0,2.2.0,10,3,667,449,1116,25,FALSE
skypager-webpack,5.0.0,5.0.3,1,1,91,5,96,1,FALSE
skypager-webpack,5.4.4,5.4.5,7,1,91,5,96,1,FALSE
skypager-webpack,5.5.0,5.5.1,9,1,91,5,96,1,FALSE
skypager-webpack,5.17.3,6.5.0,14,1,91,5,96,1,FALSE
skypager-webpack,5.5.2,5.6.0,11,1,91,5,96,1,FALSE
skypager-webpack,5.4.0,5.4.1,3,1,91,5,96,1,FALSE
skypager-webpack,5.4.1,5.4.2,4,1,91,5,96,1,FALSE
skypager-webpack,5.4.2,5.4.3,5,1,91,5,96,1,FALSE
skypager-webpack,5.4.3,5.4.4,6,1,91,5,96,1,FALSE
skypager-webpack,8.6.0,11.8.0,16,1,91,5,96,1,FALSE
skypager-webpack,6.5.0,8.6.0,15,1,91,5,96,1,FALSE
skypager-webpack,5.7.0,5.17.3,13,1,91,5,96,1,FALSE
skypager-webpack,5.6.0,5.7.0,12,1,91,5,96,1,FALSE
skypager-webpack,5.5.1,5.5.2,10,1,91,5,96,1,FALSE
skypager-webpack,5.4.5,5.5.0,8,1,91,5,96,1,FALSE
skypager-webpack,5.0.3,5.4.0,2,1,91,5,96,1,FALSE
skypager-webpack,5.0.3,5.4.0,2,1,91,5,96,1,TRUE
skypager-webpack,5.5.2,5.6.0,11,1,91,5,96,1,TRUE
skypager-webpack,5.4.0,5.4.1,3,1,91,5,96,1,TRUE
redux-react-firebase,2.0.1,2.1.0,34,5,79,43,122,8,FALSE
redux-react-firebase,2.0.0,2.0.1,33,2,2,2,4,2,FALSE
redux-react-firebase,2.3.1,2.3.3,41,3,13,5,18,5,FALSE
redux-react-firebase,2.3.3,2.3.4,42,12,751,337,1088,31,FALSE
redux-react-firebase,2.3.4,2.3.5,43,3,3,3,6,3,FALSE
redux-react-firebase,2.3.5,2.4.0,44,12,1529,1327,2856,30,FALSE
redux-react-firebase,2.5.3,2.6.0,49,2,18,8,26,10,FALSE
redux-react-firebase,2.3.0,2.3.1,40,3,13,3,16,3,FALSE
redux-react-firebase,2.2.1,2.2.3,37,5,8,11,19,5,FALSE
redux-react-firebase,2.2.0,2.2.1,36,3,2,686,688,6,FALSE
redux-react-firebase,2.2.3,2.2.4,38,4,4,4,8,4,FALSE
redux-react-firebase,2.6.0,2.6.1,50,3,19,9,28,3,FALSE
redux-react-firebase,2.1.0,2.2.0,35,2,7,6,13,4,FALSE
redux-react-firebase,2.4.0,2.5.0,45,3,7,1,8,3,FALSE
redux-react-firebase,2.5.2,2.5.3,48,3,5,5,10,3,FALSE
redux-react-firebase,2.2.4,2.3.0,39,11,581,75,656,33,FALSE
redux-react-firebase,2.5.0,2.5.1,46,3,4,16,20,4,FALSE
redux-react-firebase,2.5.1,2.5.2,47,4,8,8,16,6,FALSE
redux-react-firebase,2.3.4,2.3.5,43,3,3,3,6,3,TRUE
redux-react-firebase,1.0.4,1.1.0,5,8,68,37,105,15,FALSE
redux-react-firebase,1.1.0,1.1.1,6,6,96,18,114,8,FALSE
redux-react-firebase,1.1.3,1.1.4,9,8,16,14,30,9,FALSE
redux-react-firebase,1.1.2,1.1.3,8,6,180,13,193,7,FALSE
redux-react-firebase,1.0.0,1.0.1,1,1,0,0,0,1,FALSE
redux-react-firebase,1.0.1,1.0.2,2,3,11,2,13,3,FALSE
redux-react-firebase,1.0.2,1.0.3,3,2,14,2,16,3,FALSE
redux-react-firebase,1.0.3,1.0.4,4,2,6,1,7,2,FALSE
redux-react-firebase,1.1.5,1.2.0,11,3,317,33,350,6,FALSE
redux-react-firebase,1.1.4,1.1.5,10,13,32,15,47,13,FALSE
redux-react-firebase,1.6.2,1.6.3,20,2,9,10,19,2,FALSE
redux-react-firebase,1.6.3,1.7.0,21,11,2411,64,2475,39,FALSE
redux-react-firebase,1.6.0,1.6.1,18,3,20,3,23,3,FALSE
redux-react-firebase,1.6.1,1.6.2,19,2,2,2,4,2,FALSE
redux-react-firebase,1.9.0,1.10.0,27,3,14,3,17,3,FALSE
redux-react-firebase,1.8.0,1.8.2,25,6,58,25,83,10,FALSE
redux-react-firebase,1.7.2,1.8.0,24,8,202,158,360,14,FALSE
redux-react-firebase,1.7.1,1.7.2,23,6,698,300,998,18,FALSE
redux-react-firebase,1.7.0,1.7.1,22,6,72,44,116,17,FALSE
redux-react-firebase,1.4.0,1.5.0,16,4,51,33,84,5,FALSE
redux-react-firebase,1.1.1,1.1.2,7,3,4,4,8,4,FALSE
redux-react-firebase,1.5.0,1.6.0,17,13,148,28,176,16,FALSE
redux-react-firebase,1.3.2,1.4.0,15,1,150,1,151,4,FALSE
redux-react-firebase,1.3.1,1.3.2,14,2,11,11,22,3,FALSE
redux-react-firebase,1.3.0,1.3.1,13,2,2,2,4,2,FALSE
redux-react-firebase,1.2.0,1.3.0,12,4,11,13,24,5,FALSE
redux-react-firebase,1.12.0,1.12.1,31,4,4,2,6,4,FALSE
redux-react-firebase,1.12.1,2.0.0,32,15,1052,3205,4257,107,FALSE
redux-react-firebase,1.11.1,1.12.0,30,4,76,53,129,8,FALSE
redux-react-firebase,1.11.0,1.11.1,29,2,6,1,7,2,FALSE
redux-react-firebase,1.10.0,1.11.0,28,4,9,2,11,4,FALSE
redux-react-firebase,1.8.2,1.9.0,26,3,30,15,45,6,FALSE
redux-react-firebase,2.3.0,2.3.1,40,3,13,3,16,3,TRUE
redux-react-firebase,1.5.0,1.6.0,17,13,148,28,176,16,TRUE
react-pivoter,0.0.5,0.0.6,5,3,18,6,24,6,FALSE
react-pivoter,0.0.4,0.0.5,4,2,9,1,10,2,FALSE
react-pivoter,0.0.7,0.0.8,7,1,1,1,2,1,FALSE
react-pivoter,0.0.6,0.0.7,6,2,12,12,24,4,FALSE
react-pivoter,0.0.1,0.0.2,1,1,1,1,2,1,FALSE
react-pivoter,0.0.3,0.0.4,3,3,20,9,29,3,FALSE
react-pivoter,0.0.2,0.0.3,2,1,1,1,2,1,FALSE
react-pivoter,0.0.5,0.0.6,5,3,18,6,24,6,TRUE
meng,2.0.6,2.1.0,38,1,17,16,33,5,FALSE
meng,2.0.5,2.0.6,37,1,17,16,33,5,FALSE
meng,2.0.4,2.0.5,36,1,26,856,882,14,FALSE
meng,2.0.3,2.0.4,35,2,53,7,60,9,FALSE
meng,3.0.3,3.0.4,49,3,92,2,94,3,FALSE
meng,2.0.1,2.0.2,33,2,970,39,1009,14,TRUE
meng,3.1.4,3.1.5,51,1,20,13,33,9,FALSE
meng,3.1.9,3.1.10,55,4,103,108,211,11,FALSE
meng,3.1.8,3.1.9,54,2,275,19,294,22,FALSE
meng,3.0.4,3.1.4,50,5,75,52,127,14,FALSE
meng,2.1.8,3.0.0,46,30,95608,12881,108489,183,FALSE
meng,2.1.2,2.1.3,41,1,32,4,36,8,FALSE
meng,2.1.3,2.1.4,42,1,75,62,137,10,FALSE
meng,2.1.0,2.1.1,39,3,11,10,21,6,FALSE
meng,2.1.1,2.1.2,40,2,3,3,6,3,FALSE
meng,2.1.6,2.1.8,45,5,14,48,62,17,FALSE
meng,2.1.4,2.1.5,43,2,2,2,4,2,FALSE
meng,2.0.2,2.0.3,34,3,3231,5,3236,8,FALSE
meng,3.1.5,3.1.6,52,4,37,30,67,8,FALSE
meng,3.0.1,3.0.3,48,5,206,176,382,13,FALSE
meng,3.0.0,3.0.1,47,1,67,13,80,11,FALSE
meng,2.1.5,2.1.6,44,2,10784,5402,16186,38,FALSE
meng,3.1.13,3.1.14,59,2,21,19,40,6,FALSE
meng,1.2.6,1.2.7,28,1,17,16,33,5,FALSE
meng,1.2.7,1.2.8,29,3,15,13,28,9,FALSE
meng,1.2.4,1.2.5,26,3,6,4,10,5,FALSE
meng,1.2.5,1.2.6,27,2,5,7,12,6,FALSE
meng,1.2.2,1.2.3,24,1,3,3,6,3,FALSE
meng,1.2.3,1.2.4,25,1,4,4,8,4,FALSE
meng,1.2.8,1.2.9,30,1,5,5,10,4,FALSE
meng,1.2.9,2.0.0,31,1,116,104,220,10,TRUE
meng,2.0.0,2.0.1,32,2,11,10,21,6,FALSE
meng,3.1.12,3.1.13,58,1,2,2,4,1,FALSE
meng,3.1.11,3.1.12,57,5,154,189,343,35,FALSE
meng,3.1.10,3.1.11,56,1,32,28,60,11,FALSE
meng,3.1.16,3.2.0,62,1,6,6,12,3,FALSE
meng,3.1.15,3.1.16,61,2,9,9,18,2,FALSE
meng,3.1.14,3.1.15,60,1,5,8,13,4,FALSE
meng,3.1.6,3.1.8,53,10,853,897,1750,90,FALSE
meng,3.2.0,3.2.1,63,3,2,6,8,4,TRUE
meng,3.2.1,3.2.2,64,2,5,3,8,4,TRUE
meng,3.2.2,3.2.3,65,2,21,18,39,4,FALSE
meng,2.0.1,2.0.2,33,2,970,39,1009,14,FALSE
meng,3.1.9,3.1.10,55,4,103,108,211,11,TRUE
meng,3.3.1,3.3.2,71,4,29,26,55,12,FALSE
meng,3.3.0,3.3.1,70,2,4,4,8,3,FALSE
meng,3.3.3,3.3.4,73,3,39,40,79,16,FALSE
meng,3.3.5,3.3.6,75,1,17,16,33,5,FALSE
meng,3.3.4,3.3.5,74,2,3,298,301,24,FALSE
meng,3.3.7,3.3.8,77,3,49,19,68,9,FALSE
meng,3.3.6,3.3.7,76,1,17,16,33,5,FALSE
meng,1.2.9,2.0.0,31,1,116,104,220,10,FALSE
meng,3.2.4,3.2.5,67,3,10,10,20,4,FALSE
meng,3.2.5,3.2.6,68,2,14,14,28,4,FALSE
meng,3.2.6,3.3.0,69,14,91913,82633,174546,70,FALSE
meng,3.3.2,3.3.3,72,7,1803,1702,3505,23,FALSE
meng,3.2.0,3.2.1,63,3,2,6,8,4,FALSE
meng,3.2.1,3.2.2,64,2,5,3,8,4,FALSE
meng,3.2.3,3.2.4,66,5,45154,43317,88471,52,FALSE
meng,3.2.4,3.2.5,67,3,10,10,20,4,TRUE
mobo,0.0.7,0.0.8,8,2,171,93,264,13,FALSE
mobo,0.0.6,0.0.7,7,2,184,138,322,7,FALSE
mobo,0.1.1,0.1.2,12,7,127,83,210,18,FALSE
mobo,1.1.0,1.1.2,58,2,96,36,132,9,FALSE
mobo,1.1.3,1.1.4,60,6,852,699,1551,51,FALSE
mobo,1.1.2,1.1.3,59,2,123,72,195,8,FALSE
mobo,1.0.0,1.0.1,56,6,17019,7149,24168,78,FALSE
mobo,1.0.1,1.1.0,57,1,207,50,257,6,FALSE
mobo,1.1.7,1.2.0,64,2,152,88,240,12,FALSE
mobo,1.1.6,1.1.7,63,1,4,1,5,2,FALSE
mobo,0.6.7,0.6.8,52,18,2719,437,3156,69,FALSE
mobo,1.3.4,1.3.5,71,1,23,6,29,3,FALSE
mobo,0.6.6,0.6.7,51,1,151,6,157,20,FALSE
mobo,0.2.7,0.2.8,26,3,159,33,192,20,FALSE
mobo,0.2.6,0.2.7,25,3,41,23,64,9,FALSE
mobo,0.2.5,0.2.6,24,1,0,6,6,1,FALSE
mobo,0.2.4,0.2.5,23,1,0,6,6,1,FALSE
mobo,0.2.3,0.2.4,22,1,33,11,44,5,FALSE
mobo,0.6.5,0.6.6,50,7,2437,88,2525,24,FALSE
mobo,0.2.1,0.2.2,20,1,46,5,51,4,FALSE
mobo,0.2.0,0.2.1,19,1,43,15,58,6,FALSE
mobo,0.1.0,0.1.1,11,1,0,6,6,1,FALSE
mobo,1.1.5,1.1.6,62,1,69,34,103,4,FALSE
mobo,0.1.2,0.1.3,13,2,198,103,301,10,FALSE
mobo,0.6.4,0.6.5,49,16,921,600,1521,67,FALSE
mobo,0.1.4,0.1.5,15,4,139,165,304,28,FALSE
mobo,0.1.5,0.1.6,16,1,42,25,67,14,FALSE
mobo,0.1.6,0.1.7,17,1,190,142,332,9,FALSE
mobo,0.1.7,0.2.0,18,1,183,65,248,10,FALSE
mobo,0.6.8,0.6.9,53,2,260,219,479,18,FALSE
mobo,0.3.3,0.3.4,31,1,49,44,93,5,FALSE
mobo,0.6.3,0.6.4,48,11,2776,2261,5037,37,FALSE
mobo,0.6.2,0.6.3,47,3,20,35,55,5,FALSE
mobo,0.6.1,0.6.2,46,3,59,99,158,7,FALSE
mobo,0.3.1,0.3.2,29,3,39,9,48,9,FALSE
mobo,0.0.9,0.1.0,10,1,267,98,365,12,FALSE
mobo,0.0.8,0.0.9,9,1,14756,29,14785,17,FALSE
mobo,0.3.4,0.3.5,32,4,190,121,311,20,FALSE
mobo,0.3.5,0.4.0,33,5,510,260,770,22,FALSE
mobo,1.6.3,1.6.4,81,9,296,85,381,30,FALSE
mobo,1.6.0,1.6.1,79,1,937,938,1875,11,FALSE
mobo,1.6.1,1.6.3,80,8,459,440,899,36,FALSE
mobo,1.6.6,1.6.7,84,10,181,129,310,23,FALSE
mobo,1.6.7,1.6.8,85,1,16,7,23,2,FALSE
mobo,1.6.4,1.6.5,82,3,57,31,88,7,FALSE
mobo,1.6.5,1.6.6,83,19,2286,1489,3775,90,FALSE
mobo,0.4.1,0.4.2,35,1,20,8,28,4,FALSE
mobo,0.4.0,0.4.1,34,5,162,56,218,8,FALSE
mobo,1.6.8,1.7.0,86,5,54,9,63,11,FALSE
mobo,0.4.2,0.4.3,36,2,203,102,305,13,FALSE
mobo,0.4.5,0.4.6,39,1,13,9,22,4,FALSE
mobo,0.5.1,0.5.3,41,2,62,31,93,8,FALSE
mobo,1.8.2,1.8.3,90,6,28,11,39,7,FALSE
mobo,0.4.6,0.5.1,40,27,21802,21538,43340,325,FALSE
mobo,1.4.0,1.5.0,76,35,2152,1114,3266,102,FALSE
mobo,0.1.3,0.1.4,14,2,208,34,242,19,FALSE
mobo,1.8.1,1.8.2,89,3,6,17,23,5,FALSE
mobo,1.5.1,1.6.0,78,34,6583,8419,15002,298,FALSE
mobo,0.6.9,0.7.0,54,5,409,2257,2666,45,FALSE
mobo,1.5.0,1.5.1,77,6,480,402,882,24,FALSE
mobo,1.3.3,1.3.4,70,2,233,134,367,8,FALSE
mobo,0.5.4,0.5.5,43,4,1325,172,1497,18,FALSE
mobo,1.3.1,1.3.2,68,1,33,22,55,4,FALSE
mobo,1.3.0,1.3.1,67,4,91,23,114,6,FALSE
mobo,1.3.7,1.3.9,74,18,3822,962,4784,88,FALSE
mobo,1.3.6,1.3.7,73,4,242,77,319,11,FALSE
mobo,1.2.0,1.2.1,65,2,61,63,124,9,FALSE
mobo,0.5.5,0.6.0,44,92,7498,5019,12517,403,FALSE
mobo,1.1.4,1.1.5,61,4,310,222,532,16,FALSE
mobo,1.3.9,1.4.0,75,3,271,76,347,14,FALSE
mobo,0.4.3,0.4.4,37,1,16,10,26,2,FALSE
mobo,0.2.8,0.3.0,27,1,182,93,275,17,FALSE
mobo,1.2.1,1.3.0,66,18,1807,674,2481,153,FALSE
mobo,1.7.0,1.8.0,87,6,199,121,320,13,FALSE
mobo,1.3.2,1.3.3,69,2,40,16,56,3,FALSE
mobo,1.8.0,1.8.1,88,1,43,3,46,5,FALSE
mobo,0.4.4,0.4.5,38,1,17,14,31,3,FALSE
mobo,0.3.2,0.3.3,30,1,188,164,352,11,FALSE
mobo,1.3.5,1.3.6,72,4,202,63,265,20,FALSE
mobo,0.7.0,1.0.0,55,8,65,44,109,9,FALSE
mobo,0.6.0,0.6.1,45,1,17,2,19,5,FALSE
mobo,0.5.3,0.5.4,42,1,18,6,24,2,FALSE
mobo,0.3.0,0.3.1,28,1,44,17,61,6,FALSE
mobo,0.2.2,0.2.3,21,2,82,29,111,15,FALSE
mobo,1.1.0,1.1.2,58,2,96,36,132,9,TRUE
mobo,1.1.7,1.2.0,64,2,152,88,240,12,TRUE
mobo,0.6.1,0.6.2,46,3,59,99,158,7,TRUE
mobo,0.3.4,0.3.5,32,4,190,121,311,20,TRUE
mobo,1.6.6,1.6.7,84,10,181,129,310,23,TRUE
mobo,1.3.0,1.3.1,67,4,91,23,114,6,TRUE
mobo,1.6.0,1.6.1,79,1,937,938,1875,11,TRUE
mobo,1.1.3,1.1.4,60,6,852,699,1551,51,TRUE
mobo,1.4.0,1.5.0,76,35,2152,1114,3266,102,TRUE
mobo,1.3.7,1.3.9,74,18,3822,962,4784,88,TRUE
mobo,1.3.6,1.3.7,73,4,242,77,319,11,TRUE
mobo,0.5.5,0.6.0,44,92,7498,5019,12517,403,TRUE
mobo,0.6.2,0.6.3,47,3,20,35,55,5,TRUE
mobo,1.5.0,1.5.1,77,6,480,402,882,24,TRUE
mobo,1.0.0,1.0.1,56,6,17019,7149,24168,78,TRUE
mobo,0.7.0,1.0.0,55,8,65,44,109,9,TRUE
mobo,0.6.3,0.6.4,48,11,2776,2261,5037,37,TRUE
mobo,1.8.2,1.8.3,90,6,28,11,39,7,TRUE
mobo,0.5.1,0.5.3,41,2,62,31,93,8,TRUE
mobo,0.0.4,0.0.5,5,1,1,1,2,2,FALSE
mobo,0.0.1,0.0.2,2,3,42,27,69,8,FALSE
mobo,0.0.0,0.0.1,1,5,319,203,522,50,FALSE
mobo,0.0.3,0.0.4,4,3,343,221,564,25,FALSE
mobo,0.0.2,0.0.3,3,1,0,6,6,1,FALSE
mobo,1.1.2,1.1.3,59,2,123,72,195,8,TRUE
mobo,0.6.5,0.6.6,50,7,2437,88,2525,24,TRUE
mobo,1.6.4,1.6.5,82,3,57,31,88,7,TRUE
mobo,1.6.5,1.6.6,83,19,2286,1489,3775,90,TRUE
mobo,1.2.1,1.3.0,66,18,1807,674,2481,153,TRUE
mobo,1.1.4,1.1.5,61,4,310,222,532,16,TRUE
react-isomorphic-render,9.1.9,9.1.10,184,1,13,7,20,4,FALSE
react-isomorphic-render,9.1.8,9.1.9,183,1,353,130,483,8,FALSE
react-isomorphic-render,9.1.17,10.0.0,191,4,92,91,183,18,FALSE
react-isomorphic-render,9.1.1,9.1.2,176,1,9,0,9,1,FALSE
react-isomorphic-render,9.1.0,9.1.1,175,5,257,185,442,20,FALSE
react-isomorphic-render,9.1.3,9.1.4,178,2,4,0,4,2,FALSE
react-isomorphic-render,9.1.2,9.1.3,177,2,233,15,248,12,FALSE
react-isomorphic-render,9.1.5,9.1.6,180,2,227,40,267,16,FALSE
react-isomorphic-render,9.1.4,9.1.5,179,2,8,8,16,6,FALSE
react-isomorphic-render,9.1.7,9.1.8,182,1,1,1,2,1,FALSE
react-isomorphic-render,9.1.6,9.1.7,181,2,32,4,36,4,FALSE
react-isomorphic-render,8.0.1,8.0.2,151,2,6,6,12,2,FALSE
react-isomorphic-render,11.0.4,11.0.5,236,2,20,8,28,5,FALSE
react-isomorphic-render,11.0.5,11.0.6,237,1,1,1,2,1,FALSE
react-isomorphic-render,11.0.6,11.0.7,238,5,115,19,134,9,FALSE
react-isomorphic-render,11.0.7,11.0.8,239,1,9,7,16,5,FALSE
react-isomorphic-render,11.0.0,11.0.1,232,1,2,2,4,2,FALSE
react-isomorphic-render,11.0.1,11.0.2,233,1,4,10,14,2,FALSE
react-isomorphic-render,11.0.2,11.0.3,234,1,13,8,21,4,FALSE
react-isomorphic-render,11.0.3,11.0.4,235,1,1,1,2,1,FALSE
react-isomorphic-render,11.0.8,11.0.9,240,1,3,3,6,3,FALSE
react-isomorphic-render,11.0.9,11.0.10,241,1,2,2,4,2,FALSE
react-isomorphic-render,8.0.11,8.0.12,161,1,15,5,20,2,FALSE
react-isomorphic-render,8.0.10,8.0.11,160,4,111,91,202,18,FALSE
react-isomorphic-render,8.0.13,9.0.0,163,2,2196,805,3001,63,FALSE
react-isomorphic-render,8.0.12,8.0.13,162,1,1,1,2,1,FALSE
react-isomorphic-render,10.1.0,10.1.1,194,1,29,10,39,4,FALSE
react-isomorphic-render,10.1.1,10.1.2,195,4,70,25,95,11,FALSE
react-isomorphic-render,10.1.2,10.1.3,196,1,8,8,16,3,FALSE
react-isomorphic-render,10.1.3,10.1.4,197,1,3,3,6,3,FALSE
react-isomorphic-render,10.1.4,10.1.5,198,1,3,3,6,3,FALSE
react-isomorphic-render,10.1.5,10.1.6,199,1,3,3,6,3,FALSE
react-isomorphic-render,10.1.6,10.1.7,200,1,1,1,2,1,FALSE
react-isomorphic-render,10.1.7,10.1.8,201,2,120,48,168,10,FALSE
react-isomorphic-render,10.1.8,10.1.10,202,1,1,1,2,1,FALSE
react-isomorphic-render,11.0.14,11.0.15,246,6,42,16,58,8,FALSE
react-isomorphic-render,11.0.15,11.0.16,247,1,93,11,104,5,FALSE
react-isomorphic-render,9.0.8,9.0.9,172,1,13,13,26,3,FALSE
react-isomorphic-render,9.0.9,9.0.10,173,1,13,11,24,2,FALSE
react-isomorphic-render,9.0.4,9.0.5,168,1,1,1,2,1,FALSE
react-isomorphic-render,9.0.5,9.0.6,169,1,1,1,2,1,FALSE
react-isomorphic-render,9.0.6,9.0.7,170,4,36,31,67,7,FALSE
react-isomorphic-render,9.0.7,9.0.8,171,1,12,8,20,3,FALSE
react-isomorphic-render,9.0.0,9.0.1,164,7,547,1371,1918,41,FALSE
react-isomorphic-render,9.0.1,9.0.2,165,28,67,75,142,28,FALSE
react-isomorphic-render,9.0.2,9.0.3,166,1,1,1,2,1,FALSE
react-isomorphic-render,9.0.3,9.0.4,167,3,31,11,42,10,FALSE
react-isomorphic-render,11.0.10,11.0.11,242,2,39,5,44,4,FALSE
react-isomorphic-render,11.0.11,11.0.12,243,4,765,288,1053,20,FALSE
react-isomorphic-render,10.3.2,10.3.4,221,3,9,4,13,5,FALSE
react-isomorphic-render,10.3.0,10.3.1,219,1,12,2,14,2,FALSE
react-isomorphic-render,10.3.1,10.3.2,220,1,13,6,19,2,FALSE
react-isomorphic-render,10.3.4,10.4.0,222,1,1,1,2,1,FALSE
react-isomorphic-render,10.4.1,10.4.2,224,1,25,2,27,5,FALSE
react-isomorphic-render,10.4.0,10.4.1,223,1,125,68,193,9,FALSE
react-isomorphic-render,10.4.3,10.4.4,226,1,228,48,276,9,FALSE
react-isomorphic-render,10.4.2,10.4.3,225,1,3,2,5,2,FALSE
react-isomorphic-render,10.4.5,10.4.6,228,1,3,3,6,3,FALSE
react-isomorphic-render,10.4.4,10.4.5,227,1,186,33,219,14,FALSE
react-isomorphic-render,10.4.7,10.4.8,230,1,157,75,232,7,FALSE
react-isomorphic-render,10.4.6,10.4.7,229,1,30,4,34,4,FALSE
react-isomorphic-render,10.4.8,11.0.0,231,1,172,169,341,15,FALSE
react-isomorphic-render,9.1.16,9.1.17,190,2,25,11,36,4,FALSE
react-isomorphic-render,10.0.1,10.1.0,193,2,51,53,104,8,FALSE
react-isomorphic-render,10.0.0,10.0.1,192,1,1,1,2,1,FALSE
react-isomorphic-render,10.1.12,10.2.0,205,2,88,29,117,15,FALSE
react-isomorphic-render,10.1.10,10.1.11,203,3,31,7,38,8,FALSE
react-isomorphic-render,10.1.11,10.1.12,204,2,26,27,53,3,FALSE
react-isomorphic-render,10.2.7,10.2.8,213,2,26,9,35,4,FALSE
react-isomorphic-render,10.2.6,10.2.7,212,1,19,5,24,3,FALSE
react-isomorphic-render,10.2.5,10.2.6,211,1,1,1,2,1,FALSE
react-isomorphic-render,10.2.4,10.2.5,210,1,18,10,28,3,FALSE
react-isomorphic-render,10.2.3,10.2.4,209,1,17,1,18,4,FALSE
react-isomorphic-render,10.2.2,10.2.3,208,2,15,9,24,7,FALSE
react-isomorphic-render,10.2.1,10.2.2,207,2,8,2,10,2,FALSE
react-isomorphic-render,10.2.0,10.2.1,206,2,16,9,25,4,FALSE
react-isomorphic-render,10.2.9,10.2.10,215,2,5,3,8,3,FALSE
react-isomorphic-render,10.2.8,10.2.9,214,1,5,2,7,2,FALSE
react-isomorphic-render,9.1.11,9.1.12,186,2,39,31,70,5,FALSE
react-isomorphic-render,9.1.10,9.1.11,185,3,308,34,342,16,FALSE
react-isomorphic-render,9.1.13,9.1.14,188,1,1,1,2,1,FALSE
react-isomorphic-render,9.1.12,9.1.13,187,4,179,51,230,8,FALSE
react-isomorphic-render,9.1.14,9.1.16,189,2,45,12,57,9,FALSE
react-isomorphic-render,10.2.11,10.2.12,217,1,3,3,6,2,FALSE
react-isomorphic-render,10.2.10,10.2.11,216,1,2,2,4,2,FALSE
react-isomorphic-render,8.0.9,8.0.10,159,1,5,2,7,2,FALSE
react-isomorphic-render,8.0.8,8.0.9,158,1,1,1,2,1,FALSE
react-isomorphic-render,8.0.5,8.0.6,155,1,7,2,9,3,FALSE
react-isomorphic-render,8.0.4,8.0.5,154,2,23,5,28,4,FALSE
react-isomorphic-render,8.0.7,8.0.8,157,2,5,4,9,3,FALSE
react-isomorphic-render,8.0.6,8.0.7,156,1,13,20,33,2,FALSE
react-isomorphic-render,11.0.12,11.0.13,244,7,87,49,136,14,FALSE
react-isomorphic-render,11.0.13,11.0.14,245,1,19,4,23,5,FALSE
react-isomorphic-render,8.0.3,8.0.4,153,1,1,1,2,1,FALSE
react-isomorphic-render,8.0.2,8.0.3,152,1,7,1,8,2,FALSE
react-isomorphic-render,9.0.10,9.1.0,174,4,840,645,1485,35,FALSE
react-isomorphic-render,8.0.0,8.0.1,150,1,2,2,4,2,FALSE
react-isomorphic-render,10.2.12,10.3.0,218,2,31,22,53,7,FALSE
react-isomorphic-render,4.0.33,4.0.34,86,2,36,37,73,3,FALSE
react-isomorphic-render,4.0.32,4.0.33,85,1,57,39,96,5,FALSE
react-isomorphic-render,4.0.31,4.0.32,84,3,42,28,70,5,FALSE
react-isomorphic-render,4.0.30,4.0.31,83,1,8,3,11,3,FALSE
react-isomorphic-render,4.0.37,4.0.38,90,2,17,5,22,4,FALSE
react-isomorphic-render,4.0.36,4.0.37,89,1,74,52,126,6,FALSE
react-isomorphic-render,4.0.35,4.0.36,88,1,13,1,14,3,FALSE
react-isomorphic-render,4.0.34,4.0.35,87,2,32,19,51,7,FALSE
react-isomorphic-render,4.0.39,4.0.40,92,4,10,5,15,6,FALSE
react-isomorphic-render,4.0.38,4.0.39,91,1,10,7,17,4,FALSE
react-isomorphic-render,5.0.10,5.0.11,114,1,2,2,4,2,FALSE
react-isomorphic-render,5.0.11,6.0.0,115,1,233,208,441,19,FALSE
react-isomorphic-render,4.0.1,4.0.2,54,7,38,320,358,10,FALSE
react-isomorphic-render,4.0.0,4.0.1,53,6,11,22,33,6,FALSE
react-isomorphic-render,4.0.3,4.0.4,56,1,7,2,9,3,FALSE
react-isomorphic-render,4.0.2,4.0.3,55,1,21,13,34,3,FALSE
react-isomorphic-render,4.0.5,4.0.6,58,2,44,10,54,9,FALSE
react-isomorphic-render,4.0.4,4.0.5,57,2,33,4,37,2,FALSE
react-isomorphic-render,4.0.7,4.0.8,60,2,19,7,26,6,FALSE
react-isomorphic-render,4.0.6,4.0.7,59,1,63,15,78,9,FALSE
react-isomorphic-render,4.0.9,4.0.10,62,4,80,322,402,12,FALSE
react-isomorphic-render,4.0.8,4.0.9,61,2,10,2,12,2,FALSE
react-isomorphic-render,5.0.0,5.0.2,105,4,301,118,419,23,FALSE
react-isomorphic-render,5.0.2,5.0.3,106,1,1,1,2,1,FALSE
react-isomorphic-render,5.0.3,5.0.4,107,2,11,6,17,6,FALSE
react-isomorphic-render,4.0.40,4.1.0,93,2,82,33,115,8,FALSE
react-isomorphic-render,7.0.2,7.1.0,123,3,302,111,413,13,FALSE
react-isomorphic-render,7.0.0,7.0.1,121,14,101,87,188,18,FALSE
react-isomorphic-render,7.0.1,7.0.2,122,1,1,1,2,1,FALSE
react-isomorphic-render,5.0.4,5.0.5,108,1,1,1,2,1,FALSE
react-isomorphic-render,5.0.5,5.0.6,109,1,11,4,15,5,FALSE
react-isomorphic-render,5.0.6,5.0.7,110,3,25,6,31,7,FALSE
react-isomorphic-render,5.0.7,5.0.8,111,1,3,3,6,3,FALSE
react-isomorphic-render,5.0.8,5.0.9,112,1,60,8,68,7,FALSE
react-isomorphic-render,5.0.9,5.0.10,113,3,4,6,10,4,FALSE
react-isomorphic-render,6.1.0,7.0.0,120,3,642,339,981,20,FALSE
react-isomorphic-render,10.1.0,10.1.1,194,1,29,10,39,4,TRUE
react-isomorphic-render,3.0.4,3.0.5,51,1,2,2,4,2,FALSE
react-isomorphic-render,3.0.5,4.0.0,52,1,383,275,658,11,FALSE
react-isomorphic-render,3.0.1,3.0.2,48,1,3,354,357,8,FALSE
react-isomorphic-render,4.1.4,4.1.5,98,2,10,5,15,5,FALSE
react-isomorphic-render,4.1.5,4.1.6,99,1,7,2,9,3,FALSE
react-isomorphic-render,4.1.7,4.1.8,101,1,7,2,9,3,FALSE
react-isomorphic-render,4.1.0,4.1.1,94,2,118,100,218,8,FALSE
react-isomorphic-render,4.1.1,4.1.2,95,1,26,8,34,5,FALSE
react-isomorphic-render,4.1.2,4.1.3,96,1,14,12,26,3,FALSE
react-isomorphic-render,4.1.3,4.1.4,97,1,40,22,62,6,FALSE
react-isomorphic-render,4.1.8,4.1.9,102,1,4,2,6,3,FALSE
react-isomorphic-render,4.1.9,4.1.10,103,1,91,36,127,7,FALSE
react-isomorphic-render,7.1.17,7.1.18,141,1,1,1,2,1,FALSE
react-isomorphic-render,7.1.16,7.1.17,140,2,43,31,74,8,FALSE
react-isomorphic-render,7.1.15,7.1.16,139,1,9,3,12,3,FALSE
react-isomorphic-render,7.1.14,7.1.15,138,1,17,22,39,4,FALSE
react-isomorphic-render,7.1.13,7.1.14,137,1,18,10,28,4,FALSE
react-isomorphic-render,7.1.12,7.1.13,136,1,10,4,14,4,FALSE
react-isomorphic-render,7.1.11,7.1.12,135,2,6,3,9,3,FALSE
react-isomorphic-render,7.1.10,7.1.11,134,2,35,17,52,6,FALSE
react-isomorphic-render,7.1.19,7.1.20,143,1,1,1,2,1,FALSE
react-isomorphic-render,7.1.18,7.1.19,142,1,176,3,179,5,FALSE
react-isomorphic-render,3.0.2,3.0.3,49,1,2,1,3,2,FALSE
react-isomorphic-render,3.0.3,3.0.4,50,1,329,258,587,14,FALSE
react-isomorphic-render,6.0.3,6.1.0,119,1,116,15,131,10,FALSE
react-isomorphic-render,6.0.2,6.0.3,118,7,36,9,45,10,FALSE
react-isomorphic-render,6.0.1,6.0.2,117,1,65,21,86,10,FALSE
react-isomorphic-render,6.0.0,6.0.1,116,1,11,16,27,4,FALSE
react-isomorphic-render,7.1.24,7.1.25,148,2,88,9,97,7,FALSE
react-isomorphic-render,7.1.25,8.0.0,149,24,557,572,1129,43,FALSE
react-isomorphic-render,7.1.22,7.1.23,146,2,38,22,60,4,FALSE
react-isomorphic-render,7.1.23,7.1.24,147,1,1,1,2,1,FALSE
react-isomorphic-render,7.1.20,7.1.21,144,1,196,119,315,6,FALSE
react-isomorphic-render,7.1.21,7.1.22,145,2,119,106,225,6,FALSE
react-isomorphic-render,4.0.19,4.0.20,72,1,4,4,8,3,FALSE
react-isomorphic-render,4.0.18,4.0.19,71,3,12,21,33,4,FALSE
react-isomorphic-render,4.0.11,4.0.12,64,1,29,14,43,4,FALSE
react-isomorphic-render,4.0.10,4.0.11,63,2,11,7,18,5,FALSE
react-isomorphic-render,4.0.13,4.0.14,66,2,178,78,256,17,FALSE
react-isomorphic-render,4.0.12,4.0.13,65,1,88,47,135,3,FALSE
react-isomorphic-render,4.0.15,4.0.16,68,1,404,240,644,13,FALSE
react-isomorphic-render,4.0.14,4.0.15,67,10,30,15,45,14,FALSE
react-isomorphic-render,4.0.17,4.0.18,70,1,16,30,46,5,FALSE
react-isomorphic-render,4.0.16,4.0.17,69,3,26,23,49,6,FALSE
react-isomorphic-render,4.0.24,4.0.25,77,1,64,6,70,2,FALSE
react-isomorphic-render,4.0.26,4.0.27,79,2,42,42,84,8,FALSE
react-isomorphic-render,4.0.27,4.0.28,80,1,1,1,2,1,FALSE
react-isomorphic-render,4.0.20,4.0.21,73,1,4,2,6,2,FALSE
react-isomorphic-render,4.0.21,4.0.22,74,1,17,7,24,3,FALSE
react-isomorphic-render,4.0.22,4.0.23,75,2,98,51,149,4,TRUE
react-isomorphic-render,4.0.23,4.0.24,76,1,2,2,4,2,FALSE
react-isomorphic-render,4.0.28,4.0.29,81,2,4,2,6,4,FALSE
react-isomorphic-render,4.0.29,4.0.30,82,2,35,28,63,5,FALSE
react-isomorphic-render,4.1.10,5.0.0,104,1,1,1,2,1,FALSE
react-isomorphic-render,7.1.9,7.1.10,133,3,132,130,262,8,FALSE
react-isomorphic-render,7.1.8,7.1.9,132,1,11,3,14,2,FALSE
react-isomorphic-render,7.1.7,7.1.8,131,1,1,1,2,1,FALSE
react-isomorphic-render,7.1.6,7.1.7,130,1,246,231,477,6,FALSE
react-isomorphic-render,7.1.5,7.1.6,129,7,45,50,95,9,FALSE
react-isomorphic-render,7.1.4,7.1.5,128,1,1,1,2,1,FALSE
react-isomorphic-render,7.1.3,7.1.4,127,1,23,150,173,5,FALSE
react-isomorphic-render,7.1.2,7.1.3,126,1,5,3,8,2,FALSE
react-isomorphic-render,7.1.1,7.1.2,125,2,7,4,11,4,FALSE
react-isomorphic-render,7.1.0,7.1.1,124,1,1,1,2,1,FALSE
react-isomorphic-render,4.0.25,4.0.26,78,1,1,1,2,1,FALSE
react-isomorphic-render,4.1.6,4.1.7,100,1,4,4,8,3,FALSE
react-isomorphic-render,2.1.29,2.1.30,39,3,29,12,41,4,FALSE
react-isomorphic-render,3.0.0,3.0.1,47,2,54,16,70,4,FALSE
react-isomorphic-render,4.0.22,4.0.23,75,2,98,51,149,4,FALSE
react-isomorphic-render,2.1.32,2.1.33,42,2,60,10,70,6,FALSE
react-isomorphic-render,2.1.33,2.1.34,43,2,18,8,26,2,FALSE
react-isomorphic-render,2.1.30,2.1.31,40,2,22,6,28,4,FALSE
react-isomorphic-render,2.1.31,2.1.32,41,1,1,1,2,1,FALSE
react-isomorphic-render,2.1.36,3.0.0,46,2,57,38,95,6,FALSE
react-isomorphic-render,2.1.34,2.1.35,44,2,2,2,4,2,FALSE
react-isomorphic-render,2.1.35,2.1.36,45,2,6,4,10,2,FALSE
react-isomorphic-render,1.0.0,1.0.1,1,2,8,10,18,2,FALSE
react-isomorphic-render,1.0.1,1.0.2,2,2,118,72,190,10,FALSE
react-isomorphic-render,1.0.2,1.1.0,3,4,75,52,127,9,FALSE
react-isomorphic-render,2.1.7,2.1.8,19,2,16,8,24,3,FALSE
react-isomorphic-render,2.1.21,2.1.22,33,2,39,3,42,3,FALSE
react-isomorphic-render,2.1.20,2.1.21,32,2,68,63,131,5,FALSE
react-isomorphic-render,2.1.23,2.1.24,35,2,51,13,64,3,FALSE
react-isomorphic-render,2.1.22,2.1.23,34,2,13,4,17,3,FALSE
react-isomorphic-render,2.1.25,2.1.26,37,2,224,101,325,7,FALSE
react-isomorphic-render,2.1.26,2.1.29,38,6,124,85,209,11,FALSE
react-isomorphic-render,2.1.18,2.1.19,30,2,31,2,33,3,FALSE
react-isomorphic-render,2.1.19,2.1.20,31,2,22,9,31,6,FALSE
react-isomorphic-render,2.1.16,2.1.17,28,2,58,11,69,5,FALSE
react-isomorphic-render,2.1.17,2.1.18,29,2,2,2,4,2,FALSE
react-isomorphic-render,2.1.10,2.1.11,22,2,33,18,51,3,FALSE
react-isomorphic-render,2.1.11,2.1.12,23,6,235,41,276,10,FALSE
react-isomorphic-render,2.1.12,2.1.13,24,3,9,5,14,4,FALSE
react-isomorphic-render,2.1.13,2.1.14,25,2,26,9,35,3,FALSE
react-isomorphic-render,2.1.14,2.1.15,26,2,2,2,4,2,FALSE
react-isomorphic-render,2.1.15,2.1.16,27,2,49,34,83,4,FALSE
react-isomorphic-render,2.0.1,2.1.0,11,3,94,33,127,10,FALSE
react-isomorphic-render,2.0.0,2.0.1,10,2,18,1,19,2,FALSE
react-isomorphic-render,1.3.0,1.3.1,6,8,36,21,57,8,FALSE
react-isomorphic-render,2.1.2,2.1.3,14,1,1,1,2,1,FALSE
react-isomorphic-render,1.1.0,1.2.0,4,2,87,63,150,6,FALSE
react-isomorphic-render,2.1.8,2.1.9,20,2,267,120,387,8,FALSE
react-isomorphic-render,2.1.9,2.1.10,21,4,72,15,87,8,FALSE
react-isomorphic-render,2.1.3,2.1.4,15,2,56,21,77,5,FALSE
react-isomorphic-render,2.1.1,2.1.2,13,3,18,73,91,6,FALSE
react-isomorphic-render,2.1.0,2.1.1,12,3,5,10,15,3,FALSE
react-isomorphic-render,2.1.4,2.1.5,16,4,234,92,326,14,FALSE
react-isomorphic-render,2.1.5,2.1.6,17,2,2,2,4,2,FALSE
react-isomorphic-render,2.1.6,2.1.7,18,2,9,4,13,4,FALSE
react-isomorphic-render,2.1.24,2.1.25,36,2,211,16,227,3,FALSE
react-isomorphic-render,1.4.0,1.4.1,8,3,90,24,114,10,FALSE
react-isomorphic-render,1.4.1,2.0.0,9,2,157,92,249,10,TRUE
react-isomorphic-render,1.2.0,1.3.0,5,7,51,38,89,9,FALSE
react-isomorphic-render,1.3.1,1.4.0,7,1,1,1,2,1,FALSE
react-isomorphic-render,2.1.32,2.1.33,42,2,60,10,70,6,TRUE
react-isomorphic-render,1.4.1,2.0.0,9,2,157,92,249,10,FALSE
react-isomorphic-render,9.1.1,9.1.2,176,1,9,0,9,1,TRUE
react-isomorphic-render,9.1.0,9.1.1,175,5,257,185,442,20,TRUE
react-isomorphic-render,10.2.12,10.3.0,218,2,31,22,53,7,TRUE
react-isomorphic-render,7.1.6,7.1.7,130,1,246,231,477,6,TRUE
react-isomorphic-render,10.1.7,10.1.8,201,2,120,48,168,10,TRUE
react-isomorphic-render,10.1.8,10.1.10,202,1,1,1,2,1,TRUE
react-isomorphic-render,11.0.11,11.0.12,243,4,765,288,1053,20,TRUE
react-isomorphic-render,10.1.11,10.1.12,204,2,26,27,53,3,TRUE
react-isomorphic-render,10.2.3,10.2.4,209,1,17,1,18,4,TRUE
react-isomorphic-render,10.2.11,10.2.12,217,1,3,3,6,2,TRUE
react-isomorphic-render,2.1.0,2.1.1,12,3,5,10,15,3,TRUE
react-isomorphic-render,11.0.7,11.0.8,239,1,9,7,16,5,TRUE
react-isomorphic-render,11.0.10,11.0.11,242,2,39,5,44,4,TRUE
react-isomorphic-render,2.1.4,2.1.5,16,4,234,92,326,14,TRUE
react-isomorphic-render,10.4.2,10.4.3,225,1,3,2,5,2,TRUE
react-isomorphic-render,10.0.1,10.1.0,193,2,51,53,104,8,TRUE
react-isomorphic-render,4.0.29,4.0.30,82,2,35,28,63,5,TRUE
react-isomorphic-render,8.0.1,8.0.2,151,2,6,6,12,2,TRUE
react-isomorphic-render,4.0.9,4.0.10,62,4,80,322,402,12,TRUE
react-isomorphic-render,5.0.4,5.0.5,108,1,1,1,2,1,TRUE
react-isomorphic-render,8.0.10,8.0.11,160,4,111,91,202,18,TRUE
react-isomorphic-render,2.1.16,2.1.17,28,2,58,11,69,5,TRUE
react-isomorphic-render,10.1.6,10.1.7,200,1,1,1,2,1,TRUE
react-isomorphic-render,3.0.2,3.0.3,49,1,2,1,3,2,TRUE
react-isomorphic-render,4.0.14,4.0.15,67,10,30,15,45,14,TRUE
react-isomorphic-render,9.0.10,9.1.0,174,4,840,645,1485,35,TRUE
react-isomorphic-render,2.1.23,2.1.24,35,2,51,13,64,3,TRUE
react-isomorphic-render,2.1.25,2.1.26,37,2,224,101,325,7,TRUE
react-isomorphic-render,9.1.2,9.1.3,177,2,233,15,248,12,TRUE
react-isomorphic-render,4.1.1,4.1.2,95,1,26,8,34,5,TRUE
react-isomorphic-render,4.1.9,4.1.10,103,1,91,36,127,7,TRUE
paqs,1.0.0,1.0.1,1,9,509,206,715,20,FALSE
paqs,1.0.0,1.0.1,1,9,509,206,715,20,TRUE
grunt-react-boilerplate,0.0.1,2.0.0,1,5,134,65,199,10,FALSE
grunt-react-boilerplate,0.0.1,2.0.0,1,5,134,65,199,10,TRUE
fisher-primeng,4.0.0-rc.3-SNAPSHOT,4.0.0,1,1,1,1,2,1,FALSE
fisher-primeng,4.0.1-rc.3-SNAPSHOT,4.0.1,3,1,1,1,2,1,FALSE
fisher-primeng,4.0.2-rc.3-SNAPSHOT,4.0.4-SNAPSHOT,5,1,1,1,2,1,FALSE
fisher-primeng,4.0.2-rc.3-SNAPSHOT,4.0.4-SNAPSHOT,5,1,1,1,2,1,TRUE
babel-plugin-filter-imports,0.1.0,0.2.0,1,5,171,126,297,31,FALSE
babel-plugin-filter-imports,0.3.0,0.3.1,4,11,164,6,170,11,FALSE
babel-plugin-filter-imports,0.2.1,0.3.0,3,1,1,1,2,1,TRUE
babel-plugin-filter-imports,0.2.0,0.2.1,2,11,187,155,342,41,FALSE
babel-plugin-filter-imports,0.2.1,0.3.0,3,1,1,1,2,1,FALSE
react-inform,0.1.2,0.2.0,9,17,2666,927,3593,90,TRUE
react-inform,0.2.1,0.2.2,11,2,336,34,370,9,FALSE
react-inform,0.2.0,0.2.1,10,2,2,2,4,2,FALSE
react-inform,0.0.5,0.0.6-beta1,5,2,2,2,4,2,FALSE
react-inform,0.0.4,0.0.5,4,4,17,29,46,9,FALSE
react-inform,0.0.1,0.0.2,1,7,4016,8,4024,19,FALSE
react-inform,0.0.6-beta1,0.1.0,6,11,962,7329,8291,44,FALSE
react-inform,0.0.3,0.0.4,3,2,3,2,5,2,FALSE
react-inform,0.0.2,0.0.3,2,5,802,41,843,19,FALSE
react-inform,0.1.0,0.1.1,7,7,17,17,34,11,FALSE
react-inform,0.1.1,0.1.2,8,7,821,533,1354,81,FALSE
react-inform,0.1.2,0.2.0,9,17,2666,927,3593,90,FALSE
react-inform,0.0.6-beta1,0.1.0,6,11,962,7329,8291,44,TRUE
react-inform,0.2.0,0.2.1,10,2,2,2,4,2,TRUE
cluster-controller,0.1.0-alpha-8,0.1.1-alpha-1,16,1,2,5,7,3,FALSE
cluster-controller,0.1.0-alpha-4,0.1.0-alpha-5,12,1,2,5,7,3,FALSE
cluster-controller,0.1.0-alpha-5,0.1.0-alpha-6,13,1,2,5,7,3,FALSE
cluster-controller,0.1.0-alpha-6,0.1.0-alpha-7,14,1,2,5,7,3,FALSE
cluster-controller,0.1.0-alpha-7,0.1.0-alpha-8,15,1,2,5,7,3,FALSE
cluster-controller,0.1.1-alpha-11,0.1.1-alpha-12,19,1,2,5,7,3,FALSE
cluster-controller,0.1.0-alpha-1,0.1.0-alpha-2,9,1,2,5,7,3,FALSE
cluster-controller,0.1.0-alpha-2,0.1.0-alpha-3,10,1,2,5,7,3,FALSE
cluster-controller,0.1.0-alpha-3,0.1.0-alpha-4,11,1,2,5,7,3,FALSE
cluster-controller,0.1.2,0.1.3-alpha,29,1,2,5,7,3,FALSE
cluster-controller,0.1.1-alpha-6,0.1.1-alpha-7,25,1,2,5,7,3,FALSE
cluster-controller,0.1.3-alpha-3,0.1.4,32,1,2,5,7,3,FALSE
cluster-controller,0.1.3-alpha-2,0.1.3-alpha-3,31,1,2,5,7,3,FALSE
cluster-controller,0.1.1-alpha-10,0.1.1-alpha-11,18,1,2,5,7,3,FALSE
cluster-controller,0.1.1-alpha-9,0.1.2,28,1,2,5,7,3,FALSE
cluster-controller,0.1.1-alpha-8,0.1.1-alpha-9,27,1,2,5,7,3,FALSE
cluster-controller,0.1.1-alpha-5,0.1.1-alpha-6,24,1,2,5,7,3,FALSE
cluster-controller,0.1.1-alpha-4,0.1.1-alpha-5,23,1,2,5,7,3,FALSE
cluster-controller,0.1.1-alpha-7,0.1.1-alpha-8,26,1,2,5,7,3,FALSE
cluster-controller,0.1.1-alpha-1,0.1.1-alpha-10,17,1,2,5,7,3,FALSE
cluster-controller,0.1.1-alpha-3,0.1.1-alpha-4,22,1,2,5,7,3,FALSE
cluster-controller,0.1.1-alpha-2,0.1.1-alpha-3,21,1,2,5,7,3,FALSE
cluster-controller,0.1.3-alpha,0.1.3-alpha-2,30,1,2,5,7,3,FALSE
cluster-controller,0.0.7-alpha-1,0.0.7-alpha-2,7,1,2,5,7,3,FALSE
cluster-controller,0.0.5,0.0.6,5,1,2,5,7,3,FALSE
cluster-controller,0.0.4,0.0.5,4,1,2,5,7,3,FALSE
cluster-controller,0.0.1,0.0.2,1,1,91,31,122,3,FALSE
cluster-controller,0.0.3,0.0.4,3,1,5,5,10,3,FALSE
cluster-controller,0.0.2,0.0.3,2,1,3,2,5,2,FALSE
cluster-controller,0.0.7-alpha-2,0.1.0-alpha-1,8,1,2,5,7,3,FALSE
cluster-controller,0.0.6,0.0.7-alpha-1,6,1,2,5,7,3,FALSE
cluster-controller,0.1.0-alpha-5,0.1.0-alpha-6,13,1,2,5,7,3,TRUE
b-rc,0.3.1,0.4.0,15,9,2780,106,2886,71,FALSE
b-rc,0.2.1,0.3.0,13,1,209,3,212,13,FALSE
b-rc,0.2.0,0.2.1,12,3,29,6,35,3,FALSE
b-rc,0.1.0,0.1.1,10,4,211,776,987,20,FALSE
b-rc,0.1.1,0.2.0,11,1,463,1,464,11,FALSE
b-rc,0.0.5,0.0.6,5,8,147,6944,7091,119,FALSE
b-rc,0.0.4,0.0.5,4,2,293,286,579,9,FALSE
b-rc,0.0.7,0.0.8,7,1,6,1,7,2,FALSE
b-rc,0.0.6,0.0.7,6,1,6,1,7,2,FALSE
b-rc,0.0.1,0.0.2,1,9,5482,2942,8424,63,FALSE
b-rc,0.0.3,0.0.4,3,1,40,37,77,1,FALSE
b-rc,0.0.2,0.0.3,2,2,10,10,20,5,FALSE
b-rc,0.6.0,0.6.1,21,2,2,2,4,2,FALSE
b-rc,0.0.9,0.1.0,9,34,18372,3147,21519,326,FALSE
b-rc,0.0.8,0.0.9,8,7,577,398,975,29,FALSE
b-rc,0.4.1,0.4.2,17,1,1,0,1,1,FALSE
b-rc,0.4.0,0.4.1,16,2,3,3,6,3,FALSE
b-rc,0.4.2,0.5.0,18,10,1880,176,2056,40,FALSE
b-rc,0.5.0,0.5.1,19,1,6,2,8,3,FALSE
b-rc,0.5.1,0.6.0,20,8,1501,58,1559,51,FALSE
b-rc,0.3.0,0.3.1,14,1,6,1,7,2,FALSE
b-rc,0.1.0,0.1.1,10,4,211,776,987,20,TRUE
b-rc,0.0.9,0.1.0,9,34,18372,3147,21519,326,TRUE
b-rc,0.2.0,0.2.1,12,3,29,6,35,3,TRUE
b-rc,0.0.1,0.0.2,1,9,5482,2942,8424,63,TRUE
b-rc,0.0.2,0.0.3,2,2,10,10,20,5,TRUE
b-rc,0.5.1,0.6.0,20,8,1501,58,1559,51,TRUE
b-rc,0.0.8,0.0.9,8,7,577,398,975,29,TRUE
b-rc,0.4.2,0.5.0,18,10,1880,176,2056,40,TRUE
nooocl,0.9.0,0.9.1,1,14,376,39,415,17,TRUE
nooocl,0.10.1,0.11.0,14,4,10,10,20,5,FALSE
nooocl,0.10.0,0.10.1,13,2,28,28,56,8,FALSE
nooocl,0.11.0,0.11.1,15,1,26,24,50,2,FALSE
nooocl,0.11.1,0.12.0,16,5,432,309,741,67,FALSE
nooocl,0.12.3,0.12.4,20,10,80,47,127,15,FALSE
nooocl,0.12.2,0.12.3,19,4,22,10,32,10,FALSE
nooocl,0.12.1,0.12.2,18,2,11,7,18,3,FALSE
nooocl,0.12.0,0.12.1,17,2,84,77,161,3,FALSE
nooocl,0.12.4,0.12.5,21,14,219,76,295,22,FALSE
nooocl,0.9.0,0.9.1,1,14,376,39,415,17,FALSE
nooocl,0.9.1,0.9.2,2,8,6505,6266,12771,106,FALSE
nooocl,0.9.2,0.9.3,3,15,1432,554,1986,49,TRUE
nooocl,0.9.3,0.9.4,4,2,6,2,8,6,FALSE
nooocl,0.9.4,0.9.5,5,7,155,121,276,18,FALSE
nooocl,0.9.5,0.9.6,6,1,3,7,10,2,FALSE
nooocl,0.9.6,0.9.7,7,5,642,644,1286,12,FALSE
nooocl,0.9.7,0.9.8,8,2,747,725,1472,35,FALSE
nooocl,0.9.8,0.9.9,9,12,575,333,908,31,FALSE
nooocl,0.9.9,0.9.10,10,1,23,23,46,2,FALSE
nooocl,0.9.12,0.10.0,12,2,3,1,4,2,FALSE
nooocl,0.9.10,0.9.12,11,6,379,376,755,17,FALSE
nooocl,0.9.2,0.9.3,3,15,1432,554,1986,49,FALSE
httplease-asap,0.2.3,0.3.0-beta2,7,2,7,5,12,4,FALSE
httplease-asap,0.2.2,0.2.3,6,8,100,29,129,10,FALSE
httplease-asap,0.2.1,0.2.2,5,6,112,42,154,10,FALSE
httplease-asap,0.2.0,0.2.1,4,5,13,7,20,6,FALSE
httplease-asap,0.3.0-beta2,0.3.0,8,4,11,9,20,7,FALSE
httplease-asap,0.2.0-beta1,0.2.0-beta2,2,1,314,142,456,7,FALSE
httplease-asap,0.2.0-beta2,0.2.0,3,9,708,288,996,38,FALSE
httplease-asap,0.1.0,0.2.0-beta1,1,3,4,3,7,3,FALSE
httplease-asap,0.2.2,0.2.3,6,8,100,29,129,10,TRUE
winston-rsyslog-logstash,0.0.1,0.0.2,1,3,4,3,7,4,FALSE
winston-rsyslog-logstash,0.0.2,0.0.3,2,1,16,16,32,2,FALSE
winston-rsyslog-logstash,0.0.1,0.0.2,1,3,4,3,7,4,TRUE
dorita980,3.0.6,3.0.7,26,2,45,10,55,5,FALSE
dorita980,3.0.7,3.0.8,27,2,4,4,8,3,FALSE
dorita980,3.0.4,3.0.5,24,2,8,3,11,3,FALSE
dorita980,3.0.5,3.0.6,25,2,3,4,7,3,FALSE
dorita980,3.0.2,3.0.4,23,4,29,5,34,5,FALSE
dorita980,1.0.1,2.0.0,2,1,174,74,248,7,FALSE
dorita980,3.0.0,3.0.1,21,1,5,3,8,3,FALSE
dorita980,2.0.0,2.1.0,3,1,35,35,70,1,FALSE
dorita980,3.0.8,3.0.9,28,4,7,7,14,5,FALSE
dorita980,3.0.9,3.0.10,29,2,81,4,85,2,FALSE
dorita980,2.2.1,2.3.0,6,1,15,9,24,2,FALSE
dorita980,2.2.0,2.2.1,5,1,81,12,93,3,FALSE
dorita980,2.1.0,2.2.0,4,2,400,21,421,7,FALSE
dorita980,3.0.1,3.0.2,22,2,77,12,89,6,FALSE
dorita980,3.0.10,3.0.11,30,4,70,39,109,4,FALSE
dorita980,2.5.1,3.0.0,20,1,1078,337,1415,12,FALSE
dorita980,2.3.0,2.3.1,7,3,97,49,146,6,FALSE
dorita980,2.3.1,2.3.2,8,1,1,1,2,1,FALSE
dorita980,2.3.2,2.3.3,9,3,397,10,407,9,FALSE
dorita980,2.3.3,2.3.5,10,3,450,22,472,7,FALSE
dorita980,2.3.5,2.4.0,11,1,3,3,6,3,FALSE
dorita980,2.4.3,2.4.4,15,1,18,17,35,4,FALSE
dorita980,2.4.2,2.4.3,14,1,2,2,4,1,FALSE
dorita980,2.4.1,2.4.2,13,1,2,2,4,2,FALSE
dorita980,2.4.0,2.4.1,12,1,102,41,143,4,FALSE
dorita980,2.4.7,2.5.1,19,2,100,10,110,6,FALSE
dorita980,2.4.6,2.4.7,18,4,6,4,10,5,FALSE
dorita980,2.4.5,2.4.6,17,1,69,53,122,2,FALSE
dorita980,2.4.4,2.4.5,16,1,2,1,3,2,FALSE
dorita980,1.0.0,1.0.1,1,3,155,44,199,8,FALSE
dorita980,2.4.4,2.4.5,16,1,2,1,3,2,TRUE
dorita980,3.0.9,3.0.10,29,2,81,4,85,2,TRUE
dorita980,2.4.3,2.4.4,15,1,18,17,35,4,TRUE
dorita980,2.4.6,2.4.7,18,4,6,4,10,5,TRUE
dir-babel,1.0.8,1.0.9,9,2,5,3,8,2,FALSE
dir-babel,1.0.9,1.0.10,10,2,3,1,4,2,FALSE
dir-babel,1.0.12,1.0.13,13,2,3,2,5,2,FALSE
dir-babel,1.0.10,1.0.11,11,2,11,5,16,2,FALSE
dir-babel,1.0.11,1.0.12,12,2,2,2,4,2,FALSE
dir-babel,1.0.4,1.0.5,5,2,10,2,12,3,FALSE
dir-babel,1.0.5,1.0.6,6,2,1,2,3,2,FALSE
dir-babel,1.0.6,1.0.7,7,2,1,2,3,2,FALSE
dir-babel,1.0.7,1.0.8,8,2,3,3,6,2,FALSE
dir-babel,1.0.0,1.0.1,1,3,3,4,7,3,FALSE
dir-babel,1.0.1,1.0.2,2,2,1,2,3,2,FALSE
dir-babel,1.0.2,1.0.3,3,2,2,2,4,2,FALSE
dir-babel,1.0.3,1.0.4,4,2,4,2,6,2,FALSE
dir-babel,1.0.8,1.0.9,9,2,5,3,8,2,TRUE
fetch-observable,1.0.0,1.0.1,2,2,1272,13,1285,9,FALSE
fetch-observable,1.0.1,1.0.2,3,1,12,5,17,3,FALSE
fetch-observable,1.0.4,1.0.5,6,1,326,156,482,4,FALSE
fetch-observable,1.0.5,1.1.0,7,3,485,325,810,18,FALSE
fetch-observable,1.1.1,1.2.0,9,1,10,6,16,6,FALSE
fetch-observable,1.1.0,1.1.1,8,1,10,10,20,4,FALSE
fetch-observable,1.0.3,1.0.4,5,1,5,10,15,5,FALSE
fetch-observable,1.2.0,1.2.1,10,1,28,26,54,6,FALSE
fetch-observable,1.0.2,1.0.3,4,1,9,414,423,6,FALSE
fetch-observable,0.0.1,1.0.0,1,3,332,137,469,16,FALSE
fetch-observable,0.0.1,1.0.0,1,3,332,137,469,16,TRUE
AnimIt,0.0.7,0.0.8,7,2,5,6,11,3,FALSE
AnimIt,0.0.6,0.0.7,6,1,16,3,19,1,FALSE
AnimIt,0.0.9,0.0.10,9,1,198,310,508,10,FALSE
AnimIt,0.0.8,0.0.9,8,1,16,3,19,1,FALSE
AnimIt,0.0.11,0.0.12,11,1,2342,60,2402,6,FALSE
AnimIt,0.0.10,0.0.11,10,1,16,3,19,1,FALSE
AnimIt,0.0.5,0.0.6,5,12,257,105,362,22,FALSE
AnimIt,0.0.4,0.0.5,4,1,223,216,439,14,FALSE
AnimIt,0.0.1,0.0.2,1,1,16,3,19,1,FALSE
AnimIt,0.0.3,0.0.4,3,1,16,3,19,1,FALSE
AnimIt,0.0.2,0.0.3,2,1,32,3,35,4,FALSE
AnimIt,0.0.8,0.0.9,8,1,16,3,19,1,TRUE
AnimIt,0.0.3,0.0.4,3,1,16,3,19,1,TRUE
ng2-typing-carousel,0.1.0,0.1.1,1,1,15,16,31,6,FALSE
ng2-typing-carousel,0.1.0,0.1.1,1,1,15,16,31,6,TRUE
ng2-typing-carousel,0.1.2,0.1.3,3,2,102,13,115,9,FALSE
ng2-typing-carousel,0.1.3,0.1.4,4,1,3,3,6,1,FALSE
ng2-typing-carousel,0.1.3,0.1.4,4,1,3,3,6,1,TRUE
redux-blueprint,0.2.22,0.2.23,22,2,3,3,6,3,FALSE
redux-blueprint,0.2.20,0.2.21,20,2,2,2,4,2,FALSE
redux-blueprint,0.2.18,0.2.19,18,3,11,7,18,4,FALSE
redux-blueprint,0.2.21,0.2.22,21,2,3,3,6,3,FALSE
redux-blueprint,0.2.19,0.2.20,19,2,6,5,11,3,FALSE
redux-blueprint,0.2.7,0.2.8,7,2,2,2,4,2,FALSE
redux-blueprint,0.2.6,0.2.7,6,2,5738,1,5739,26,FALSE
redux-blueprint,0.2.5,0.2.6,5,2,2,2,4,2,FALSE
redux-blueprint,0.2.4,0.2.5,4,3,8,5745,5753,33,FALSE
redux-blueprint,0.2.3,0.2.4,3,3,5739,2,5741,27,FALSE
redux-blueprint,0.2.2,0.2.3,2,2,89,6936,7025,37,FALSE
redux-blueprint,0.1.0,0.2.2,1,4,11,50,61,6,FALSE
redux-blueprint,0.2.9,0.2.10,9,3,5,5,10,3,FALSE
redux-blueprint,0.2.8,0.2.9,8,3,2,3,5,3,FALSE
redux-blueprint,0.2.17,0.2.18,17,4,10,6,16,5,FALSE
redux-blueprint,0.2.16,0.2.17,16,3,8,3,11,4,FALSE
redux-blueprint,0.2.15,0.2.16,15,3,1947,589,2536,12,FALSE
redux-blueprint,0.2.14,0.2.15,14,3,73,28,101,5,FALSE
redux-blueprint,0.2.13,0.2.14,13,3,333,295,628,8,FALSE
redux-blueprint,0.2.12,0.2.13,12,3,476,590,1066,9,FALSE
redux-blueprint,0.2.11,0.2.12,11,3,720,869,1589,12,FALSE
redux-blueprint,0.2.10,0.2.11,10,3,61,53,114,9,FALSE
redux-blueprint,0.2.14,0.2.15,14,3,73,28,101,5,TRUE
react-wxeap,2.2.5,2.2.6,179,1,57,13,70,9,FALSE
react-wxeap,2.2.4,2.2.5,178,1,16,17,33,5,FALSE
react-wxeap,2.2.6,2.3.0-alpha.0,180,3,895,27,922,16,FALSE
react-wxeap,2.2.1,2.2.2,175,1,38,15,53,8,FALSE
react-wxeap,2.2.0,2.2.1,174,1,54,9,63,6,FALSE
react-wxeap,2.2.3,2.2.4,177,1,16,17,33,5,FALSE
react-wxeap,2.2.2,2.2.3,176,1,16,17,33,5,FALSE
react-wxeap,2.1.0,2.1.1,171,1,16,17,33,5,FALSE
react-wxeap,2.1.1,2.2.0-alpha.0,172,2,267,29,296,15,FALSE
react-wxeap,2.2.0-alpha.0,2.2.0,173,1,16,17,33,5,FALSE
react-wxeap,2.4.0-alpha.0,2.4.0-alpha.1,187,1,16,17,33,5,FALSE
react-wxeap,2.4.0-alpha.1,2.4.0,188,1,170,106,276,13,FALSE
react-wxeap,2.3.0-alpha.0,2.3.0,181,1,16,17,33,5,FALSE
react-wxeap,2.3.0,2.3.1,182,1,16,17,33,5,FALSE
react-wxeap,2.3.1,2.3.2-alpha.0,183,1,1086,83,1169,9,FALSE
react-wxeap,2.3.2,2.3.3,185,1,16,17,33,5,FALSE
react-wxeap,2.3.3,2.4.0-alpha.0,186,1,99,13,112,12,FALSE
react-wxeap,2.4.2,2.5.0,191,1,16,17,33,5,FALSE
react-wxeap,2.4.1,2.4.2,190,1,16,17,33,5,FALSE
react-wxeap,2.4.0,2.4.1,189,1,16,17,33,5,FALSE
react-wxeap,2.5.0,2.6.0-alpha.0,192,1,427,28,455,16,FALSE
react-wxeap,2.6.0-alpha.0,2.6.0-alpha.1,193,1,16,17,33,5,FALSE
react-wxeap,2.6.0-alpha.1,2.6.0-alpha.2,194,1,16,17,33,5,FALSE
react-wxeap,2.6.0-alpha.2,2.6.0,195,1,16,17,33,5,FALSE
react-wxeap,2.3.2-alpha.0,2.3.2,184,1,16,17,33,5,FALSE
react-wxeap,2.0.0-alpha.4,2.0.0-alpha.5,148,1,16,17,33,5,FALSE
react-wxeap,2.0.0-alpha.2,2.0.0-alpha.3,146,1,16,17,33,5,FALSE
react-wxeap,2.0.0-alpha.3,2.0.0-alpha.4,147,1,16,17,33,5,FALSE
react-wxeap,2.0.0-alpha.0,2.0.0-alpha.1,144,1,16,17,33,5,FALSE
react-wxeap,2.0.0-alpha.1,2.0.0-alpha.2,145,1,16,17,33,5,FALSE
react-wxeap,1.0.4,1.1.0-alpha0,122,1,20,14,34,3,FALSE
react-wxeap,1.1.0-alpha8,1.1.0-alpha9,131,5,345,2415,2760,60,FALSE
react-wxeap,1.0.0-beta8,1.0.0-beta9,116,1,16,17,33,5,FALSE
react-wxeap,1.0.0,1.0.1,118,1,16,17,33,5,FALSE
react-wxeap,1.0.1,1.0.2,119,1,68,20,88,11,FALSE
react-wxeap,1.0.0-beta10,1.0.0-beta11,108,1,16,17,33,5,FALSE
react-wxeap,1.1.0-alpha1,1.1.0-alpha2,124,1,16,17,33,5,FALSE
react-wxeap,1.1.0-alpha0,1.1.0-alpha1,123,1,16,17,33,5,FALSE
react-wxeap,1.1.0-alpha3,1.1.0-alpha4,126,1,16,17,33,5,FALSE
react-wxeap,1.1.0-alpha2,1.1.0-alpha3,125,1,16,17,33,5,FALSE
react-wxeap,1.1.0-alpha5,1.1.0-alpha6,128,1,16,17,33,5,FALSE
react-wxeap,1.1.0-alpha4,1.1.0-alpha5,127,1,16,17,33,5,FALSE
react-wxeap,1.1.0-alpha7,1.1.0-alpha8,130,1,16,17,33,5,FALSE
react-wxeap,1.1.0-alpha6,1.1.0-alpha7,129,1,16,17,33,5,FALSE
react-wxeap,1.1.0-rc.0,1.1.0,139,1,16,17,33,5,FALSE
react-wxeap,1.0.2,1.0.3,120,2,114,43,157,17,FALSE
react-wxeap,1.0.3,1.0.4,121,1,16,17,33,5,FALSE
react-wxeap,2.1.0-alpha.1,2.1.0,170,1,13,8,21,1,FALSE
react-wxeap,1.0.0-beta3,1.0.0-beta4,111,1,16,17,33,5,FALSE
react-wxeap,1.0.0-beta2,1.0.0-beta3,110,1,16,17,33,5,FALSE
react-wxeap,1.0.0-beta1,1.0.0-beta10,107,8,1589,1289,2878,89,FALSE
react-wxeap,1.0.0-beta0,1.0.0-beta1,106,1,28,15,43,6,FALSE
react-wxeap,1.0.0-beta7,1.0.0-beta8,115,1,16,17,33,5,FALSE
react-wxeap,1.0.0-beta6,1.0.0-beta7,114,4,79,23,102,17,FALSE
react-wxeap,1.0.0-beta5,1.0.0-beta6,113,1,16,17,33,5,FALSE
react-wxeap,1.0.0-beta4,1.0.0-beta5,112,1,108,63,171,13,FALSE
react-wxeap,2.0.0-beta.3,2.0.0-beta.4,154,1,16,17,33,5,FALSE
react-wxeap,2.0.0-beta.2,2.0.0-beta.3,153,3,484,20,504,16,FALSE
react-wxeap,1.0.0-beta9,1.0.0,117,2,1040,669,1709,50,FALSE
react-wxeap,2.0.0-beta.0,2.0.0-beta.1,151,6,980,227,1207,62,FALSE
react-wxeap,2.0.0-beta.7,2.0.0-beta.8,158,1,10,18,28,6,FALSE
react-wxeap,2.0.0-beta.6,2.0.0-beta.7,157,1,134,46,180,6,FALSE
react-wxeap,2.0.0-beta.5,2.0.0-beta.6,156,1,773,59,832,17,FALSE
react-wxeap,2.0.0-beta.4,2.0.0-beta.5,155,1,16,17,33,5,FALSE
react-wxeap,2.0.1,2.1.0-alpha.0,168,2,187,78,265,20,FALSE
react-wxeap,2.0.0,2.0.1,167,1,16,17,33,5,FALSE
react-wxeap,2.0.0-beta.15,2.0.0,166,3,328,40,368,18,FALSE
react-wxeap,2.0.0-beta.14,2.0.0-beta.15,165,1,16,17,33,5,FALSE
react-wxeap,2.0.0-beta.13,2.0.0-beta.14,164,1,16,17,33,5,FALSE
react-wxeap,2.0.0-beta.12,2.0.0-beta.13,163,4,118,36,154,9,FALSE
react-wxeap,2.0.0-beta.11,2.0.0-beta.12,162,1,16,17,33,5,FALSE
react-wxeap,2.0.0-beta.10,2.0.0-beta.11,161,3,218,23,241,18,FALSE
react-wxeap,1.1.0-beta1,1.1.0-beta2,135,1,16,17,33,5,FALSE
react-wxeap,1.1.1,1.1.2,141,1,46,17,63,5,FALSE
react-wxeap,1.1.0,1.1.1,140,2,1049,1184,2233,84,FALSE
react-wxeap,1.1.3,2.0.0-alpha.0,143,2,15,6,21,6,FALSE
react-wxeap,1.1.2,1.1.3,142,1,16,17,33,5,FALSE
react-wxeap,2.0.0-alpha.6,2.0.0-beta.0,150,1,16,17,33,5,FALSE
react-wxeap,2.0.0-alpha.5,2.0.0-alpha.6,149,1,16,17,33,5,FALSE
react-wxeap,2.0.0-beta.9,2.0.0-beta.10,160,4,100,26,126,16,FALSE
react-wxeap,2.0.0-beta.8,2.0.0-beta.9,159,1,36,17,53,11,FALSE
react-wxeap,1.1.0-alpha9,1.1.0-beta.1,132,7,2599,307,2906,85,FALSE
react-wxeap,1.1.0-beta2,1.1.0-beta3,136,2,53,8,61,12,FALSE
react-wxeap,1.1.0-beta3,1.1.0-beta4,137,1,16,17,33,5,FALSE
react-wxeap,1.1.0-beta0,1.1.0-beta1,134,1,3,15,18,15,FALSE
react-wxeap,2.1.0-alpha.0,2.1.0-alpha.1,169,2,370,50,420,8,FALSE
react-wxeap,1.1.0-beta4,1.1.0-rc.0,138,1,16,17,33,5,FALSE
react-wxeap,2.0.0-beta.1,2.0.0-beta.2,152,1,16,17,33,5,FALSE
react-wxeap,0.3.18,0.3.19,47,1,16,17,33,5,FALSE
react-wxeap,0.3.19,0.3.20,48,1,206,13,219,6,FALSE
react-wxeap,0.3.14,0.3.15,43,1,16,17,33,5,FALSE
react-wxeap,0.3.15,0.3.16,44,2,79,29,108,17,FALSE
react-wxeap,0.3.16,0.3.17,45,1,16,17,33,5,FALSE
react-wxeap,0.3.17,0.3.18,46,1,171,3,174,10,FALSE
react-wxeap,0.3.10,0.3.11,40,4,1365,46,1411,30,FALSE
react-wxeap,0.3.11,0.3.12,41,1,6,3,9,3,FALSE
react-wxeap,0.3.12,0.3.14,42,1,9,3,12,5,FALSE
react-wxeap,0.5.18,0.5.19,77,1,16,17,33,5,FALSE
react-wxeap,0.5.19,0.6.0,78,1,19,9,28,7,FALSE
react-wxeap,0.8.7,0.8.8,100,1,16,17,33,5,FALSE
react-wxeap,0.5.16,0.5.17,75,1,16,17,33,5,FALSE
react-wxeap,0.5.17,0.5.18,76,1,16,17,33,5,FALSE
react-wxeap,0.5.14,0.5.15,73,1,16,17,33,5,FALSE
react-wxeap,0.5.15,0.5.16,74,1,26,14,40,4,FALSE
react-wxeap,0.5.12,0.5.13,71,1,98,13,111,11,FALSE
react-wxeap,0.5.13,0.5.14,72,1,16,17,33,5,FALSE
react-wxeap,0.5.10,0.5.11,69,1,16,17,33,5,FALSE
react-wxeap,0.5.11,0.5.12,70,1,16,17,33,5,FALSE
react-wxeap,0.6.3,0.6.4,82,1,16,17,33,5,FALSE
react-wxeap,0.6.2,0.6.3,81,1,124,37,161,10,FALSE
react-wxeap,0.6.1,0.6.2,80,1,16,17,33,5,FALSE
react-wxeap,0.6.0,0.6.1,79,1,16,17,33,5,FALSE
react-wxeap,0.6.4,0.7.0,83,1,59,47,106,6,FALSE
react-wxeap,0.4.1,0.4.2,58,1,24,16,40,6,FALSE
react-wxeap,0.4.0,0.4.1,57,1,10,3,13,4,FALSE
react-wxeap,0.4.2,0.5.0,59,1,16,17,33,5,FALSE
react-wxeap,0.8.8,0.9.0,101,1,156,237,393,9,FALSE
react-wxeap,0.8.5,0.8.6,98,1,228,39,267,8,FALSE
react-wxeap,0.8.4,0.8.5,97,1,16,17,33,5,FALSE
react-wxeap,0.8.6,0.8.7,99,1,16,17,33,5,FALSE
react-wxeap,0.8.1,0.8.2,94,2,450,86,536,73,FALSE
react-wxeap,0.8.3,0.8.4,96,2,422,6,428,29,FALSE
react-wxeap,0.8.2,0.8.3,95,1,16,17,33,5,FALSE
react-wxeap,0.7.8,0.8.0,92,1,142,6,148,8,FALSE
react-wxeap,0.7.6,0.7.7,90,1,28,28,56,14,FALSE
react-wxeap,0.7.7,0.7.8,91,1,5,2,7,3,FALSE
react-wxeap,0.7.4,0.7.5,88,1,16,17,33,5,FALSE
react-wxeap,0.7.5,0.7.6,89,1,16,17,33,5,FALSE
react-wxeap,0.7.2,0.7.3,86,1,16,17,33,5,FALSE
react-wxeap,0.7.3,0.7.4,87,1,133,55,188,8,FALSE
react-wxeap,0.7.0,0.7.1,84,1,49,3,52,6,FALSE
react-wxeap,0.7.1,0.7.2,85,1,16,17,33,5,FALSE
react-wxeap,0.5.8,0.5.10,68,1,504,467,971,11,FALSE
react-wxeap,0.5.4,0.5.5,64,1,16,17,33,5,FALSE
react-wxeap,0.5.5,0.5.6,65,1,16,17,33,5,FALSE
react-wxeap,0.5.6,0.5.7,66,1,16,17,33,5,FALSE
react-wxeap,0.5.7,0.5.8,67,1,16,17,33,5,FALSE
react-wxeap,0.5.0,0.5.1,60,1,16,17,33,5,FALSE
react-wxeap,0.5.1,0.5.2,61,1,16,17,33,5,FALSE
react-wxeap,0.5.2,0.5.3,62,1,595,9,604,22,FALSE
react-wxeap,0.5.3,0.5.4,63,1,16,17,33,5,FALSE
react-wxeap,0.9.0,0.9.1,102,1,16,17,33,5,FALSE
react-wxeap,0.9.1,0.9.2,103,3,234,107,341,36,FALSE
react-wxeap,0.9.2,1.0.0-beta.11,104,21,2427,1533,3960,175,FALSE
react-wxeap,0.8.0,0.8.1,93,1,16,17,33,5,FALSE
react-wxeap,0.3.21,0.3.22,50,1,13,14,27,5,FALSE
react-wxeap,0.3.20,0.3.21,49,1,0,3,3,1,FALSE
react-wxeap,0.3.23,0.3.24,52,1,16,17,33,5,FALSE
react-wxeap,0.3.22,0.3.23,51,1,16,17,33,5,FALSE
react-wxeap,0.3.25,0.3.26,54,1,69,25,94,10,FALSE
react-wxeap,0.3.24,0.3.25,53,1,16,17,33,5,FALSE
react-wxeap,0.3.27,0.4.0,56,1,8,11,19,6,FALSE
react-wxeap,0.3.26,0.3.27,55,1,8,11,19,6,FALSE
react-wxeap,0.3.8,0.3.9,38,1,16,17,33,5,FALSE
react-wxeap,0.3.9,0.3.10,39,1,16,17,33,5,FALSE
react-wxeap,0.3.2,0.3.3,32,1,16,17,33,5,FALSE
react-wxeap,0.3.3,0.3.4,33,1,16,17,33,5,FALSE
react-wxeap,0.3.0,0.3.1,30,1,16,17,33,5,FALSE
react-wxeap,0.3.1,0.3.2,31,1,16,17,33,5,FALSE
react-wxeap,0.3.6,0.3.7,36,1,16,17,33,5,FALSE
react-wxeap,0.3.7,0.3.8,37,1,16,17,33,5,FALSE
react-wxeap,0.3.4,0.3.5,34,1,16,17,33,5,FALSE
react-wxeap,0.3.5,0.3.6,35,1,16,17,33,5,FALSE
react-wxeap,0.1.21,0.1.22,19,1,16,17,33,5,FALSE
react-wxeap,0.1.22,0.2.0,20,1,16,17,33,5,FALSE
react-wxeap,0.6.2,0.6.3,81,1,124,37,161,10,TRUE
react-wxeap,0.1.10,0.1.11,8,1,16,17,33,5,FALSE
react-wxeap,0.2.7,0.2.8,28,1,16,17,33,5,FALSE
react-wxeap,0.1.9,0.1.10,7,1,16,17,33,5,FALSE
react-wxeap,0.2.5,0.2.6,26,1,16,17,33,5,FALSE
react-wxeap,0.2.2,0.2.3,23,1,16,17,33,5,FALSE
react-wxeap,0.2.1,0.2.2,22,1,16,17,33,5,FALSE
react-wxeap,0.2.0,0.2.1,21,1,16,17,33,5,FALSE
react-wxeap,0.1.8,0.1.9,6,1,16,17,33,5,FALSE
react-wxeap,0.2.6,0.2.7,27,1,16,17,33,5,FALSE
react-wxeap,0.2.4,0.2.5,25,1,16,17,33,5,FALSE
react-wxeap,0.2.3,0.2.4,24,1,16,17,33,5,FALSE
react-wxeap,0.1.3,0.1.4,1,1,16,17,33,5,FALSE
react-wxeap,0.1.4,0.1.5,2,1,16,17,33,5,FALSE
react-wxeap,0.1.5,0.1.6,3,1,16,17,33,5,FALSE
react-wxeap,0.1.6,0.1.7,4,1,16,17,33,5,FALSE
react-wxeap,0.2.8,0.3.0,29,1,16,17,33,5,FALSE
react-wxeap,0.7.1,0.7.2,85,1,16,17,33,5,TRUE
react-wxeap,0.1.7,0.1.8,5,1,16,17,33,5,FALSE
react-wxeap,0.8.1,0.8.2,94,2,450,86,536,73,TRUE
react-wxeap,0.1.12,0.1.13,10,1,16,17,33,5,FALSE
react-wxeap,0.1.13,0.1.14,11,1,16,17,33,5,FALSE
react-wxeap,0.1.11,0.1.12,9,1,16,17,33,5,FALSE
react-wxeap,0.1.16,0.1.17,14,1,16,17,33,5,FALSE
react-wxeap,0.1.17,0.1.18,15,1,16,17,33,5,FALSE
react-wxeap,0.1.14,0.1.15,12,1,16,17,33,5,FALSE
react-wxeap,0.1.15,0.1.16,13,1,16,17,33,5,FALSE
react-wxeap,0.1.18,0.1.19,16,1,16,17,33,5,FALSE
react-wxeap,0.1.19,0.1.20,17,1,16,17,33,5,FALSE
react-wxeap,0.1.20,0.1.21,18,1,16,17,33,5,FALSE
react-wxeap,1.0.0-beta6,1.0.0-beta7,114,4,79,23,102,17,TRUE
react-wxeap,2.2.6,2.3.0-alpha.0,180,3,895,27,922,16,TRUE
react-wxeap,2.4.1,2.4.2,190,1,16,17,33,5,TRUE
DFP,1.14.0,1.16.4,24,1,1,1,2,1,FALSE
DFP,1.13.1,1.14.0,23,1,1,1,2,1,FALSE
DFP,1.13.0,1.13.1,22,1,1,1,2,1,FALSE
DFP,1.16.4,1.16.5,25,1,1,1,2,1,FALSE
DFP,1.17.0,2.0.1,27,1,1,1,2,1,FALSE
DFP,1.12.3,1.13.0,21,1,1,1,2,1,FALSE
DFP,1.12.0,1.12.1,18,1,1,1,2,1,FALSE
DFP,1.12.1,1.12.2,19,1,1,1,2,1,FALSE
DFP,1.12.2,1.12.3,20,1,1,1,2,1,FALSE
DFP,1.16.5,1.17.0,26,1,1,1,2,1,FALSE
DFP,1.0.0,1.2.2,4,1,1,1,2,1,FALSE
DFP,1.5.3,1.6.0,6,1,1,1,2,1,FALSE
DFP,1.6.2,1.6.3,9,1,1,1,2,1,FALSE
DFP,1.6.3,1.7.4,10,1,1,1,2,1,FALSE
DFP,1.6.0,1.6.1,7,1,1,1,2,1,FALSE
DFP,1.6.1,1.6.2,8,1,1,1,2,1,FALSE
DFP,1.2.2,1.5.3,5,1,1,1,2,1,FALSE
DFP,0.2.2,1.0.0,3,1,1,1,2,1,FALSE
DFP,0.2.0,0.2.2,2,1,1,1,2,1,FALSE
DFP,0.1.0,0.2.0,1,1,1,1,2,1,FALSE
DFP,1.7.4,1.8.0,11,1,1,1,2,1,FALSE
DFP,1.8.0,1.8.6,12,1,1,1,2,1,FALSE
DFP,1.8.6,1.9.2,13,1,1,1,2,1,FALSE
DFP,1.11.0,1.12.0,17,1,1,1,2,1,FALSE
DFP,1.9.2,1.10.0,14,1,1,1,2,1,FALSE
DFP,1.10.0,1.10.1,15,1,1,1,2,1,FALSE
DFP,1.10.1,1.11.0,16,1,1,1,2,1,FALSE
DFP,1.10.1,1.11.0,16,1,1,1,2,1,TRUE
DFP,0.2.0,0.2.2,2,1,1,1,2,1,TRUE
DFP,1.8.6,1.9.2,13,1,1,1,2,1,TRUE
DFP,1.9.2,1.10.0,14,1,1,1,2,1,TRUE
DFP,1.17.0,2.0.1,27,1,1,1,2,1,TRUE
DFP,1.0.0,1.2.2,4,1,1,1,2,1,TRUE
DFP,1.12.3,1.13.0,21,1,1,1,2,1,TRUE
DFP,1.11.0,1.12.0,17,1,1,1,2,1,TRUE
DFP,1.2.2,1.5.3,5,1,1,1,2,1,TRUE
DFP,1.12.2,1.12.3,20,1,1,1,2,1,TRUE
DFP,1.16.5,1.17.0,26,1,1,1,2,1,TRUE
cogs-sdk,3.0.6,3.1.0,36,5,398,64,462,12,FALSE
cogs-sdk,3.0.4,3.0.5,34,2,2,2,4,2,FALSE
cogs-sdk,3.1.0,3.2.0,37,3,17,16,33,5,FALSE
cogs-sdk,3.0.2,3.0.3,32,2,4,4,8,3,FALSE
cogs-sdk,3.0.3,3.0.4,33,2,2,2,4,2,FALSE
cogs-sdk,3.0.0,3.0.1,30,3,13,17,30,5,FALSE
cogs-sdk,3.0.1,3.0.2,31,2,2,2,4,2,FALSE
cogs-sdk,3.7.7,3.7.8,57,2,6,6,12,2,FALSE
cogs-sdk,4.9.3,4.9.4,98,2,21,2,23,2,FALSE
cogs-sdk,3.11.0,3.11.1,75,2,13,10,23,2,FALSE
cogs-sdk,4.9.4,4.9.5,99,2,8,4,12,2,FALSE
cogs-sdk,3.0.5,3.0.6,35,2,42,27,69,5,FALSE
cogs-sdk,2.6.4,2.6.5,28,8,135,122,257,15,FALSE
cogs-sdk,4.9.5,4.9.6,100,2,3,3,6,2,FALSE
cogs-sdk,4.8.0,4.9.0,94,3,42,24,66,6,FALSE
cogs-sdk,3.11.2,4.0.0,77,2,20,6,26,3,FALSE
cogs-sdk,4.3.4,4.4.0,87,2,5,5,10,2,FALSE
cogs-sdk,3.8.4,3.8.5,65,2,16,16,32,2,FALSE
cogs-sdk,4.9.6,4.9.7,101,2,3,4,7,2,FALSE
cogs-sdk,4.0.0,4.1.0,78,2,18,7,25,2,FALSE
cogs-sdk,3.8.5,3.8.6,66,2,3,3,6,2,FALSE
cogs-sdk,4.1.0,4.1.1,79,2,5,2,7,4,FALSE
cogs-sdk,4.1.1,4.2.0,80,2,42,22,64,2,FALSE
cogs-sdk,3.10.0,3.11.0,74,3,5,5,10,3,FALSE
cogs-sdk,3.8.2,3.8.3,63,2,3,3,6,2,FALSE
cogs-sdk,3.11.1,3.11.2,76,2,21,13,34,2,FALSE
cogs-sdk,3.3.3,3.3.4,42,2,2,2,4,2,FALSE
cogs-sdk,3.7.10,3.8.0,60,2,2,1,3,2,FALSE
cogs-sdk,3.3.2,3.3.3,41,2,10,3,13,3,FALSE
cogs-sdk,4.6.1,4.6.3,91,5,28,14,42,9,FALSE
cogs-sdk,4.9.1,4.9.2,96,5,234,97,331,10,FALSE
cogs-sdk,3.8.10,3.9.0,71,2,10,4,14,2,FALSE
cogs-sdk,4.3.2,4.3.3,85,2,12,7,19,2,FALSE
cogs-sdk,3.7.8,3.7.9,58,2,16,5,21,2,FALSE
cogs-sdk,4.6.0,4.6.1,90,2,5,5,10,2,FALSE
cogs-sdk,3.3.4,3.3.5,43,2,5,3,8,2,FALSE
cogs-sdk,4.5.0,4.6.0,89,3,14,8,22,5,FALSE
cogs-sdk,4.3.0,4.3.1,83,2,2,2,4,2,FALSE
cogs-sdk,4.3.1,4.3.2,84,2,17,3,20,4,FALSE
cogs-sdk,3.7.5,3.7.6,55,2,34,26,60,2,FALSE
cogs-sdk,3.3.5,3.3.6,44,1,1,1,2,1,FALSE
cogs-sdk,4.9.2,4.9.3,97,2,4,2,6,2,FALSE
cogs-sdk,3.8.8,3.8.9,69,2,3,2,5,2,FALSE
cogs-sdk,3.8.9,3.8.10,70,2,2,2,4,2,FALSE
cogs-sdk,3.8.6,3.8.7,67,2,3,3,6,2,FALSE
cogs-sdk,3.8.7,3.8.8,68,2,10,5,15,2,FALSE
cogs-sdk,3.9.1,3.10.0,73,2,16,4,20,3,FALSE
cogs-sdk,3.9.0,3.9.1,72,2,4,4,8,2,FALSE
cogs-sdk,4.9.0,4.9.1,95,9,143,29,172,11,FALSE
cogs-sdk,3.8.3,3.8.4,64,2,2,3,5,2,FALSE
cogs-sdk,3.8.0,3.8.1,61,2,3,3,6,2,FALSE
cogs-sdk,3.8.1,3.8.2,62,2,2,2,4,2,FALSE
cogs-sdk,5.0.0,5.0.1,103,3,6,7,13,5,FALSE
cogs-sdk,3.4.0,3.5.0,47,3,73,29,102,6,FALSE
cogs-sdk,4.7.0,4.8.0,93,2,8,8,16,2,FALSE
cogs-sdk,3.6.0,3.7.0,49,2,26,30,56,3,FALSE
cogs-sdk,2.6.1,2.6.2,25,3,3,3,6,3,FALSE
cogs-sdk,2.6.0,2.6.1,24,7,65,15,80,7,FALSE
cogs-sdk,2.6.3,2.6.4,27,2,17,3,20,2,FALSE
cogs-sdk,2.6.2,2.6.3,26,3,106,2,108,5,FALSE
cogs-sdk,4.6.3,4.7.0,92,2,12,3,15,2,FALSE
cogs-sdk,4.4.0,4.5.0,88,13,1015,1017,2032,25,FALSE
cogs-sdk,3.5.0,3.6.0,48,2,39,3,42,3,FALSE
cogs-sdk,3.3.1,3.3.2,40,2,5,5,10,2,FALSE
cogs-sdk,3.3.0,3.3.1,39,2,9,9,18,2,FALSE
cogs-sdk,4.2.1,4.3.0,82,3,31,11,42,4,FALSE
cogs-sdk,4.2.0,4.2.1,81,2,3,3,6,2,FALSE
cogs-sdk,3.2.0,3.3.0,38,2,7,6,13,2,FALSE
cogs-sdk,4.3.3,4.3.4,86,2,3,3,6,2,FALSE
cogs-sdk,3.3.7,3.4.0,46,3,41,14,55,3,FALSE
cogs-sdk,3.3.6,3.3.7,45,3,6,2,8,3,FALSE
cogs-sdk,3.7.9,3.7.10,59,2,6,6,12,2,FALSE
cogs-sdk,3.7.4,3.7.5,54,2,2,2,4,2,FALSE
cogs-sdk,4.9.7,5.0.0,102,3,6,8,14,4,FALSE
cogs-sdk,3.7.6,3.7.7,56,2,3,1,4,2,FALSE
cogs-sdk,3.7.1,3.7.2,51,2,2,2,4,2,FALSE
cogs-sdk,3.7.0,3.7.1,50,2,2,2,4,2,FALSE
cogs-sdk,3.7.3,3.7.4,53,2,37,23,60,2,FALSE
cogs-sdk,3.7.2,3.7.3,52,2,26,6,32,2,FALSE
cogs-sdk,1.0.2,1.0.3,1,2,3,3,6,3,FALSE
cogs-sdk,1.0.3,2.0.0,2,1,3,1,4,2,FALSE
cogs-sdk,2.5.1,2.5.2,20,2,18,12,30,4,FALSE
cogs-sdk,2.4.2,2.4.3,17,2,14,3,17,3,FALSE
cogs-sdk,3.0.2,3.0.3,32,2,4,4,8,3,TRUE
cogs-sdk,3.0.3,3.0.4,33,2,2,2,4,2,TRUE
cogs-sdk,2.0.0,2.1.0,3,2,19,6,25,7,FALSE
cogs-sdk,2.2.1,2.2.2,12,1,13,6,19,1,FALSE
cogs-sdk,2.2.0,2.2.1,11,2,4,4,8,2,FALSE
cogs-sdk,2.2.2,2.3.0,13,2,184,1,185,4,FALSE
cogs-sdk,2.5.4,2.6.0,23,10,418,280,698,22,FALSE
cogs-sdk,2.5.3,2.5.4,22,2,65,12,77,5,FALSE
cogs-sdk,2.4.3,2.5.0,18,3,92,35,127,7,FALSE
cogs-sdk,2.4.1,2.4.2,16,2,51,16,67,4,FALSE
cogs-sdk,2.1.2,2.1.3,6,2,11,2,13,2,FALSE
cogs-sdk,2.1.3,2.1.4,7,3,10,10,20,3,FALSE
cogs-sdk,2.1.0,2.1.1,4,2,7,7,14,2,FALSE
cogs-sdk,2.1.1,2.1.2,5,2,15,10,25,2,FALSE
cogs-sdk,2.1.6,2.2.0,10,2,6,2,8,3,FALSE
cogs-sdk,2.1.4,2.1.5,8,2,8,6,14,2,FALSE
cogs-sdk,2.1.5,2.1.6,9,2,6,6,12,2,FALSE
cogs-sdk,2.5.2,2.5.3,21,2,4,4,8,2,FALSE
cogs-sdk,2.3.0,2.4.0,14,2,36,9,45,3,FALSE
cogs-sdk,2.5.0,2.5.1,19,2,3,6,9,2,FALSE
cogs-sdk,2.4.0,2.4.1,15,2,5,5,10,2,FALSE
cogs-sdk,3.0.5,3.0.6,35,2,42,27,69,5,TRUE
cogs-sdk,4.9.0,4.9.1,95,9,143,29,172,11,TRUE
cogs-sdk,2.5.0,2.5.1,19,2,3,6,9,2,TRUE
cogs-sdk,3.8.10,3.9.0,71,2,10,4,14,2,TRUE
cogs-sdk,2.2.1,2.2.2,12,1,13,6,19,1,TRUE
cogs-sdk,3.3.7,3.4.0,46,3,41,14,55,3,TRUE
cogs-sdk,4.9.6,4.9.7,101,2,3,4,7,2,TRUE
cogs-sdk,4.3.0,4.3.1,83,2,2,2,4,2,TRUE
cogs-sdk,3.7.1,3.7.2,51,2,2,2,4,2,TRUE
cogs-sdk,3.2.0,3.3.0,38,2,7,6,13,2,TRUE
vc-cake,0.4.10,0.5.0,31,2,5,1,6,2,FALSE
vc-cake,0.3.2,0.3.3,17,2,4,3,7,2,FALSE
vc-cake,0.3.3,0.3.4,18,3,24,52,76,6,FALSE
vc-cake,0.3.0,0.3.1,15,3,795,849,1644,37,FALSE
vc-cake,0.3.1,0.3.2,16,2,1,1,2,2,FALSE
vc-cake,0.3.4,0.3.5,19,2,14,2,16,3,FALSE
vc-cake,0.3.5,0.4.0,20,2,11,1,12,3,FALSE
vc-cake,0.4.9,0.4.10,30,2,2,2,4,2,FALSE
vc-cake,0.4.8,0.4.9,29,3,16,4097,4113,33,FALSE
vc-cake,0.2.5,0.3.0,14,3,70,8,78,9,FALSE
vc-cake,0.2.4,0.2.5,13,2,12,7,19,3,FALSE
vc-cake,0.4.4,0.4.5,25,6,4202,25,4227,41,FALSE
vc-cake,0.4.5,0.4.6,26,2,2,2,4,2,FALSE
vc-cake,0.4.1,0.4.2,22,2,3,3,6,2,FALSE
vc-cake,0.4.0,0.4.1,21,2,2,2,4,2,FALSE
vc-cake,0.4.3,0.4.4,24,10,310,40,350,28,FALSE
vc-cake,0.4.2,0.4.3,23,2,19,18,37,4,FALSE
vc-cake,0.5.0,0.5.1,32,2,16,10,26,2,FALSE
vc-cake,0.4.7,0.4.8,28,4,39,21,60,6,FALSE
vc-cake,0.4.6,0.4.7,27,2,5,4,9,3,FALSE
vc-cake,0.2.3,0.2.4,12,4,109,5,114,9,FALSE
vc-cake,0.2.2,0.2.3,11,3,2,2,4,3,FALSE
vc-cake,0.2.1,0.2.2,10,3,23,19,42,5,FALSE
vc-cake,0.2.0,0.2.1,9,3,5,5,10,3,FALSE
vc-cake,0.1.6,0.1.7,7,19,1865,1283,3148,118,FALSE
vc-cake,0.1.7,0.2.0,8,13,554,225,779,67,FALSE
vc-cake,0.3.1,0.3.2,16,2,1,1,2,2,TRUE
vc-cake,0.3.5,0.4.0,20,2,11,1,12,3,TRUE
vc-cake,0.4.0,0.4.1,21,2,2,2,4,2,TRUE
get-firefox,0.0.3,0.0.4,3,5,184,129,313,12,FALSE
get-firefox,0.0.1,0.0.2,1,1,17,18,35,3,FALSE
get-firefox,0.0.3,0.0.4,3,5,184,129,313,12,TRUE
get-firefox,0.0.2,0.0.3,2,1,281,40,321,4,FALSE
get-firefox,1.1.1,1.2.0,7,5,150,66,216,10,FALSE
get-firefox,1.1.0,1.1.1,6,2,155,14,169,13,FALSE
get-firefox,1.0.0,1.1.0,5,1,376,66,442,7,FALSE
get-firefox,0.0.4,1.0.0,4,4,468,244,712,14,FALSE
get-firefox,1.3.0,1.4.0,9,8,11,18,29,8,FALSE
get-firefox,1.2.0,1.3.0,8,4,131,216,347,18,FALSE
get-firefox,1.4.0,1.5.0,10,5,125,120,245,9,FALSE
get-firefox,1.4.0,1.5.0,10,5,125,120,245,9,TRUE
cellx,1.6.52,1.6.53,116,1,239,196,435,8,FALSE
cellx,1.6.90,1.6.91,149,1,20,8,28,4,FALSE
cellx,1.6.91,1.6.92,150,1,20,10,30,4,FALSE
cellx,1.6.92,1.6.93,151,1,15,15,30,5,FALSE
cellx,1.6.93,1.7.0,152,1,92,145,237,11,FALSE
cellx,1.6.78,1.6.80,138,2,209,182,391,10,FALSE
cellx,1.6.40,1.6.41,105,3,437,429,866,3,FALSE
cellx,1.6.50,1.6.51,114,1,49,263,312,12,FALSE
cellx,1.6.51,1.6.52,115,1,93,98,191,6,TRUE
cellx,1.6.74,1.6.75,134,1,18,18,36,4,FALSE
cellx,1.6.53,1.6.54,117,1,17,6,23,2,FALSE
cellx,1.6.72,1.6.73,132,1,78,40,118,5,FALSE
cellx,1.6.55,1.6.56,119,2,78,76,154,13,FALSE
cellx,1.6.70,1.6.71,130,1,2,2,4,2,FALSE
cellx,1.6.71,1.6.72,131,1,249,107,356,6,FALSE
cellx,1.6.58,1.6.59,121,1,93,98,191,6,FALSE
cellx,1.6.59,1.6.60,122,1,62,6,68,5,FALSE
cellx,1.6.31,1.6.32,96,1,45,45,90,21,FALSE
cellx,1.6.36,1.6.37,101,1,93,98,191,6,FALSE
cellx,1.6.37,1.6.38,102,1,352,330,682,9,FALSE
cellx,1.6.34,1.6.35,99,1,48,78,126,7,FALSE
cellx,1.6.35,1.6.36,100,1,93,98,191,6,FALSE
cellx,1.6.60,1.6.61,123,1,37,15,52,4,FALSE
cellx,1.7.9,1.7.10,160,1,5,5,10,4,FALSE
cellx,1.7.8,1.7.9,159,1,592,756,1348,15,FALSE
cellx,1.7.7,1.7.8,158,1,93,98,191,6,FALSE
cellx,1.7.6,1.7.7,157,1,32,27,59,5,FALSE
cellx,1.7.5,1.7.6,156,1,93,98,191,6,FALSE
cellx,1.7.4,1.7.5,155,1,93,98,191,6,FALSE
cellx,1.7.1,1.7.4,154,1,96,52,148,8,TRUE
cellx,1.7.0,1.7.1,153,1,583,569,1152,8,FALSE
cellx,1.6.76,1.6.77,136,1,6,6,12,4,FALSE
cellx,1.6.89,1.6.90,148,1,209,183,392,9,FALSE
cellx,1.6.88,1.6.89,147,2,12,12,24,2,FALSE
cellx,1.6.77,1.6.78,137,1,22,8,30,4,FALSE
cellx,1.6.83,1.6.84,142,1,20,6,26,5,FALSE
cellx,1.6.82,1.6.83,141,1,93,98,191,6,FALSE
cellx,1.6.81,1.6.82,140,1,169,168,337,14,FALSE
cellx,1.6.80,1.6.81,139,1,93,98,191,6,FALSE
cellx,1.6.87,1.6.88,146,1,314,25,339,10,FALSE
cellx,1.6.86,1.6.87,145,1,120,115,235,6,FALSE
cellx,1.6.85,1.6.86,144,1,93,98,191,6,FALSE
cellx,1.6.84,1.6.85,143,1,93,98,191,6,FALSE
cellx,1.6.39,1.6.40,104,2,57,43,100,7,FALSE
cellx,1.6.38,1.6.39,103,1,24,10,34,6,FALSE
cellx,1.6.54,1.6.55,118,4,1618,28,1646,11,FALSE
cellx,1.6.68,1.6.70,129,1,98,70,168,5,FALSE
cellx,1.6.73,1.6.74,133,1,140,88,228,4,FALSE
cellx,1.6.65,1.6.67,127,2,60,4,64,10,FALSE
cellx,1.6.64,1.6.65,126,1,68,54,122,8,FALSE
cellx,1.6.67,1.6.68,128,1,186,125,311,5,FALSE
cellx,1.6.56,1.6.58,120,1,202,93,295,7,FALSE
cellx,1.6.61,1.6.62,124,1,2,1,3,2,FALSE
cellx,1.6.75,1.6.76,135,1,22,14,36,4,TRUE
cellx,1.6.49,1.6.50,113,1,8,8,16,6,FALSE
cellx,1.6.48,1.6.49,112,1,464,162,626,9,FALSE
cellx,1.6.46,1.6.48,111,2,267,156,423,14,FALSE
cellx,1.6.45,1.6.46,110,1,139,28,167,7,FALSE
cellx,1.6.44,1.6.45,109,1,93,98,191,6,FALSE
cellx,1.6.43,1.6.44,108,1,25,17,42,9,FALSE
cellx,1.6.42,1.6.43,107,1,21,3,24,4,FALSE
cellx,1.6.41,1.6.42,106,1,38,14,52,12,FALSE
cellx,1.6.62,1.6.64,125,1,75,42,117,8,FALSE
cellx,1.6.32,1.6.33,97,2,1464,302,1766,8,FALSE
cellx,1.7.10,1.7.11,161,1,11,9,20,2,FALSE
cellx,1.6.33,1.6.34,98,1,93,98,191,6,FALSE
cellx,1.0.0,1.0.1,23,1,1176,10479,11655,8,FALSE
cellx,1.0.1,1.0.2,24,1,93,98,191,6,FALSE
cellx,1.0.2,1.1.0,25,2,1357,1145,2502,21,FALSE
cellx,1.6.14,1.6.15,80,1,91,88,179,6,FALSE
cellx,1.6.15,1.6.17,81,1,93,98,191,6,FALSE
cellx,1.6.17,1.6.18,82,1,47,6,53,6,FALSE
cellx,1.6.10,1.6.11,77,1,93,98,191,6,FALSE
cellx,1.6.11,1.6.12,78,1,99,94,193,10,FALSE
cellx,1.6.12,1.6.14,79,1,887,838,1725,17,FALSE
cellx,1.6.18,1.6.19,83,1,96,58,154,5,FALSE
cellx,1.6.19,1.6.20,84,1,33,25,58,9,FALSE
cellx,0.3.0,0.4.0,3,1,167,131,298,5,FALSE
cellx,1.5.11,1.5.12,67,1,93,98,191,6,FALSE
cellx,1.5.12,1.6.0,68,1,42,12,54,6,FALSE
cellx,1.6.2,1.6.5,71,2,241,217,458,27,FALSE
cellx,1.6.0,1.6.1,69,1,3817,1448,5265,32,FALSE
cellx,1.6.1,1.6.2,70,1,8,8,16,4,FALSE
cellx,1.6.6,1.6.7,73,2,31,24,55,15,FALSE
cellx,1.6.7,1.6.8,74,1,33,5,38,6,FALSE
cellx,1.6.5,1.6.6,72,1,93,98,191,6,FALSE
cellx,1.6.8,1.6.9,75,2,28,8,36,8,FALSE
cellx,1.6.9,1.6.10,76,1,15,15,30,6,FALSE
cellx,1.4.2,1.4.5,50,1,93,98,191,6,FALSE
cellx,1.4.12,1.4.15,58,1,68,14,82,6,FALSE
cellx,1.4.10,1.4.11,56,1,93,98,191,6,FALSE
cellx,1.4.11,1.4.12,57,1,1770,1712,3482,18,FALSE
cellx,1.4.16,1.5.0,60,1,92,92,184,10,FALSE
cellx,1.4.15,1.4.16,59,1,9,23,32,11,FALSE
cellx,1.2.10,1.2.11,38,1,155,139,294,7,FALSE
cellx,1.2.11,1.2.12,39,1,25,23,48,7,FALSE
cellx,1.2.12,1.2.13,40,1,93,98,191,6,FALSE
cellx,1.2.15,1.2.16,43,1,15,13,28,3,FALSE
cellx,1.6.75,1.6.76,135,1,22,14,36,4,FALSE
cellx,1.4.7,1.4.8,53,1,278,274,552,12,FALSE
cellx,1.2.18,1.3.0,46,1,52,208,260,7,FALSE
cellx,0.11.4,0.11.5,19,1,41,37,78,5,FALSE
cellx,1.2.5,1.2.6,33,1,36,29,65,7,FALSE
cellx,0.11.5,1.0.0-rc1,20,1,193,486,679,18,TRUE
cellx,1.6.51,1.6.52,115,1,93,98,191,6,FALSE
cellx,0.6.0,0.7.0,7,1,93,98,191,6,FALSE
cellx,0.11.0,0.11.1,16,1,15,7,22,7,FALSE
cellx,0.11.1,0.11.3,17,1,9,11,20,7,FALSE
cellx,0.11.3,0.11.4,18,1,35,29,64,5,FALSE
cellx,0.4.0,0.5.0,4,1,241,307,548,12,FALSE
cellx,1.5.9,1.5.11,66,2,5972,5677,11649,67,FALSE
cellx,1.5.8,1.5.9,65,1,93,98,191,6,FALSE
cellx,1.5.5,1.5.6,63,1,93,98,191,6,FALSE
cellx,1.5.6,1.5.8,64,2,639,288,927,27,FALSE
cellx,1.5.1,1.5.5,62,1,93,98,191,6,FALSE
cellx,1.5.0,1.5.1,61,1,93,98,191,6,FALSE
cellx,1.3.0,1.4.0,47,1,42,4,46,6,FALSE
cellx,1.1.1,1.2.0,27,1,338,184,522,14,FALSE
cellx,1.1.0,1.1.1,26,1,114,68,182,9,FALSE
cellx,0.9.0,0.9.1,10,1,5,5,10,5,FALSE
cellx,0.2.0,0.3.0,2,1,453,539,992,9,FALSE
cellx,0.1.0,0.2.0,1,2,30636,61,30697,52,FALSE
cellx,1.0.0-rc1,1.0.0-rc2,21,1,10569,4026,14595,16,FALSE
cellx,1.0.0-rc2,1.0.0,22,1,45,56,101,9,FALSE
cellx,0.10.1,0.10.2,14,1,106,98,204,8,FALSE
cellx,0.10.0,0.10.1,13,1,93,98,191,6,FALSE
cellx,0.10.2,0.11.0,15,1,93,98,191,6,FALSE
cellx,1.6.30,1.6.31,95,2,8719,2798,11517,34,FALSE
cellx,0.7.0,0.8.0,8,2,597,737,1334,15,FALSE
cellx,0.9.1,0.9.2,11,1,7,3,10,5,FALSE
cellx,0.5.0,0.5.1,5,1,40,40,80,4,FALSE
cellx,0.5.1,0.6.0,6,1,17,77,94,5,FALSE
cellx,1.7.1,1.7.4,154,1,96,52,148,8,FALSE
cellx,1.4.0,1.4.1,48,1,93,98,191,6,FALSE
cellx,1.4.1,1.4.2,49,1,93,98,191,6,FALSE
cellx,0.9.2,0.10.0,12,1,93,98,191,6,FALSE
cellx,1.2.13,1.2.14,41,1,93,98,191,6,FALSE
cellx,1.2.14,1.2.15,42,1,15,15,30,7,FALSE
cellx,1.4.5,1.4.6,51,1,93,98,191,6,FALSE
cellx,1.4.6,1.4.7,52,1,93,98,191,6,FALSE
cellx,1.7.10,1.7.11,161,1,11,9,20,2,TRUE
cellx,1.4.8,1.4.9,54,1,93,98,191,6,FALSE
cellx,1.4.9,1.4.10,55,1,44,40,84,7,FALSE
cellx,0.8.0,0.9.0,9,1,320,686,1006,14,FALSE
cellx,1.2.6,1.2.7,34,1,10,9,19,4,FALSE
cellx,1.2.7,1.2.8,35,1,93,98,191,6,FALSE
cellx,1.2.4,1.2.5,32,1,38,2,40,6,FALSE
cellx,1.2.2,1.2.3,30,1,5,75,80,3,FALSE
cellx,1.2.3,1.2.4,31,1,25,25,50,6,FALSE
cellx,1.2.0,1.2.1,28,1,93,98,191,6,FALSE
cellx,1.2.1,1.2.2,29,1,11,9,20,6,FALSE
cellx,1.2.16,1.2.17,44,1,48,20,68,5,FALSE
cellx,1.2.8,1.2.9,36,1,77,55,132,11,FALSE
cellx,1.2.9,1.2.10,37,1,73,25,98,5,FALSE
cellx,1.6.29,1.6.30,94,1,262,254,516,8,FALSE
cellx,1.6.28,1.6.29,93,1,8,0,8,2,FALSE
cellx,1.6.21,1.6.22,86,1,26,26,52,6,FALSE
cellx,1.6.20,1.6.21,85,1,182,48,230,5,FALSE
cellx,1.6.23,1.6.24,88,1,93,98,191,6,FALSE
cellx,1.6.22,1.6.23,87,1,93,98,191,6,FALSE
cellx,1.6.25,1.6.26,90,1,93,98,191,6,FALSE
cellx,1.6.24,1.6.25,89,1,242,128,370,8,FALSE
cellx,1.6.27,1.6.28,92,1,166,40,206,12,FALSE
cellx,1.6.26,1.6.27,91,1,138,21,159,3,FALSE
cellx,1.2.17,1.2.18,45,1,24,24,48,5,FALSE
cellx,0.11.5,1.0.0-rc1,20,1,193,486,679,18,FALSE
cellx,1.6.6,1.6.7,73,2,31,24,55,15,TRUE
cellx,1.6.7,1.6.8,74,1,33,5,38,6,TRUE
cellx,1.7.5,1.7.6,156,1,93,98,191,6,TRUE
cellx,1.6.70,1.6.71,130,1,2,2,4,2,TRUE
cellx,1.6.54,1.6.55,118,4,1618,28,1646,11,TRUE
cellx,1.6.55,1.6.56,119,2,78,76,154,13,TRUE
cellx,1.6.21,1.6.22,86,1,26,26,52,6,TRUE
cellx,1.2.2,1.2.3,30,1,5,75,80,3,TRUE
cellx,1.6.87,1.6.88,146,1,314,25,339,10,TRUE
cellx,1.6.39,1.6.40,104,2,57,43,100,7,TRUE
cellx,1.6.44,1.6.45,109,1,93,98,191,6,TRUE
cellx,1.6.43,1.6.44,108,1,25,17,42,9,TRUE
cellx,1.6.42,1.6.43,107,1,21,3,24,4,TRUE
cellx,1.6.32,1.6.33,97,2,1464,302,1766,8,TRUE
cellx,1.0.0-rc2,1.0.0,22,1,45,56,101,9,TRUE
cellx,1.7.7,1.7.8,158,1,93,98,191,6,TRUE
cellx,1.7.4,1.7.5,155,1,93,98,191,6,TRUE
cellx,1.6.90,1.6.91,149,1,20,8,28,4,TRUE
cellx,0.1.0,0.2.0,1,2,30636,61,30697,52,TRUE
cellx,1.7.9,1.7.10,160,1,5,5,10,4,TRUE
cellx,1.0.0,1.0.1,23,1,1176,10479,11655,8,TRUE
cellx,1.6.26,1.6.27,91,1,138,21,159,3,TRUE
cellx,1.6.27,1.6.28,92,1,166,40,206,12,TRUE
cellx,1.6.28,1.6.29,93,1,8,0,8,2,TRUE
cellx,1.6.61,1.6.62,124,1,2,1,3,2,TRUE
cellx,1.5.0,1.5.1,61,1,93,98,191,6,TRUE
cellx,1.5.5,1.5.6,63,1,93,98,191,6,TRUE
cellx,1.6.45,1.6.46,110,1,139,28,167,7,TRUE
cellx,1.5.8,1.5.9,65,1,93,98,191,6,TRUE
cellx,1.4.2,1.4.5,50,1,93,98,191,6,TRUE
cellx,1.6.10,1.6.11,77,1,93,98,191,6,TRUE
cellx,1.6.50,1.6.51,114,1,49,263,312,12,TRUE
cellx,1.6.31,1.6.32,96,1,45,45,90,21,TRUE
cellx,1.6.2,1.6.5,71,2,241,217,458,27,TRUE
cellx,1.6.5,1.6.6,72,1,93,98,191,6,TRUE
cellx,1.2.7,1.2.8,35,1,93,98,191,6,TRUE
react-scripts,1.0.4,1.0.5,49,5,70,18,88,12,FALSE
react-scripts,1.0.5,1.0.6,50,9,105,23,128,18,FALSE
react-scripts,1.0.6,1.0.7,51,10,82,30,112,15,FALSE
react-scripts,1.0.0,1.0.1,45,22,210,67,277,31,FALSE
react-scripts,1.0.1,1.0.2,46,14,654,49,703,65,FALSE
react-scripts,1.0.2,1.0.3,47,6,82,30,112,10,FALSE
react-scripts,1.0.3,1.0.4,48,3,28,4,32,5,FALSE
react-scripts,0.6.0,0.6.1,19,11,93,20,113,14,FALSE
react-scripts,0.2.2,0.2.3,6,12,60,47,107,18,FALSE
react-scripts,0.2.1,0.2.2,5,55,1268,510,1778,116,FALSE
react-scripts,0.2.0,0.2.1,4,20,275,91,366,28,FALSE
react-scripts,1.0.0-alpha.134d2297,1.0.0-alpha.55afd862,40,22,1509,900,2409,78,FALSE
react-scripts,0.3.1,0.4.0,11,18,569,212,781,56,FALSE
react-scripts,0.7.0,0.8.0,23,54,789,305,1094,93,FALSE
react-scripts,0.3.0-alpha,0.3.0-beta,8,43,340,176,516,77,FALSE
react-scripts,0.4.1,0.4.2,13,44,409,178,587,63,FALSE
react-scripts,0.4.0,0.4.1,12,14,254,130,384,23,FALSE
react-scripts,0.4.3,0.5.0,16,43,1521,776,2297,172,FALSE
react-scripts,0.4.2,0.4.3-0,14,1,1,1,2,1,FALSE
react-scripts,0.5.0,0.5.1,17,6,28,50,78,7,FALSE
react-scripts,0.5.1,0.6.0,18,8,499,102,601,14,FALSE
react-scripts,0.9.0,0.9.1,30,67,940,449,1389,109,FALSE
react-scripts,0.9.1,0.9.2,31,6,230,82,312,10,FALSE
react-scripts,0.9.2,0.9.3,32,16,287,82,369,19,FALSE
react-scripts,0.9.3,0.9.4,33,39,1388,519,1907,162,FALSE
react-scripts,0.9.4,0.9.5,34,21,3266,1762,5028,105,FALSE
react-scripts,0.4.3-0,0.4.3,15,1,1,1,2,1,FALSE
react-scripts,0.8.5,0.9.0,29,38,2598,499,3097,195,FALSE
react-scripts,0.8.4,0.8.5,28,23,191,85,276,39,FALSE
react-scripts,0.8.1,0.8.2,25,22,423,104,527,35,FALSE
react-scripts,0.8.0,0.8.1,24,6,12,6,18,7,FALSE
react-scripts,0.8.3,0.8.4,27,18,290,151,441,26,FALSE
react-scripts,0.8.2,0.8.3,26,6,82,22,104,7,FALSE
react-scripts,0.3.0-beta,0.3.0,9,8,319,53,372,19,FALSE
react-scripts,0.3.0,0.3.1,10,5,24,7,31,5,FALSE
react-scripts,0.2.0-alpha.1,0.2.0,3,16,147,51,198,24,FALSE
react-scripts,1.0.4,1.0.5,49,5,70,18,88,12,TRUE
react-scripts,1.0.5,1.0.6,50,9,105,23,128,18,TRUE
react-scripts,1.0.0,1.0.1,45,22,210,67,277,31,TRUE
react-scripts,1.0.2,1.0.3,47,6,82,30,112,10,TRUE
react-scripts,0.7.0,0.8.0,23,54,789,305,1094,93,TRUE
react-scripts,0.9.0,0.9.1,30,67,940,449,1389,109,TRUE
react-scripts,0.9.3,0.9.4,33,39,1388,519,1907,162,TRUE
react-scripts,0.9.4,0.9.5,34,21,3266,1762,5028,105,TRUE
react-scripts,0.8.5,0.9.0,29,38,2598,499,3097,195,TRUE
react-scripts,0.1.0,0.2.0-alpha.1,2,53,718,424,1142,90,FALSE
react-scripts,0.3.0-alpha,0.3.0-beta,8,43,340,176,516,77,TRUE
react-scripts,0.3.0-beta,0.3.0,9,8,319,53,372,19,TRUE
react-scripts,0.3.0,0.3.1,10,5,24,7,31,5,TRUE
react-scripts,0.4.1,0.4.2,13,44,409,178,587,63,TRUE
react-scripts,0.8.1,0.8.2,25,22,423,104,527,35,TRUE
react-scripts,0.2.2,0.2.3,6,12,60,47,107,18,TRUE
react-scripts,1.0.6,1.0.7,51,10,82,30,112,15,TRUE
react-scripts,1.0.1,1.0.2,46,14,654,49,703,65,TRUE
react-scripts,0.6.0,0.6.1,19,11,93,20,113,14,TRUE
react-scripts,0.5.0,0.5.1,17,6,28,50,78,7,TRUE
react-scripts,0.5.1,0.6.0,18,8,499,102,601,14,TRUE
node-steam-market-crawler,1.3.3,1.3.4,14,2,13,2,15,2,FALSE
node-steam-market-crawler,1.0.2,1.2.0,1,29,1805,1272,3077,72,FALSE
node-steam-market-crawler,1.3.2,1.3.3,13,2,85,1,86,5,FALSE
node-steam-market-crawler,1.3.1,1.3.2,12,2,2,3,5,3,FALSE
node-steam-market-crawler,1.2.6,1.2.7,7,2,3,3,6,3,FALSE
node-steam-market-crawler,1.2.7,1.2.8,8,2,17,11,28,2,FALSE
node-steam-market-crawler,1.2.4,1.2.5,5,1,2,2,4,2,FALSE
node-steam-market-crawler,1.2.5,1.2.6,6,1,2,2,4,2,FALSE
node-steam-market-crawler,1.2.3,1.2.4,4,1,12,3,15,4,FALSE
node-steam-market-crawler,1.2.0,1.2.1,2,2,5,2,7,2,FALSE
node-steam-market-crawler,1.2.1,1.2.3,3,8,556,591,1147,19,FALSE
node-steam-market-crawler,1.3.0,1.3.1,11,1,65,3,68,3,FALSE
node-steam-market-crawler,1.2.8,1.2.9,9,1,17,4,21,3,FALSE
node-steam-market-crawler,1.2.9,1.3.0,10,4,31,22,53,5,FALSE
node-steam-market-crawler,1.3.3,1.3.4,14,2,13,2,15,2,TRUE
node-steam-market-crawler,1.2.5,1.2.6,6,1,2,2,4,2,TRUE
node-steam-market-crawler,1.3.0,1.3.1,11,1,65,3,68,3,TRUE
node-steam-market-crawler,1.2.9,1.3.0,10,4,31,22,53,5,TRUE
vue-supply,0.1.0,0.1.1,3,8,151,81,232,10,FALSE
vue-supply,0.0.1,0.0.2,1,2,6,54,60,4,FALSE
vue-supply,0.0.2,0.1.0,2,2,710,54,764,12,FALSE
vue-supply,0.0.2,0.1.0,2,2,710,54,764,12,TRUE
vue-supply,0.1.0,0.1.1,3,8,151,81,232,10,TRUE
isomorphic-dispatcher,1.0.0,1.0.1,14,2,17,12,29,5,FALSE
isomorphic-dispatcher,1.0.0-rc12,1.0.0-rc13,4,2,6,2,8,2,FALSE
isomorphic-dispatcher,1.0.0-rc10,1.0.0-rc11,2,2,5,2,7,2,FALSE
isomorphic-dispatcher,1.0.0-rc11,1.0.0-rc12,3,2,3,1,4,2,FALSE
isomorphic-dispatcher,1.0.0-rc8,1.0.0-rc9,12,2,8,3,11,3,FALSE
isomorphic-dispatcher,1.0.0-rc9,1.0.0,13,12,1871,1981,3852,32,FALSE
isomorphic-dispatcher,1.0.0-rc1,1.0.0-rc10,1,54,3627,3153,6780,111,FALSE
isomorphic-dispatcher,1.0.0-rc2,1.0.0-rc3,6,2,61,26,87,4,FALSE
isomorphic-dispatcher,1.0.0-rc3,1.0.0-rc4,7,2,16,22,38,2,FALSE
isomorphic-dispatcher,1.0.0-rc4,1.0.0-rc5,8,2,7,5,12,3,FALSE
isomorphic-dispatcher,1.0.0-rc5,1.0.0-rc6,9,2,3,3,6,3,FALSE
isomorphic-dispatcher,1.0.0-rc6,1.0.0-rc7,10,2,31,29,60,10,FALSE
isomorphic-dispatcher,1.0.0-rc7,1.0.0-rc8,11,36,3455,2992,6447,78,FALSE
isomorphic-dispatcher,1.0.0-rc9,1.0.0,13,12,1871,1981,3852,32,TRUE
isomorphic-dispatcher,1.0.0-rc1,1.0.0-rc10,1,54,3627,3153,6780,111,TRUE
flummox,1.1.1,1.2.0,5,2,27,1,28,3,FALSE
flummox,3.1.2,3.2.0,45,8,227,94,321,16,FALSE
flummox,3.1.1,3.1.2,44,10,141,28,169,13,FALSE
flummox,3.1.0,3.1.1,43,22,268,64,332,26,FALSE
flummox,3.0.0,3.0.1,41,12,155,129,284,16,FALSE
flummox,3.0.1,3.1.0,42,47,472,243,715,68,FALSE
flummox,2.7.1,2.7.2,23,4,8,6,14,4,FALSE
flummox,3.5.1,3.5.2,54,9,145,8,153,12,FALSE
flummox,2.10.0,2.11.0,30,13,483,255,738,28,FALSE
flummox,2.8.0,2.9.0,25,14,179,73,252,20,FALSE
flummox,3.6.0,3.6.1,56,1,8,21,29,2,FALSE
flummox,2.13.0,2.13.1,38,6,38,29,67,9,FALSE
flummox,2.13.1,2.13.2,39,124,3806,2856,6662,205,FALSE
flummox,3.6.1,3.6.2,57,1,10,2,12,3,FALSE
flummox,2.6.1,2.6.2,20,21,241,85,326,26,FALSE
flummox,4.0.0-alpha2,4.0.0-rc1,66,63,2737,3611,6348,193,FALSE
flummox,3.6.2,3.6.3,58,3,17,2451,2468,6,FALSE
flummox,3.6.3,3.6.4,59,1,63,39,102,4,FALSE
flummox,2.11.0,2.12.0,31,7,113,29,142,13,FALSE
flummox,2.12.1,2.12.2,33,4,44,38,82,10,FALSE
flummox,2.12.0,2.12.1,32,3,34,22,56,6,FALSE
flummox,2.12.3,2.12.4,35,4,233,229,462,7,FALSE
flummox,2.12.2,2.12.3,34,14,653,1923,2576,74,FALSE
flummox,2.12.5,2.13.0,37,6,171,100,271,10,FALSE
flummox,2.12.4,2.12.5,36,7,177,111,288,9,FALSE
flummox,3.6.5,3.6.6,61,3,550,594,1144,8,FALSE
flummox,4.0.0-alpha,4.0.0-alpha2,65,8,422,224,646,22,FALSE
flummox,2.9.0,2.9.1,26,1,3,2,5,1,FALSE
flummox,2.4.0,2.5.0,16,8,73,33,106,15,FALSE
flummox,2.5.0,2.5.1,17,14,1339,1292,2631,26,FALSE
flummox,2.5.1,2.6.0,18,32,3785,4118,7903,100,FALSE
flummox,2.9.2,2.9.3,28,10,60,32,92,22,FALSE
flummox,2.9.3,2.10.0,29,7,89,9,98,9,FALSE
flummox,3.4.0,3.5.0,52,9,1368,1123,2491,130,FALSE
flummox,2.9.1,2.9.2,27,8,213,117,330,10,FALSE
flummox,2.6.0,2.6.1,19,7,39,26,65,11,FALSE
flummox,2.6.2,2.7.0,21,6,44,4,48,8,FALSE
flummox,2.7.0,2.7.1,22,3,7,3,10,3,FALSE
flummox,3.5.2,3.6.0,55,120,6684,5831,12515,305,FALSE
flummox,2.7.2,2.8.0,24,10,342,37,379,18,FALSE
flummox,3.5.0,3.5.1,53,11,1865,671,2536,57,FALSE
flummox,3.3.1,3.3.2,49,2,99,99,198,5,FALSE
flummox,3.3.0,3.3.1,48,11,587,211,798,23,FALSE
flummox,3.3.3,3.4.0,51,3,169,53,222,8,FALSE
flummox,3.3.2,3.3.3,50,5,8,36,44,7,FALSE
flummox,3.2.0,3.2.1,46,3,34,32,66,6,FALSE
flummox,3.2.1,3.3.0,47,16,3992,436,4428,123,FALSE
flummox,3.6.6,3.6.7,62,1,6,2,8,3,FALSE
flummox,3.6.7,3.6.8,63,1,101,103,204,4,FALSE
flummox,3.6.4,3.6.5,60,2,1482,3,1485,5,FALSE
flummox,1.0.0,1.0.1,1,2,3,3,6,2,FALSE
flummox,1.0.1,1.0.2,2,3,509,4,513,4,FALSE
flummox,1.1.0,1.1.1,4,4,455,890,1345,16,FALSE
flummox,1.0.2,1.1.0,3,3,10,4,14,4,FALSE
flummox,2.2.1,2.3.0,14,22,1151,278,1429,54,FALSE
flummox,2.0.2-beta,2.0.3,9,7,83,7,90,7,FALSE
flummox,2.0.3,2.1.0,10,6,251,17,268,13,FALSE
flummox,2.1.0,2.1.1,11,1,1,1,2,1,FALSE
flummox,2.1.1,2.2.0,12,2,63,8,71,4,FALSE
flummox,2.0.0-beta,2.0.1-beta,7,2,6,4,10,3,FALSE
flummox,2.3.0,2.4.0,15,18,1401,66,1467,30,FALSE
flummox,1.2.0,2.0.0-beta,6,16,973,644,1617,61,FALSE
flummox,2.0.1-beta,2.0.2-beta,8,1,4,0,4,1,FALSE
flummox,2.2.0,2.2.1,13,6,14,12,26,7,FALSE
flummox,2.7.2,2.8.0,24,10,342,37,379,18,TRUE
flummox,2.12.5,2.13.0,37,6,171,100,271,10,TRUE
flummox,2.2.0,2.2.1,13,6,14,12,26,7,TRUE
flummox,3.6.5,3.6.6,61,3,550,594,1144,8,TRUE
flummox,3.1.0,3.1.1,43,22,268,64,332,26,TRUE
flummox,3.0.0,3.0.1,41,12,155,129,284,16,TRUE
flummox,3.5.2,3.6.0,55,120,6684,5831,12515,305,TRUE
is-in-range,1.0.0,1.0.1,1,2,8,2,10,2,FALSE
is-in-range,1.0.0,1.0.1,1,2,8,2,10,2,TRUE
nxus-clientjs,3.0.0,4.0.0-0,3,10,274,193,467,26,FALSE
nxus-clientjs,4.0.0-4,4.0.0-5,8,13,188,41,229,18,FALSE
nxus-clientjs,4.0.0-5,4.0.0-6,9,8,83,26,109,12,FALSE
nxus-clientjs,4.0.0-6,4.0.0-7,10,3,6,6,12,3,FALSE
nxus-clientjs,4.0.0-7,4.0.0-8,11,3,5,5,10,3,FALSE
nxus-clientjs,4.0.0-0,4.0.0-1,4,3,19,16,35,3,FALSE
nxus-clientjs,4.0.0-1,4.0.0-2,5,4,44,44,88,4,FALSE
nxus-clientjs,4.0.0-2,4.0.0-3,6,5,85,32,117,6,FALSE
nxus-clientjs,4.0.0-3,4.0.0-4,7,8,55,17,72,8,FALSE
nxus-clientjs,3.0.0-1,3.0.0,2,9,109,48,157,12,FALSE
nxus-clientjs,3.0.0-0,3.0.0-1,1,4,96,26,122,7,FALSE
nxus-clientjs,4.0.0-6,4.0.0-7,10,3,6,6,12,3,TRUE
butler,0.4.1,0.4.2,6,7,264,261,525,14,FALSE
butler,0.0.4,0.4.0,4,1,2,2,4,1,FALSE
butler,0.4.0,0.4.1,5,10,263,71,334,23,FALSE
butler,0.4.1,0.4.2,6,7,264,261,525,14,TRUE
sd-builder,1.6.0,1.7.0,21,3,68,1,69,3,FALSE
sd-builder,1.0.4,1.0.5,5,2,9,3,12,2,FALSE
sd-builder,1.0.5,1.0.6,6,2,11,5,16,2,FALSE
sd-builder,1.0.6,1.0.7,7,2,3,3,6,2,FALSE
sd-builder,1.0.7,1.0.8,8,2,5,2,7,3,FALSE
sd-builder,1.0.0,1.0.1,1,2,2,2,4,2,FALSE
sd-builder,1.0.1,1.0.2,2,2,4,2,6,2,FALSE
sd-builder,1.0.2,1.0.3,3,2,3,2,5,2,FALSE
sd-builder,1.0.3,1.0.4,4,3,14,6,20,3,FALSE
sd-builder,1.0.8,1.1.0,9,2,25,1,26,3,FALSE
sd-builder,2.1.0,2.2.0,25,7,82,34,116,12,FALSE
sd-builder,2.0.0,2.1.0-rc1,23,3,100,39,139,7,FALSE
sd-builder,1.1.1,1.2.0,11,2,2,1,3,2,FALSE
sd-builder,2.1.0-rc1,2.1.0,24,1,1,1,2,1,FALSE
sd-builder,1.7.0,2.0.0,22,4,19,18,37,5,FALSE
sd-builder,1.4.0,1.4.1,15,2,2,1,3,2,FALSE
sd-builder,1.4.1,1.4.2,16,2,5,6,11,2,FALSE
sd-builder,1.4.2,1.4.3,17,2,2,1,3,2,FALSE
sd-builder,1.4.3,1.4.4,18,2,2,2,4,2,FALSE
sd-builder,1.4.4,1.5.0,19,2,2,2,4,2,FALSE
sd-builder,1.5.0,1.6.0,20,2,8,4,12,4,FALSE
sd-builder,1.3.1,1.4.0,14,2,34,15,49,2,FALSE
sd-builder,1.3.0,1.3.1,13,2,2,2,4,2,FALSE
sd-builder,1.2.0,1.3.0,12,2,2,2,4,2,FALSE
sd-builder,1.1.0,1.1.1,10,2,7,7,14,2,FALSE
sd-builder,2.1.0,2.2.0,25,7,82,34,116,12,TRUE
sd-builder,2.2.0,3.0.0,26,2,319,410,729,15,FALSE
sd-builder,4.0.0,4.0.1,29,5,13,12,25,8,FALSE
sd-builder,3.0.0,3.0.1,27,2,3,2,5,2,FALSE
sd-builder,3.0.1,4.0.0,28,7,88,22,110,16,FALSE
sd-builder,2.0.0,2.1.0-rc1,23,3,100,39,139,7,TRUE
sd-builder,1.5.0,1.6.0,20,2,8,4,12,4,TRUE
sd-builder,1.6.0,1.7.0,21,3,68,1,69,3,TRUE
sd-builder,1.2.0,1.3.0,12,2,2,2,4,2,TRUE
espower-babel,1.4.0,1.4.1,2,5,6,6,12,5,FALSE
espower-babel,1.4.1,1.5.0,3,7,45,41,86,18,FALSE
espower-babel,3.1.1,3.2.0,10,5,72,22,94,11,FALSE
espower-babel,3.1.0,3.1.1,9,7,17,9,26,9,FALSE
espower-babel,3.0.0,3.1.0,8,6,92,25,117,7,FALSE
espower-babel,4.0.0,4.0.1,13,13,160,34,194,20,FALSE
espower-babel,2.0.0,2.1.0,5,5,34,30,64,11,FALSE
espower-babel,3.3.0,4.0.0,12,9,60,30,90,15,FALSE
espower-babel,1.3.0,1.4.0,1,7,126,21,147,18,FALSE
espower-babel,3.2.0,3.3.0,11,6,19,19,38,8,FALSE
espower-babel,2.1.0,2.1.1,6,3,3,3,6,3,FALSE
espower-babel,4.0.1,4.0.2,14,2,2,2,4,2,FALSE
espower-babel,2.1.1,3.0.0,7,8,272,78,350,19,FALSE
espower-babel,4.0.2,4.0.3,15,2,21,18,39,2,FALSE
espower-babel,3.1.0,3.1.1,9,7,17,9,26,9,TRUE
espower-babel,3.3.0,4.0.0,12,9,60,30,90,15,TRUE
espower-babel,2.1.0,2.1.1,6,3,3,3,6,3,TRUE
espower-babel,1.4.1,1.5.0,3,7,45,41,86,18,TRUE
espower-babel,2.0.0,2.1.0,5,5,34,30,64,11,TRUE
util.toolbox,0.0.5,0.0.6,5,2,2,3,5,2,FALSE
util.toolbox,0.0.4,0.0.5,4,2,28,10,38,7,FALSE
util.toolbox,0.0.7,0.0.8,7,2,7,7,14,5,FALSE
util.toolbox,0.0.6,0.0.7,6,2,17,6,23,6,FALSE
util.toolbox,0.0.1,0.0.2,1,2,6,7,13,5,FALSE
util.toolbox,0.0.3,0.0.4,3,2,66,7,73,6,FALSE
util.toolbox,0.0.2,0.0.3,2,2,342,12,354,8,FALSE
util.toolbox,0.0.9,0.0.10,9,2,356,31,387,9,FALSE
util.toolbox,0.0.8,0.0.9,8,2,111,57,168,7,FALSE
util.toolbox,0.0.10,0.0.11,10,2,6,7,13,5,FALSE
util.toolbox,0.0.27,0.0.28,27,2,9,5,14,5,FALSE
util.toolbox,0.0.28,0.0.29,28,2,13,4,17,5,FALSE
util.toolbox,0.0.29,0.0.30,29,2,74,82,156,7,FALSE
util.toolbox,0.0.33,0.0.34,33,2,4985,3746,8731,5,FALSE
util.toolbox,0.0.32,0.0.33,32,2,3748,4879,8627,4,FALSE
util.toolbox,0.0.31,0.0.32,31,2,15,7,22,4,FALSE
util.toolbox,0.0.30,0.0.31,30,2,4890,136306,141196,50,FALSE
util.toolbox,0.0.12,0.0.13,12,2,174,212,386,8,FALSE
util.toolbox,0.0.11,0.0.12,11,2,3864,28,3892,8,FALSE
util.toolbox,0.0.15,0.0.16,15,2,166,268,434,10,FALSE
util.toolbox,0.0.14,0.0.15,14,2,9,20,29,6,FALSE
util.toolbox,0.0.17,0.0.18,17,2,450,322,772,6,FALSE
util.toolbox,0.0.16,0.0.17,16,2,52,21,73,7,FALSE
util.toolbox,0.0.13,0.0.14,13,2,1535,614,2149,8,FALSE
util.toolbox,0.0.19,0.0.20,19,2,17,4,21,3,FALSE
util.toolbox,0.0.18,0.0.19,18,2,6,6,12,5,FALSE
util.toolbox,0.0.20,0.0.21,20,2,10,94,104,7,FALSE
util.toolbox,0.0.21,0.0.22,21,2,6,7,13,6,FALSE
util.toolbox,0.0.22,0.0.23,22,2,11,27,38,5,FALSE
util.toolbox,0.0.23,0.0.24,23,2,7,13,20,5,FALSE
util.toolbox,0.0.24,0.0.25,24,2,55,86,141,7,FALSE
util.toolbox,0.0.25,0.0.26,25,2,81,49,130,7,FALSE
util.toolbox,0.0.26,0.0.27,26,2,713,207,920,15,FALSE
util.toolbox,0.0.32,0.0.33,32,2,3748,4879,8627,4,TRUE
util.toolbox,0.0.24,0.0.25,24,2,55,86,141,7,TRUE
util.toolbox,0.0.15,0.0.16,15,2,166,268,434,10,TRUE
util.toolbox,0.0.17,0.0.18,17,2,450,322,772,6,TRUE
util.toolbox,0.0.16,0.0.17,16,2,52,21,73,7,TRUE
util.toolbox,0.0.11,0.0.12,11,2,3864,28,3892,8,TRUE
util.toolbox,0.0.13,0.0.14,13,2,1535,614,2149,8,TRUE
util.toolbox,0.0.12,0.0.13,12,2,174,212,386,8,TRUE
util.toolbox,0.0.18,0.0.19,18,2,6,6,12,5,TRUE
util.toolbox,0.0.30,0.0.31,30,2,4890,136306,141196,50,TRUE
util.toolbox,0.0.6,0.0.7,6,2,17,6,23,6,TRUE
util.toolbox,0.0.2,0.0.3,2,2,342,12,354,8,TRUE
util.toolbox,0.0.8,0.0.9,8,2,111,57,168,7,TRUE
util.toolbox,0.0.26,0.0.27,26,2,713,207,920,15,TRUE
util.toolbox,0.0.9,0.0.10,9,2,356,31,387,9,TRUE
react-autolink-text,1.0.0,1.0.1,1,2,7,1,8,2,FALSE
react-autolink-text,1.0.1,1.0.2,2,4,156,11,167,9,FALSE
react-autolink-text,1.0.2,2.0.0,3,4,48,24,72,12,FALSE
react-autolink-text,1.0.2,2.0.0,3,4,48,24,72,12,TRUE
gcg-tweaked,0.5.4,0.5.5,4,1,1,1,2,1,FALSE
gcg-tweaked,0.5.5,0.5.6,5,2,3,3,6,2,FALSE
gcg-tweaked,0.5.6,0.5.7,6,1,14,11,25,2,FALSE
gcg-tweaked,0.5.1,0.5.2,1,2,3,4,7,2,FALSE
gcg-tweaked,0.5.2,0.5.3,2,2,2,2,4,2,FALSE
gcg-tweaked,0.5.3,0.5.4,3,2,12,3,15,4,FALSE
gcg-tweaked,0.5.6,0.5.7,6,1,14,11,25,2,TRUE
fetch-intercept,1.0.0,2.0.0,1,2,54,6,60,7,TRUE
fetch-intercept,2.0.1,2.1.0,3,5,115,85,200,11,FALSE
fetch-intercept,2.0.0,2.0.1,2,1,8,4,12,3,FALSE
fetch-intercept,2.2.1,2.2.2,6,4,8,10,18,5,FALSE
fetch-intercept,2.2.0,2.2.1,5,1,6,1,7,3,FALSE
fetch-intercept,2.2.2,2.2.3,7,3,13,3,16,5,FALSE
fetch-intercept,2.1.0,2.2.0,4,7,76,71,147,15,FALSE
fetch-intercept,1.0.0,2.0.0,1,2,54,6,60,7,FALSE
fetch-intercept,2.2.0,2.2.1,5,1,6,1,7,3,TRUE
fetch-intercept,2.0.1,2.1.0,3,5,115,85,200,11,TRUE
joj-core,2.0.5,2.0.6,20,3,374,189,563,40,FALSE
joj-core,2.0.4,2.0.5,19,22,5162,4936,10098,594,FALSE
joj-core,2.0.3,2.0.4,18,1,23,19,42,6,FALSE
joj-core,2.0.2,2.0.3,17,1,23,19,42,6,FALSE
joj-core,2.0.1,2.0.2,16,5,1978,1393,3371,164,FALSE
joj-core,2.0.0,2.0.1,15,3,652,305,957,57,FALSE
joj-core,1.1.0,1.2.0,1,1,23,19,42,6,FALSE
joj-core,1.2.0,1.3.0,2,2,191,444,635,36,FALSE
joj-core,1.4.1,1.4.2,4,2,343,1230,1573,20,FALSE
joj-core,1.4.2,1.4.3,5,1,1,336,337,5,FALSE
joj-core,1.4.3,1.5.0,6,2,599,531,1130,37,FALSE
joj-core,1.5.1,1.5.2,8,1,23,19,42,6,FALSE
joj-core,1.5.0,1.5.1,7,2,468,351,819,13,FALSE
joj-core,1.6.0,1.6.1,10,1,649,484,1133,34,FALSE
joj-core,1.6.1,1.7.0,11,1,281,187,468,11,FALSE
joj-core,1.5.2,1.6.0,9,1,152,109,261,9,FALSE
joj-core,1.7.2,2.0.0,14,66,53224,35289,88513,1999,FALSE
joj-core,1.7.1,1.7.2,13,1,13,16,29,5,FALSE
joj-core,1.7.0,1.7.1,12,1,971,680,1651,44,FALSE
joj-core,1.3.0,1.4.1,3,17,10198,8015,18213,324,FALSE
joj-core,1.1.0,1.2.0,1,1,23,19,42,6,TRUE
joj-core,2.0.4,2.0.5,19,22,5162,4936,10098,594,TRUE
joj-core,1.5.0,1.5.1,7,2,468,351,819,13,TRUE
joj-core,1.6.1,1.7.0,11,1,281,187,468,11,TRUE
joj-core,1.4.1,1.4.2,4,2,343,1230,1573,20,TRUE
joj-core,1.5.2,1.6.0,9,1,152,109,261,9,TRUE
joj-core,1.7.2,2.0.0,14,66,53224,35289,88513,1999,TRUE
joj-core,1.7.1,1.7.2,13,1,13,16,29,5,TRUE
react-task,4.0.1,4.0.2,13,2,4,4,8,2,FALSE
react-task,1.1.0,2.0.0,7,6,830,189,1019,12,FALSE
react-task,1.0.0,1.0.1,4,1,1,1,2,1,FALSE
react-task,1.0.1,1.0.2,5,2,3,2,5,3,FALSE
react-task,1.0.2,1.1.0,6,5,474,281,755,24,FALSE
react-task,4.0.0,4.0.1,12,2,2,2,4,2,FALSE
react-task,2.0.0,2.1.0,8,2,154,144,298,4,FALSE
react-task,3.0.1,4.0.0,11,21,1093,1384,2477,35,FALSE
react-task,3.0.0,3.0.1,10,8,240,131,371,13,FALSE
react-task,0.2.1,1.0.0,3,11,315,83,398,18,FALSE
react-task,0.2.0,0.2.1,2,6,139,94,233,9,FALSE
react-task,0.1.0,0.2.0,1,1,1,1,2,1,FALSE
react-task,2.1.0,3.0.0,9,6,238,184,422,14,FALSE
react-task,2.0.0,2.1.0,8,2,154,144,298,4,TRUE
react-task,1.0.2,1.1.0,6,5,474,281,755,24,TRUE
react-task,2.1.0,3.0.0,9,6,238,184,422,14,TRUE
react-task,3.0.0,3.0.1,10,8,240,131,371,13,TRUE
react-form-builder,0.0.9,0.0.10,8,3,109,5,114,7,FALSE
react-form-builder,0.0.8,0.0.9,7,3,7,5,12,3,FALSE
react-form-builder,0.0.15,0.0.16,14,4,8,9,17,4,FALSE
react-form-builder,0.0.14,0.0.15,13,1,20133,20071,40204,6,FALSE
react-form-builder,0.0.17,0.0.18,16,3,20,82,102,56,FALSE
react-form-builder,0.0.16,0.0.17,15,2,23525,21565,45090,5,FALSE
react-form-builder,0.0.11,0.0.12,10,3,20142,20135,40277,5,FALSE
react-form-builder,0.0.10,0.0.11,9,8,43102,42402,85504,45,FALSE
react-form-builder,0.0.13,0.0.14,12,2,9,3,12,2,FALSE
react-form-builder,0.0.12,0.0.13,11,2,3,2,5,2,FALSE
react-form-builder,0.1.1,0.1.2,26,1,8,5,13,3,FALSE
react-form-builder,0.1.2,0.1.3,27,1,1,1,2,1,FALSE
react-form-builder,0.1.3,0.1.4,28,1,2,2,4,1,FALSE
react-form-builder,0.0.19,0.0.20,18,2,59,64,123,9,FALSE
react-form-builder,0.0.18,0.0.19,17,1,3,3,6,1,FALSE
react-form-builder,0.1.6,0.1.7,31,1,2,2,4,1,FALSE
react-form-builder,0.1.7,0.1.8,32,1,48012,45650,93662,24,FALSE
react-form-builder,0.0.5,0.0.6,4,1,2,2,4,1,FALSE
react-form-builder,0.0.4,0.0.5,3,1,1,1,2,1,FALSE
react-form-builder,0.0.6,0.0.7,5,2,36693,36781,73474,8,FALSE
react-form-builder,0.0.3,0.0.4,2,15,1303,90,1393,27,FALSE
react-form-builder,0.0.2,0.0.3,1,1,1,1,2,1,FALSE
react-form-builder,0.1.23,0.1.24,47,1,2,2,4,2,FALSE
react-form-builder,0.1.4,0.1.5,29,1,3,3,6,2,FALSE
react-form-builder,0.1.21,0.1.22,45,2,3,3,6,3,FALSE
react-form-builder,0.1.20,0.1.21,44,1,1,0,1,1,FALSE
react-form-builder,0.1.27,0.1.28,51,3,16,6,22,4,FALSE
react-form-builder,0.1.26,0.1.27,50,2,2,1,3,2,FALSE
react-form-builder,0.1.25,0.1.26,49,1,3,3,6,1,FALSE
react-form-builder,0.1.24,0.1.25,48,1,5,7,12,2,FALSE
react-form-builder,0.0.7,0.0.8,6,4,15,13,28,6,FALSE
react-form-builder,0.0.20,0.0.21,19,1,35,28,63,2,FALSE
react-form-builder,0.0.21,0.0.22,20,4,9,10,19,4,FALSE
react-form-builder,0.0.22,0.0.23,21,2,4,3,7,2,FALSE
react-form-builder,0.0.23,0.0.24,22,1,1,2,3,2,FALSE
react-form-builder,0.0.24,0.0.25,23,3,184,205,389,24,FALSE
react-form-builder,0.0.25,0.0.26,24,2,3,11,14,2,FALSE
react-form-builder,0.0.26,0.1.1,25,2,86,65,151,36,FALSE
react-form-builder,0.1.9,0.1.10,34,1,1204,1236,2440,4,FALSE
react-form-builder,0.1.12,0.1.13,37,1,1,1,2,1,FALSE
react-form-builder,0.1.13,0.1.14,38,1,1,1,2,1,FALSE
react-form-builder,0.1.10,0.1.11,35,1,1,1,2,1,FALSE
react-form-builder,0.1.11,0.1.12,36,1,1,1,2,1,FALSE
react-form-builder,0.1.17,0.1.18,41,1,1281,1395,2676,4,FALSE
react-form-builder,0.1.14,0.1.15,39,4,208,108,316,12,FALSE
react-form-builder,0.1.15,0.1.17,40,1,4,3,7,2,FALSE
react-form-builder,0.1.18,0.1.19,42,1,2,4,6,4,FALSE
react-form-builder,0.1.19,0.1.20,43,2,4,4,8,4,FALSE
react-form-builder,0.1.8,0.1.9,33,1,1968,3805,5773,4,FALSE
react-form-builder,0.1.28,0.1.29,52,2,2,2,4,2,FALSE
react-form-builder,0.1.22,0.1.23,46,2,2,2,4,2,FALSE
react-form-builder,0.1.5,0.1.6,30,2,6,4,10,4,FALSE
react-form-builder,0.1.20,0.1.21,44,1,1,0,1,1,TRUE
react-form-builder,0.1.14,0.1.15,39,4,208,108,316,12,TRUE
react-form-builder,0.1.15,0.1.17,40,1,4,3,7,2,TRUE
react-form-builder,0.1.19,0.1.20,43,2,4,4,8,4,TRUE
react-form-builder,0.0.24,0.0.25,23,3,184,205,389,24,TRUE
react-form-builder,0.0.25,0.0.26,24,2,3,11,14,2,TRUE
react-form-builder,0.0.16,0.0.17,15,2,23525,21565,45090,5,TRUE
react-form-builder,0.0.6,0.0.7,5,2,36693,36781,73474,8,TRUE
react-form-builder,0.0.7,0.0.8,6,4,15,13,28,6,TRUE
react-form-builder,0.0.21,0.0.22,20,4,9,10,19,4,TRUE
react-form-builder,0.0.3,0.0.4,2,15,1303,90,1393,27,TRUE
react-form-builder,0.0.26,0.1.1,25,2,86,65,151,36,TRUE
react-form-builder,0.1.28,0.1.29,52,2,2,2,4,2,TRUE
react-simple-format,0.1.0,0.1.1,1,10,396,199,595,22,FALSE
react-simple-format,0.1.1,0.2.0,2,3,38,6,44,6,FALSE
react-simple-format,0.2.0,0.3.0,3,2,7,4,11,2,FALSE
react-simple-format,0.2.0,0.3.0,3,2,7,4,11,2,TRUE
moize,1.0.0,1.0.1,1,1,7,2,9,2,FALSE
moize,1.1.1,1.1.2,6,2,2108,90,2198,24,FALSE
moize,1.1.0,1.1.1,5,2,50,60,110,14,FALSE
moize,1.1.2,1.2.0,7,3,194,78,272,31,FALSE
moize,1.0.1,1.0.2,2,3,7,9,16,6,FALSE
moize,2.0.1,2.0.2,21,3,371,43,414,19,FALSE
moize,1.0.3,1.1.0,4,2,332,180,512,14,FALSE
moize,2.2.1,2.2.2,34,3,1177,624,1801,17,FALSE
moize,2.2.0,2.2.1,33,3,145,66,211,13,FALSE
moize,2.2.3,2.3.0,36,4,4894,3006,7900,50,FALSE
moize,2.2.2,2.2.3,35,8,5207,721,5928,47,FALSE
moize,2.1.2,2.1.3,28,2,3480,1114,4594,60,FALSE
moize,2.1.3,2.1.4,29,3,695,269,964,25,FALSE
moize,2.1.0,2.1.1,26,3,796,1164,1960,31,FALSE
moize,2.1.1,2.1.2,27,3,46,28,74,15,FALSE
moize,2.1.6,2.2.0,32,5,1335,1177,2512,46,FALSE
moize,2.1.4,2.1.5,30,2,76,26,102,14,FALSE
moize,2.1.5,2.1.6,31,4,372,767,1139,31,FALSE
moize,2.0.2,2.0.3-0,22,2,17,17,34,4,FALSE
moize,1.0.2,1.0.3,3,2,10,18,28,12,FALSE
moize,2.0.0,2.0.1,20,3,189,51,240,15,FALSE
moize,2.0.3,2.1.0,25,6,217,21,238,17,FALSE
moize,1.4.0,1.4.1,13,1,31,11,42,5,FALSE
moize,1.4.1,1.4.2,14,4,327,295,622,12,TRUE
moize,1.4.2,1.4.3,15,5,353,195,548,42,FALSE
moize,1.4.3,1.4.4,16,4,1501,621,2122,33,FALSE
moize,1.4.4,1.4.5,17,3,212,378,590,47,FALSE
moize,1.4.5,1.5.0,18,3,620,216,836,32,FALSE
moize,2.3.0,2.3.1,37,3,3974,702,4676,39,FALSE
moize,2.3.1,2.3.2,38,3,437,2116,2553,27,FALSE
moize,2.3.2,2.3.3,39,5,151,203,354,27,FALSE
moize,1.5.0,2.0.0,19,4,1791,1471,3262,68,FALSE
moize,1.3.3,1.4.0,12,2,534,318,852,24,FALSE
moize,1.3.2,1.3.3,11,2,394,234,628,26,FALSE
moize,1.3.1,1.3.2,10,2,124,170,294,30,FALSE
moize,1.3.0,1.3.1,9,1,9,6,15,5,FALSE
moize,1.2.0,1.3.0,8,7,599,87,686,34,FALSE
moize,2.0.3-1,2.0.3,24,3,90,29,119,15,FALSE
moize,2.0.3-0,2.0.3-1,23,2,4,3,7,4,FALSE
moize,1.4.1,1.4.2,14,4,327,295,622,12,FALSE
moize,1.3.3,1.4.0,12,2,534,318,852,24,TRUE
moize,2.1.0,2.1.1,26,3,796,1164,1960,31,TRUE
moize,1.5.0,2.0.0,19,4,1791,1471,3262,68,TRUE
moize,1.3.1,1.3.2,10,2,124,170,294,30,TRUE
moize,2.1.2,2.1.3,28,2,3480,1114,4594,60,TRUE
moize,1.3.2,1.3.3,11,2,394,234,628,26,TRUE
moize,1.1.1,1.1.2,6,2,2108,90,2198,24,TRUE
moize,1.4.3,1.4.4,16,4,1501,621,2122,33,TRUE
moize,1.2.0,1.3.0,8,7,599,87,686,34,TRUE
pokemongo-api,1.7.1,1.8.0,2,4,28,41,69,7,FALSE
pokemongo-api,1.8.0,1.8.1,3,1,1,0,1,1,FALSE
pokemongo-api,1.8.1,1.8.2,4,2,3,3,6,2,FALSE
pokemongo-api,1.8.2,1.8.3,5,11,3359,3512,6871,43,FALSE
pokemongo-api,1.7.0,1.7.1,1,7,26,26,52,9,FALSE
pokemongo-api,1.8.2,1.8.3,5,11,3359,3512,6871,43,TRUE
pokemongo-api,1.7.0,1.7.1,1,7,26,26,52,9,TRUE
postcss-autoreset,1.1.1,1.1.2,4,12,111,30,141,23,FALSE
postcss-autoreset,1.1.0,1.1.1,3,1,1,1,2,1,FALSE
postcss-autoreset,1.1.3,1.1.4,6,3,8,3,11,5,FALSE
postcss-autoreset,1.1.2,1.1.3,5,6,227,169,396,27,FALSE
postcss-autoreset,1.0.0,1.0.1,1,9,147,31,178,13,FALSE
postcss-autoreset,1.0.1,1.1.0,2,5,115,69,184,21,FALSE
postcss-autoreset,1.2.0,1.2.1,9,6,83,6,89,18,FALSE
postcss-autoreset,1.2.1,2.0.0,10,5,2780,507,3287,8,FALSE
postcss-autoreset,1.1.5,1.2.0,8,8,77,8,85,12,FALSE
postcss-autoreset,1.1.4,1.1.5,7,2,42,8,50,12,FALSE
postcss-autoreset,1.1.5,1.2.0,8,8,77,8,85,12,TRUE
npm-popular,1.0.4,1.0.5,15,9,129,60,189,19,FALSE
npm-popular,1.0.5,1.0.6,16,3,18,19,37,5,FALSE
npm-popular,1.0.0,1.0.1,11,1,3,1,4,1,FALSE
npm-popular,1.0.1,1.0.2,12,11,99,58,157,15,FALSE
npm-popular,1.0.2,1.0.3,13,2,7,5,12,2,FALSE
npm-popular,1.0.3,1.0.4,14,1,1,1,2,1,FALSE
npm-popular,0.3.0,0.3.1,9,2,3,3,6,3,FALSE
npm-popular,0.3.1,1.0.0,10,4,7,6,13,4,FALSE
npm-popular,0.2.5,0.3.0,8,15,266,253,519,25,FALSE
npm-popular,0.2.4,0.2.5,7,2,2,2,4,2,FALSE
npm-popular,0.2.3,0.2.4,6,6,11,9,20,7,FALSE
npm-popular,0.2.2,0.2.3,5,1,17,23,40,1,FALSE
npm-popular,0.2.1,0.2.2,4,1,17,23,40,1,TRUE
npm-popular,0.2.0,0.2.1,3,1,17,23,40,1,FALSE
npm-popular,0.1.1,0.1.2,1,2,2,2,4,2,FALSE
npm-popular,0.1.2,0.2.0,2,10,51,24,75,13,FALSE
npm-popular,0.3.1,1.0.0,10,4,7,6,13,4,TRUE
npm-popular,0.2.1,0.2.2,4,1,17,23,40,1,FALSE
write-up,12.3.0,12.3.1,27,2,9,3,12,3,FALSE
write-up,12.3.1,12.4.0,28,3,168,102,270,8,FALSE
write-up,3.1.0,3.2.0,10,12,223,54,277,22,FALSE
write-up,1.0.1,2.0.0,7,8,201,25,226,14,FALSE
write-up,3.0.0,3.1.0,9,9,131,35,166,12,FALSE
write-up,2.0.0,3.0.0,8,24,651,376,1027,101,FALSE
write-up,9.1.0,10.0.0,21,209,21870,17526,39396,1275,FALSE
write-up,9.0.0,9.1.0,20,13,696,448,1144,30,FALSE
write-up,23.0.0,24.0.0,47,49,1721,8028,9749,336,FALSE
write-up,14.0.0,15.0.0,35,53,1382,689,2071,85,FALSE
write-up,17.0.0,18.0.0,38,4,260,235,495,38,FALSE
write-up,6.0.0,7.0.0,17,63,1140,1091,2231,120,FALSE
write-up,13.0.2,14.0.0,34,23,2961,2708,5669,225,FALSE
write-up,13.0.0,13.0.1,32,28,734,390,1124,195,FALSE
write-up,13.0.1,13.0.2,33,4,92,34,126,8,FALSE
write-up,0.1.0,1.0.0-rc.1,1,13,1318,1338,2656,126,FALSE
write-up,34.0.0,34.0.1,62,2,6,8,14,5,FALSE
write-up,28.1.0,29.0.0,53,27,662,781,1443,75,FALSE
write-up,12.2.0,12.3.0,26,11,657,91,748,13,FALSE
write-up,4.0.1,4.1.0,14,21,1103,687,1790,26,FALSE
write-up,4.0.0,4.0.1,13,3,62,21,83,4,FALSE
write-up,4.1.0,5.0.0,15,86,2115,1802,3917,179,FALSE
write-up,33.0.1,34.0.0,61,4,21,20,41,8,FALSE
write-up,20.0.1,20.1.0,43,15,314,112,426,22,FALSE
write-up,28.0.0,28.1.0,52,7,50,22,72,12,FALSE
write-up,15.0.0,16.0.0,36,3,2010,2011,4021,164,FALSE
write-up,19.1.0,20.0.0,41,3,1983,1990,3973,347,FALSE
write-up,11.0.0,12.0.0,23,25,372,385,757,41,FALSE
write-up,25.0.0,26.0.0,49,36,882,682,1564,105,FALSE
write-up,27.0.0,28.0.0,51,8,69,180,249,19,FALSE
write-up,24.0.0,25.0.0,48,20,802,865,1667,230,FALSE
write-up,30.1.0,31.0.0,56,57,1983,2513,4496,134,FALSE
write-up,19.0.0,19.1.0,40,24,1831,1550,3381,29,FALSE
write-up,32.0.0,32.0.1,58,11,74,32,106,15,FALSE
write-up,20.1.0,21.0.0,44,13,15065,16564,31629,646,FALSE
write-up,22.0.0,23.0.0,46,73,2958,2917,5875,168,FALSE
write-up,21.0.0,22.0.0,45,31,7019,6919,13938,289,FALSE
write-up,1.0.0-rc.5,1.0.1,6,1,1,1,2,1,FALSE
write-up,1.0.0-rc.4,1.0.0-rc.5,5,11,428,67,495,13,FALSE
write-up,1.0.0-rc.3,1.0.0-rc.4,4,18,615,121,736,28,FALSE
write-up,1.0.0-rc.2,1.0.0-rc.3,3,157,5316,1658,6974,271,FALSE
write-up,26.0.0,27.0.0,50,9,148,66,214,15,FALSE
write-up,29.0.0,30.0.0,54,5,122,115,237,26,FALSE
write-up,31.0.0,32.0.0,57,32,3328,2577,5905,293,TRUE
write-up,5.0.0,6.0.0,16,38,872,496,1368,76,FALSE
write-up,12.6.0,13.0.0,31,47,1761,2106,3867,113,FALSE
write-up,7.0.0,8.0.0,18,123,6366,5071,11437,610,FALSE
write-up,16.0.0,17.0.0,37,13,305,314,619,79,FALSE
write-up,33.0.0,33.0.1,60,8,91,105,196,17,FALSE
write-up,8.0.0,9.0.0,19,3,2,30,32,3,FALSE
write-up,18.0.0,19.0.0,39,38,1881,1544,3425,199,FALSE
write-up,20.0.0,20.0.1,42,7,251,114,365,13,FALSE
write-up,3.3.0,4.0.0,12,29,1275,128,1403,41,FALSE
write-up,12.1.0,12.2.0,25,84,2540,1312,3852,171,FALSE
write-up,12.4.0,12.5.0,29,9,362,53,415,43,FALSE
write-up,3.2.0,3.3.0,11,83,3936,2508,6444,184,FALSE
write-up,10.0.0,11.0.0,22,29,2782,2641,5423,317,FALSE
write-up,12.0.0,12.1.0,24,4,24,22,46,5,FALSE
write-up,32.0.1,33.0.0,59,2,74,75,149,13,FALSE
write-up,30.0.0,30.1.0,55,4,15,14,29,7,FALSE
write-up,1.0.0-rc.1,1.0.0-rc.2,2,2,32,17,49,4,FALSE
write-up,12.5.0,12.6.0,30,29,1202,436,1638,49,FALSE
write-up,2.0.0,3.0.0,8,24,651,376,1027,101,TRUE
write-up,9.1.0,10.0.0,21,209,21870,17526,39396,1275,TRUE
write-up,9.0.0,9.1.0,20,13,696,448,1144,30,TRUE
write-up,23.0.0,24.0.0,47,49,1721,8028,9749,336,TRUE
write-up,14.0.0,15.0.0,35,53,1382,689,2071,85,TRUE
write-up,6.0.0,7.0.0,17,63,1140,1091,2231,120,TRUE
write-up,13.0.2,14.0.0,34,23,2961,2708,5669,225,TRUE
write-up,13.0.0,13.0.1,32,28,734,390,1124,195,TRUE
write-up,13.0.1,13.0.2,33,4,92,34,126,8,TRUE
write-up,28.1.0,29.0.0,53,27,662,781,1443,75,TRUE
write-up,12.2.0,12.3.0,26,11,657,91,748,13,TRUE
write-up,4.1.0,5.0.0,15,86,2115,1802,3917,179,TRUE
write-up,20.0.1,20.1.0,43,15,314,112,426,22,TRUE
write-up,28.0.0,28.1.0,52,7,50,22,72,12,TRUE
write-up,11.0.0,12.0.0,23,25,372,385,757,41,TRUE
write-up,25.0.0,26.0.0,49,36,882,682,1564,105,TRUE
write-up,24.0.0,25.0.0,48,20,802,865,1667,230,TRUE
write-up,30.1.0,31.0.0,56,57,1983,2513,4496,134,TRUE
write-up,19.0.0,19.1.0,40,24,1831,1550,3381,29,TRUE
write-up,32.0.0,32.0.1,58,11,74,32,106,15,TRUE
write-up,20.1.0,21.0.0,44,13,15065,16564,31629,646,TRUE
write-up,22.0.0,23.0.0,46,73,2958,2917,5875,168,TRUE
write-up,21.0.0,22.0.0,45,31,7019,6919,13938,289,TRUE
write-up,1.0.0-rc.3,1.0.0-rc.4,4,18,615,121,736,28,TRUE
write-up,1.0.0-rc.2,1.0.0-rc.3,3,157,5316,1658,6974,271,TRUE
write-up,26.0.0,27.0.0,50,9,148,66,214,15,TRUE
write-up,29.0.0,30.0.0,54,5,122,115,237,26,TRUE
write-up,12.6.0,13.0.0,31,47,1761,2106,3867,113,TRUE
write-up,7.0.0,8.0.0,18,123,6366,5071,11437,610,TRUE
write-up,16.0.0,17.0.0,37,13,305,314,619,79,TRUE
write-up,33.0.0,33.0.1,60,8,91,105,196,17,TRUE
write-up,18.0.0,19.0.0,39,38,1881,1544,3425,199,TRUE
write-up,20.0.0,20.0.1,42,7,251,114,365,13,TRUE
write-up,3.3.0,4.0.0,12,29,1275,128,1403,41,TRUE
write-up,12.1.0,12.2.0,25,84,2540,1312,3852,171,TRUE
write-up,3.2.0,3.3.0,11,83,3936,2508,6444,184,TRUE
write-up,10.0.0,11.0.0,22,29,2782,2641,5423,317,TRUE
write-up,32.0.1,33.0.0,59,2,74,75,149,13,TRUE
write-up,30.0.0,30.1.0,55,4,15,14,29,7,TRUE
write-up,12.5.0,12.6.0,30,29,1202,436,1638,49,TRUE
write-up,31.0.0,32.0.0,57,32,3328,2577,5905,293,FALSE
node-project-template,1.4.0,1.4.3,3,13,366,87,453,56,FALSE
node-project-template,1.1.0,1.3.0,1,3,130,49,179,15,FALSE
node-project-template,1.4.3,1.4.5,4,12,7099,6908,14007,54,FALSE
node-project-template,1.4.5,2.1.0,5,14,235,173,408,38,FALSE
node-project-template,1.3.0,1.4.0,2,2,112,67,179,19,FALSE
node-project-template,2.1.0,2.1.1,6,15,1117,1167,2284,123,FALSE
node-project-template,2.1.1,2.1.2,7,1,11336,7623,18959,4,FALSE
node-project-template,1.3.0,1.4.0,2,2,112,67,179,19,TRUE
node-project-template,1.4.5,2.1.0,5,14,235,173,408,38,TRUE
cubbie,1.1.1,1.1.2,26,8,145,73,218,16,FALSE
cubbie,1.1.0,1.1.1,25,2,121,7,128,4,FALSE
cubbie,1.1.3,1.1.4,28,2,3,3,6,3,FALSE
cubbie,1.1.2,1.1.3,27,3,49,12,61,5,FALSE
cubbie,1.0.0,1.1.0,24,3,5,4,9,3,FALSE
cubbie,1.1.4,1.1.5,29,4,588,70,658,12,FALSE
cubbie,1.1.7,1.1.8,32,4,6,5,11,4,FALSE
cubbie,1.1.6,1.1.7,31,2,7,16,23,14,FALSE
cubbie,1.1.9,1.2.0,34,2,23,3,26,3,FALSE
cubbie,1.1.8,1.1.9,33,1,3,1,4,2,FALSE
cubbie,0.0.12,0.0.13,12,2,43,23,66,5,FALSE
cubbie,0.0.15,0.0.16,15,6,208,54,262,18,FALSE
cubbie,0.0.14,0.0.15,14,3,540,463,1003,9,FALSE
cubbie,0.0.17,0.0.18,17,3,158,12,170,10,FALSE
cubbie,0.0.16,0.0.17,16,3,37,10,47,8,FALSE
cubbie,0.0.13,0.0.14,13,3,1142,1108,2250,14,FALSE
cubbie,0.2.0,0.3.0,20,2,747,475,1222,7,FALSE
cubbie,0.1.0,0.2.0,19,2,854,855,1709,7,FALSE
cubbie,1.1.5,1.1.6,30,4,9403,1457,10860,17,FALSE
cubbie,0.0.18,0.1.0,18,2,229,1394,1623,8,FALSE
cubbie,2.0.1,3.0.0,39,4,174,34,208,11,FALSE
cubbie,0.3.0,0.4.0,21,2,3952,1833,5785,17,FALSE
cubbie,2.0.0,2.0.1,38,10,85,60,145,16,FALSE
cubbie,3.0.0,3.1.0,40,3,144,36,180,7,FALSE
cubbie,0.4.1,1.0.0,23,7,864,1410,2274,40,FALSE
cubbie,0.4.0,0.4.1,22,13,1133,868,2001,39,FALSE
cubbie,1.3.0,2.0.0,37,4,2056,1729,3785,26,FALSE
cubbie,1.2.0,1.2.1,35,3,745,732,1477,5,FALSE
cubbie,1.2.1,1.3.0,36,9,1927,1645,3572,18,FALSE
cubbie,0.0.5,0.0.6,5,2,182,52,234,10,FALSE
cubbie,0.0.4,0.0.5,4,1,4885,27,4912,9,FALSE
cubbie,0.0.7,0.0.8,7,2,116,303,419,5,FALSE
cubbie,0.0.6,0.0.7,6,2,523,238,761,7,FALSE
cubbie,0.0.3,0.0.4,3,2,15,9,24,4,FALSE
cubbie,0.0.9,0.0.10,9,2,19,7,26,4,FALSE
cubbie,0.0.8,0.0.9,8,2,3146,299,3445,8,FALSE
cubbie,0.0.10,0.0.11,10,2,80,84,164,4,FALSE
cubbie,0.0.17,0.0.18,17,3,158,12,170,10,TRUE
cubbie,0.0.11,0.0.12,11,4,15546,6488,22034,9,FALSE
cubbie,0.0.1,0.0.2,1,1,7,4,11,3,FALSE
cubbie,0.0.2,0.0.3,2,3,1311,9,1320,8,FALSE
cubbie,0.0.8,0.0.9,8,2,3146,299,3445,8,TRUE
cubbie,3.0.0,3.1.0,40,3,144,36,180,7,TRUE
cubbie,0.0.6,0.0.7,6,2,523,238,761,7,TRUE
cubbie,1.1.5,1.1.6,30,4,9403,1457,10860,17,TRUE
cubbie,1.1.7,1.1.8,32,4,6,5,11,4,TRUE
cubbie,0.0.12,0.0.13,12,2,43,23,66,5,TRUE
angular2-config-generator,1.0.4,1.0.5,5,3,31,4,35,5,FALSE
angular2-config-generator,1.0.5,2.0.0,6,11,283,75,358,35,FALSE
angular2-config-generator,1.0.0,1.0.1,1,3,10,4,14,3,FALSE
angular2-config-generator,1.0.1,1.0.2,2,7,12,7,19,8,FALSE
angular2-config-generator,1.0.2,1.0.3,3,3,5,15,20,3,FALSE
angular2-config-generator,1.0.3,1.0.4,4,3,31,31,62,3,FALSE
angular2-config-generator,2.3.0,2.3.1,16,2,2,2,4,2,FALSE
angular2-config-generator,2.3.1,2.3.2,17,3,4,2,6,4,FALSE
angular2-config-generator,2.0.0,2.1.0,7,2,73,44,117,7,FALSE
angular2-config-generator,2.2.1,2.2.2,13,2,3,2,5,2,TRUE
angular2-config-generator,2.2.0,2.2.1,12,2,3,3,6,2,FALSE
angular2-config-generator,2.2.3,2.3.0,15,12,218,283,501,40,FALSE
angular2-config-generator,2.2.2,2.2.3,14,2,16,16,32,3,FALSE
angular2-config-generator,2.1.2,2.1.3,10,2,2,2,4,2,FALSE
angular2-config-generator,2.1.3,2.2.0,11,2,139,4,143,12,FALSE
angular2-config-generator,2.1.0,2.1.1,8,2,1,3,4,2,FALSE
angular2-config-generator,2.1.1,2.1.2,9,2,2,2,4,2,FALSE
angular2-config-generator,2.2.1,2.2.2,13,2,3,2,5,2,FALSE
angular2-config-generator,2.2.2,2.2.3,14,2,16,16,32,3,TRUE
legofy,0.1.5,0.1.6,5,5,22,10,32,5,FALSE
legofy,0.1.8,0.1.9,8,1,4,5,9,3,FALSE
legofy,0.1.7,0.1.8,7,6,9,7,16,6,FALSE
legofy,0.1.10,0.1.11,10,5,15,11,26,8,FALSE
legofy,0.1.9,0.1.10,9,1,225,212,437,7,FALSE
legofy,0.1.4,0.1.5,4,12,51,40,91,15,FALSE
legofy,0.1.6,0.1.7,6,27,365,88,453,41,FALSE
legofy,0.1.1,0.1.2,1,6,272,25,297,20,FALSE
legofy,0.1.2,0.1.3,2,12,88,74,162,18,FALSE
legofy,0.1.3,0.1.4,3,11,77,24,101,19,FALSE
legofy,0.1.10,0.1.11,10,5,15,11,26,8,TRUE
draftjs-to-html,0.3.1,0.3.2,21,1,5,4,9,4,FALSE
draftjs-to-html,0.3.6,0.3.7,26,1,15,10,25,5,FALSE
draftjs-to-html,0.2.7,0.2.8,18,1,15,16,31,3,FALSE
draftjs-to-html,0.2.6,0.2.7,17,1,5,5,10,4,FALSE
draftjs-to-html,0.2.5,0.2.6,16,1,33,24,57,4,FALSE
draftjs-to-html,0.2.4,0.2.5,15,1,5,5,10,4,FALSE
draftjs-to-html,0.2.3,0.2.4,14,1,34,34,68,3,FALSE
draftjs-to-html,0.2.2,0.2.3,13,1,24,17,41,3,FALSE
draftjs-to-html,0.2.1,0.2.2,12,5,146,35,181,11,FALSE
draftjs-to-html,0.2.0,0.2.1,11,3,41,42,83,8,FALSE
draftjs-to-html,0.1.0,0.1.1,1,4,39,38,77,4,FALSE
draftjs-to-html,0.1.1,0.1.2,2,1,5,5,10,4,FALSE
draftjs-to-html,0.1.2,0.1.3,3,1,5,5,10,4,FALSE
draftjs-to-html,0.1.3,0.1.4,4,1,5,5,10,4,FALSE
draftjs-to-html,0.1.4,0.1.5,5,1,5,5,10,4,FALSE
draftjs-to-html,0.1.5,0.1.6,6,1,5,5,10,4,FALSE
draftjs-to-html,0.1.6,0.1.7,7,1,5,5,10,4,FALSE
draftjs-to-html,0.2.8,0.3.0,19,2,31,9,40,6,FALSE
draftjs-to-html,0.3.8,0.3.9,28,1,17,12,29,6,FALSE
draftjs-to-html,0.3.9,0.4.0,29,1,25,26,51,4,FALSE
draftjs-to-html,0.6.3,0.7.0,41,7,22,22,44,10,FALSE
draftjs-to-html,0.3.3,0.3.4,23,2,15,14,29,4,FALSE
draftjs-to-html,0.3.0,0.3.1,20,1,3754,75,3829,15,FALSE
draftjs-to-html,0.6.0,0.6.1,38,5,1061,1061,2122,20,FALSE
draftjs-to-html,0.3.7,0.3.8,27,1,4,4,8,4,FALSE
draftjs-to-html,0.3.4,0.3.5,24,1,5,5,10,4,FALSE
draftjs-to-html,0.3.5,0.3.6,25,1,13,8,21,5,FALSE
draftjs-to-html,0.4.1,0.4.2,31,1,4,4,8,4,FALSE
draftjs-to-html,0.4.0,0.4.1,30,3,123,67,190,10,FALSE
draftjs-to-html,0.4.3,0.4.4,33,2,11,15,26,7,FALSE
draftjs-to-html,0.1.7,0.1.8,8,1,5,5,10,4,FALSE
draftjs-to-html,0.5.0,0.5.1,36,4,291,593,884,13,FALSE
draftjs-to-html,0.5.1,0.6.0,37,6,710,1240,1950,22,FALSE
draftjs-to-html,0.6.2,0.6.3,40,1,5,5,10,4,FALSE
draftjs-to-html,0.1.8,0.1.9,9,1,5,5,10,4,FALSE
draftjs-to-html,0.4.2,0.4.3,32,3,11,11,22,10,FALSE
draftjs-to-html,0.1.9,0.2.0,10,1,5,5,10,4,FALSE
draftjs-to-html,0.4.5,0.5.0,35,2,591,465,1056,13,FALSE
draftjs-to-html,0.4.4,0.4.5,34,1,5,5,10,4,FALSE
draftjs-to-html,0.3.2,0.3.3,22,3,111,95,206,9,FALSE
draftjs-to-html,0.7.0,0.7.1,42,1,5,5,10,4,FALSE
draftjs-to-html,0.7.1,0.7.2,43,3,5,5,10,5,FALSE
draftjs-to-html,0.6.1,0.6.2,39,2,31,13,44,7,FALSE
draftjs-to-html,0.3.0,0.3.1,20,1,3754,75,3829,15,TRUE
draftjs-to-html,0.6.2,0.6.3,40,1,5,5,10,4,TRUE
draftjs-to-html,0.1.0,0.1.1,1,4,39,38,77,4,TRUE
draftjs-to-html,0.3.8,0.3.9,28,1,17,12,29,6,TRUE
draftjs-to-html,0.5.1,0.6.0,37,6,710,1240,1950,22,TRUE
draftjs-to-html,0.4.1,0.4.2,31,1,4,4,8,4,TRUE
draftjs-to-html,0.4.2,0.4.3,32,3,11,11,22,10,TRUE
draftjs-to-html,0.2.7,0.2.8,18,1,15,16,31,3,TRUE
draftjs-to-html,0.2.2,0.2.3,13,1,24,17,41,3,TRUE
draftjs-to-html,0.3.2,0.3.3,22,3,111,95,206,9,TRUE
draftjs-to-html,0.4.0,0.4.1,30,3,123,67,190,10,TRUE
draftjs-to-html,0.2.1,0.2.2,12,5,146,35,181,11,TRUE
draftjs-to-html,0.7.0,0.7.1,42,1,5,5,10,4,TRUE
javascript-obfuscator,0.9.0-dev.2,0.9.0-dev.3,46,18,4267,3380,7647,192,FALSE
javascript-obfuscator,0.9.0-beta.1,0.9.0-beta.2,40,15,1495,1029,2524,84,FALSE
javascript-obfuscator,0.9.0-dev.10,0.9.0-dev.11,54,9,5865,2174,8039,197,FALSE
javascript-obfuscator,0.9.0-dev.4,0.9.0-dev.5,48,6,1231,1018,2249,65,FALSE
javascript-obfuscator,0.9.0-dev.3,0.9.0-dev.4,47,6,873,495,1368,26,FALSE
javascript-obfuscator,0.9.0-dev.8,0.9.0-dev.9,52,9,3357,2822,6179,381,FALSE
javascript-obfuscator,0.9.0-dev.5,0.9.0-dev.6,49,11,2001,1125,3126,63,FALSE
javascript-obfuscator,0.9.0-dev.9,0.9.0-dev.10,53,12,1507,1283,2790,149,FALSE
javascript-obfuscator,0.9.0-dev.6,0.9.0-dev.7,50,14,1988,1233,3221,85,FALSE
javascript-obfuscator,0.9.0-dev.7,0.9.0-dev.8,51,11,4139,3057,7196,86,FALSE
javascript-obfuscator,0.9.0-dev.11,0.9.0,55,56,7435,6605,14040,337,FALSE
javascript-obfuscator,0.8.0-dev.4,0.8.0,32,23,3943,3482,7425,195,FALSE
javascript-obfuscator,0.9.0-beta.2,0.9.0-beta.3,41,16,2190,1027,3217,89,FALSE
javascript-obfuscator,0.9.0-beta.3,0.9.0-beta.4,42,11,2526,3494,6020,94,FALSE
javascript-obfuscator,0.9.0-beta.4,0.9.0-beta.5,43,6,307,209,516,17,FALSE
javascript-obfuscator,0.8.0-dev.3,0.8.0-dev.4,31,1,17,19,36,5,FALSE
javascript-obfuscator,0.7.2,0.7.3,27,17,3351,1989,5340,236,FALSE
javascript-obfuscator,0.7.3,0.8.0-beta.1,28,101,249214,11849,261063,870,FALSE
javascript-obfuscator,0.7.0,0.7.1,25,24,2583,1496,4079,138,FALSE
javascript-obfuscator,0.7.1,0.7.2,26,29,2349,1872,4221,225,FALSE
javascript-obfuscator,0.10.0-beta.1,0.10.0-beta.2,61,1,219,91,310,16,FALSE
javascript-obfuscator,0.7.0-dev.1,0.7.0-dev.2,22,2,101,20,121,7,FALSE
javascript-obfuscator,0.7.0-dev.2,0.7.0-dev.3,23,5,206,166,372,13,FALSE
javascript-obfuscator,0.7.0-dev.3,0.7.0,24,4,10,12,22,4,FALSE
javascript-obfuscator,0.9.0,0.9.1,56,3,995,1711,2706,8,FALSE
javascript-obfuscator,0.9.1,0.9.2,57,10,1702,1711,3413,25,FALSE
javascript-obfuscator,0.9.2,0.9.3,58,1,140,22,162,12,FALSE
javascript-obfuscator,0.9.3,0.9.4,59,1,26,110,136,5,FALSE
javascript-obfuscator,0.8.5,0.8.6,38,2,146,79,225,12,FALSE
javascript-obfuscator,0.8.4,0.8.5,37,6,252,214,466,52,FALSE
javascript-obfuscator,0.8.6,0.9.0-beta.1,39,14,6717,2902,9619,265,FALSE
javascript-obfuscator,0.8.1,0.8.2,34,13,4348,3056,7404,174,FALSE
javascript-obfuscator,0.8.0,0.8.1,33,1,11,5,16,4,FALSE
javascript-obfuscator,0.8.3,0.8.4,36,135,45164,33951,79115,1728,FALSE
javascript-obfuscator,0.8.2,0.8.3,35,60,25391,18364,43755,916,FALSE
javascript-obfuscator,0.9.0-dev.1,0.9.0-dev.2,45,40,11418,9963,21381,367,FALSE
javascript-obfuscator,0.8.0-beta.1,0.8.0-beta.2,29,3,639,360,999,13,FALSE
javascript-obfuscator,0.9.0-beta.1,0.9.0-beta.2,40,15,1495,1029,2524,84,TRUE
javascript-obfuscator,0.6.2,0.7.0-dev.1,21,4,9,9,18,5,FALSE
javascript-obfuscator,0.6.1,0.6.2-beta.0,19,29,3040,2567,5607,150,FALSE
javascript-obfuscator,0.6.2-beta.0,0.6.2,20,1,219,91,310,16,FALSE
javascript-obfuscator,0.9.0-dev.3,0.9.0-dev.4,47,6,873,495,1368,26,TRUE
javascript-obfuscator,0.9.0-dev.2,0.9.0-dev.3,46,18,4267,3380,7647,192,TRUE
javascript-obfuscator,0.2.1,0.3.0,8,6,76,175,251,19,FALSE
javascript-obfuscator,0.2.0,0.2.1,7,1,3531,6,3537,10,FALSE
javascript-obfuscator,0.1.0,0.1.1,2,1,14,6,20,2,FALSE
javascript-obfuscator,0.1.1,0.1.2,3,4,8,929,937,47,FALSE
javascript-obfuscator,0.1.2,0.1.3,4,2,5,4,9,2,FALSE
javascript-obfuscator,0.1.3,0.1.4,5,3,905,3,908,24,FALSE
javascript-obfuscator,0.1.4,0.2.0,6,21,4735,5292,10027,211,FALSE
javascript-obfuscator,0.3.0,0.4.0,9,58,5475,4681,10156,467,FALSE
javascript-obfuscator,0.6.0,0.6.1,18,159,18327,18272,36599,695,FALSE
javascript-obfuscator,0.5.4,0.6.0,17,62,13410,11895,25305,341,FALSE
javascript-obfuscator,0.4.0,0.4.2,10,1,10,1,11,1,FALSE
javascript-obfuscator,0.4.3,0.5.0,12,2,77,46,123,20,FALSE
javascript-obfuscator,0.4.2,0.4.3,11,5,199,47,246,51,FALSE
javascript-obfuscator,0.5.0,0.5.1,13,1,5,7,12,5,FALSE
javascript-obfuscator,0.5.1,0.5.2,14,46,1059,569,1628,214,FALSE
javascript-obfuscator,0.5.2,0.5.3,15,2,43,39,82,4,FALSE
javascript-obfuscator,0.5.3,0.5.4,16,3,5,5,10,3,FALSE
javascript-obfuscator,0.7.0-dev.2,0.7.0-dev.3,23,5,206,166,372,13,TRUE
javascript-obfuscator,0.7.1,0.7.2,26,29,2349,1872,4221,225,TRUE
javascript-obfuscator,0.7.2,0.7.3,27,17,3351,1989,5340,236,TRUE
javascript-obfuscator,0.7.0,0.7.1,25,24,2583,1496,4079,138,TRUE
javascript-obfuscator,0.10.0-beta.1,0.10.0-beta.2,61,1,219,91,310,16,TRUE
javascript-obfuscator,0.7.0-dev.1,0.7.0-dev.2,22,2,101,20,121,7,TRUE
javascript-obfuscator,0.7.0-dev.3,0.7.0,24,4,10,12,22,4,TRUE
javascript-obfuscator,0.0.9,0.1.0,1,1,4,1,5,1,FALSE
javascript-obfuscator,0.9.0-beta.2,0.9.0-beta.3,41,16,2190,1027,3217,89,TRUE
javascript-obfuscator,0.6.1,0.6.2-beta.0,19,29,3040,2567,5607,150,TRUE
javascript-obfuscator,0.9.1,0.9.2,57,10,1702,1711,3413,25,TRUE
javascript-obfuscator,0.9.0-dev.4,0.9.0-dev.5,48,6,1231,1018,2249,65,TRUE
atomic-style,0.3.1,0.3.2,1,3,4,5,9,4,TRUE
react-rte,0.1.8,0.1.9,9,13,129,16,145,17,FALSE
react-rte,0.1.9,0.1.10,10,7,128,28,156,12,FALSE
react-rte,0.2.0,0.3.0,17,3,14,15,29,4,FALSE
react-rte,0.1.0,0.1.1,1,1,2,1,3,2,FALSE
react-rte,0.1.1,0.1.2,2,25,2707,461,3168,66,FALSE
react-rte,0.1.2,0.1.3,3,1,2,1,3,2,FALSE
react-rte,0.1.3,0.1.4,4,6,295,20,315,17,FALSE
react-rte,0.1.4,0.1.5,5,4,10,0,10,4,FALSE
react-rte,0.1.5,0.1.6,6,44,2891,819,3710,122,FALSE
react-rte,0.1.6,0.1.7,7,20,321,149,470,38,FALSE
react-rte,0.1.7,0.1.8,8,11,52,2054,2106,33,FALSE
react-rte,0.10.1,0.11.0,27,10,56,38,94,16,FALSE
react-rte,0.10.0,0.10.1,26,5,55,17,72,8,FALSE
react-rte,0.3.0,0.4.0,18,6,31,15,46,8,FALSE
react-rte,0.6.0,0.7.0,21,7,36,21,57,8,FALSE
react-rte,0.7.0,0.8.0,22,2,86,25,111,6,FALSE
react-rte,0.4.0,0.5.0,19,3,13,9,22,6,FALSE
react-rte,0.5.0,0.6.0,20,15,210,91,301,38,FALSE
react-rte,0.9.0,0.10.0,25,8,84,31,115,10,FALSE
react-rte,0.8.1,0.9.0,24,2,32,7,39,4,FALSE
react-rte,0.8.0,0.8.1,23,3,13,9,22,6,FALSE
react-rte,0.1.13,0.1.14,13,2,2,2,4,2,FALSE
react-rte,0.1.10,0.1.11,11,12,326,226,552,51,FALSE
react-rte,0.1.11,0.1.13,12,29,267,84,351,30,FALSE
react-rte,0.1.16,0.2.0,16,4,46,12,58,6,FALSE
react-rte,0.1.14,0.1.15,14,4,89,63,152,16,FALSE
react-rte,0.1.15,0.1.16,15,3,7,8,15,3,FALSE
react-rte,0.1.1,0.1.2,2,25,2707,461,3168,66,TRUE
react-rte,0.1.16,0.2.0,16,4,46,12,58,6,TRUE
react-rte,0.1.6,0.1.7,7,20,321,149,470,38,TRUE
react-rte,0.1.7,0.1.8,8,11,52,2054,2106,33,TRUE
react-rte,0.1.10,0.1.11,11,12,326,226,552,51,TRUE
react-rte,0.1.15,0.1.16,15,3,7,8,15,3,TRUE
react-rte,0.2.0,0.3.0,17,3,14,15,29,4,TRUE
react-rte,0.1.11,0.1.13,12,29,267,84,351,30,TRUE
react-rte,0.1.14,0.1.15,14,4,89,63,152,16,TRUE
react-rte,0.3.0,0.4.0,18,6,31,15,46,8,TRUE
react-rte,0.5.0,0.6.0,20,15,210,91,301,38,TRUE
html-webpack-plugin,2.15.0,2.16.0,42,10,190,51,241,19,FALSE
html-webpack-plugin,2.14.0,2.15.0,41,9,2908,156,3064,204,FALSE
html-webpack-plugin,2.18.0,2.19.0,47,2,17,1,18,5,FALSE
html-webpack-plugin,2.19.0,2.20.0,48,3,233,15,248,19,FALSE
html-webpack-plugin,2.13.0,2.14.0,40,1,5,5,10,2,FALSE
html-webpack-plugin,2.25.0,2.26.0,56,3,3715,13,3728,8,FALSE
html-webpack-plugin,2.11.0,2.12.0,38,4,173,19,192,10,FALSE
html-webpack-plugin,2.22.0,2.23.0,52,14,256,39,295,20,FALSE
html-webpack-plugin,2.12.0,2.13.0,39,5,454,12,466,25,FALSE
html-webpack-plugin,2.23.0,2.24.0,53,1,19,13,32,2,FALSE
html-webpack-plugin,2.20.0,2.21.0,49,5,212,40,252,18,FALSE
html-webpack-plugin,2.21.1,2.22.0,51,3,642,611,1253,32,FALSE
html-webpack-plugin,2.21.0,2.21.1,50,4,113,34,147,7,FALSE
html-webpack-plugin,2.27.1,2.28.0,59,1,6,3,9,3,FALSE
html-webpack-plugin,2.9.0,2.10.0,36,19,334,42,376,38,FALSE
html-webpack-plugin,2.26.0,2.27.0,57,12,27,8,35,13,FALSE
html-webpack-plugin,2.10.0,2.11.0,37,9,416,36,452,14,FALSE
html-webpack-plugin,2.8.2,2.9.0,35,8,102,43,145,13,FALSE
html-webpack-plugin,2.8.1,2.8.2,34,6,34,11,45,7,FALSE
html-webpack-plugin,2.8.0,2.8.1,33,1,21,10,31,2,FALSE
html-webpack-plugin,2.24.0,2.24.1,54,3,22,18,40,7,FALSE
html-webpack-plugin,2.24.1,2.25.0,55,10,39,21,60,13,FALSE
html-webpack-plugin,2.17.0,2.18.0,46,1,7,7,14,1,FALSE
html-webpack-plugin,2.27.0,2.27.1,58,1,5,5,10,2,FALSE
html-webpack-plugin,2.16.1,2.16.2,44,4,16,7,23,10,FALSE
html-webpack-plugin,2.16.0,2.16.1,43,9,134,83,217,24,FALSE
html-webpack-plugin,2.16.2,2.17.0,45,3,82,78,160,37,FALSE
html-webpack-plugin,2.6.4,2.6.5,29,1,15,27,42,2,FALSE
html-webpack-plugin,2.7.1,2.7.2,31,2,143,3,146,16,FALSE
html-webpack-plugin,2.6.1,2.6.2,26,10,70,22,92,14,FALSE
html-webpack-plugin,2.6.0,2.6.1,25,1,5,5,10,2,FALSE
html-webpack-plugin,2.6.3,2.6.4,28,5,22,4,26,6,FALSE
html-webpack-plugin,2.6.2,2.6.3,27,4,1232,22,1254,43,FALSE
html-webpack-plugin,2.6.5,2.7.1,30,5,2734,828,3562,142,FALSE
html-webpack-plugin,2.7.2,2.8.0,32,13,541,175,716,25,FALSE
html-webpack-plugin,2.0.4,2.1.0,19,16,178,44,222,27,FALSE
html-webpack-plugin,2.0.3,2.0.4,18,13,81,31,112,16,FALSE
html-webpack-plugin,2.0.2,2.0.3,17,10,81,18,99,13,FALSE
html-webpack-plugin,2.2.0,2.3.0,21,1,198,13,211,4,FALSE
html-webpack-plugin,2.1.0,2.2.0,20,5,216,39,255,22,FALSE
html-webpack-plugin,1.6.2,1.7.0,15,17,224,43,267,27,FALSE
html-webpack-plugin,1.6.0,1.6.1,13,7,31,29,60,8,TRUE
html-webpack-plugin,1.6.1,1.6.2,14,63,1124,610,1734,152,FALSE
html-webpack-plugin,1.4.0,1.5.0,9,20,164,46,210,25,FALSE
html-webpack-plugin,2.3.0,2.4.0,22,2,83,117,200,26,FALSE
html-webpack-plugin,1.5.1,1.5.2,11,1,2,2,4,1,FALSE
html-webpack-plugin,1.5.0,1.5.1,10,5,10,8,18,5,FALSE
html-webpack-plugin,1.5.2,1.6.0,12,5,56,9,65,12,FALSE
html-webpack-plugin,1.3.0,1.4.0,8,16,911,348,1259,49,FALSE
html-webpack-plugin,1.2.0,1.3.0,7,14,476,66,542,27,FALSE
html-webpack-plugin,2.4.0,2.5.0,23,9,71,28,99,11,FALSE
html-webpack-plugin,2.5.0,2.6.0,24,1,155,98,253,11,FALSE
html-webpack-plugin,2.24.0,2.24.1,54,3,22,18,40,7,TRUE
html-webpack-plugin,2.16.0,2.16.1,43,9,134,83,217,24,TRUE
html-webpack-plugin,1.6.0,1.6.1,13,7,31,29,60,8,FALSE
html-webpack-plugin,2.12.0,2.13.0,39,5,454,12,466,25,TRUE
html-webpack-plugin,2.16.2,2.17.0,45,3,82,78,160,37,TRUE
html-webpack-plugin,2.7.1,2.7.2,31,2,143,3,146,16,TRUE
html-webpack-plugin,1.1.0,1.2.0,6,25,746,147,893,62,FALSE
html-webpack-plugin,1.0.0,1.0.1,4,2,45,25,70,3,FALSE
html-webpack-plugin,1.0.1,1.1.0,5,4,81,23,104,6,FALSE
html-webpack-plugin,0.2.0,0.4.0,2,6,116,38,154,14,FALSE
html-webpack-plugin,0.1.0,0.2.0,1,1,5,5,10,2,FALSE
html-webpack-plugin,0.4.0,1.0.0,3,1,1,1,2,1,FALSE
html-webpack-plugin,2.1.0,2.2.0,20,5,216,39,255,22,TRUE
html-webpack-plugin,1.0.0,1.0.1,4,2,45,25,70,3,TRUE
html-webpack-plugin,1.3.0,1.4.0,8,16,911,348,1259,49,TRUE
html-webpack-plugin,2.5.0,2.6.0,24,1,155,98,253,11,TRUE
html-webpack-plugin,2.8.1,2.8.2,34,6,34,11,45,7,TRUE
redux-react-starter,1.1.0,1.1.2,3,4,467,388,855,24,FALSE
redux-react-starter,1.1.2,1.2.0,4,5,1134,784,1918,22,FALSE
redux-react-starter,1.0.0,1.1.0,2,27,1930,764,2694,115,FALSE
redux-react-starter,1.1.2,1.2.0,4,5,1134,784,1918,22,TRUE
redux-react-starter,1.0.0,1.1.0,2,27,1930,764,2694,115,TRUE
airborne,0.11.3,0.11.4,32,1,5,9,14,2,FALSE
airborne,0.6.0,0.6.1,13,7,429,1820,2249,31,FALSE
airborne,0.11.0,0.11.1,29,4,80,109,189,7,FALSE
airborne,0.11.1,0.11.2,30,1,5,9,14,2,FALSE
airborne,0.6.5,0.6.6,18,2,313,60,373,10,FALSE
airborne,0.5.16,0.6.0,12,8,1806,1512,3318,116,FALSE
airborne,0.11.5,0.11.6,34,2,30,21,51,7,FALSE
airborne,0.5.15,0.5.16,11,1,19,8,27,6,FALSE
airborne,0.5.12,0.5.13,9,1,62,7,69,9,FALSE
airborne,0.5.13,0.5.15,10,2,234,112,346,16,FALSE
airborne,0.5.10,0.5.11,7,1,50,1,51,3,FALSE
airborne,0.5.11,0.5.12,8,1,51,4,55,8,FALSE
airborne,0.10.0,0.11.0,28,2,2,4,6,2,FALSE
airborne,0.6.8,0.7.0,21,4,395,106,501,13,FALSE
airborne,0.6.3,0.6.4,16,1,10,10,20,1,FALSE
airborne,0.6.2,0.6.3,15,1,213,20,233,6,FALSE
airborne,0.6.1,0.6.2,14,3,266,47,313,9,FALSE
airborne,0.11.7,0.12.0,36,1,5,9,14,2,FALSE
airborne,0.6.7,0.6.8,20,1,5,9,14,2,FALSE
airborne,0.6.6,0.6.7,19,4,414,41,455,14,FALSE
airborne,0.11.2,0.11.3,31,1,4,4,8,3,FALSE
airborne,0.6.4,0.6.5,17,1,175,26,201,4,FALSE
airborne,0.12.0,0.12.1,37,1,5,9,14,2,FALSE
airborne,0.5.8,0.5.9,5,1,11,2,13,2,FALSE
airborne,0.5.9,0.5.10,6,1,15,4,19,3,FALSE
airborne,0.5.5,0.5.6,2,1,13,15,28,2,FALSE
airborne,0.5.6,0.5.7,3,1,5,2,7,2,FALSE
airborne,0.5.7,0.5.8,4,1,5,611,616,8,FALSE
airborne,0.5.3,0.5.5,1,4,46,10,56,11,FALSE
airborne,0.9.0,0.9.1,26,1,1,1,2,1,FALSE
airborne,0.9.1,0.10.0,27,1,4,0,4,1,FALSE
airborne,0.8.1,0.9.0,25,1,21,5,26,3,FALSE
airborne,0.8.0,0.8.1,24,1,1,2,3,1,FALSE
airborne,0.11.4,0.11.5,33,1,5,9,14,2,FALSE
airborne,0.7.0,0.7.1,22,1,2,2,4,1,FALSE
airborne,0.7.1,0.8.0,23,2,240,38,278,12,FALSE
airborne,0.11.6,0.11.7,35,1,5,9,14,2,FALSE
airborne,0.7.0,0.7.1,22,1,2,2,4,1,TRUE
airborne,0.6.7,0.6.8,20,1,5,9,14,2,TRUE
airborne,0.5.16,0.6.0,12,8,1806,1512,3318,116,TRUE
airborne,0.6.6,0.6.7,19,4,414,41,455,14,TRUE
byu-cas,0.0.1,0.0.2,1,1,8,8,16,3,FALSE
byu-cas,1.0.1,1.0.2,5,1,2,2,4,2,FALSE
byu-cas,0.0.3,1.0.0,3,1,105,14,119,4,FALSE
byu-cas,1.0.3,2.0.0,7,1,81,72,153,3,FALSE
byu-cas,0.0.2,0.0.3,2,2,5,6,11,3,TRUE
byu-cas,1.0.0,1.0.1,4,2,23,8,31,3,FALSE
byu-cas,1.0.2,1.0.3,6,3,24,15,39,5,TRUE
byu-cas,0.0.2,0.0.3,2,2,5,6,11,3,FALSE
byu-cas,1.0.2,1.0.3,6,3,24,15,39,5,FALSE
byu-cas,1.0.0,1.0.1,4,2,23,8,31,3,TRUE
validator.js-asserts,0.0.5,0.0.6,5,5,29,31,60,10,FALSE
validator.js-asserts,0.0.4,0.0.5,4,7,806,66,872,28,FALSE
validator.js-asserts,0.0.6,0.0.7,6,5,322,27,349,18,FALSE
validator.js-asserts,0.0.1,0.0.2,1,5,278,8,286,12,FALSE
validator.js-asserts,0.0.3,0.0.4,3,3,6,3,9,4,FALSE
validator.js-asserts,0.0.2,0.0.3,2,13,1558,58,1616,25,FALSE
validator.js-asserts,0.0.4,0.0.5,4,7,806,66,872,28,TRUE
validator.js-asserts,0.0.7,1.0.0,7,7,6604,2955,9559,224,FALSE
validator.js-asserts,2.0.1,2.0.2,11,11,264,289,553,162,FALSE
validator.js-asserts,2.3.0,2.3.1,15,6,40,32,72,13,FALSE
validator.js-asserts,2.3.1,3.0.0,16,3,26,19,45,12,FALSE
validator.js-asserts,1.1.0,2.0.0,9,33,2979,2247,5226,274,FALSE
validator.js-asserts,2.0.0,2.0.1,10,5,378,90,468,40,FALSE
validator.js-asserts,3.0.1,3.0.2,18,3,13,45,58,8,FALSE
validator.js-asserts,3.0.0,3.0.1,17,4,454,17,471,22,FALSE
validator.js-asserts,2.2.0,2.3.0,14,3,320,5,325,16,TRUE
validator.js-asserts,3.0.2,3.1.0,19,4,1458,5,1463,23,FALSE
validator.js-asserts,2.1.0,2.2.0,13,5,323,7,330,18,FALSE
validator.js-asserts,1.0.0,1.1.0,8,10,587,40,627,32,FALSE
validator.js-asserts,2.0.2,2.1.0,12,5,243,31,274,13,FALSE
validator.js-asserts,2.2.0,2.3.0,14,3,320,5,325,16,FALSE
olymp,9.0.0-39,9.0.0-40,39,2,1066,48,1114,30,FALSE
olymp,9.0.0-38,9.0.0-39,38,2,6,6,12,6,FALSE
olymp,9.0.0-33,9.0.0-34,33,2,4,4,8,4,FALSE
olymp,9.0.0-32,9.0.0-33,32,2,10,14,24,4,FALSE
olymp,9.0.0-31,9.0.0-32,31,2,2,4,6,4,FALSE
olymp,9.0.0-30,9.0.0-31,30,2,20,58,78,8,FALSE
olymp,9.0.0-37,9.0.0-38,37,2,16,2,18,6,FALSE
olymp,9.0.0-36,9.0.0-37,36,6,436,370,806,36,FALSE
olymp,9.0.0-35,9.0.0-36,35,2,8,8,16,6,FALSE
olymp,9.0.0-34,9.0.0-35,34,2,24,6,30,4,FALSE
olymp,15.0.0-alpha.20,15.0.0-alpha.21,254,2,66,30,96,8,FALSE
olymp,15.0.0-alpha.21,15.0.0-alpha.22,255,2,12,6,18,2,FALSE
olymp,15.0.0-alpha.22,15.0.0-alpha.23,256,2,6,2,8,4,FALSE
olymp,15.0.0-alpha.23,15.0.0-alpha.24,257,1,27,27,54,12,FALSE
olymp,15.0.0-alpha.24,15.0.0-alpha.25,258,1,27,27,54,12,FALSE
olymp,15.0.0-alpha.25,15.0.0-alpha.26,259,1,27,27,54,12,FALSE
olymp,15.0.0-alpha.26,15.0.0-alpha.27,260,1,27,27,54,12,FALSE
olymp,15.0.0-alpha.27,15.0.0-alpha.28,261,1,27,27,54,12,FALSE
olymp,15.0.0-alpha.28,15.0.0-alpha.29,262,2,48,36,84,14,FALSE
olymp,15.0.0-alpha.29,15.0.0-beta.1,263,2,2,2,4,2,FALSE
olymp,14.0.11,14.0.12,194,2,10,6,16,4,FALSE
olymp,15.0.1,15.0.2,288,186,49824,47678,97502,2046,FALSE
olymp,15.0.2,15.0.3,289,36,3172,1580,4752,344,FALSE
olymp,15.0.0-beta.1,15.0.0-beta.2,264,88,11806,3714,15520,660,FALSE
olymp,9.0.1-8,9.0.1-9,76,2,8,6,14,8,FALSE
olymp,15.0.0-alpha.19,15.0.0-alpha.20,253,1,27,27,54,12,FALSE
olymp,15.0.0-alpha.18,15.0.0-alpha.19,252,1,27,27,54,12,FALSE
olymp,9.0.1-9,9.0.1-10,77,2,16,16,32,8,FALSE
olymp,15.0.0-alpha.15,15.0.0-alpha.16,249,2,12,16,28,6,FALSE
olymp,15.0.0-alpha.14,15.0.0-alpha.15,248,2,268,18,286,16,FALSE
olymp,15.0.0-alpha.17,15.0.0-alpha.18,251,1,27,27,54,12,FALSE
olymp,15.0.0-alpha.16,15.0.0-alpha.17,250,4,8,6,14,6,FALSE
olymp,15.0.0-alpha.11,15.0.0-alpha.12,245,2,1734,142,1876,70,FALSE
olymp,15.0.0-alpha.10,15.0.0-alpha.11,244,2,4,4,8,4,FALSE
olymp,15.0.0-alpha.13,15.0.0-alpha.14,247,2,2,12,14,4,FALSE
olymp,15.0.0-alpha.12,15.0.0-alpha.13,246,2,16,30,46,6,FALSE
olymp,14.2.19,14.2.20,226,2,254,44,298,30,FALSE
olymp,14.2.18,14.2.19,225,66,36536,6110,42646,834,FALSE
olymp,14.2.13,14.2.14,220,2,12,12,24,6,FALSE
olymp,14.2.12,14.2.13,219,62,8010,1624,9634,446,FALSE
olymp,14.2.11,14.2.12,218,50,7810,2588,10398,440,FALSE
olymp,14.2.10,14.2.11,217,2,32,32,64,6,FALSE
olymp,14.2.17,14.2.18,224,140,8770,6254,15024,610,FALSE
olymp,14.2.16,14.2.17,223,38,3906,2214,6120,244,FALSE
olymp,14.2.15,14.2.16,222,6,806,690,1496,54,FALSE
olymp,14.2.14,14.2.15,221,1,27,27,54,12,FALSE
olymp,12.0.17,12.0.18,152,10,238,206,444,98,FALSE
olymp,12.0.16,12.0.17,151,4,600,452,1052,104,FALSE
olymp,12.0.15,12.0.16,150,6,156,140,296,28,FALSE
olymp,12.0.14,12.0.15,149,4,206,1644,1850,38,FALSE
olymp,12.0.13,12.0.14,148,1,27,27,54,12,FALSE
olymp,12.0.12,12.0.13,147,2,12,12,24,4,FALSE
olymp,12.0.11,12.0.12,146,1,27,27,54,12,FALSE
olymp,12.0.10,12.0.11,145,4,10,10,20,8,FALSE
olymp,9.0.1-1,9.0.1-2,69,26,3960,1526,5486,188,FALSE
olymp,9.0.1-2,9.0.1-3,70,4,284,302,586,24,FALSE
olymp,9.0.1-3,9.0.1-4,71,16,1004,844,1848,80,FALSE
olymp,9.0.1-4,9.0.1-5,72,4,340,156,496,20,FALSE
olymp,9.0.1-5,9.0.1-6,73,22,3844,802,4646,114,FALSE
olymp,9.0.1-6,9.0.1-7,74,18,1836,1672,3508,176,FALSE
olymp,9.0.1-7,9.0.1-8,75,2,32,14,46,4,FALSE
olymp,9.0.0-45,9.0.0-46,45,4,10,8,18,6,FALSE
olymp,9.0.0-11,9.0.0-12,11,6,14,14,28,12,FALSE
olymp,9.0.0-10,9.0.0-11,10,12,1588,490,2078,52,FALSE
olymp,9.0.0-13,9.0.0-14,13,2,6256,4,6260,34,FALSE
olymp,9.0.0-12,9.0.0-13,12,4,4,4,8,4,FALSE
olymp,9.0.0-15,9.0.0-16,15,2,10,6262,6272,36,FALSE
olymp,9.0.0-14,9.0.0-15,14,2,6,6,12,4,FALSE
olymp,9.0.0-17,9.0.0-18,17,4,4,4,8,4,FALSE
olymp,9.0.0-16,9.0.0-17,16,2,6,6,12,4,FALSE
olymp,9.0.0-19,9.0.0-20,19,2,18,18,36,6,FALSE
olymp,9.0.0-18,9.0.0-19,18,2,4,4,8,4,FALSE
olymp,14.1.8,14.2.0,208,2,2,2,4,2,FALSE
olymp,12.0.19,12.0.20,154,18,112,128,240,32,FALSE
olymp,14.1.5,14.1.6,205,4,288,22,310,1412,FALSE
olymp,14.1.6,14.1.7,206,4,170,44,214,16,FALSE
olymp,12.0.18,12.0.19,153,24,512,116,628,130,FALSE
olymp,14.1.0,14.1.1,200,6,8,8,16,6,FALSE
olymp,14.1.1,14.1.2,201,2,260,52,312,14,FALSE
olymp,14.1.2,14.1.3,202,2,38,16,54,32,FALSE
olymp,14.1.3,14.1.4,203,2,2,2,4,2,FALSE
olymp,15.0.0-beta.17,15.0.0-beta.18,279,16,1492,1216,2708,114,FALSE
olymp,15.0.0-beta.25,15.0.1,287,4,1514,12,1526,38,FALSE
olymp,14.0.0-alpha.1,14.0.0-alpha.2,175,1,27,27,54,12,FALSE
olymp,14.2.9,14.2.10,216,14,414,190,604,64,FALSE
olymp,9.0.1-23,11.0.1-1,91,8,80166,42234,122400,2006,FALSE
olymp,9.0.1-22,9.0.1-23,90,2,10,10,20,4,FALSE
olymp,9.0.1-21,9.0.1-22,89,2,6,6,12,4,FALSE
olymp,9.0.1-20,9.0.1-21,88,2,10,10,20,4,FALSE
olymp,9.0.0-64,9.0.0-66,64,12,28,16,44,16,FALSE
olymp,9.0.0-66,9.0.0-67,65,12,660,240,900,46,FALSE
olymp,9.0.0-67,9.0.0-68,66,6,18,50,68,12,FALSE
olymp,9.0.0-60,9.0.0-61,60,2,18,10,28,2,FALSE
olymp,9.0.0-61,9.0.0-62,61,18,578,792,1370,82,FALSE
olymp,9.0.0-62,9.0.0-63,62,18,1642,176,1818,64,FALSE
olymp,9.0.0-63,9.0.0-64,63,10,72,44,116,22,FALSE
olymp,14.0.0-alpha.4,14.0.0-alpha.5,178,1,27,27,54,12,FALSE
olymp,9.0.0-68,9.0.0-69,67,36,7308,3814,11122,256,FALSE
olymp,9.0.0-69,9.0.1-1,68,8,424,88,512,34,FALSE
olymp,14.0.0-alpha.5,14.0.0-alpha.6,179,6,690,1928,2618,40,FALSE
olymp,14.0.0-alpha.2,14.0.0-alpha.3,176,1,27,27,54,12,FALSE
olymp,14.0.0-alpha.6,14.0.0-alpha.7,180,2,6,6,12,4,FALSE
olymp,14.2.8,14.2.9,215,1,27,27,54,12,FALSE
olymp,14.0.0-alpha.7,14.0.0-alpha.8,181,6,1734,1318,3052,58,FALSE
olymp,14.2.5,14.2.6,212,12,706,516,1222,44,FALSE
olymp,14.2.4,14.2.5,211,60,2348,1362,3710,250,FALSE
olymp,14.0.0-alpha.3,14.0.0-alpha.4,177,1,27,27,54,12,FALSE
olymp,9.0.1-12,9.0.1-13,80,1,27,27,54,12,FALSE
olymp,14.0.14,14.0.15,197,2,54,36,90,8,FALSE
olymp,13.0.0-next8,13.0.0-next9,173,2,8,14,22,6,FALSE
olymp,13.0.0-next9,14.0.0-alpha.1,174,4,2290,452,2742,30,FALSE
olymp,9.0.1-16,9.0.1-17,84,2,18,14,32,8,FALSE
olymp,14.0.10,14.0.11,193,2,42,46,88,2,FALSE
olymp,14.0.13,14.0.14,196,2,80,76,156,10,FALSE
olymp,14.0.12,14.0.13,195,2,24,22,46,4,FALSE
olymp,13.0.0-next2,13.0.0-next3,167,4,38,706,744,14,FALSE
olymp,13.0.0-next3,13.0.0-next4,168,4,670,244,914,86,FALSE
olymp,9.0.1-18,9.0.1-19,86,10,206,30,236,18,FALSE
olymp,9.0.1-19,9.0.1-20,87,6,6,6,12,6,FALSE
olymp,13.0.0-next6,13.0.0-next7,171,2,16,14,30,6,FALSE
olymp,15.0.0-beta.3,15.0.0-beta.4,266,2,220,110,330,14,FALSE
olymp,13.0.0-next4,13.0.0-next5,169,2,20,2,22,6,FALSE
olymp,13.0.0-next5,13.0.0-next6,170,2,44,66,110,6,FALSE
olymp,14.2.22,14.2.23,229,1,27,27,54,12,FALSE
olymp,14.2.23,14.2.24,230,2,26,10,36,8,FALSE
olymp,14.2.20,14.2.21,227,2,346,102,448,16,FALSE
olymp,14.2.21,14.2.22,228,1,27,27,54,12,FALSE
olymp,14.2.26,14.2.27,233,18,19874,3274,23148,222,FALSE
olymp,14.2.24,14.2.25,231,2,194,74,268,8,FALSE
olymp,14.2.25,14.2.26,232,2,26,12,38,8,FALSE
olymp,15.0.0-beta.21,15.0.0-beta.22,283,4,304,192,496,16,FALSE
olymp,15.0.0-beta.20,15.0.0-beta.21,282,1,27,27,54,12,FALSE
olymp,14.0.1,14.0.2,184,1,27,27,54,12,FALSE
olymp,14.0.3,14.0.4,186,2,342,60,402,14,FALSE
olymp,14.0.2,14.0.3,185,6,60,38,98,18,FALSE
olymp,14.0.5,14.0.6,188,2,238,178,416,14,FALSE
olymp,14.0.4,14.0.5,187,2,136,24,160,8,FALSE
olymp,14.0.7,14.0.8,190,2,54,22,76,12,FALSE
olymp,14.0.6,14.0.7,189,6,660,276,936,24,FALSE
olymp,14.0.9,14.0.10,192,4,22,14,36,6,FALSE
olymp,14.0.8,14.0.9,191,2,4,4,8,4,FALSE
olymp,12.0.21,12.0.22,156,16,454,228,682,60,FALSE
olymp,9.0.0-23,9.0.0-24,23,2,24,2,26,4,FALSE
olymp,14.2.3,14.2.4,210,18,14776,508,15284,1500,FALSE
olymp,14.2.0,14.2.3,209,4,4,4,8,4,FALSE
olymp,14.2.7,14.2.8,214,1,27,27,54,12,FALSE
olymp,14.2.6,14.2.7,213,2,42,30,72,8,FALSE
olymp,12.0.28,12.0.29,163,1,27,27,54,12,FALSE
olymp,12.0.26,12.0.27,161,2,8,4,12,4,FALSE
olymp,12.0.27,12.0.28,162,14,22876,14146,37022,726,FALSE
olymp,12.0.24,12.0.25,159,12,854,834,1688,104,FALSE
olymp,12.0.25,12.0.26,160,8,128,98,226,64,FALSE
olymp,12.0.22,12.0.23,157,2,28,32,60,6,FALSE
olymp,12.0.23,12.0.24,158,2,10,4,14,6,FALSE
olymp,12.0.20,12.0.21,155,4,16,12,28,10,FALSE
olymp,15.0.0-beta.22,15.0.0-beta.23,284,10,462,282,744,42,FALSE
olymp,15.0.0-beta.9,15.0.0-beta.11,272,1,27,27,54,12,FALSE
olymp,9.0.0-5,9.0.0-6,5,4,50,4306,4356,80,FALSE
olymp,9.0.0-4,9.0.0-5,4,2,12,12672,12684,10,FALSE
olymp,9.0.0-7,9.0.0-8,7,2,90,4,94,6,FALSE
olymp,9.0.0-6,9.0.0-7,6,2,4,4,8,4,FALSE
olymp,9.0.0-1,9.0.0-2,1,2,800,1691,2491,49,FALSE
olymp,9.0.0-3,9.0.0-4,3,2,14,10,24,6,FALSE
olymp,9.0.0-2,9.0.0-3,2,26,7112,259,7371,62,FALSE
olymp,9.0.0-9,9.0.0-10,9,2,82,58,140,10,FALSE
olymp,9.0.0-8,9.0.0-9,8,4,14,10,24,6,FALSE
olymp,11.0.1-4,11.0.1-5,95,2,18,18,36,8,FALSE
olymp,11.0.1-5,11.0.1-6,96,4,6,6,12,6,FALSE
olymp,11.0.1-6,11.0.1-7,97,2,6,4,10,4,FALSE
olymp,11.0.1-7,11.0.1-8,98,2,6,16,22,6,FALSE
olymp,11.0.1-1,11.0.1-2,92,4,402,224,626,180,FALSE
olymp,11.0.1-2,11.0.1-3,93,4,16,6,22,8,FALSE
olymp,11.0.1-3,11.0.1-4,94,2,14,12,26,10,FALSE
olymp,15.0.0-beta.11,15.0.0-beta.12,273,2,16,32,48,6,FALSE
olymp,15.0.0-beta.12,15.0.0-beta.13,274,2,92,108,200,8,FALSE
olymp,15.0.0-beta.13,15.0.0-beta.14,275,4,8,8,16,4,FALSE
olymp,15.0.0-beta.14,15.0.0-beta.15,276,30,1990,1260,3250,132,FALSE
olymp,15.0.0-beta.15,15.0.0-beta.16,277,2,4,6,10,4,FALSE
olymp,15.0.0-beta.16,15.0.0-beta.17,278,10,1164,180,1344,52,FALSE
olymp,15.0.0-beta.19,15.0.0-beta.20,281,2,8944,3680,12624,4,FALSE
olymp,12.0.7,12.0.8,142,10,304,6438,6742,128,FALSE
olymp,12.0.6,12.0.7,141,30,1802,1246,3048,200,FALSE
olymp,12.0.5,12.0.6,140,4,54,58,112,16,FALSE
olymp,12.0.4,12.0.5,139,6,198,126,324,34,FALSE
olymp,12.0.3,12.0.4,138,2,12416,15516,27932,30,FALSE
olymp,12.0.2,12.0.3,137,1,27,27,54,12,FALSE
olymp,12.0.1,12.0.2,136,1,27,27,54,12,FALSE
olymp,12.0.9,12.0.10,144,4,870,1312,2182,92,FALSE
olymp,12.0.8,12.0.9,143,12,1512,8368,9880,330,FALSE
olymp,14.1.4,14.1.5,204,4,13022,26,13048,1410,FALSE
olymp,14.0.16,14.1.0,199,2,98,92,190,6,FALSE
olymp,15.0.0-alpha.4,15.0.0-alpha.5,238,2,974,190,1164,42,FALSE
olymp,9.0.1-11,9.0.1-12,79,2,16,6,22,8,FALSE
olymp,15.0.0-alpha.9,15.0.0-alpha.10,243,2,30,58,88,2,FALSE
olymp,14.0.15,14.0.16,198,2,14,8,22,4,FALSE
olymp,14.1.7,14.1.8,207,1,27,27,54,12,FALSE
olymp,15.0.0-beta.24,15.0.0-beta.25,286,12,2916,778,3694,194,FALSE
olymp,9.0.1-13,9.0.1-14,81,2,14,14,28,6,FALSE
olymp,15.0.0-alpha.1,15.0.0-alpha.2,235,1,27,27,54,12,FALSE
olymp,15.0.0-alpha.3,15.0.0-alpha.4,237,22,2438,1352,3790,150,FALSE
olymp,15.0.0-alpha.2,15.0.0-alpha.3,236,4,10,12,22,6,FALSE
olymp,15.0.0-alpha.5,15.0.0-alpha.6,239,2,112,90,202,12,FALSE
olymp,9.0.1-10,9.0.1-11,78,2,8,4,12,4,FALSE
olymp,15.0.0-alpha.7,15.0.0-alpha.8,241,4,8,10,18,8,FALSE
olymp,15.0.0-alpha.6,15.0.0-alpha.7,240,2,1788,776,2564,86,FALSE
olymp,9.0.0-48,9.0.0-49,48,4,10,10,20,4,FALSE
olymp,9.0.0-49,9.0.0-50,49,2,10,10,20,4,FALSE
olymp,9.0.0-42,9.0.0-43,42,8,28,34,62,12,FALSE
olymp,9.0.0-43,9.0.0-44,43,8,568,214,782,34,FALSE
olymp,9.0.0-40,9.0.0-41,40,2,4,2,6,2,FALSE
olymp,9.0.0-41,9.0.0-42,41,10,1504,1154,2658,64,FALSE
olymp,9.0.0-46,9.0.0-47,46,2,2,4,6,2,FALSE
olymp,9.0.0-47,9.0.0-48,47,2,14,4,18,4,FALSE
olymp,9.0.0-44,9.0.0-45,44,2,58,44,102,6,FALSE
olymp,9.0.1-17,9.0.1-18,85,4,12,12,24,8,FALSE
olymp,14.0.0-alpha.8,14.0.0-alpha.9,182,2,16,8,24,4,FALSE
olymp,9.0.0-29,9.0.0-30,29,4,20,12966,12986,14,FALSE
olymp,14.0.0-alpha.9,14.0.1,183,10,4812,2052,6864,206,FALSE
olymp,15.0.0-beta.8,15.0.0-beta.9,271,2,6,6,12,2,FALSE
olymp,15.0.0-alpha.8,15.0.0-alpha.9,242,4,26,8,34,10,FALSE
olymp,9.0.0-20,9.0.0-21,20,2,6276,2,6278,34,FALSE
olymp,9.0.0-21,9.0.0-22,21,2,4,4,8,4,FALSE
olymp,9.0.0-22,9.0.0-23,22,2,110,2,112,8,FALSE
olymp,9.0.1-15,9.0.1-16,83,6,42,26,68,24,FALSE
olymp,9.0.0-24,9.0.0-25,24,2,4,2,6,4,FALSE
olymp,9.0.0-25,9.0.0-26,25,2,62,24,86,10,FALSE
olymp,9.0.0-26,9.0.0-27,26,2,8,8,16,2,FALSE
olymp,9.0.0-27,9.0.0-28,27,4,84,1096,1180,14,FALSE
olymp,15.0.0-beta.6,15.0.0-beta.7,269,34,598,596,1194,84,FALSE
olymp,9.0.0-28,9.0.0-29,28,12,13716,6502,20218,56,FALSE
olymp,15.0.0-beta.18,15.0.0-beta.19,280,2,16,16,32,8,FALSE
olymp,15.0.0-beta.7,15.0.0-beta.8,270,2,128,124,252,6,FALSE
olymp,15.0.0-beta.23,15.0.0-beta.24,285,4,14,30,44,4,FALSE
olymp,15.0.0-beta.4,15.0.0-beta.5,267,26,1418,974,2392,140,FALSE
olymp,15.0.0-beta.5,15.0.0-beta.6,268,24,2804,2334,5138,166,FALSE
olymp,13.0.0-next1,13.0.0-next10,165,18,808,1054,1862,130,FALSE
olymp,15.0.0-beta.2,15.0.0-beta.3,265,4,454,130,584,20,FALSE
olymp,13.0.0-next7,13.0.0-next8,172,2,12,8,20,6,FALSE
olymp,9.0.1-14,9.0.1-15,82,1,27,27,54,12,FALSE
olymp,9.0.0-59,9.0.0-60,59,2,14,14,28,2,FALSE
olymp,9.0.0-58,9.0.0-59,58,60,1730,1694,3424,134,FALSE
olymp,9.0.0-55,9.0.0-56,55,2,4,4,8,4,FALSE
olymp,9.0.0-54,9.0.0-55,54,4,8,4,12,8,FALSE
olymp,9.0.0-57,9.0.0-58,57,20,2520,1044,3564,102,FALSE
olymp,9.0.0-56,9.0.0-57,56,2,8,20,28,6,FALSE
olymp,9.0.0-51,9.0.0-52,51,2,8,8,16,6,FALSE
olymp,9.0.0-50,9.0.0-51,50,2,10,10,20,4,FALSE
olymp,9.0.0-53,9.0.0-54,53,2,2,6,8,4,FALSE
olymp,9.0.0-52,9.0.0-53,52,4,8,4,12,6,FALSE
olymp,12.0.0-14,12.0.0-15,113,10,850,34,884,26,FALSE
olymp,12.0.0-15,12.0.0-16,114,4,16,2,18,4,FALSE
olymp,12.0.0-21,12.0.0-22,120,2,8,6,14,4,FALSE
olymp,12.0.0-20,12.0.0-21,119,18,1118,772,1890,90,FALSE
olymp,12.0.0-23,12.0.0-24,122,6,60,50,110,14,FALSE
olymp,12.0.0-22,12.0.0-23,121,2,46,38,84,6,FALSE
olymp,12.0.0-25,12.0.0-26,124,1,27,27,54,12,FALSE
olymp,12.0.0-24,12.0.0-25,123,4,582,236,818,54,FALSE
olymp,12.0.0-27,12.0.0-28,126,38,1560,1368,2928,144,FALSE
olymp,12.0.0-26,12.0.0-27,125,10,340,88,428,44,FALSE
olymp,12.0.0-29,12.0.0-30,128,6,430,514,944,60,FALSE
olymp,12.0.0-28,12.0.0-29,127,14,1642,1428,3070,102,FALSE
olymp,12.0.0-32,12.0.0-33,131,2,4,4,8,4,FALSE
olymp,12.0.0-33,12.0.0-34,132,6,1584,966,2550,56,FALSE
olymp,12.0.0-30,12.0.0-31,129,8,1756,1680,3436,122,FALSE
olymp,12.0.0-31,12.0.0-32,130,28,1738,1442,3180,144,FALSE
olymp,12.0.0-34,12.0.0-35,133,10,15664,1360,17024,44,FALSE
olymp,12.0.0-19,12.0.0-20,118,2,20,16,36,4,FALSE
olymp,12.0.0-10,12.0.0-11,109,1,27,27,54,12,FALSE
olymp,12.0.0-11,12.0.0-12,110,4,66,54,120,8,FALSE
olymp,12.0.0-12,12.0.0-13,111,6,308,130,438,38,FALSE
olymp,12.0.0-13,12.0.0-14,112,20,3908,23104,27012,288,FALSE
olymp,12.0.0-16,12.0.0-17,115,158,14686,10204,24890,798,FALSE
olymp,12.0.0-17,12.0.0-18,116,10,572,324,896,100,FALSE
olymp,12.0.0,12.0.1,135,444,114404,91316,205720,3050,FALSE
olymp,11.0.1-8,12.0.0-1,99,1,27,27,54,12,FALSE
olymp,12.0.0-2,12.0.0-3,101,2,9804,38140,47944,392,FALSE
olymp,12.0.0-3,12.0.0-4,102,6,32,3206,3238,14,FALSE
olymp,12.0.0-1,12.0.0-2,100,1,27,27,54,12,FALSE
olymp,12.0.0-6,12.0.0-7,105,6,8,8,16,6,FALSE
olymp,12.0.0-7,12.0.0-8,106,2,4,4,8,2,FALSE
olymp,12.0.0-4,12.0.0-5,103,2,4,2,6,4,FALSE
olymp,12.0.0-5,12.0.0-6,104,8,24,3922,3946,60,FALSE
olymp,12.0.0-8,12.0.0-9,107,14,27902,408,28310,140,FALSE
olymp,12.0.0-9,12.0.0-10,108,6,28260,740,29000,136,FALSE
olymp,12.0.0-18,12.0.0-19,117,28,1116,1048,2164,126,FALSE
olymp,14.0.0-alpha.6,14.0.0-alpha.7,180,2,6,6,12,4,TRUE
olymp,15.0.1,15.0.2,288,186,49824,47678,97502,2046,TRUE
olymp,14.2.26,14.2.27,233,18,19874,3274,23148,222,TRUE
olymp,9.0.1-4,9.0.1-5,72,4,340,156,496,20,TRUE
olymp,9.0.1-3,9.0.1-4,71,16,1004,844,1848,80,TRUE
olymp,14.1.1,14.1.2,201,2,260,52,312,14,TRUE
olymp,14.0.6,14.0.7,189,6,660,276,936,24,TRUE
olymp,15.0.0-beta.6,15.0.0-beta.7,269,34,598,596,1194,84,TRUE
olymp,14.1.5,14.1.6,205,4,288,22,310,1412,TRUE
olymp,14.2.24,14.2.25,231,2,194,74,268,8,TRUE
olymp,15.0.2,15.0.3,289,36,3172,1580,4752,344,TRUE
olymp,9.0.0-11,9.0.0-12,11,6,14,14,28,12,TRUE
olymp,15.0.0-beta.25,15.0.1,287,4,1514,12,1526,38,TRUE
olymp,13.0.0-next3,13.0.0-next4,168,4,670,244,914,86,TRUE
olymp,9.0.1-18,9.0.1-19,86,10,206,30,236,18,TRUE
olymp,14.2.25,14.2.26,232,2,26,12,38,8,TRUE
olymp,14.0.3,14.0.4,186,2,342,60,402,14,TRUE
olymp,12.0.27,12.0.28,162,14,22876,14146,37022,726,TRUE
olymp,14.2.9,14.2.10,216,14,414,190,604,64,TRUE
olymp,15.0.0-beta.16,15.0.0-beta.17,278,10,1164,180,1344,52,TRUE
olymp,9.0.0-58,9.0.0-59,58,60,1730,1694,3424,134,TRUE
olymp,15.0.0-beta.18,15.0.0-beta.19,280,2,16,16,32,8,TRUE
olymp,15.0.0-beta.14,15.0.0-beta.15,276,30,1990,1260,3250,132,TRUE
olymp,15.0.0-alpha.3,15.0.0-alpha.4,237,22,2438,1352,3790,150,TRUE
olymp,15.0.0-beta.24,15.0.0-beta.25,286,12,2916,778,3694,194,TRUE
olymp,14.2.17,14.2.18,224,140,8770,6254,15024,610,TRUE
olymp,15.0.0-beta.19,15.0.0-beta.20,281,2,8944,3680,12624,4,TRUE
olymp,9.0.0-42,9.0.0-43,42,8,28,34,62,12,TRUE
olymp,14.0.0-alpha.2,14.0.0-alpha.3,176,1,27,27,54,12,TRUE
olymp,9.0.0-25,9.0.0-26,25,2,62,24,86,10,TRUE
olymp,12.0.18,12.0.19,153,24,512,116,628,130,TRUE
olymp,12.0.24,12.0.25,159,12,854,834,1688,104,TRUE
xxi-svg-map,1.1.0,1.2.0,2,1,36,361,397,7,FALSE
xxi-svg-map,1.3.0,1.4.0,5,1,8,1,9,3,FALSE
xxi-svg-map,1.2.0,1.2.1,3,2,12,6,18,6,FALSE
xxi-svg-map,1.2.1,1.3.0,4,1,14,1,15,4,FALSE
xxi-svg-map,1.0.0,1.1.0,1,11,48777,1065,49842,50,FALSE
xxi-svg-map,1.2.1,1.3.0,4,1,14,1,15,4,TRUE
xxi-svg-map,1.3.0,1.4.0,5,1,8,1,9,3,TRUE
angular-cli,1.0.0-beta.2-mobile.1,1.0.0-beta.2-mobile.2,80,2,4,3,7,2,FALSE
angular-cli,1.0.0-beta.11-webpack,1.0.0-beta.11-webpack.2,64,12,1983,265,2248,45,FALSE
angular-cli,1.0.0-beta.2-mobile.2,1.0.0-beta.2-mobile.3,81,4,70,12,82,13,FALSE
angular-cli,1.0.0-beta.2-mobile.3,1.0.0-beta.2-mobile.4,82,10,546,101,647,20,FALSE
angular-cli,1.0.0-beta.8,1.0.0-beta.9,42,12,209,18,227,20,FALSE
angular-cli,1.0.0-beta.9,1.0.0-beta.10,43,14,7282,903,8185,42,FALSE
angular-cli,1.0.0-beta.6,1.0.0-beta.8,41,13,408,48,456,15,FALSE
angular-cli,1.0.0-beta.12-1,1.0.0-beta.19-3,77,134,3939,1213,5152,391,FALSE
angular-cli,1.0.0-beta.5,1.0.0-beta.6,40,47,840,664,1504,104,FALSE
angular-cli,1.0.0-beta.4,1.0.0-beta.5,39,8,136,21,157,17,FALSE
angular-cli,1.0.0-beta.14,1.0.0-beta.15,46,7,93,97,190,18,FALSE
angular-cli,1.0.0-beta.15,1.0.0-beta.16,47,18,1450,249,1699,106,FALSE
angular-cli,1.0.0-beta.16,1.0.0-beta.17,48,31,1413,474,1887,99,FALSE
angular-cli,1.0.0-beta.17,1.0.0-beta.18,49,51,688,268,956,114,FALSE
angular-cli,1.0.0-beta.10,1.0.0-beta.12,44,126,18516,20165,38681,782,FALSE
angular-cli,1.0.0-beta.12,1.0.0-beta.14,45,2,35,24,59,6,FALSE
angular-cli,1.0.0-beta.2-mobile,1.0.0-beta.2-mobile.1,79,2,6,21,27,5,FALSE
angular-cli,1.0.0-beta.11-webpack.8,1.0.0-beta.11-webpack.9,71,32,9342,8512,17854,325,FALSE
angular-cli,1.0.0-beta.11-webpack.3,1.0.0-beta.11-webpack.4,66,1,4,3,7,3,FALSE
angular-cli,1.0.0-beta.11-webpack.2,1.0.0-beta.11-webpack.3,65,56,4862,3082,7944,295,FALSE
angular-cli,1.0.0-beta.11-webpack.7,1.0.0-beta.11-webpack.8,70,1,2,2,4,1,FALSE
angular-cli,1.0.0-beta.11-webpack.6,1.0.0-beta.11-webpack.7,69,1,2,2,4,1,FALSE
angular-cli,1.0.0-beta.11-webpack.5,1.0.0-beta.11-webpack.6,68,1,2,2,4,1,FALSE
angular-cli,1.0.0-beta.11-webpack.4,1.0.0-beta.11-webpack.5,67,1,2,2,4,2,FALSE
angular-cli,1.0.0-beta.28,1.0.0-beta.28.2,61,1,2,2,4,1,FALSE
angular-cli,1.0.0-beta.25,1.0.0-beta.25.2,54,1,2,2,4,1,FALSE
angular-cli,1.0.0-beta.24,1.0.0-beta.25,53,57,3346,8621,11967,257,FALSE
angular-cli,1.0.0-beta.27,1.0.0-beta.28,60,1,2,2,4,1,FALSE
angular-cli,1.0.0-beta.26,1.0.0-beta.27,59,41,8178,1646,9824,271,FALSE
angular-cli,1.0.0-beta.21,1.0.0-beta.22,51,16,1355,449,1804,87,FALSE
angular-cli,1.0.0-beta.22,1.0.0-beta.24,52,60,8640,1828,10468,264,FALSE
angular-cli,1.0.0-beta.28.2,1.0.0-beta.28.3,62,1,2,2,4,1,FALSE
angular-cli,1.0.0-beta.18,1.0.0-beta.21,50,66,9192,1634,10826,326,FALSE
angular-cli,1.0.0-beta.25.4,1.0.0-beta.25.5,57,1,1,0,1,1,FALSE
angular-cli,1.0.0-beta.25.5,1.0.0-beta.26,58,37,1626,490,2116,120,FALSE
angular-cli,1.0.0-beta.25.2,1.0.0-beta.25.3,55,1,2,2,4,1,FALSE
angular-cli,1.0.0-beta.25.3,1.0.0-beta.25.4,56,1,2,2,4,1,FALSE
angular-cli,1.0.0-beta.20-4,1.0.0-beta.22-1,87,32,1609,602,2211,143,FALSE
angular-cli,1.0.0-beta.20-1,1.0.0-beta.20-2,84,1,4,5,9,3,FALSE
angular-cli,1.0.0-beta.20-2,1.0.0-beta.20-3,85,1,1,0,1,1,FALSE
angular-cli,1.0.0-beta.20-3,1.0.0-beta.20-4,86,1,2,2,4,1,FALSE
angular-cli,1.0.0-beta.11-webpack.2,1.0.0-beta.11-webpack.3,65,56,4862,3082,7944,295,TRUE
angular-cli,0.0.15,0.0.16,16,2,57,16,73,8,FALSE
angular-cli,0.0.14,0.0.15,15,2,5,8,13,6,FALSE
angular-cli,0.0.17,0.0.18,18,2,19,10,29,4,TRUE
angular-cli,0.0.16,0.0.17,17,3,8,5,13,4,FALSE
angular-cli,0.0.11,0.0.12,12,2,2,2,4,2,TRUE
angular-cli,0.0.10,0.0.11,11,4,5,5,10,4,TRUE
angular-cli,0.0.13,0.0.14,14,2,2,2,4,2,FALSE
angular-cli,0.0.12,0.0.13,13,15,200,49,249,31,TRUE
angular-cli,0.0.19,0.0.20,20,2,2,2,4,2,FALSE
angular-cli,0.0.18,0.0.19,19,2,2,2,4,2,FALSE
angular-cli,0.0.20,0.0.22,21,63,3965,939,4904,203,FALSE
angular-cli,0.0.22,0.0.23,22,3,26,4,30,4,FALSE
angular-cli,0.0.23,0.0.24,23,10,129,1363,1492,22,FALSE
angular-cli,0.0.24,0.0.25,24,17,605,224,829,51,TRUE
angular-cli,0.0.25,0.0.26,25,28,2159,2108,4267,92,TRUE
angular-cli,0.0.26,0.0.27,26,4,119,4,123,6,TRUE
angular-cli,0.0.27,0.0.28,27,7,2405,2196,4601,75,TRUE
angular-cli,0.0.28,0.0.29,28,4,48,18,66,6,TRUE
angular-cli,0.0.29,0.0.30,29,20,1218,630,1848,79,TRUE
angular-cli,1.0.0-beta.11-webpack,1.0.0-beta.11-webpack.2,64,12,1983,265,2248,45,TRUE
angular-cli,0.0.33,0.0.34,32,25,660,133,793,55,TRUE
angular-cli,0.0.31,0.0.33,31,22,1033,441,1474,84,TRUE
angular-cli,0.0.5,0.0.6,6,1,1,1,2,1,FALSE
angular-cli,0.0.4,0.0.5,5,3,3,2,5,3,TRUE
angular-cli,0.0.7,0.0.8,8,2,1,3,4,2,FALSE
angular-cli,0.0.1,0.0.2,2,21,1051,818,1869,71,TRUE
angular-cli,0.0.3,0.0.4,4,2,113,5,118,13,FALSE
angular-cli,0.0.2,0.0.3,3,2,1,2,3,2,FALSE
angular-cli,0.0.9,0.0.10,10,3,209,21,230,5,FALSE
angular-cli,0.0.8,0.0.9,9,2,59,4,63,2,FALSE
angular-cli,0.0.30,0.0.31,30,11,1268,886,2154,57,TRUE
angular-cli,0.0.6,0.0.7,7,2,17,1,18,3,FALSE
angular-cli,0.0.17,0.0.18,18,2,19,10,29,4,FALSE
angular-cli,0.0.11,0.0.12,12,2,2,2,4,2,FALSE
angular-cli,0.0.10,0.0.11,11,4,5,5,10,4,FALSE
angular-cli,0.0.12,0.0.13,13,15,200,49,249,31,FALSE
angular-cli,0.0.31,0.0.33,31,22,1033,441,1474,84,FALSE
angular-cli,0.0.30,0.0.31,30,11,1268,886,2154,57,FALSE
angular-cli,0.0.4,0.0.5,5,3,3,2,5,3,FALSE
angular-cli,0.0.34,0.0.37,33,49,1392,934,2326,203,FALSE
angular-cli,0.0.1,0.0.2,2,21,1051,818,1869,71,FALSE
angular-cli,0.0.33,0.0.34,32,25,660,133,793,55,FALSE
angular-cli,0.0.39,0.1.0,35,4,8,4,12,4,FALSE
angular-cli,1.0.0-beta.0,1.0.0-beta.1,37,2,2,2,4,2,FALSE
angular-cli,1.0.0-beta.1,1.0.0-beta.4,38,44,1280,409,1689,126,FALSE
angular-cli,0.0.37,0.0.39,34,6,28,33,61,8,FALSE
angular-cli,0.0.24,0.0.25,24,17,605,224,829,51,FALSE
angular-cli,0.0.25,0.0.26,25,28,2159,2108,4267,92,FALSE
angular-cli,0.0.26,0.0.27,26,4,119,4,123,6,FALSE
angular-cli,0.0.27,0.0.28,27,7,2405,2196,4601,75,FALSE
angular-cli,0.0.28,0.0.29,28,4,48,18,66,6,FALSE
angular-cli,0.0.29,0.0.30,29,20,1218,630,1848,79,FALSE
angular-cli,0.1.0,1.0.0-beta.0,36,3,3,3,6,3,FALSE
angular-cli,1.0.0-beta.2-mobile.4,1.0.0-beta.20-1,83,387,40290,24463,64753,1617,FALSE
angular-cli,1.0.0-beta.21,1.0.0-beta.22,51,16,1355,449,1804,87,TRUE
angular-cli,1.0.0-beta.26,1.0.0-beta.27,59,41,8178,1646,9824,271,TRUE
angular-cli,1.0.0-beta.4,1.0.0-beta.5,39,8,136,21,157,17,TRUE
angular-cli,1.0.0-beta.24,1.0.0-beta.25,53,57,3346,8621,11967,257,TRUE
angular-cli,1.0.0-beta.22,1.0.0-beta.24,52,60,8640,1828,10468,264,TRUE
angular-cli,1.0.0-beta.14,1.0.0-beta.15,46,7,93,97,190,18,TRUE
angular-cli,1.0.0-beta.20-1,1.0.0-beta.20-2,84,1,4,5,9,3,TRUE
angular-cli,1.0.0-beta.2-mobile.4,1.0.0-beta.20-1,83,387,40290,24463,64753,1617,TRUE
angular-cli,0.0.37,0.0.39,34,6,28,33,61,8,TRUE
angular-cli,1.0.0-beta.2-mobile.2,1.0.0-beta.2-mobile.3,81,4,70,12,82,13,TRUE
angular-cli,1.0.0-beta.2-mobile.3,1.0.0-beta.2-mobile.4,82,10,546,101,647,20,TRUE
node-weixin-api,0.0.9,0.0.10,8,1,17,14,31,3,FALSE
node-weixin-api,0.0.8,0.0.9,7,3,45,13,58,8,FALSE
node-weixin-api,0.0.15,0.0.16,14,1,6,4,10,2,FALSE
node-weixin-api,0.0.14,0.0.15,13,1,2,0,2,1,FALSE
node-weixin-api,0.0.17,0.0.18,16,4,14,9,23,5,FALSE
node-weixin-api,0.0.16,0.0.17,15,1,2,0,2,1,FALSE
node-weixin-api,0.0.11,0.0.12,10,1,13,12,25,3,FALSE
node-weixin-api,0.0.10,0.0.11,9,1,44,2,46,3,FALSE
node-weixin-api,0.0.13,0.0.14,12,9,774,184,958,30,FALSE
node-weixin-api,0.0.12,0.0.13,11,13,852,217,1069,33,FALSE
node-weixin-api,0.0.5,0.0.7,5,3,214,40,254,15,FALSE
node-weixin-api,0.0.4,0.0.5,4,1,106,30,136,5,FALSE
node-weixin-api,0.0.7,0.0.8,6,3,1251,352,1603,27,FALSE
node-weixin-api,0.0.1,0.0.2,1,9,1057,229,1286,65,TRUE
node-weixin-api,0.0.3,0.0.4,3,1,2,0,2,1,FALSE
node-weixin-api,0.0.2,0.0.3,2,13,1147,545,1692,55,FALSE
node-weixin-api,0.2.4,0.2.5,22,3,7,6,13,4,FALSE
node-weixin-api,0.2.1,0.2.2,19,1,8,1,9,2,FALSE
node-weixin-api,0.2.0,0.2.1,18,2,139,2769,2908,36,FALSE
node-weixin-api,0.0.18,0.2.0,17,1,2,0,2,1,FALSE
node-weixin-api,0.2.9,0.3.0-alpha,27,1,3,0,3,1,FALSE
node-weixin-api,0.2.8,0.2.9,26,1,8,8,16,1,FALSE
node-weixin-api,0.3.0-alpha,0.3.0-beta,28,2,14,11,25,2,FALSE
node-weixin-api,0.3.0-beta,0.3.0,29,1,1,1,2,1,FALSE
node-weixin-api,0.2.7,0.2.8,25,2,3,3,6,2,FALSE
node-weixin-api,0.2.6,0.2.7,24,1,2,2,4,1,FALSE
node-weixin-api,0.2.5,0.2.6,23,2,17,43,60,6,FALSE
node-weixin-api,0.2.3,0.2.4,21,1,2,2,4,1,FALSE
node-weixin-api,0.2.2,0.2.3,20,3,25,21,46,6,FALSE
node-weixin-api,0.3.0-beta,0.3.0,29,1,1,1,2,1,TRUE
node-weixin-api,0.5.0,0.5.1,39,4,8,2,10,4,FALSE
node-weixin-api,0.4.4,0.4.5,35,6,57,23,80,6,FALSE
node-weixin-api,0.4.1,0.4.2,32,4,136,175,311,17,FALSE
node-weixin-api,0.4.0,0.4.1,31,1,2,0,2,1,FALSE
node-weixin-api,0.4.3,0.4.4,34,1,2,2,4,1,FALSE
node-weixin-api,0.4.2,0.4.3,33,3,5,3,8,3,FALSE
node-weixin-api,0.4.5,0.4.6,36,1,2,2,4,1,FALSE
node-weixin-api,0.4.7,0.5.0,38,3,19,19,38,4,FALSE
node-weixin-api,0.4.6,0.4.7,37,1,2,2,4,1,FALSE
node-weixin-api,0.0.1,0.0.2,1,9,1057,229,1286,65,FALSE
fquery,0.9.0,0.10.0,10,26,615,223,838,56,FALSE
fquery,0.10.0,0.11.0,11,28,778,10133,10911,80,FALSE
fquery,0.8.1,0.9.0,9,13,240,220,460,29,FALSE
fquery,0.8.0,0.8.1,8,4,87,49,136,10,FALSE
fquery,0.11.0,0.12.0,12,43,6745,5830,12575,416,FALSE
fquery,0.6.0,0.7.0,6,11,934,120,1054,49,FALSE
fquery,0.7.0,0.8.0,7,5,285,145,430,17,FALSE
fquery,0.12.3,0.12.4,16,1,2,679,681,10,FALSE
fquery,0.12.2,0.12.3,15,1,2,2,4,1,FALSE
fquery,0.12.1,0.12.2,14,2,4,103,107,2,FALSE
fquery,0.12.0,0.12.1,13,2,2819,2348,5167,84,FALSE
fquery,0.4.0,0.5.0,4,5,87,43,130,8,FALSE
fquery,0.5.0,0.6.0,5,5,51,15,66,10,FALSE
fquery,0.2.0,0.3.0,2,11,10210,332,10542,55,FALSE
fquery,0.3.0,0.4.0,3,6,160,77,237,15,FALSE
fquery,0.12.4,0.12.5,17,1,129,92,221,6,FALSE
fquery,0.1.0,0.2.0,1,24,6278,2618,8896,208,FALSE
fquery,0.10.0,0.11.0,11,28,778,10133,10911,80,TRUE
fquery,0.12.13,0.12.14,26,1,380,255,635,41,FALSE
fquery,0.12.12,0.12.13,25,3,30,17,47,5,FALSE
fquery,0.12.11,0.12.12,24,1,1,78,79,2,FALSE
fquery,0.12.10,0.12.11,23,1,2,5,7,2,FALSE
fquery,0.12.17,0.13.0,30,7,925,1099,2024,51,FALSE
fquery,0.12.16,0.12.17,29,2,1931,1905,3836,52,FALSE
fquery,0.12.15,0.12.16,28,1,4,2,6,2,FALSE
fquery,0.12.14,0.12.15,27,1,3,3,6,2,FALSE
fquery,0.12.7,0.12.8,20,2,65,116,181,10,FALSE
fquery,0.16.2,0.16.3,39,2,32,32,64,4,FALSE
fquery,0.16.1,0.16.2,38,1,2,13,15,3,FALSE
fquery,0.16.0,0.16.1,37,1,3,19,22,3,FALSE
fquery,0.16.3,0.16.4,40,1,380,255,635,41,FALSE
fquery,0.12.9,0.12.10,22,4,22,13,35,5,FALSE
fquery,0.12.8,0.12.9,21,1,380,255,635,41,FALSE
fquery,0.13.2,0.13.3,33,1,2,2,4,2,FALSE
fquery,0.13.3,0.14.0,34,1,4,4,8,2,FALSE
fquery,0.13.0,0.13.1,31,1,380,255,635,41,FALSE
fquery,0.12.6,0.12.7,19,1,2,180,182,5,FALSE
fquery,0.15.0,0.16.0,36,1,1,26,27,3,FALSE
fquery,0.14.0,0.15.0,35,2,71,1,72,3,FALSE
fquery,0.12.5,0.12.6,18,1,2,111,113,4,FALSE
fquery,0.13.1,0.13.2,32,1,24,17,41,5,FALSE
fquery,0.16.3,0.16.4,40,1,380,255,635,41,TRUE
fquery,0.12.6,0.12.7,19,1,2,180,182,5,TRUE
fquery,0.12.14,0.12.15,27,1,3,3,6,2,TRUE
fquery,0.12.4,0.12.5,17,1,129,92,221,6,TRUE
restful.js,0.9.0,0.9.1,7,4,52,23,75,18,FALSE
restful.js,0.9.1,0.9.2,8,7,1444,58,1502,24,FALSE
restful.js,0.9.2,0.9.3,9,5,906,122,1028,25,FALSE
restful.js,0.9.3,0.9.4,10,4,4898,4537,9435,30,FALSE
restful.js,0.9.4,0.9.5,11,5,224,124,348,22,FALSE
restful.js,0.9.5,0.9.6,12,3,171,165,336,14,FALSE
restful.js,0.6.2,0.7.0,5,14,937,355,1292,67,FALSE
restful.js,0.6.1,0.6.2,4,8,361,65,426,24,FALSE
restful.js,0.6.0,0.6.1,3,1,32,20,52,11,FALSE
restful.js,0.9.3,0.9.4,10,4,4898,4537,9435,30,TRUE
restful.js,0.5.0,0.5.2,1,7,65,21,86,14,FALSE
restful.js,0.5.2,0.6.0,2,10,612,302,914,43,FALSE
restful.js,0.6.2,0.7.0,5,14,937,355,1292,67,TRUE
restful.js,0.7.0,0.9.0,6,34,19939,6051,25990,205,FALSE
restful.js,0.5.0,0.5.2,1,7,65,21,86,14,TRUE
webdriverajax,1.1.1,2.0.0,6,2,443,565,1008,10,FALSE
webdriverajax,1.1.0,1.1.1,5,8,1762,61,1823,13,FALSE
webdriverajax,1.0.0,1.0.1,1,2,8,3,11,3,FALSE
webdriverajax,1.0.1,1.0.2,2,2,6,2,8,2,FALSE
webdriverajax,1.0.2,1.0.3,3,3,137,56,193,9,FALSE
webdriverajax,1.0.3,1.1.0,4,5,263,49,312,9,FALSE
webdriverajax,1.0.2,1.0.3,3,3,137,56,193,9,TRUE
top-gh-contribs,0.0.5,0.0.6,5,3,9,1,10,3,FALSE
top-gh-contribs,0.0.4,0.0.5,4,3,35,18,53,5,FALSE
top-gh-contribs,1.1.1,2.0.0,9,4,2111,6737,8848,11,FALSE
top-gh-contribs,0.0.6,1.0.0,6,3,13723,45,13768,19,FALSE
top-gh-contribs,0.0.1,0.0.2,1,3,6,4,10,3,FALSE
top-gh-contribs,1.0.1,1.1.1,8,9,10950,15576,26526,30,FALSE
top-gh-contribs,0.0.3,0.0.4,3,3,35,5,40,3,FALSE
top-gh-contribs,0.0.2,0.0.3,2,5,22,10,32,6,FALSE
top-gh-contribs,2.0.0,2.0.1,10,3,85,17,102,7,FALSE
top-gh-contribs,2.0.1,2.0.2,11,3,21,27,48,3,TRUE
top-gh-contribs,1.0.0,1.0.1,7,5,11,11,22,5,TRUE
top-gh-contribs,2.0.3,2.0.4,13,1,1,1,2,1,FALSE
top-gh-contribs,2.0.2,2.0.3,12,8,159,33,192,11,FALSE
top-gh-contribs,0.0.5,0.0.6,5,3,9,1,10,3,TRUE
top-gh-contribs,0.0.3,0.0.4,3,3,35,5,40,3,TRUE
top-gh-contribs,2.0.0,2.0.1,10,3,85,17,102,7,TRUE
top-gh-contribs,2.0.1,2.0.2,11,3,21,27,48,3,FALSE
top-gh-contribs,1.0.0,1.0.1,7,5,11,11,22,5,FALSE
google-books-search-promise,1.0.1,1.1.0,2,3,326,36,362,8,FALSE
google-books-search-promise,1.0.1,1.1.0,2,3,326,36,362,8,TRUE
sails-hook-cron,2.1.0,2.1.1,3,1,6,18,24,4,FALSE
sails-hook-cron,2.1.1,2.2.0,4,60,117,99,216,70,FALSE
sails-hook-cron,1.0.0,2.0.0,1,9,85,52,137,10,FALSE
sails-hook-cron,2.0.0,2.1.0,2,17,80,130,210,23,FALSE
sails-hook-cron,2.1.1,2.2.0,4,60,117,99,216,70,TRUE
asd-agent,1.0.1,1.0.2,2,2,30,11,41,9,FALSE
asd-agent,1.0.2,1.0.3,3,2,5,1,6,3,FALSE
asd-agent,1.0.3,1.0.4,4,2,1,3,4,2,FALSE
asd-agent,1.0.4,1.0.5,5,2,2,4,6,3,FALSE
asd-agent,1.0.5,1.1.0,6,2,46,29,75,6,FALSE
asd-agent,1.1.1,1.2.0,8,2,15,7,22,2,FALSE
asd-agent,1.0.0,1.0.1,1,2,60,29,89,14,FALSE
asd-agent,1.1.0,1.1.1,7,2,28,1,29,3,FALSE
asd-agent,1.0.5,1.1.0,6,2,46,29,75,6,TRUE
passport-wechat,0.0.5,0.0.6,6,1,2,2,4,1,FALSE
passport-wechat,0.0.4,0.0.5,5,1,2,2,4,1,FALSE
passport-wechat,0.0.7,0.0.8,8,2,635,12,647,17,FALSE
passport-wechat,0.0.6,0.0.7,7,1,2,2,4,1,FALSE
passport-wechat,0.0.1,0.0.2,2,1,2,2,4,1,FALSE
passport-wechat,0.0.3,0.0.4,4,1,2,2,4,1,FALSE
passport-wechat,2.0.1,2.0.2,16,2,9,3,12,2,FALSE
passport-wechat,0.0.2,0.0.3,3,1,2,2,4,1,FALSE
passport-wechat,2.0.0,2.0.1,15,6,33,12,45,8,FALSE
passport-wechat,0.0.9,0.1.0,10,1,2,2,4,1,FALSE
passport-wechat,0.0.8,0.0.9,9,3,244,388,632,13,FALSE
passport-wechat,0.1.1,0.1.2,12,2,23,73,96,5,FALSE
passport-wechat,0.1.0,0.1.1,11,1,2,2,4,1,FALSE
passport-wechat,2.0.3,2.0.4,18,4,31,16,47,6,FALSE
passport-wechat,0.1.2,0.1.3,13,1,2,2,4,1,FALSE
passport-wechat,0.1.3,2.0.0,14,16,607,501,1108,39,FALSE
passport-wechat,2.0.2,2.0.3,17,10,565,1117,1682,28,FALSE
passport-wechat,0.0.2,0.0.3,3,1,2,2,4,1,TRUE
passport-wechat,0.0.7,0.0.8,8,2,635,12,647,17,TRUE
passport-wechat,0.0.0,0.0.1,1,1,2,2,4,1,FALSE
passport-wechat,0.0.0,0.0.1,1,1,2,2,4,1,TRUE
passport-wechat,0.0.8,0.0.9,9,3,244,388,632,13,TRUE
react-json-tree,0.7.2,0.7.3,27,1,1,1,2,1,FALSE
react-json-tree,0.7.3,0.7.4,28,5,46,22,68,11,FALSE
react-json-tree,0.1.8,0.1.9,5,2,1,29,30,3,FALSE
react-json-tree,0.1.9,0.2.0,6,12,380,115,495,45,FALSE
react-json-tree,0.7.0,0.7.1,25,1,2,2,4,1,FALSE
react-json-tree,0.2.0,0.3.0,7,7,157,6,163,12,FALSE
react-json-tree,0.7.1,0.7.2,26,3,25,7,32,5,FALSE
react-json-tree,0.1.5,0.1.8,4,9,106,27,133,17,FALSE
react-json-tree,0.10.1,0.10.2,35,5,28,9,37,6,FALSE
react-json-tree,0.10.0,0.10.1,34,7,27,16,43,7,FALSE
react-json-tree,0.10.3,0.10.4,37,3,36,13,49,8,FALSE
react-json-tree,0.10.2,0.10.3,36,2,41,19,60,3,FALSE
react-json-tree,0.10.5,0.10.6,39,6,82,38,120,12,FALSE
react-json-tree,0.10.4,0.10.5,38,3,17,8,25,6,FALSE
react-json-tree,0.10.7,0.10.8,41,3,18,15,33,12,FALSE
react-json-tree,0.10.6,0.10.7,40,2,14,9,23,6,FALSE
react-json-tree,0.6.3,0.6.4,19,2,2,2,4,2,FALSE
react-json-tree,0.6.2,0.6.3,18,2,5,3,8,3,FALSE
react-json-tree,0.7.4,0.8.0,29,2,29,35,64,5,FALSE
react-json-tree,0.6.0,0.6.1,16,3,43,23,66,5,FALSE
react-json-tree,0.6.7,0.6.8,23,2,4,3,7,4,FALSE
react-json-tree,0.6.6,0.6.7,22,1,1,1,2,1,FALSE
react-json-tree,0.6.5,0.6.6,21,4,47,8,55,6,FALSE
react-json-tree,0.6.4,0.6.5,20,2,9,3,12,2,FALSE
react-json-tree,0.4.0,0.5.0,9,6,48,32,80,14,FALSE
react-json-tree,0.5.6,0.6.0,15,6,697,553,1250,26,FALSE
react-json-tree,0.5.0,0.5.1,10,4,24,24,48,7,FALSE
react-json-tree,0.5.1,0.5.2,11,5,47,19,66,15,FALSE
react-json-tree,0.5.2,0.5.3,12,2,4,3,7,3,FALSE
react-json-tree,0.5.3,0.5.5,13,2,68,32,100,6,FALSE
react-json-tree,0.9.0,0.10.0,33,3,136,97,233,14,FALSE
react-json-tree,0.8.1,0.8.2,31,2,16,13,29,2,FALSE
react-json-tree,0.8.0,0.8.1,30,3,21,9,30,4,FALSE
react-json-tree,0.8.2,0.9.0,32,2,1,2,3,2,FALSE
react-json-tree,0.6.8,0.7.0,24,4,747,585,1332,29,FALSE
react-json-tree,0.5.5,0.5.6,14,5,49,41,90,17,FALSE
react-json-tree,0.6.1,0.6.2,17,4,9,3,12,7,FALSE
react-json-tree,0.10.8,0.10.9,42,2,2,1,3,2,FALSE
react-json-tree,0.3.0,0.4.0,8,7,1020,1542,2562,51,FALSE
react-json-tree,0.1.1,0.1.3,2,5,288,3,291,18,FALSE
react-json-tree,0.1.3,0.1.5,3,11,104,25,129,15,FALSE
react-json-tree,0.1.0,0.1.1,1,3,8,1,9,3,FALSE
react-json-tree,0.7.4,0.8.0,29,2,29,35,64,5,TRUE
react-json-tree,0.1.5,0.1.8,4,9,106,27,133,17,TRUE
react-json-tree,0.10.6,0.10.7,40,2,14,9,23,6,TRUE
react-json-tree,0.5.1,0.5.2,11,5,47,19,66,15,TRUE
react-json-tree,0.10.1,0.10.2,35,5,28,9,37,6,TRUE
react-json-tree,0.5.0,0.5.1,10,4,24,24,48,7,TRUE
react-json-tree,0.7.1,0.7.2,26,3,25,7,32,5,TRUE
react-json-tree,0.2.0,0.3.0,7,7,157,6,163,12,TRUE
restful-redux,1.1.1,1.2.0,5,2,82,25,107,6,FALSE
restful-redux,1.1.0,1.1.1,4,3,10,3,13,3,FALSE
restful-redux,3.0.4,3.0.5,29,2,7,1,8,3,FALSE
restful-redux,3.0.5,3.0.6,30,2,38,30,68,3,FALSE
restful-redux,1.0.0,1.0.1,1,6,21,18,39,7,FALSE
restful-redux,1.0.1,1.0.2,2,4,10,10,20,4,FALSE
restful-redux,1.0.2,1.1.0,3,2,63,19,82,5,FALSE
restful-redux,2.0.0,2.0.1,19,3,6,2,8,3,FALSE
restful-redux,2.0.0-beta2,2.0.0-beta3,17,1,15,30,45,3,FALSE
restful-redux,2.0.0-beta3,2.0.0,18,3,205,63,268,9,TRUE
restful-redux,3.1.1,3.1.2,34,2,108,4,112,4,FALSE
restful-redux,3.1.0,3.1.1,33,2,69,9,78,5,FALSE
restful-redux,2.2.1,3.0.0,24,3,590,373,963,16,FALSE
restful-redux,2.2.0,2.2.1,23,3,223,69,292,16,FALSE
restful-redux,3.0.7,3.1.0,32,2,45,5,50,4,FALSE
restful-redux,3.0.2,3.0.3,27,2,5,2,7,3,FALSE
restful-redux,2.1.0,2.1.1,21,3,33,36,69,5,FALSE
restful-redux,2.1.1,2.2.0,22,5,140,90,230,26,FALSE
restful-redux,3.0.3,3.0.4,28,2,49,27,76,4,FALSE
restful-redux,3.0.0,3.0.1,25,3,20,6,26,5,FALSE
restful-redux,3.0.1,3.0.2,26,2,128,19,147,6,FALSE
restful-redux,3.2.0,3.2.1,36,3,19,8,27,4,FALSE
restful-redux,3.4.2,3.4.3,45,2,37,4,41,4,FALSE
restful-redux,1.4.0,1.4.1,10,3,14,4,18,3,FALSE
restful-redux,1.4.1,1.4.2,11,3,5,2,7,3,FALSE
restful-redux,2.0.1,2.1.0,20,5,224,53,277,13,FALSE
restful-redux,1.4.3,1.4.4,13,2,5,2,7,3,FALSE
restful-redux,1.4.4,1.5.0,14,5,426,114,540,12,FALSE
restful-redux,1.5.0,2.0.0-beta,15,2,86,55,141,7,FALSE
restful-redux,1.3.2,1.4.0,9,2,202,13,215,11,FALSE
restful-redux,1.3.1,1.3.2,8,3,42,28,70,4,FALSE
restful-redux,1.3.0,1.3.1,7,2,43,11,54,5,FALSE
restful-redux,1.2.0,1.3.0,6,3,111,93,204,8,FALSE
restful-redux,2.0.0-beta,2.0.0-beta2,16,2,6,2,8,3,FALSE
restful-redux,1.4.2,1.4.3,12,3,8,5,13,4,FALSE
restful-redux,3.4.3,3.4.4,46,3,32,10,42,5,FALSE
restful-redux,3.4.0,3.4.1,43,4,20,9,29,6,FALSE
restful-redux,3.4.1,3.4.2,44,2,38,12,50,4,FALSE
restful-redux,3.4.4,3.5.0,47,3,198,63,261,9,FALSE
restful-redux,3.5.2,3.5.3,50,3,5,2,7,3,FALSE
restful-redux,3.5.1,3.5.2,49,3,8,6,14,4,FALSE
restful-redux,3.5.0,3.5.1,48,4,73,6,79,7,FALSE
restful-redux,3.3.1,3.3.2,40,3,166,4,170,6,FALSE
restful-redux,3.3.0,3.3.1,39,2,7,2,9,3,FALSE
restful-redux,3.3.3,3.4.0,42,5,225,67,292,11,FALSE
restful-redux,3.3.2,3.3.3,41,14,457,86,543,22,FALSE
restful-redux,3.1.2,3.2.0,35,2,102,16,118,8,FALSE
restful-redux,3.2.1,3.2.2,37,2,12,5,17,3,FALSE
restful-redux,3.2.2,3.3.0,38,4,475,280,755,10,FALSE
restful-redux,3.0.6,3.0.7,31,2,5,1,6,3,FALSE
restful-redux,2.0.0-beta3,2.0.0,18,3,205,63,268,9,FALSE
restful-redux,1.1.0,1.1.1,4,3,10,3,13,3,TRUE
restful-redux,3.0.7,3.1.0,32,2,45,5,50,4,TRUE
restful-redux,3.1.2,3.2.0,35,2,102,16,118,8,TRUE
restful-redux,3.4.1,3.4.2,44,2,38,12,50,4,TRUE
restful-redux,1.5.0,2.0.0-beta,15,2,86,55,141,7,TRUE
restful-redux,1.4.4,1.5.0,14,5,426,114,540,12,TRUE
restful-redux,3.4.0,3.4.1,43,4,20,9,29,6,TRUE
restful-redux,3.2.2,3.3.0,38,4,475,280,755,10,TRUE
restful-redux,2.0.0-beta,2.0.0-beta2,16,2,6,2,8,3,TRUE
restful-redux,3.0.4,3.0.5,29,2,7,1,8,3,TRUE
victory-axis,1.4.0,1.5.0,11,41,25822,33409,59231,100,FALSE
victory-axis,1.1.0,1.2.0,7,3,460,305,765,9,FALSE
victory-axis,1.0.0,1.0.1,4,2,30,3,33,2,FALSE
victory-axis,1.0.1,1.0.2,5,21,718,512,1230,37,FALSE
victory-axis,1.0.2,1.1.0,6,13,45322,44468,89790,29,FALSE
victory-axis,0.0.3,1.0.0,3,28,2381,1122,3503,65,FALSE
victory-axis,0.0.2,0.0.3,2,4,91,49,140,4,FALSE
victory-axis,1.5.1,1.5.2,13,25,382617,13860,396477,163,FALSE
victory-axis,1.5.0,1.5.1,12,3,307,98,405,11,FALSE
victory-axis,1.5.3,1.5.4,15,4,41,49,90,9,FALSE
victory-axis,1.5.2,1.5.3,14,5,9103,3755,12858,23,FALSE
victory-axis,1.3.1,1.4.0,10,12,537,588,1125,19,FALSE
victory-axis,1.3.0,1.3.1,9,8,11262,956,12218,20,FALSE
victory-axis,1.2.0,1.3.0,8,7,380,310,690,18,FALSE
victory-axis,0.0.1,0.0.2,1,2,21985,20,22005,5,FALSE
victory-axis,1.5.0,1.5.1,12,3,307,98,405,11,TRUE
victory-axis,1.0.1,1.0.2,5,21,718,512,1230,37,TRUE
victory-axis,1.3.1,1.4.0,10,12,537,588,1125,19,TRUE
victory-axis,1.5.5,1.5.6,17,3,326,294,620,9,FALSE
victory-axis,1.5.6,1.5.7,18,3,2040,1918,3958,7,TRUE
victory-axis,1.5.4,1.5.5,16,25,33352,286579,319931,101,FALSE
victory-axis,1.5.7,1.6.0,19,36,2041,1985,4026,75,FALSE
victory-axis,1.5.6,1.5.7,18,3,2040,1918,3958,7,FALSE
victory-axis,1.6.0,2.0.0,20,8,28019,18924,46943,19,FALSE
victory-axis,1.6.0,2.0.0,20,8,28019,18924,46943,19,TRUE
react-most,0.6.5,0.6.6,23,11,3292,212,3504,36,FALSE
react-most,0.2.1,0.2.2,4,2,5,3,8,2,FALSE
react-most,0.1.0,0.1.1,1,8,296,378,674,30,FALSE
react-most,0.1.1,0.2.0,2,39,41905,382,42287,82,FALSE
react-most,0.6.3,0.6.4,21,1,1,1,2,1,FALSE
react-most,0.6.2,0.6.3,20,11,238,189,427,17,FALSE
react-most,0.3.0,0.4.0,6,3,232,54,286,13,TRUE
react-most,0.6.6,0.7.0,24,33,12025,10206,22231,61,FALSE
react-most,0.7.0,0.7.1,25,7,937,340,1277,14,FALSE
react-most,0.6.4,0.6.5,22,4,121,114,235,12,FALSE
react-most,0.5.4,0.6.0,17,7,370,180,550,16,FALSE
react-most,0.4.0,0.4.1,7,2,3,1,4,2,FALSE
react-most,0.4.3,0.4.4,10,4,9426,105,9531,4,FALSE
react-most,0.4.2,0.4.3,9,3,23,17,40,5,FALSE
react-most,0.4.5,0.5.0,12,4,3802,162,3964,18,FALSE
react-most,0.4.4,0.4.5,11,2,5,2,7,3,FALSE
react-most,0.5.2,0.5.3,15,9,316,40682,40998,23,FALSE
react-most,0.5.3,0.5.4,16,2,2,2,4,2,FALSE
react-most,0.4.1,0.4.2,8,3,53,54,107,6,FALSE
react-most,0.5.0,0.5.1,13,4,38,75,113,12,FALSE
react-most,0.5.1,0.5.2,14,9,6763,277,7040,34,FALSE
react-most,0.6.1,0.6.2,19,1,1,1,2,1,FALSE
react-most,0.2.2,0.3.0,5,4,40823,25,40848,11,FALSE
react-most,1.1.1,1.1.2,30,5,287,115,402,14,FALSE
react-most,1.1.0,1.1.1,29,2,21,17,38,5,FALSE
react-most,1.1.3,1.1.4,32,2,326,313,639,4,FALSE
react-most,1.1.2,1.1.3,31,7,6502,616,7118,29,FALSE
react-most,1.0.0,1.1.0,28,5,126,117,243,19,FALSE
react-most,0.8.0,1.0.0,27,22,4156,26488,30644,104,TRUE
react-most,0.7.1,0.8.0,26,11,3759,585,4344,24,FALSE
react-most,0.3.0,0.4.0,6,3,232,54,286,13,FALSE
react-most,1.0.0,1.1.0,28,5,126,117,243,19,TRUE
react-most,0.7.0,0.7.1,25,7,937,340,1277,14,TRUE
react-most,0.8.0,1.0.0,27,22,4156,26488,30644,104,FALSE
react-most,1.1.0,1.1.1,29,2,21,17,38,5,TRUE
react-most,1.1.2,1.1.3,31,7,6502,616,7118,29,TRUE
react-most,0.4.2,0.4.3,9,3,23,17,40,5,TRUE
react-most,0.5.2,0.5.3,15,9,316,40682,40998,23,TRUE
react-most,0.1.0,0.1.1,1,8,296,378,674,30,TRUE
stilr,1.1.0,1.2.0,8,10,26,8,34,11,FALSE
stilr,0.0.1,0.0.2,1,2,8,3,11,3,FALSE
stilr,0.0.2,0.1.0,2,8,141,48,189,11,FALSE
stilr,0.3.0,1.0.0,6,5,168,48,216,8,FALSE
stilr,1.2.1,1.2.2,10,13,361,64,425,22,FALSE
stilr,1.2.2,1.2.4,11,10,61,51,112,22,FALSE
stilr,0.2.2,0.3.0,5,7,157,17,174,10,TRUE
stilr,1.2.0,1.2.1,9,4,24,9,33,6,FALSE
stilr,0.2.0,0.2.2,4,9,102,37,139,11,FALSE
stilr,0.1.0,0.2.0,3,6,59,19,78,7,FALSE
stilr,1.0.0,1.1.0,7,13,77,35,112,13,FALSE
stilr,1.1.0,1.2.0,8,10,26,8,34,11,TRUE
stilr,1.2.4,1.3.0,12,14,2583,97,2680,39,FALSE
stilr,0.2.2,0.3.0,5,7,157,17,174,10,FALSE
stilr,1.2.0,1.2.1,9,4,24,9,33,6,TRUE
meiosis-react,0.7.0,0.7.1,5,4,110,887,997,33,FALSE
meiosis-react,0.7.1,0.8.0,6,10,122,8727,8849,40,FALSE
meiosis-react,0.5.0,0.7.0,4,7,6987,63,7050,41,FALSE
meiosis-react,0.4.4,0.5.0,3,6,80,89,169,27,FALSE
meiosis-react,0.4.1,0.4.2,1,4,21610,2182,23792,18,FALSE
meiosis-react,0.4.2,0.4.4,2,4,2743,38798,41541,35,FALSE
meiosis-react,0.7.0,0.7.1,5,4,110,887,997,33,TRUE
meiosis-react,0.5.0,0.7.0,4,7,6987,63,7050,41,TRUE
resin-discoverable-services,1.2.1,1.2.2,10,3,11,5,16,4,FALSE
resin-discoverable-services,1.0.4,1.1.0,5,9,323,115,438,14,FALSE
resin-discoverable-services,1.1.0,1.1.1,6,4,27,13,40,5,FALSE
resin-discoverable-services,1.1.1,1.1.2,7,6,48,11,59,10,FALSE
resin-discoverable-services,1.1.2,1.2.0,8,5,140,23,163,11,FALSE
resin-discoverable-services,1.0.0,1.0.1,1,4,7,3,10,4,FALSE
resin-discoverable-services,1.0.1,1.0.2,2,2,128,110,238,6,FALSE
resin-discoverable-services,1.0.2,1.0.3,3,5,718,142,860,13,FALSE
resin-discoverable-services,1.0.3,1.0.4,4,5,126,38,164,12,FALSE
resin-discoverable-services,1.2.0,1.2.1,9,3,9,5,14,4,FALSE
resin-discoverable-services,1.0.3,1.0.4,4,5,126,38,164,12,TRUE
phptoast,1.1.0,2.0.0,2,2,25,55,80,6,FALSE
phptoast,1.0.0,1.1.0,1,3,5,2,7,2,FALSE
phptoast,2.0.1,2.1.0,4,2,2,2,4,2,TRUE
phptoast,2.0.0,2.0.1,3,2,2,2,4,2,FALSE
phptoast,2.1.0,2.1.1,5,2,3,7,10,2,FALSE
phptoast,3.1.0,3.2.0,10,3,923,10,933,16,FALSE
phptoast,2.0.1,2.1.0,4,2,2,2,4,2,FALSE
phptoast,3.14.0,3.15.0,26,2,166,2,168,3,FALSE
phptoast,2.2.0,2.3.0,7,5,345,5,350,9,FALSE
phptoast,3.17.0,3.18.0,31,3,525,3,528,9,FALSE
phptoast,4.0.1,4.1.0,37,7,1914,259,2173,59,FALSE
phptoast,4.0.0,4.0.1,36,2,110,35,145,6,FALSE
phptoast,2.1.1,2.2.0,6,2,76,76,152,74,FALSE
phptoast,4.1.0,4.2.0,38,4,539,94,633,28,FALSE
phptoast,3.0.0,3.1.0,9,2,75,1,76,3,FALSE
phptoast,3.16.0,3.16.1,29,2,119,26,145,3,FALSE
phptoast,3.16.1,3.17.0,30,2,68,2,70,3,FALSE
phptoast,3.10.0,3.11.0,21,4,172,8,180,8,FALSE
phptoast,3.15.0,3.15.1,27,2,42,94,136,3,FALSE
phptoast,3.11.0,3.12.0,22,2,2,2,4,2,FALSE
phptoast,3.12.0,3.13.0,23,2,135,2,137,3,FALSE
phptoast,3.13.1,3.14.0,25,2,83,2,85,3,FALSE
phptoast,3.13.0,3.13.1,24,2,5,5,10,3,FALSE
phptoast,3.3.1,3.4.0,13,2,65,3,68,3,FALSE
phptoast,2.3.0,3.0.0,8,2,657,81,738,6,FALSE
phptoast,3.18.0,3.18.1,32,2,13,7,20,5,FALSE
phptoast,3.18.1,3.19.0,33,2,281,2,283,3,FALSE
phptoast,3.19.0,3.20.0,34,2,132,4,136,3,FALSE
phptoast,3.9.0,3.10.0,20,4,204,17,221,7,FALSE
phptoast,3.8.0,3.9.0,19,4,243,3,246,7,FALSE
phptoast,4.5.0,4.6.0,42,3,492,5,497,7,FALSE
phptoast,3.4.0,3.5.0,14,2,107,2,109,3,FALSE
phptoast,4.4.0,4.5.0,41,5,329,11,340,11,FALSE
phptoast,3.5.1,3.6.0,16,2,156,2,158,3,FALSE
phptoast,3.5.0,3.5.1,15,2,28,2,30,3,FALSE
phptoast,3.6.0,3.7.0,17,4,652,3,655,14,FALSE
phptoast,3.3.0,3.3.1,12,1,1,1,2,1,FALSE
phptoast,4.2.0,4.3.0,39,2,189,2,191,3,FALSE
phptoast,3.2.0,3.3.0,11,3,238,3,241,5,FALSE
phptoast,4.3.0,4.4.0,40,3,152,2,154,5,FALSE
phptoast,3.20.0,4.0.0,35,2,113,21,134,5,FALSE
phptoast,3.7.0,3.8.0,18,2,120,2,122,4,FALSE
phptoast,3.15.1,3.16.0,28,2,101,4,105,3,FALSE
phptoast,2.2.0,2.3.0,7,5,345,5,350,9,TRUE
sandwich-expando,1.0.4,1.0.5,5,1,10,10,20,3,FALSE
sandwich-expando,1.0.5,1.1.0,6,1,11,11,22,2,FALSE
sandwich-expando,1.0.0,1.0.1,1,1,3,5,8,1,FALSE
sandwich-expando,1.0.1,1.0.2,2,1,10,10,20,3,FALSE
sandwich-expando,1.0.2,1.0.3,3,1,4,6,10,2,FALSE
sandwich-expando,1.0.3,1.0.4,4,2,3,1,4,3,FALSE
sandwich-expando,1.1.0,1.1.1,7,1,2,2,4,2,FALSE
sandwich-expando,1.0.1,1.0.2,2,1,10,10,20,3,TRUE
netsuite-fasttrack-toolkit-ss2,0.5.1,0.5.2,11,1,2,2,4,1,FALSE
netsuite-fasttrack-toolkit-ss2,0.5.2,0.5.3,12,5,382,15,397,8,FALSE
netsuite-fasttrack-toolkit-ss2,0.5.3,0.5.4,13,2,21,14,35,5,FALSE
netsuite-fasttrack-toolkit-ss2,0.3.0,0.4.0,6,8,330,266,596,34,FALSE
netsuite-fasttrack-toolkit-ss2,0.4.1,0.4.2,8,1,4,2,6,2,FALSE
netsuite-fasttrack-toolkit-ss2,0.2.4,0.3.0,5,2,89,43,132,4,FALSE
netsuite-fasttrack-toolkit-ss2,0.2.3,0.2.4,4,1,6,3,9,2,FALSE
netsuite-fasttrack-toolkit-ss2,0.2.2,0.2.3,3,4,16,20,36,11,FALSE
netsuite-fasttrack-toolkit-ss2,0.2.1,0.2.2,2,1,1,1,2,1,TRUE
netsuite-fasttrack-toolkit-ss2,0.2.0,0.2.1,1,13,228,315,543,39,FALSE
netsuite-fasttrack-toolkit-ss2,0.4.0,0.4.1,7,1,1,1,2,1,FALSE
netsuite-fasttrack-toolkit-ss2,0.4.2,0.5.0,9,9,597,121,718,28,FALSE
netsuite-fasttrack-toolkit-ss2,0.5.0,0.5.1,10,3,20,22,42,4,FALSE
netsuite-fasttrack-toolkit-ss2,0.2.1,0.2.2,2,1,1,1,2,1,FALSE
netsuite-fasttrack-toolkit-ss2,0.3.0,0.4.0,6,8,330,266,596,34,TRUE
netsuite-fasttrack-toolkit-ss2,0.2.4,0.3.0,5,2,89,43,132,4,TRUE
netsuite-fasttrack-toolkit-ss2,0.2.2,0.2.3,3,4,16,20,36,11,TRUE
netsuite-fasttrack-toolkit-ss2,0.2.0,0.2.1,1,13,228,315,543,39,TRUE
netsuite-fasttrack-toolkit-ss2,0.4.2,0.5.0,9,9,597,121,718,28,TRUE
netsuite-fasttrack-toolkit-ss2,0.5.0,0.5.1,10,3,20,22,42,4,TRUE
netsuite-fasttrack-toolkit-ss2,0.5.1,0.5.2,11,1,2,2,4,1,TRUE
netsuite-fasttrack-toolkit-ss2,0.5.2,0.5.3,12,5,382,15,397,8,TRUE
netsuite-fasttrack-toolkit-ss2,0.5.3,0.5.4,13,2,21,14,35,5,TRUE
bricks.js,1.1.1,1.1.2,4,3,7,7,14,5,FALSE
bricks.js,1.1.0,1.1.1,3,1,7,7,14,5,FALSE
bricks.js,1.1.2,1.2.0,5,3,286,256,542,11,FALSE
bricks.js,1.0.0,1.0.1,1,2,9,30,39,7,FALSE
bricks.js,1.0.1,1.1.0,2,5,26,17,43,11,FALSE
bricks.js,1.4.0,1.5.0,9,2,11,4,15,4,FALSE
bricks.js,1.5.0,1.6.0,10,5,37,7,44,7,FALSE
bricks.js,1.6.0,1.7.0,11,11,89,60,149,16,FALSE
bricks.js,1.3.0,1.4.0,8,6,16,12,28,8,FALSE
bricks.js,1.2.0,1.2.1,6,2,7,6,13,4,FALSE
bricks.js,1.2.1,1.3.0,7,4,62,56,118,21,FALSE
bricks.js,1.7.0,1.8.0,12,15,204,235,439,26,FALSE
bricks.js,1.1.1,1.1.2,4,3,7,7,14,5,TRUE
bricks.js,1.0.0,1.0.1,1,2,9,30,39,7,TRUE
bricks.js,1.0.1,1.1.0,2,5,26,17,43,11,TRUE
xroxy-proxy-scraper,1.0.0,1.0.1,1,1,1,1,2,1,TRUE
xroxy-proxy-scraper,1.0.1,1.0.3,2,2,10,27,37,5,FALSE
tracking-protection,1.0.4,1.0.5,5,1,6,2,8,3,FALSE
tracking-protection,1.0.5,1.0.6,6,2,4,4,8,2,FALSE
tracking-protection,1.0.6,1.0.7,7,1,18,2,20,2,TRUE
tracking-protection,1.0.7,1.0.8,8,1,211,157,368,13,FALSE
tracking-protection,1.0.0,1.0.1,1,3,5,3,8,3,FALSE
tracking-protection,1.0.1,1.0.2,2,3,9,9,18,6,FALSE
tracking-protection,1.0.2,1.0.3,3,1,8,6,14,3,FALSE
tracking-protection,1.0.3,1.0.4,4,1,14,3,17,3,FALSE
tracking-protection,1.1.0,1.1.1,10,2,3,6,9,2,TRUE
tracking-protection,1.0.8,1.1.0,9,4,85,35,120,10,FALSE
tracking-protection,1.0.6,1.0.7,7,1,18,2,20,2,FALSE
tracking-protection,1.1.0,1.1.1,10,2,3,6,9,2,FALSE
tracking-protection,1.1.3,1.1.4,13,2,33,12,45,6,FALSE
tracking-protection,1.1.2,1.1.3,12,11,8796,2989,11785,18,FALSE
tracking-protection,1.1.1,1.1.2,11,3,7,6,13,3,FALSE
tracking-protection,1.1.5,1.1.6,15,1,2,2,4,2,FALSE
tracking-protection,1.1.4,1.1.5,14,2,3,3,6,3,FALSE
tracking-protection,1.1.1,1.1.2,11,3,7,6,13,3,TRUE
tracking-protection,1.0.2,1.0.3,3,1,8,6,14,3,TRUE
mws-sdk-promises,0.9.8,0.9.9,1,1,18,18,36,2,FALSE
mws-sdk-promises,0.9.9,0.9.10,2,1,152,142,294,9,FALSE
mws-sdk-promises,0.9.12,0.9.13,5,5,52,12,64,6,FALSE
mws-sdk-promises,0.9.13,0.9.14,6,5,9,3,12,6,FALSE
mws-sdk-promises,0.9.10,0.9.11,3,1,4,0,4,1,FALSE
mws-sdk-promises,0.9.11,0.9.12,4,1,4,3,7,2,FALSE
mws-sdk-promises,0.9.16,0.9.17,9,5,190,1,191,13,FALSE
mws-sdk-promises,0.9.14,0.9.15,7,3,18,14,32,4,TRUE
mws-sdk-promises,0.9.15,0.9.16,8,4,33,21,54,6,FALSE
mws-sdk-promises,0.9.14,0.9.15,7,3,18,14,32,4,FALSE
persistent-c,6.0.0,7.0.0,37,4,53,23,76,6,FALSE
persistent-c,3.0.0,4.0.0,11,2,45,29,74,5,FALSE
persistent-c,9.1.0,9.2.0,43,8,49,56,105,9,FALSE
persistent-c,9.0.0,9.0.1,41,2,54,43,97,5,FALSE
persistent-c,9.0.1,9.1.0,42,3,22,17,39,3,FALSE
persistent-c,5.1.0,5.1.1,17,2,2,2,4,2,FALSE
persistent-c,10.1.1,10.2.0,53,3,36,1,37,3,FALSE
persistent-c,4.0.1,5.0.0,13,4,201,94,295,6,FALSE
persistent-c,5.5.0,5.6.0,28,3,25,4,29,3,FALSE
persistent-c,5.4.0,5.5.0,27,3,3,2,5,3,FALSE
persistent-c,9.5.0,10.0.0,50,3,443,395,838,12,FALSE
persistent-c,5.6.3,5.6.4,32,2,2,1,3,2,FALSE
persistent-c,4.0.0,4.0.1,12,2,5,1,6,2,FALSE
persistent-c,5.0.2,5.1.0,16,3,38,3,41,3,FALSE
persistent-c,5.2.2,5.2.3,23,4,25,5,30,4,FALSE
persistent-c,5.2.3,5.2.4,24,2,5,5,10,3,FALSE
persistent-c,5.2.0,5.2.1,21,2,2,2,4,2,FALSE
persistent-c,5.2.1,5.2.2,22,1,1,1,2,1,FALSE
persistent-c,5.2.4,5.3.0,25,9,153,76,229,12,FALSE
persistent-c,5.1.1,5.1.2,18,2,2,2,4,2,FALSE
persistent-c,5.3.0,5.4.0,26,2,25,7,32,2,FALSE
persistent-c,5.0.0,5.0.1,14,5,5,8,13,5,TRUE
persistent-c,5.0.1,5.0.2,15,3,41,24,65,3,FALSE
persistent-c,7.0.0,8.0.0,38,2,52,42,94,3,FALSE
persistent-c,9.4.0,9.4.1,48,2,2,2,4,2,FALSE
persistent-c,9.4.1,9.5.0,49,6,129,60,189,12,FALSE
persistent-c,8.0.1,9.0.0,40,12,362,222,584,14,FALSE
persistent-c,8.0.0,8.0.1,39,6,8,8,16,6,FALSE
persistent-c,5.1.3,5.2.0,20,2,3,3,6,2,FALSE
persistent-c,5.1.2,5.1.3,19,2,6,6,12,2,FALSE
persistent-c,5.7.2,5.7.3,35,3,5,5,10,3,FALSE
persistent-c,5.6.4,5.7.0,33,3,17,8,25,3,FALSE
persistent-c,5.7.0,5.7.2,34,16,350,229,579,27,FALSE
persistent-c,5.6.2,5.6.3,31,3,5,5,10,4,FALSE
persistent-c,10.0.0,10.1.0,51,4,40,27,67,5,FALSE
persistent-c,5.6.0,5.6.1,29,2,2,2,4,2,FALSE
persistent-c,5.6.1,5.6.2,30,2,6,2,8,3,FALSE
persistent-c,10.1.0,10.1.1,52,2,7,4,11,2,FALSE
persistent-c,9.3.0,9.4.0,47,2,35,21,56,3,FALSE
persistent-c,9.2.2,9.3.0,46,3,6,7,13,3,FALSE
persistent-c,9.2.0,9.2.1,44,2,14,11,25,2,FALSE
persistent-c,9.2.1,9.2.2,45,2,6,4,10,2,FALSE
persistent-c,1.0.0,1.0.1,7,2,2,3,5,2,FALSE
persistent-c,1.0.1,2.0.0,8,2,2,2,4,2,FALSE
persistent-c,2.0.0,2.1.0,9,3,66,27,93,6,FALSE
persistent-c,0.1.0,0.1.1,1,2,2,1,3,2,FALSE
persistent-c,0.1.1,0.1.2,2,2,16,4,20,3,FALSE
persistent-c,0.1.2,0.1.3,3,2,2,1,3,2,FALSE
persistent-c,0.1.3,0.1.4,4,2,1,3,4,2,FALSE
persistent-c,0.1.4,0.1.5,5,2,6,16,22,2,FALSE
persistent-c,0.1.5,1.0.0,6,2,8,60,68,2,FALSE
persistent-c,2.1.0,3.0.0,10,6,394,199,593,11,FALSE
persistent-c,5.2.4,5.3.0,25,9,153,76,229,12,TRUE
persistent-c,5.0.0,5.0.1,14,5,5,8,13,5,FALSE
persistent-c,5.0.1,5.0.2,15,3,41,24,65,3,TRUE
persistent-c,5.7.0,5.7.2,34,16,350,229,579,27,TRUE
lettersorter,0.0.15,0.0.16,15,1,47,11,58,7,FALSE
lettersorter,0.0.14,0.0.15,14,1,47,11,58,7,FALSE
lettersorter,0.0.17,0.0.18,17,1,152,10,162,6,FALSE
lettersorter,0.0.16,0.0.17,16,2,657,123,780,14,FALSE
lettersorter,0.0.11,0.0.12,11,1,6,2,8,3,FALSE
lettersorter,0.0.10,0.0.11,10,1,116,110,226,3,FALSE
lettersorter,0.0.13,0.0.14,13,1,47,11,58,7,FALSE
lettersorter,0.0.12,0.0.13,12,1,9,7,16,7,FALSE
lettersorter,0.1.1,0.1.2,31,1,2,2,4,1,TRUE
lettersorter,0.1.2,0.1.3,32,1,1,2,3,1,FALSE
lettersorter,0.1.3,0.1.5,33,1,47,11,58,7,FALSE
lettersorter,0.0.19,0.0.20,19,2,1754,1928,3682,26,FALSE
lettersorter,0.0.18,0.0.19,18,3,14,6,20,6,FALSE
lettersorter,0.1.6,0.1.7,35,1,11,3,14,3,FALSE
lettersorter,0.0.30,0.1.1,30,1,480,100,580,9,FALSE
lettersorter,0.0.5,0.0.6,5,1,29,9,38,5,FALSE
lettersorter,0.0.4,0.0.5,4,2,271,10,281,10,FALSE
lettersorter,0.0.7,0.0.8,7,17,3432,3027,6459,96,FALSE
lettersorter,0.0.6,0.0.7,6,10,172,28,200,14,FALSE
lettersorter,0.0.1,0.0.2,1,1,3,3,6,2,FALSE
lettersorter,0.0.3,0.0.4,3,1,20,11,31,4,FALSE
lettersorter,0.0.2,0.0.3,2,1,68,7,75,4,FALSE
lettersorter,0.0.9,0.0.10,9,1,47,11,58,7,FALSE
lettersorter,0.0.8,0.0.9,8,1,2,2,4,2,FALSE
lettersorter,0.1.5,0.1.6,34,1,45,20,65,7,FALSE
lettersorter,0.1.7,0.1.8,36,1,47,11,58,7,FALSE
lettersorter,0.9.1,0.9.2,38,1,47,11,58,7,FALSE
lettersorter,0.9.2,0.9.3,39,1,47,11,58,7,FALSE
lettersorter,0.9.3,0.9.4,40,1,47,11,58,7,FALSE
lettersorter,0.0.20,0.0.21,20,2,658,5,663,8,FALSE
lettersorter,0.0.21,0.0.22,21,1,36,3,39,6,FALSE
lettersorter,0.0.22,0.0.23,22,1,6,34,40,6,FALSE
lettersorter,0.0.23,0.0.24,23,2,32,7,39,6,FALSE
lettersorter,0.0.24,0.0.25,24,1,5,2,7,3,FALSE
lettersorter,0.0.25,0.0.26,25,2,22,7,29,5,FALSE
lettersorter,0.0.26,0.0.27,26,1,15,3,18,5,FALSE
lettersorter,0.0.27,0.0.28,27,2,9,9,18,3,FALSE
lettersorter,0.0.28,0.0.29,28,1,8,1,9,3,FALSE
lettersorter,0.0.29,0.0.30,29,1,43,17,60,7,FALSE
lettersorter,0.1.8,0.9.1,37,1,47,11,58,7,FALSE
lettersorter,0.1.1,0.1.2,31,1,2,2,4,1,FALSE
lettersorter,0.1.3,0.1.5,33,1,47,11,58,7,TRUE
lettersorter,0.0.20,0.0.21,20,2,658,5,663,8,TRUE
lettersorter,0.0.23,0.0.24,23,2,32,7,39,6,TRUE
fellowshipone,0.0.1,0.0.2,1,15,535,148,683,24,FALSE
fellowshipone,0.0.2,0.1.0,2,31,4145,1848,5993,62,FALSE
fellowshipone,0.3.2,0.3.3,18,48,1391,845,2236,123,FALSE
fellowshipone,0.3.3,0.3.4,19,18,86,70,156,31,FALSE
fellowshipone,0.3.0,0.3.1,16,2,40,2,42,3,FALSE
fellowshipone,0.3.1,0.3.2,17,3,6,6,12,3,FALSE
fellowshipone,0.2.7,0.2.8,13,2,133,19,152,7,FALSE
fellowshipone,0.2.6,0.2.7,12,6,57,69,126,7,FALSE
fellowshipone,0.2.5,0.2.6,11,1,3,6,9,2,FALSE
fellowshipone,0.2.4,0.2.5,10,2,8,4,12,3,FALSE
fellowshipone,0.2.3,0.2.4,9,1,2,2,4,2,FALSE
fellowshipone,0.2.2,0.2.3,8,1,3,3,6,3,FALSE
fellowshipone,0.2.1,0.2.2,7,1,44,1,45,4,FALSE
fellowshipone,0.2.0,0.2.1,6,1,5,5,10,5,FALSE
fellowshipone,0.1.0,0.1.1,3,2,4,1,5,2,FALSE
fellowshipone,0.1.1,0.1.2,4,1,23,11,34,5,FALSE
fellowshipone,0.1.2,0.2.0,5,5,373,6,379,24,FALSE
fellowshipone,0.2.9,0.3.0,15,1,1,1,2,1,FALSE
fellowshipone,0.2.8,0.2.9,14,7,500,100,600,26,FALSE
fellowshipone,0.3.3,0.3.4,19,18,86,70,156,31,TRUE
fellowshipone,0.1.2,0.2.0,5,5,373,6,379,24,TRUE
fellowshipone,0.0.1,0.0.2,1,15,535,148,683,24,TRUE
fellowshipone,0.3.2,0.3.3,18,48,1391,845,2236,123,TRUE
fellowshipone,0.0.2,0.1.0,2,31,4145,1848,5993,62,TRUE
fellowshipone,0.2.1,0.2.2,7,1,44,1,45,4,TRUE
idsp-web-seed2-paging,1.0.4,1.0.5,5,1,5,4,9,2,FALSE
idsp-web-seed2-paging,1.0.5,1.0.6,6,2,78,31,109,6,FALSE
idsp-web-seed2-paging,1.0.6,1.0.7,7,1,27,13,40,4,FALSE
idsp-web-seed2-paging,1.0.7,1.0.8,8,1,6,6,12,2,FALSE
idsp-web-seed2-paging,1.0.0,1.0.1,1,1,27,13,40,4,FALSE
idsp-web-seed2-paging,1.0.1,1.0.2,2,1,27,13,40,4,FALSE
idsp-web-seed2-paging,1.0.2,1.0.3,3,1,27,13,40,4,FALSE
idsp-web-seed2-paging,1.0.3,1.0.4,4,1,35,10,45,4,FALSE
idsp-web-seed2-paging,1.0.8,1.0.9,9,1,9,46,55,4,TRUE
idsp-web-seed2-paging,1.0.9,1.0.10,10,1,191,1,192,2,FALSE
idsp-web-seed2-paging,1.0.12,1.0.13,13,1,27,13,40,4,FALSE
idsp-web-seed2-paging,1.0.10,1.0.11,11,1,3,3,6,2,FALSE
idsp-web-seed2-paging,1.0.11,1.0.12,12,2,278,27,305,11,TRUE
idsp-web-seed2-paging,1.0.8,1.0.9,9,1,9,46,55,4,FALSE
idsp-web-seed2-paging,1.0.9,1.0.10,10,1,191,1,192,2,TRUE
idsp-web-seed2-paging,1.0.11,1.0.12,12,2,278,27,305,11,FALSE
levelgraph-query,1.0.0,1.0.1,1,2,25,25,50,5,TRUE
levelgraph-query,1.0.1,1.0.2,2,4,7,3,10,4,FALSE
levelgraph-query,1.0.2,1.0.3,3,2,3,3,6,3,FALSE
levelgraph-query,1.0.3,1.0.4,4,3,7,6,13,4,FALSE
levelgraph-query,1.0.0,1.0.1,1,2,25,25,50,5,FALSE
redux-waitfor-middleware,1.0.0,1.0.1,1,3,514,4,518,12,TRUE
redux-waitfor-middleware,1.0.0,1.0.1,1,3,514,4,518,12,FALSE
crossref,0.1.0,0.1.1,1,4,28,23,51,11,FALSE
crossref,0.1.1,0.1.2,2,1,2,2,4,1,FALSE
crossref,1.0.4,1.0.5,8,3,70,77,147,5,FALSE
crossref,1.0.5,1.0.6,9,2,3,3,6,3,FALSE
crossref,1.0.6,1.0.7,10,2,3,3,6,3,FALSE
crossref,1.0.7,1.0.8,11,3,14,28,42,5,FALSE
crossref,1.0.0,1.0.1,4,2,4,4,8,2,FALSE
crossref,1.0.1,1.0.2,5,2,8,7,15,4,FALSE
crossref,1.0.2,1.0.3,6,2,4,4,8,2,FALSE
crossref,1.0.3,1.0.4,7,3,8,8,16,4,TRUE
crossref,1.1.0,1.2.0,13,6,74,55,129,8,FALSE
crossref,1.0.8,1.1.0,12,7,108,91,199,12,FALSE
crossref,1.2.0,1.2.1,14,2,30,23,53,3,FALSE
crossref,0.1.2,1.0.0,3,2,75,70,145,6,FALSE
crossref,0.1.2,1.0.0,3,2,75,70,145,6,TRUE
crossref,1.0.3,1.0.4,7,3,8,8,16,4,FALSE
crossref,1.1.0,1.2.0,13,6,74,55,129,8,TRUE
vue-search-select,1.0.0,1.0.1,1,3,10585,222,10807,14,FALSE
vue-search-select,1.0.4,1.0.5,5,1,19,11,30,4,FALSE
vue-search-select,1.0.5,1.0.6,6,3,24,10613,10637,10,FALSE
vue-search-select,1.0.6,1.0.7,7,1,2,1,3,2,FALSE
vue-search-select,1.0.7,1.0.8,8,2,2,2,4,2,FALSE
vue-search-select,1.0.1,1.0.2,2,1,54,21,75,2,FALSE
vue-search-select,1.0.2,1.0.3,3,4,6,10,16,4,FALSE
vue-search-select,1.0.3,1.0.4,4,2,14,4,18,2,FALSE
vue-search-select,1.1.0,1.1.1,10,7,10871,22,10893,48,FALSE
vue-search-select,1.1.6,1.2.0,16,4,182,153,335,27,FALSE
vue-search-select,1.0.8,1.1.0,9,1,80,5,85,7,FALSE
vue-search-select,1.1.3,1.1.4,13,2,5,6,11,6,FALSE
vue-search-select,1.1.2,1.1.3,12,2,62,99,161,7,FALSE
vue-search-select,1.1.1,1.1.2,11,2,21,11,32,4,FALSE
vue-search-select,1.2.0,1.2.1,17,1,25,4,29,2,FALSE
vue-search-select,1.1.5,1.1.6,15,6,131,92,223,33,FALSE
vue-search-select,1.1.4,1.1.5,14,1,3,4,7,4,FALSE
vue-search-select,1.1.6,1.2.0,16,4,182,153,335,27,TRUE
vue-search-select,2.0.2,2.3.0,21,8,5461,10378,15839,137,FALSE
vue-search-select,2.0.1,2.0.2,20,1,53,53,106,3,FALSE
vue-search-select,2.0.0,2.0.1,19,1,1,1,2,1,FALSE
vue-search-select,2.3.0,2.3.1,22,6,5832,24,5856,16,FALSE
vue-search-select,2.3.1,2.3.2,23,1,140,114,254,5,FALSE
vue-search-select,2.3.2,2.3.3,24,1,1158,958,2116,15,FALSE
vue-search-select,2.3.3,2.3.4,25,4,358,118,476,14,FALSE
vue-search-select,2.3.4,2.3.5,26,6,402,484,886,57,FALSE
vue-search-select,2.3.5,2.3.6,27,2,304,62,366,28,FALSE
vue-search-select,2.3.6,2.3.7,28,5,311,120,431,14,FALSE
vue-search-select,2.3.7,2.3.8-alpha.0,29,3,1686,352,2038,38,FALSE
vue-search-select,1.2.1,2.0.0,18,14,45003,24870,69873,198,FALSE
vue-search-select,2.3.8-alpha.1,2.3.8,31,9,421,109,530,24,FALSE
vue-search-select,2.3.8-alpha.0,2.3.8-alpha.1,30,9,5288,817,6105,47,FALSE
vue-search-select,2.3.0,2.3.1,22,6,5832,24,5856,16,TRUE
vue-search-select,2.0.2,2.3.0,21,8,5461,10378,15839,137,TRUE
vue-search-select,2.3.4,2.3.5,26,6,402,484,886,57,TRUE
vue-search-select,1.1.3,1.1.4,13,2,5,6,11,6,TRUE
vue-search-select,2.3.3,2.3.4,25,4,358,118,476,14,TRUE
vue-search-select,2.3.2,2.3.3,24,1,1158,958,2116,15,TRUE
vue-search-select,1.0.4,1.0.5,5,1,19,11,30,4,TRUE
vue-search-select,1.2.1,2.0.0,18,14,45003,24870,69873,198,TRUE
vue-search-select,2.3.5,2.3.6,27,2,304,62,366,28,TRUE
vue-search-select,2.3.7,2.3.8-alpha.0,29,3,1686,352,2038,38,TRUE
react-komposer-native,0.0.1,0.0.2,1,1,1,1,2,1,FALSE
react-komposer-native,0.0.2,0.0.3,2,8,1079,361,1440,14,FALSE
react-komposer-native,0.0.2,0.0.3,2,8,1079,361,1440,14,TRUE
js-joda,0.3.8,0.3.9,9,13,1057,721,1778,17,FALSE
js-joda,0.3.9,0.3.10,10,10,519,98,617,20,FALSE
js-joda,0.3.6,0.3.7,7,41,3622,1351,4973,56,FALSE
js-joda,0.3.7,0.3.8,8,8,449,172,621,21,FALSE
js-joda,0.2.5,0.3.6,6,34,6838,4663,11501,60,FALSE
js-joda,0.2.4,0.2.5,5,31,11361,11183,22544,57,FALSE
js-joda,0.2.3,0.2.4,4,92,22827,10272,33099,199,FALSE
js-joda,0.2.2,0.2.3,3,82,20823,6382,27205,298,FALSE
js-joda,1.4.0,1.5.0,41,19,2660,2578,5238,125,FALSE
js-joda,1.5.1,1.5.2,43,19,1519,1487,3006,36,FALSE
js-joda,1.5.0,1.5.1,42,5,19,6,25,8,FALSE
js-joda,1.3.1,1.4.0,40,4,19,58,77,9,FALSE
js-joda,1.3.0,1.3.1,39,46,13241,12505,25746,99,FALSE
js-joda,1.2.0,1.3.0,38,3,169,28,197,7,FALSE
js-joda,1.1.15,1.1.16,35,2,19,24,43,6,FALSE
js-joda,1.1.14,1.1.15,34,15,8695,4469,13164,53,FALSE
js-joda,1.1.17,1.2.0,37,29,824,604,1428,44,FALSE
js-joda,1.1.16,1.1.17,36,2,7,13,20,5,FALSE
js-joda,1.1.1,1.1.2,21,29,243,196,439,34,FALSE
js-joda,1.1.0,1.1.1,20,8,2246,2035,4281,28,FALSE
js-joda,1.1.3,1.1.4,23,1,3,3,6,3,FALSE
js-joda,1.1.2,1.1.3,22,4,50,44,94,9,FALSE
js-joda,1.1.5,1.1.6,25,6,375,28,403,11,FALSE
js-joda,1.0.1,1.0.2,18,5,183,870,1053,13,FALSE
js-joda,1.0.2,1.1.0,19,80,18413,5564,23977,207,FALSE
js-joda,1.1.6,1.1.7,26,2,22,6,28,6,FALSE
js-joda,1.1.9,1.1.10,29,16,1047,555,1602,44,FALSE
js-joda,1.1.8,1.1.9,28,52,3095,1112,4207,76,FALSE
js-joda,0.2.1,0.2.2,2,224,21862,3438,25300,445,FALSE
js-joda,0.2.0,0.2.1,1,1,1,1,2,1,FALSE
js-joda,1.1.4,1.1.5,24,8,125,44,169,18,FALSE
js-joda,1.1.7,1.1.8,27,2,2073,2074,4147,6,FALSE
js-joda,0.3.14,0.9.1,15,102,21217,12251,33468,217,FALSE
js-joda,0.3.10,0.3.11,11,16,898,571,1469,32,FALSE
js-joda,0.3.11,0.3.12,12,37,8179,4510,12689,70,FALSE
js-joda,0.3.12,0.3.13,13,12,1104,214,1318,24,FALSE
js-joda,0.3.13,0.3.14,14,16,1983,78,2061,26,FALSE
js-joda,0.9.1,0.9.3,16,43,16573,7958,24531,122,FALSE
js-joda,0.9.3,1.0.1,17,4,8,8,16,5,FALSE
js-joda,1.1.11,1.1.12,31,138,17092,5589,22681,740,FALSE
js-joda,1.1.10,1.1.11,30,8,735,175,910,19,FALSE
js-joda,1.1.13,1.1.14,33,29,9528,8767,18295,364,FALSE
js-joda,1.1.12,1.1.13,32,39,5697,2160,7857,137,FALSE
js-joda,1.1.2,1.1.3,22,4,50,44,94,9,TRUE
js-joda,0.2.4,0.2.5,5,31,11361,11183,22544,57,TRUE
js-joda,1.1.6,1.1.7,26,2,22,6,28,6,TRUE
js-joda,1.1.1,1.1.2,21,29,243,196,439,34,TRUE
js-joda,0.3.11,0.3.12,12,37,8179,4510,12689,70,TRUE
js-joda,0.3.13,0.3.14,14,16,1983,78,2061,26,TRUE
js-joda,1.1.12,1.1.13,32,39,5697,2160,7857,137,TRUE
js-joda,1.1.17,1.2.0,37,29,824,604,1428,44,TRUE
js-joda,1.4.0,1.5.0,41,19,2660,2578,5238,125,TRUE
js-joda,1.5.1,1.5.2,43,19,1519,1487,3006,36,TRUE
js-joda,1.5.0,1.5.1,42,5,19,6,25,8,TRUE
js-joda,1.3.0,1.3.1,39,46,13241,12505,25746,99,TRUE
js-joda,1.2.0,1.3.0,38,3,169,28,197,7,TRUE
js-joda,1.1.13,1.1.14,33,29,9528,8767,18295,364,TRUE
js-joda,1.1.14,1.1.15,34,15,8695,4469,13164,53,TRUE
js-joda,1.1.10,1.1.11,30,8,735,175,910,19,TRUE
js-joda,0.9.3,1.0.1,17,4,8,8,16,5,TRUE
rapid.js,0.0.5,0.0.6,5,4,25383,36,25419,54,FALSE
rapid.js,0.0.4,0.0.5,4,6,86,89,175,31,FALSE
rapid.js,0.0.7,0.0.8,7,2,34,22,56,3,FALSE
rapid.js,0.0.6,0.0.7,6,2,188,77,265,6,FALSE
rapid.js,0.0.1,0.0.2,1,3,8,5,13,4,FALSE
rapid.js,0.0.3,0.0.4,3,2,1,342525,342526,4690,FALSE
rapid.js,0.0.2,0.0.3,2,3,2004,2724,4728,103,FALSE
rapid.js,0.0.6,0.0.7,6,2,188,77,265,6,TRUE
swagger-to-html,0.3.0,0.4.0,11,7,231,6,237,23,FALSE
swagger-to-html,0.2.3,0.3.0,10,9,694,234,928,69,FALSE
swagger-to-html,0.2.2,0.2.3,9,2,17,5,22,4,FALSE
swagger-to-html,0.2.1,0.2.2,8,2,123,33,156,9,FALSE
swagger-to-html,0.2.0,0.2.1,7,4,17,14,31,4,FALSE
swagger-to-html,0.0.5,0.1.0,5,2,948,62,1010,11,FALSE
swagger-to-html,0.0.4,0.0.5,4,2,2,2,4,2,FALSE
swagger-to-html,0.0.1,0.0.2,1,2,3,3,6,2,FALSE
swagger-to-html,0.0.3,0.0.4,3,2,1,6,7,2,FALSE
swagger-to-html,0.0.2,0.0.3,2,2,2,2,4,2,FALSE
swagger-to-html,0.1.0,0.2.0,6,18,609,209,818,51,FALSE
swagger-to-html,0.2.1,0.2.2,8,2,123,33,156,9,TRUE
redux-replicate-fs,1.0.0,1.0.1,6,2,28,7,35,5,FALSE
redux-replicate-fs,1.0.1,1.0.2,7,2,2,6,8,3,FALSE
redux-replicate-fs,3.0.0,3.0.1,17,2,15,4,19,2,FALSE
redux-replicate-fs,1.0.3,2.0.0-alpha.0,9,2,124,57,181,4,FALSE
redux-replicate-fs,2.0.0-alpha.6,3.0.0,16,2,34,15,49,3,FALSE
redux-replicate-fs,2.0.0-alpha.4,2.0.0-alpha.5,14,2,4,2,6,2,FALSE
redux-replicate-fs,2.0.0-alpha.5,2.0.0-alpha.6,15,2,49,2,51,2,FALSE
redux-replicate-fs,2.0.0-alpha.2,2.0.0-alpha.3,12,3,67,24,91,4,FALSE
redux-replicate-fs,2.0.0-alpha.3,2.0.0-alpha.4,13,2,10,8,18,2,FALSE
redux-replicate-fs,2.0.0-alpha.0,2.0.0-alpha.1,10,1,7,5,12,2,FALSE
redux-replicate-fs,2.0.0-alpha.1,2.0.0-alpha.2,11,3,149,77,226,3,FALSE
redux-replicate-fs,1.0.2,1.0.3,8,3,13,4,17,3,FALSE
redux-replicate-fs,0.3.2,1.0.0,5,3,174,148,322,4,FALSE
redux-replicate-fs,0.3.1,0.3.2,4,2,5,11,16,3,FALSE
redux-replicate-fs,3.0.0,3.0.1,17,2,15,4,19,2,TRUE
redux-replicate-fs,1.0.3,2.0.0-alpha.0,9,2,124,57,181,4,TRUE
redux-replicate-fs,0.3.0,0.3.1,3,2,32,6,38,6,FALSE
redux-replicate-fs,0.2.0,0.3.0,2,2,43,19,62,3,FALSE
redux-replicate-fs,0.1.2,0.2.0,1,1,1,1,2,1,FALSE
redux-replicate-fs,2.0.0-alpha.2,2.0.0-alpha.3,12,3,67,24,91,4,TRUE
redux-replicate-fs,0.3.0,0.3.1,3,2,32,6,38,6,TRUE
fast-validator,1.0.0,1.0.1,4,4,1235,303,1538,25,FALSE
fast-validator,1.0.1,1.0.2,5,4,97,51,148,9,FALSE
fast-validator,0.0.3,1.0.0,3,42,1791,817,2608,194,FALSE
fast-validator,0.0.2,0.0.3,2,1,6,13,19,2,FALSE
fast-validator,0.0.1,0.0.2,1,2,13339,13101,26440,62,FALSE
fast-validator,1.0.2,1.0.3,6,3,24,14,38,4,FALSE
fast-validator,0.0.1,0.0.2,1,2,13339,13101,26440,62,TRUE
gonebusy-nodejs-client,0.1.0,0.1.1,9,1,1278,1152,2430,99,FALSE
gonebusy-nodejs-client,0.0.5,0.0.6,4,3,15,5,20,5,FALSE
gonebusy-nodejs-client,0.0.4,0.0.5,3,1,8,130,138,7,FALSE
gonebusy-nodejs-client,0.0.7,0.0.8,6,1,39,8,47,5,FALSE
gonebusy-nodejs-client,0.0.6,0.0.7,5,2,13,4,17,5,FALSE
gonebusy-nodejs-client,0.0.3,0.0.4,2,2,44,40,84,8,FALSE
gonebusy-nodejs-client,0.0.2,0.0.3,1,24,4306,880,5186,143,FALSE
gonebusy-nodejs-client,0.0.9,0.1.0,8,4,8963,10564,19527,133,FALSE
gonebusy-nodejs-client,0.0.8,0.0.9,7,4,46,32,78,21,FALSE
gonebusy-nodejs-client,0.0.5,0.0.6,4,3,15,5,20,5,TRUE
gonebusy-nodejs-client,0.0.6,0.0.7,5,2,13,4,17,5,TRUE
redux-viewmodel,0.0.1,0.1.0,1,1,386,10,396,15,FALSE
redux-viewmodel,0.3.0,0.3.1,8,2,7,3,10,3,FALSE
redux-viewmodel,0.3.1,0.4.0,9,1,47,16,63,3,FALSE
redux-viewmodel,0.1.0,0.1.1,2,3,14,15,29,9,FALSE
redux-viewmodel,0.2.1,0.3.0,7,2,230,85,315,9,FALSE
redux-viewmodel,0.2.0,0.2.1,6,3,127,49,176,9,FALSE
redux-viewmodel,0.4.1,0.4.2,11,1,13,5,18,3,FALSE
redux-viewmodel,0.1.1,0.1.2,3,1,268,1,269,2,FALSE
redux-viewmodel,0.1.2,0.1.3,4,6,44,7,51,8,FALSE
redux-viewmodel,0.1.3,0.2.0,5,3,150,40,190,9,FALSE
redux-viewmodel,0.4.0,0.4.1,10,1,3,1,4,3,FALSE
redux-viewmodel,0.1.3,0.2.0,5,3,150,40,190,9,TRUE
redux-viewmodel,0.3.0,0.3.1,8,2,7,3,10,3,TRUE
redux-viewmodel,0.2.0,0.2.1,6,3,127,49,176,9,TRUE
redux-viewmodel,0.4.1,0.4.2,11,1,13,5,18,3,TRUE
static-base-contrib,0.3.0,0.4.0,3,4,649,146,795,47,FALSE
static-base-contrib,1.0.0,1.0.1,14,2,29,18,47,14,FALSE
static-base-contrib,1.0.1,1.0.2,15,1,5,3,8,3,FALSE
static-base-contrib,1.0.2,1.0.3,16,1,15,7,22,4,FALSE
static-base-contrib,0.5.0,0.5.1,10,1,2,2,4,1,FALSE
static-base-contrib,0.6.1,1.0.0,13,1,654,276,930,38,FALSE
static-base-contrib,0.6.0,0.6.1,12,1,3,3,6,3,FALSE
static-base-contrib,0.4.4,0.4.5,8,1,3,3,6,3,FALSE
static-base-contrib,0.4.1,0.4.2,5,2,334,291,625,31,FALSE
static-base-contrib,0.2.0,0.3.0,2,1,186,104,290,23,FALSE
static-base-contrib,0.1.0,0.2.0,1,1,537,160,697,25,FALSE
static-base-contrib,0.4.0,0.4.1,4,1,15,7,22,4,FALSE
static-base-contrib,0.4.3,0.4.4,7,1,52,17,69,6,FALSE
static-base-contrib,0.4.2,0.4.3,6,1,37,12,49,4,FALSE
static-base-contrib,0.4.5,0.5.0,9,1,193,120,313,14,FALSE
static-base-contrib,0.5.1,0.6.0,11,1,94,6,100,7,FALSE
static-base-contrib,0.4.5,0.5.0,9,1,193,120,313,14,TRUE
frest,0.1.0,0.2.0,2,9,1048,164,1212,34,FALSE
frest,0.1.0-dev.0,0.1.0,1,6,7071,390,7461,40,FALSE
frest,0.3.0,0.4.0,4,7,787,209,996,50,FALSE
frest,0.2.0,0.3.0,3,4,146,18,164,10,FALSE
frest,0.2.0,0.3.0,3,4,146,18,164,10,TRUE
frest,0.1.0,0.2.0,2,9,1048,164,1212,34,TRUE
frest,0.1.0-dev.0,0.1.0,1,6,7071,390,7461,40,TRUE
crds-core,1.6.4-rc.0,1.7.0,274,2,277,13,290,17,FALSE
crds-core,0.0.53-22,0.0.53-23,52,1,2,2,4,2,FALSE
crds-core,0.0.53-23,0.0.53-24,53,1,2,2,4,2,FALSE
crds-core,0.0.53-20,0.0.53-21,50,1,0,1,1,1,FALSE
crds-core,0.0.53-21,0.0.53-22,51,1,2,2,4,2,FALSE
crds-core,0.0.53-26,0.0.53-27,56,1,0,1,1,1,FALSE
crds-core,0.0.53-27,0.0.53,57,1,2,2,4,2,FALSE
crds-core,0.0.53-24,0.0.53-25,54,3,3922,15,3937,7,FALSE
crds-core,0.0.53-25,0.0.53-26,55,1,1,1,2,1,FALSE
crds-core,0.0.168,0.0.169,178,4,8,4,12,4,FALSE
crds-core,0.0.169,0.0.170,179,2,5,111,116,11,FALSE
crds-core,0.0.161,0.0.162,171,1,1,1,2,1,FALSE
crds-core,0.0.162,0.0.163,172,6,38,16,54,9,FALSE
crds-core,0.0.163,0.0.164,173,2,272,33,305,12,FALSE
crds-core,0.0.164,0.0.165,174,4,376,47,423,23,FALSE
crds-core,0.0.165,0.0.166,175,3,31,27,58,3,FALSE
crds-core,0.0.166,0.0.167,176,2,3,2,5,2,FALSE
crds-core,0.0.167,0.0.168,177,4,7,113,120,13,FALSE
crds-core,1.12.0,1.12.1,317,2,2,2,4,2,FALSE
crds-core,1.12.1,1.12.2-rc.0,318,2,2,2,4,2,FALSE
crds-core,1.12.2,1.13.0,324,2,276,68,344,10,FALSE
crds-core,1.10.2,1.11.0,310,1,1,1,2,1,FALSE
crds-core,1.10.0,1.10.1,301,2,2,2,4,2,FALSE
crds-core,1.10.1,1.10.2-rc.0,302,3,19,24,43,4,FALSE
crds-core,1.16.0,1.16.1,354,1,1,1,2,1,FALSE
crds-core,1.16.1,1.16.2-rc.0,355,2,10,10,20,2,FALSE
crds-core,1.16.2,1.17.0,360,1,1,1,2,1,TRUE
crds-core,0.0.73,0.0.74,84,1,1,1,2,1,FALSE
crds-core,0.0.72,0.0.73,83,4,42,14,56,13,FALSE
crds-core,0.0.71,0.0.72,82,3,289,129,418,15,FALSE
crds-core,0.0.70,0.0.71,81,10,4371,270,4641,47,FALSE
crds-core,0.0.77,0.0.78,88,8,259,232,491,19,FALSE
crds-core,0.0.76,0.0.77,87,3,33,3,36,5,FALSE
crds-core,0.0.75,0.0.76,86,1,1,1,2,1,FALSE
crds-core,0.0.74,0.0.75,85,5,76,38,114,14,FALSE
crds-core,0.0.79,0.0.80,90,4,32,8,40,6,FALSE
crds-core,0.0.78,0.0.79,89,13,1598,789,2387,40,FALSE
crds-core,1.4.4-rc.0,1.5.0,255,2,160,27,187,7,FALSE
crds-core,1.14.2,1.14.3-rc.0,337,5,25,71,96,11,FALSE
crds-core,1.14.0,1.14.1,333,3,13,13,26,10,FALSE
crds-core,1.14.1,1.14.2-rc.0,334,2,2,2,4,2,FALSE
crds-core,0.0.40,0.0.41,32,1,114,13,127,3,FALSE
crds-core,1.0.17,1.1.0,226,1,264,159,423,18,FALSE
crds-core,1.12.2-rc.4,1.12.2,323,3,316,107,423,12,FALSE
crds-core,1.12.2-rc.1,1.12.2-rc.2,320,7,268,42,310,14,FALSE
crds-core,1.6.0,1.6.1-rc.0,262,9,138,28,166,20,FALSE
crds-core,1.12.2-rc.3,1.12.2-rc.4,322,6,384,119,503,22,FALSE
crds-core,1.12.2-rc.2,1.12.2-rc.3,321,2,2,2,4,2,FALSE
crds-core,1.0.15-rc.0,1.0.15-rc.1,220,3,3,3,6,3,FALSE
crds-core,1.0.15-rc.1,1.0.15-rc.2,221,5,12,12,24,5,FALSE
crds-core,0.0.111,0.0.112,122,2,18,16,34,7,FALSE
crds-core,0.0.110,0.0.111,121,9,150,119,269,25,FALSE
crds-core,0.0.113,0.0.114,124,6,5,14,19,5,FALSE
crds-core,0.0.112,0.0.113,123,7,110,56,166,17,FALSE
crds-core,0.0.115,0.0.116,126,5,82,22,104,10,FALSE
crds-core,0.0.114,0.0.115,125,4,8,2,10,4,FALSE
crds-core,0.0.117,0.0.118,128,3,362,134,496,11,FALSE
crds-core,0.0.116,0.0.117,127,6,327,241,568,17,FALSE
crds-core,0.0.119,0.0.120,130,5,82,97,179,9,FALSE
crds-core,0.0.118,0.0.119,129,5,124,59,183,15,FALSE
crds-core,1.9.4-rc.0,1.9.4-rc.1,299,2,2,2,4,2,FALSE
crds-core,1.9.4-rc.1,1.10.0,300,5,354,39,393,17,FALSE
crds-core,1.14.2-rc.1,1.14.2,336,1,1,1,2,1,FALSE
crds-core,1.14.2-rc.0,1.14.2-rc.1,335,3,19,3,22,5,FALSE
crds-core,0.0.42,0.0.43,34,2,5,3,8,4,FALSE
crds-core,0.0.43,0.0.44,35,2,5,3,8,4,FALSE
crds-core,1.9.0-rc.2,1.9.0-rc.3,288,5,37,5,42,9,FALSE
crds-core,0.0.41,0.0.42,33,2,4,4,8,4,FALSE
crds-core,0.0.47,0.0.50,40,12,33,28,61,13,FALSE
crds-core,0.0.44,0.0.45-2,36,2,19,6,25,3,FALSE
crds-core,1.6.3-rc.0,1.6.3,272,2,252,13,265,17,FALSE
crds-core,1.4.2-rc.1,1.4.2-rc.2,241,6,53,6,59,8,FALSE
crds-core,1.4.2-rc.0,1.4.2-rc.1,240,5,556,41,597,8,FALSE
crds-core,1.4.2-rc.3,1.4.2-rc.4,243,5,102,23,125,6,FALSE
crds-core,1.4.2-rc.2,1.4.2-rc.3,242,6,143,29,172,7,FALSE
crds-core,1.4.2-rc.5,1.4.2-rc.6,245,9,22,15,37,9,FALSE
crds-core,1.4.2-rc.4,1.4.2-rc.5,244,6,68,10,78,6,FALSE
crds-core,1.4.2-rc.7,1.4.2-rc.8,247,4,18,3,21,4,FALSE
crds-core,1.4.2-rc.6,1.4.2-rc.7,246,3,3,1,4,3,FALSE
crds-core,1.4.2-rc.9,1.4.2-rc.10,249,3,81,81,162,11,FALSE
crds-core,1.4.2-rc.8,1.4.2-rc.9,248,5,172,146,318,7,FALSE
crds-core,0.0.53-17,0.0.53-18,48,1,1,1,2,1,FALSE
crds-core,0.0.53-16,0.0.53-17,47,1,1,1,2,1,FALSE
crds-core,0.0.53-15,0.0.53-16,46,1,3,6,9,2,FALSE
crds-core,0.0.53-14,0.0.53-15,45,1,0,1,1,1,FALSE
crds-core,0.0.53-12,0.0.53-14,44,1,0,1,1,1,FALSE
crds-core,0.0.53-11,0.0.53-12,43,1,0,1,1,1,FALSE
crds-core,0.0.53-10,0.0.53-11,42,1,0,1,1,1,FALSE
crds-core,1.9.1-rc.2,1.9.1-rc.3,292,3,27,1,28,3,FALSE
crds-core,1.9.1-rc.0,1.9.1-rc.2,291,16,136,56,192,24,FALSE
crds-core,0.0.53-18,0.0.53-20,49,1,0,1,1,1,FALSE
crds-core,0.0.54-8,0.0.54,67,2,4,4,8,2,FALSE
crds-core,0.0.54-4,0.0.54-5,63,1,0,1,1,1,FALSE
crds-core,0.0.54-5,0.0.54-6,64,1,0,1,1,1,FALSE
crds-core,0.0.54-6,0.0.54-7,65,1,9,7,16,2,FALSE
crds-core,0.0.54-7,0.0.54-8,66,2,7,8,15,3,FALSE
crds-core,0.0.54-0,0.0.54-1,59,1,1,1,2,1,FALSE
crds-core,0.0.54-1,0.0.54-2,60,1,2,2,4,2,FALSE
crds-core,0.0.54-2,0.0.54-3,61,1,0,1,1,1,FALSE
crds-core,0.0.54-3,0.0.54-4,62,1,0,1,1,1,FALSE
crds-core,0.0.88,0.0.89,99,3,3,3,6,3,FALSE
crds-core,0.0.89,0.0.90,100,3,11,13,24,3,FALSE
crds-core,0.0.86,0.0.87,97,4,79,74,153,13,FALSE
crds-core,0.0.87,0.0.88,98,7,47,42,89,13,FALSE
crds-core,0.0.84,0.0.85,95,7,223,74,297,16,FALSE
crds-core,0.0.85,0.0.86,96,4,561,760,1321,15,FALSE
crds-core,0.0.82,0.0.83,93,12,1175,1589,2764,40,FALSE
crds-core,0.0.83,0.0.84,94,6,161,20,181,22,FALSE
crds-core,0.0.80,0.0.81,91,12,775,174,949,50,FALSE
crds-core,0.0.81,0.0.82,92,9,145,125,270,23,FALSE
crds-core,0.0.155,0.0.156,166,2,3,4,7,2,FALSE
crds-core,0.0.154,0.0.155,165,1,1,1,2,1,FALSE
crds-core,0.0.157,0.0.158,168,4,22,9,31,7,FALSE
crds-core,0.0.156,0.0.157,167,4,10,2,12,4,FALSE
crds-core,0.0.151,0.0.152,162,1,1,1,2,1,FALSE
crds-core,0.0.150,0.0.151,161,6,127,84,211,20,FALSE
crds-core,0.0.153,0.0.154,164,3,17,9,26,3,FALSE
crds-core,0.0.152,0.0.153,163,4,118,89,207,15,FALSE
crds-core,0.0.159,0.0.161,170,11,467,250,717,39,FALSE
crds-core,0.0.158,0.0.159,169,10,443,210,653,41,FALSE
crds-core,1.7.2-rc.0,1.7.2-rc.1,277,3,3,39,42,3,FALSE
crds-core,1.7.2-rc.1,1.7.2-rc.2,278,9,559,129,688,22,FALSE
crds-core,1.7.2-rc.2,1.7.2-rc.3,279,2,4,2,6,2,FALSE
crds-core,1.7.2-rc.3,1.7.2-rc.4,280,4,4,20,24,4,FALSE
crds-core,0.0.15,0.0.16,13,13,2115,2006,4121,57,FALSE
crds-core,0.0.14,0.0.15,12,11,605,262,867,33,FALSE
crds-core,0.0.17,0.0.18,15,10,2275,1268,3543,54,FALSE
crds-core,0.0.16,0.0.17,14,6,1335,19,1354,13,FALSE
crds-core,0.0.10,0.0.13,10,24,607,255860,256467,153,FALSE
crds-core,0.0.13,0.0.14,11,9,414,57,471,40,FALSE
crds-core,1.9.0-rc.1,1.9.0-rc.2,287,7,94,46,140,11,FALSE
crds-core,0.0.19,0.0.20,17,5,2369,37,2406,20,FALSE
crds-core,0.0.18,0.0.19,16,10,6965,51,7016,34,FALSE
crds-core,1.0.10-1,1.0.10,208,1,0,1,1,1,FALSE
crds-core,1.0.10-0,1.0.10-1,207,3,3,2,5,3,FALSE
crds-core,1.0.17-rc.0,1.0.17-rc.1,224,17,930,729,1659,59,FALSE
crds-core,1.0.14-0,1.0.14,213,3,3,3,6,3,FALSE
crds-core,1.10.2-rc.3,1.10.2-rc.4,306,4,50,2,52,4,FALSE
crds-core,0.0.125,0.0.126,136,5,203,210,413,10,FALSE
crds-core,1.10.2-rc.1,1.10.2-rc.2,304,4,12,10,22,5,FALSE
crds-core,1.10.2-rc.0,1.10.2-rc.1,303,3,47,24,71,4,FALSE
crds-core,1.10.2-rc.6,1.10.2,309,6,249,121,370,10,FALSE
crds-core,1.0.15,1.0.17-rc.0,223,5,4,4,8,4,FALSE
crds-core,1.10.2-rc.5,1.10.2-rc.6,308,4,14,3,17,4,FALSE
crds-core,1.10.2-rc.4,1.10.2-rc.5,307,6,307,218,525,11,FALSE
crds-core,1.16.2-rc.1,1.16.2-rc.2,357,5,51,27,78,11,FALSE
crds-core,1.16.2-rc.0,1.16.2-rc.1,356,2,47,19,66,5,FALSE
crds-core,1.16.2-rc.3,1.16.2,359,1,1,1,2,1,FALSE
crds-core,1.16.2-rc.2,1.16.2-rc.3,358,3,3,3,6,3,FALSE
crds-core,1.8.0,1.9.0-rc.1,286,5,6,6,12,5,FALSE
crds-core,1.4.0,1.4.1,238,7,111,35,146,9,FALSE
crds-core,1.4.1,1.4.2-rc.0,239,2,2,2,4,2,FALSE
crds-core,1.4.2,1.4.3-rc.0,252,1,1,1,2,1,FALSE
crds-core,1.4.3,1.4.4-rc.0,254,2,3,3,6,3,FALSE
crds-core,0.0.108,0.0.109,119,8,334,126,460,30,FALSE
crds-core,0.0.109,0.0.110,120,9,270,46,316,25,FALSE
crds-core,0.0.106,0.0.107,117,4,7,1,8,4,FALSE
crds-core,0.0.107,0.0.108,118,3,23,27,50,5,FALSE
crds-core,0.0.104,0.0.105,115,4,187,1,188,9,FALSE
crds-core,0.0.105,0.0.106,116,5,13,13,26,9,FALSE
crds-core,0.0.102,0.0.103,113,7,154,141,295,26,FALSE
crds-core,0.0.103,0.0.104,114,2,114,105,219,7,FALSE
crds-core,0.0.100,0.0.101,111,5,195,65,260,25,FALSE
crds-core,1.5.0,1.5.1,256,1,1,1,2,1,FALSE
crds-core,1.2.0,1.3.0,228,4,68,8,76,4,FALSE
crds-core,1.5.1,1.5.2-rc.0,257,2,2,2,4,2,FALSE
crds-core,1.0.4,1.0.5,199,5,37,230,267,11,FALSE
crds-core,1.0.5,1.0.6,200,4,247,126,373,18,FALSE
crds-core,1.0.6,1.0.7,201,3,3,2,5,3,FALSE
crds-core,1.0.7,1.0.8-0,202,3,13,19,32,4,FALSE
crds-core,1.0.1,1.0.2-0,195,18,487,249,736,32,FALSE
crds-core,1.0.2,1.0.3,197,3,29,3,32,3,FALSE
crds-core,1.0.3,1.0.4,198,5,404,4,408,7,FALSE
crds-core,1.0.8,1.0.9-0,204,4,14,20,34,5,FALSE
crds-core,1.0.9,1.0.10-0,206,2,2,2,4,2,FALSE
crds-core,0.0.59,0.0.60,71,1,1,1,2,1,FALSE
crds-core,0.0.50,0.0.53-10,41,11,29,32,61,21,FALSE
crds-core,0.0.53,0.0.54-0,58,1,4,4,8,2,FALSE
crds-core,0.0.54,0.0.56,68,1,1,1,2,1,FALSE
crds-core,0.0.57,0.0.59,70,1,1,1,2,1,FALSE
crds-core,0.0.56,0.0.57,69,1,1,1,2,1,FALSE
crds-core,1.6.3,1.6.4-rc.0,273,2,2,2,4,2,FALSE
crds-core,1.0.14,1.0.15-0,214,2,1,1,2,1,FALSE
crds-core,1.6.1,1.6.3-rc.0,271,12,287,27,314,29,FALSE
crds-core,1.0.12,1.0.13,211,3,15,2,17,5,FALSE
crds-core,1.0.13,1.0.14-0,212,2,3,2,5,3,FALSE
crds-core,1.0.10,1.0.11,209,6,17,21,38,7,FALSE
crds-core,1.0.11,1.0.12,210,3,4,24,28,3,FALSE
crds-core,1.9.3-rc.1,1.9.3-rc.2,296,4,313,64,377,11,FALSE
crds-core,1.9.3-rc.0,1.9.3-rc.1,295,7,128,23,151,17,FALSE
crds-core,1.9.3-rc.2,1.9.3,297,2,247,33,280,12,FALSE
crds-core,1.0.15-4,1.0.15-5,218,2,14,1,15,4,FALSE
crds-core,1.0.15-5,1.0.15-rc.0,219,2,2,2,4,2,FALSE
crds-core,1.0.15-3,1.0.15-4,217,2,14,17,31,3,FALSE
crds-core,1.0.15-0,1.0.15-1,215,2,1,12,13,2,FALSE
crds-core,1.0.15-1,1.0.15-3,216,3,10,23,33,9,FALSE
crds-core,1.11.3-rc.0,1.12.0,316,3,66,15,81,9,FALSE
crds-core,1.5.2-rc.2,1.5.2,260,6,155,16,171,15,FALSE
crds-core,1.5.2-rc.0,1.5.2-rc.1,258,5,568,103,671,23,FALSE
crds-core,1.5.2-rc.1,1.5.2-rc.2,259,3,51,41,92,3,FALSE
crds-core,1.4.2-rc.11,1.4.2,251,1,1,1,2,1,FALSE
crds-core,1.4.2-rc.10,1.4.2-rc.11,250,2,270,2,272,4,FALSE
crds-core,1.13.1,1.13.2-rc.0,326,2,2,2,4,2,FALSE
crds-core,1.13.0,1.13.1,325,2,2,2,4,2,FALSE
crds-core,1.14.3-rc.0,1.14.3-rc.1,338,3,15,15,30,3,FALSE
crds-core,1.11.2,1.11.3-rc.0,315,2,2,2,4,2,FALSE
crds-core,1.11.1,1.11.2-rc.0,312,4,32,25,57,7,FALSE
crds-core,1.11.0,1.11.1,311,2,2,2,4,2,FALSE
crds-core,1.17.1,1.17.2-rc.0,362,3,5,9,14,5,FALSE
crds-core,1.17.0,1.17.1,361,1,1,1,2,1,FALSE
crds-core,0.0.137,0.0.138,148,3,3,7,10,3,FALSE
crds-core,0.0.136,0.0.137,147,3,47,9,56,5,FALSE
crds-core,0.0.135,0.0.136,146,3,27,27,54,11,FALSE
crds-core,0.0.134,0.0.135,145,1,1,1,2,1,FALSE
crds-core,0.0.99,0.0.100,110,4,77,40,117,11,FALSE
crds-core,0.0.98,0.0.99,109,3,27,21,48,8,FALSE
crds-core,0.0.131,0.0.132,142,4,36,2,38,6,FALSE
crds-core,0.0.130,0.0.131,141,4,86,1078,1164,18,FALSE
crds-core,0.0.95,0.0.96,106,10,49,40,89,18,FALSE
crds-core,0.0.94,0.0.95,105,2,207,130,337,14,FALSE
crds-core,0.0.97,0.0.98,108,5,102,4,106,9,FALSE
crds-core,0.0.96,0.0.97,107,2,62,42,104,6,FALSE
crds-core,0.0.91,0.0.92,102,6,761,866,1627,36,FALSE
crds-core,0.0.90,0.0.91,101,2,15,1,16,2,FALSE
crds-core,0.0.139,0.0.140,150,5,253,178,431,22,FALSE
crds-core,0.0.92,0.0.93,103,4,77,12,89,10,FALSE
crds-core,1.15.2,1.16.0,353,15,153,215,368,28,FALSE
crds-core,1.15.1,1.15.2-rc.0,342,2,2,2,4,2,FALSE
crds-core,1.15.0,1.15.1,341,13,57,118,175,20,FALSE
crds-core,0.0.142,0.0.143,153,4,14,9,23,6,FALSE
crds-core,0.0.143,0.0.144,154,5,8,6,14,5,FALSE
crds-core,0.0.140,0.0.141,151,7,142,74,216,13,FALSE
crds-core,0.0.141,0.0.142,152,3,9,1,10,3,FALSE
crds-core,0.0.146,0.0.147,157,3,56,11,67,12,FALSE
crds-core,0.0.147,0.0.148,158,5,37,3,40,5,FALSE
crds-core,0.0.144,0.0.145,155,4,16,28,44,4,FALSE
crds-core,0.0.145,0.0.146,156,6,105,15,120,18,FALSE
crds-core,0.0.148,0.0.149,159,2,2,1,3,2,FALSE
crds-core,0.0.149,0.0.150,160,9,353,137,490,40,FALSE
crds-core,1.14.3-rc.1,1.14.3-rc.2,339,2,8,8,16,2,FALSE
crds-core,0.0.20,0.0.21,18,5,36,164,200,20,FALSE
crds-core,0.0.21,0.0.22,19,13,1313,30,1343,45,FALSE
crds-core,0.0.22,0.0.23,20,8,400,832,1232,50,FALSE
crds-core,0.0.23,0.0.24,21,4,8,8,16,8,FALSE
crds-core,0.0.24,0.0.25,22,14,450,505,955,54,FALSE
crds-core,0.0.25,0.0.26,23,18,1345,1011,2356,79,FALSE
crds-core,0.0.26,0.0.27,24,8,465,115,580,57,FALSE
crds-core,0.0.27,0.0.28,25,10,1254,1112,2366,34,FALSE
crds-core,0.0.28,0.0.29,26,7,1441,1198,2639,53,FALSE
crds-core,0.0.29,0.0.30,27,6,223,73,296,32,FALSE
crds-core,0.0.5,0.0.6,5,3,680,68504,69184,13,FALSE
crds-core,0.0.4,0.0.5,4,5,131,69,200,17,FALSE
crds-core,0.0.7,0.0.8,7,2,2,2,4,2,FALSE
crds-core,0.0.6,0.0.7,6,6,12,34685,34697,29,FALSE
crds-core,0.0.1,0.0.2,1,12,68862,1000,69862,39,FALSE
crds-core,0.0.3,0.0.4,3,1,0,1,1,1,FALSE
crds-core,0.0.2,0.0.3,2,10,207718,2829,210547,105,FALSE
crds-core,0.0.9,0.0.10,9,5,59,13,72,11,FALSE
crds-core,0.0.8,0.0.9,8,4,15,17352,17367,19,FALSE
crds-core,1.7.4-rc.0,1.7.4-rc.1,284,4,13,1,14,4,FALSE
crds-core,1.7.4-rc.1,1.8.0,285,1,2,2,4,1,FALSE
crds-core,1.4.3-rc.0,1.4.3,253,3,44,5,49,6,FALSE
crds-core,0.0.179,0.0.180,189,5,198,75,273,20,FALSE
crds-core,0.0.178,0.0.179,188,2,161,70,231,12,FALSE
crds-core,0.0.173,0.0.174,183,4,11,6,17,4,FALSE
crds-core,0.0.172,0.0.173,182,4,82,140,222,22,FALSE
crds-core,0.0.171,0.0.172,181,3,7,5,12,3,FALSE
crds-core,0.0.170,0.0.171,180,3,5,11,16,5,FALSE
crds-core,0.0.177,0.0.178,187,5,29,10,39,8,FALSE
crds-core,0.0.176,0.0.177,186,9,306,176,482,38,FALSE
crds-core,0.0.175,0.0.176,185,2,3,1,4,2,FALSE
crds-core,0.0.174,0.0.175,184,4,9,3,12,6,FALSE
crds-core,0.0.133,0.0.134,144,1,1,1,2,1,FALSE
crds-core,0.0.132,0.0.133,143,5,625,273,898,21,FALSE
crds-core,0.0.184,1.0.1,194,3,10755,2526,13281,154,FALSE
crds-core,0.0.182,0.0.183,192,3,3,3,6,3,FALSE
crds-core,0.0.183,0.0.184,193,4,99,3,102,8,FALSE
crds-core,0.0.180,0.0.181,190,5,65,22,87,8,FALSE
crds-core,0.0.181,0.0.182,191,3,169,8,177,5,FALSE
crds-core,0.0.64,0.0.65,75,3,2,2,4,3,FALSE
crds-core,0.0.65,0.0.66,76,3,3,3,6,3,FALSE
crds-core,0.0.66,0.0.67,77,1,1,1,2,1,FALSE
crds-core,0.0.67,0.0.68,78,4,8,6,14,4,FALSE
crds-core,0.0.60,0.0.62,72,1,1,1,2,1,FALSE
crds-core,0.0.62,0.0.63,73,2,2,2,4,2,FALSE
crds-core,0.0.63,0.0.64,74,2,2,2,4,2,FALSE
crds-core,0.0.68,0.0.69,79,2,3921,13,3934,6,FALSE
crds-core,0.0.69,0.0.70,80,5,3925,71,3996,16,FALSE
crds-core,1.13.2-rc.2,1.13.2-rc.3,329,2,219,1,220,6,FALSE
crds-core,1.13.2-rc.3,1.13.2-rc.4,330,3,3,3,6,3,FALSE
crds-core,1.13.2-rc.0,1.13.2-rc.1,327,2,9,2,11,9,FALSE
crds-core,1.13.2-rc.1,1.13.2-rc.2,328,5,330,108,438,13,FALSE
crds-core,0.0.93,0.0.94,104,9,480,292,772,38,FALSE
crds-core,1.13.2-rc.4,1.13.2-rc.5,331,6,16,16,32,13,FALSE
crds-core,0.0.138,0.0.139,149,5,174,166,340,7,FALSE
crds-core,1.15.2-rc.4,1.15.2-rc.5,347,4,28,11,39,7,FALSE
crds-core,1.15.2-rc.5,1.15.2-rc.6,348,2,8,7,15,3,FALSE
crds-core,1.15.2-rc.6,1.15.2-rc.7,349,3,11,1,12,3,FALSE
crds-core,1.15.2-rc.7,1.15.2-rc.8,350,5,78,23,101,13,FALSE
crds-core,1.15.2-rc.0,1.15.2-rc.1,343,5,13,32,45,7,FALSE
crds-core,1.15.2-rc.1,1.15.2-rc.2,344,3,199,167,366,5,FALSE
crds-core,1.15.2-rc.2,1.15.2-rc.3,345,2,46,28,74,9,FALSE
crds-core,1.15.2-rc.3,1.15.2-rc.4,346,4,153,132,285,15,FALSE
crds-core,1.15.2-rc.8,1.15.2-rc.9,351,6,104,184,288,13,FALSE
crds-core,1.11.2-rc.0,1.11.2-rc.1,313,2,63,13,76,6,FALSE
crds-core,1.11.2-rc.1,1.11.2,314,6,131,70,201,14,FALSE
crds-core,0.0.101,0.0.102,112,4,61,47,108,8,FALSE
crds-core,0.0.45-2,0.0.45-3,37,1,18,5,23,2,FALSE
crds-core,0.0.45-3,0.0.45-4,38,1,2,2,4,2,FALSE
crds-core,0.0.45-4,0.0.47,39,9,13,13,26,11,FALSE
crds-core,1.12.2-rc.0,1.12.2-rc.1,319,2,16,19,35,3,FALSE
crds-core,1.9.1,1.9.3-rc.0,294,21,165,59,224,29,FALSE
crds-core,1.9.0,1.9.1-rc.0,290,2,2,2,4,2,FALSE
crds-core,1.9.3,1.9.4-rc.0,298,1,1,1,2,1,FALSE
crds-core,0.0.124,0.0.125,135,3,7,5,12,3,TRUE
crds-core,1.10.2-rc.2,1.10.2-rc.3,305,2,4,2,6,3,FALSE
crds-core,0.0.126,0.0.127,137,4,66,6,72,7,FALSE
crds-core,0.0.127,0.0.128,138,7,48,29,77,11,FALSE
crds-core,0.0.120,0.0.121,131,2,9,3,12,2,FALSE
crds-core,0.0.121,0.0.122,132,3,33,11,44,3,FALSE
crds-core,0.0.122,0.0.123,133,2,2,3,5,3,FALSE
crds-core,0.0.123,0.0.124,134,2,2,3,5,3,FALSE
crds-core,0.0.128,0.0.129,139,13,230,82,312,32,FALSE
crds-core,0.0.129,0.0.130,140,5,3,5,8,5,FALSE
crds-core,1.5.2,1.6.0,261,1,1,1,2,1,FALSE
crds-core,1.3.1,1.4.0,237,4,459,788,1247,30,FALSE
crds-core,1.3.0,1.3.1-rc.0,229,3,11,7,18,3,FALSE
crds-core,1.3.1-rc.1,1.3.1-rc.2,231,4,213,176,389,13,FALSE
crds-core,1.3.1-rc.0,1.3.1-rc.1,230,11,518,289,807,22,FALSE
crds-core,1.3.1-rc.3,1.3.1-rc.4,233,9,475,729,1204,29,FALSE
crds-core,1.3.1-rc.2,1.3.1-rc.3,232,4,333,1100,1433,16,FALSE
crds-core,1.3.1-rc.5,1.3.1-rc.6,235,6,560,788,1348,33,FALSE
crds-core,1.3.1-rc.4,1.3.1-rc.5,234,11,893,1509,2402,52,FALSE
crds-core,1.1.0,1.2.0,227,15,418,420,838,23,FALSE
crds-core,0.0.39,0.0.40,31,1,0,1,1,1,FALSE
crds-core,0.0.37,0.0.39,30,1,0,1,1,1,FALSE
crds-core,0.0.31,0.0.37,29,11,279,102,381,38,FALSE
crds-core,0.0.30,0.0.31,28,7,1673,1246,2919,77,FALSE
crds-core,1.7.3,1.7.4-rc.0,283,1,1,1,2,1,FALSE
crds-core,1.7.2,1.7.3,282,5,6,30,36,6,FALSE
crds-core,1.7.1,1.7.2-rc.0,276,2,2,2,4,2,FALSE
crds-core,1.7.0,1.7.1,275,2,2,2,4,2,FALSE
crds-core,1.6.1-rc.6,1.6.1-rc.7,269,3,13,7,20,3,FALSE
crds-core,1.6.1-rc.4,1.6.1-rc.5,267,7,295,18,313,25,FALSE
crds-core,1.6.1-rc.5,1.6.1-rc.6,268,3,9,3,12,3,FALSE
crds-core,1.6.1-rc.2,1.6.1-rc.3,265,5,63,4,67,8,FALSE
crds-core,1.6.1-rc.3,1.6.1-rc.4,266,6,41,5,46,7,FALSE
crds-core,1.6.1-rc.0,1.6.1-rc.1,263,4,11,3,14,4,FALSE
crds-core,1.6.1-rc.1,1.6.1-rc.2,264,1,1,1,2,1,FALSE
crds-core,1.16.2,1.17.0,360,1,1,1,2,1,FALSE
crds-core,0.0.156,0.0.157,167,4,10,2,12,4,TRUE
crds-core,1.0.15-0,1.0.15-1,215,2,1,12,13,2,TRUE
crds-core,1.5.2-rc.2,1.5.2,260,6,155,16,171,15,TRUE
crds-core,1.11.2-rc.1,1.11.2,314,6,131,70,201,14,TRUE
crds-core,0.0.124,0.0.125,135,3,7,5,12,3,FALSE
crds-core,1.6.4-rc.0,1.7.0,274,2,277,13,290,17,TRUE
crds-core,0.0.182,0.0.183,192,3,3,3,6,3,TRUE
crds-core,0.0.14,0.0.15,12,11,605,262,867,33,TRUE
crds-core,1.12.2-rc.3,1.12.2-rc.4,322,6,384,119,503,22,TRUE
crds-core,1.11.2-rc.0,1.11.2-rc.1,313,2,63,13,76,6,TRUE
crds-core,0.0.127,0.0.128,138,7,48,29,77,11,TRUE
crds-core,0.0.105,0.0.106,116,5,13,13,26,9,TRUE
crds-core,0.0.47,0.0.50,40,12,33,28,61,13,TRUE
crds-core,0.0.93,0.0.94,104,9,480,292,772,38,TRUE
crds-core,0.0.129,0.0.130,140,5,3,5,8,5,TRUE
crds-core,0.0.95,0.0.96,106,10,49,40,89,18,TRUE
crds-core,0.0.164,0.0.165,174,4,376,47,423,23,TRUE
crds-core,0.0.132,0.0.133,143,5,625,273,898,21,TRUE
crds-core,1.0.17,1.1.0,226,1,264,159,423,18,TRUE
crds-core,0.0.111,0.0.112,122,2,18,16,34,7,TRUE
crds-core,1.10.2-rc.1,1.10.2-rc.2,304,4,12,10,22,5,TRUE
crds-core,0.0.108,0.0.109,119,8,334,126,460,30,TRUE
crds-core,1.0.15-1,1.0.15-3,216,3,10,23,33,9,TRUE
crds-core,1.14.3-rc.0,1.14.3-rc.1,338,3,15,15,30,3,TRUE
crds-core,1.15.0,1.15.1,341,13,57,118,175,20,TRUE
crds-core,0.0.148,0.0.149,159,2,2,1,3,2,TRUE
crds-core,0.0.24,0.0.25,22,14,450,505,955,54,TRUE
crds-core,0.0.5,0.0.6,5,3,680,68504,69184,13,TRUE
crds-core,0.0.181,0.0.182,191,3,169,8,177,5,TRUE
crds-core,0.0.120,0.0.121,131,2,9,3,12,2,TRUE
crds-core,0.0.128,0.0.129,139,13,230,82,312,32,TRUE
crds-core,1.3.1,1.4.0,237,4,459,788,1247,30,TRUE
crds-core,0.0.167,0.0.168,177,4,7,113,120,13,TRUE
crds-core,1.10.2,1.11.0,310,1,1,1,2,1,TRUE
crds-core,0.0.74,0.0.75,85,5,76,38,114,14,TRUE
crds-core,1.12.2-rc.1,1.12.2-rc.2,320,7,268,42,310,14,TRUE
crds-core,0.0.110,0.0.111,121,9,150,119,269,25,TRUE
crds-core,0.0.80,0.0.81,91,12,775,174,949,50,TRUE
crds-core,1.10.2-rc.6,1.10.2,309,6,249,121,370,10,TRUE
crds-core,0.0.25,0.0.26,23,18,1345,1011,2356,79,TRUE
crds-core,1.7.4-rc.0,1.7.4-rc.1,284,4,13,1,14,4,TRUE
crds-core,1.13.2-rc.3,1.13.2-rc.4,330,3,3,3,6,3,TRUE
crds-core,1.13.2-rc.1,1.13.2-rc.2,328,5,330,108,438,13,TRUE
crds-core,1.15.2-rc.6,1.15.2-rc.7,349,3,11,1,12,3,TRUE
crds-core,1.10.2-rc.2,1.10.2-rc.3,305,2,4,2,6,3,TRUE
crds-core,0.0.30,0.0.31,28,7,1673,1246,2919,77,TRUE
crds-core,0.0.115,0.0.116,126,5,82,22,104,10,TRUE
crds-core,0.0.104,0.0.105,115,4,187,1,188,9,TRUE
crds-core,0.0.22,0.0.23,20,8,400,832,1232,50,TRUE
crds-core,0.0.8,0.0.9,8,4,15,17352,17367,19,TRUE
crds-core,0.0.179,0.0.180,189,5,198,75,273,20,TRUE
crds-core,0.0.133,0.0.134,144,1,1,1,2,1,TRUE
crds-core,0.0.180,0.0.181,190,5,65,22,87,8,TRUE
crds-core,1.0.3,1.0.4,198,5,404,4,408,7,TRUE
crds-core,0.0.70,0.0.71,81,10,4371,270,4641,47,TRUE
crds-core,0.0.82,0.0.83,93,12,1175,1589,2764,40,TRUE
crds-core,0.0.135,0.0.136,146,3,27,27,54,11,TRUE
crds-core,1.7.2-rc.1,1.7.2-rc.2,278,9,559,129,688,22,TRUE
crds-core,1.0.15-rc.0,1.0.15-rc.1,220,3,3,3,6,3,TRUE
crds-core,1.3.1-rc.2,1.3.1-rc.3,232,4,333,1100,1433,16,TRUE
crds-core,0.0.118,0.0.119,129,5,124,59,183,15,TRUE
crds-core,1.17.1,1.17.2-rc.0,362,3,5,9,14,5,TRUE
crds-core,1.6.1-rc.3,1.6.1-rc.4,266,6,41,5,46,7,TRUE
crds-core,0.0.106,0.0.107,117,4,7,1,8,4,TRUE
crds-core,1.5.2-rc.0,1.5.2-rc.1,258,5,568,103,671,23,TRUE
crds-core,1.14.2-rc.0,1.14.2-rc.1,335,3,19,3,22,5,TRUE
crds-core,1.9.0-rc.1,1.9.0-rc.2,287,7,94,46,140,11,TRUE
crds-core,0.0.1,0.0.2,1,12,68862,1000,69862,39,TRUE
crds-core,0.0.116,0.0.117,127,6,327,241,568,17,TRUE
crds-core,0.0.19,0.0.20,17,5,2369,37,2406,20,TRUE
crds-core,0.0.102,0.0.103,113,7,154,141,295,26,TRUE
crds-core,1.11.3-rc.0,1.12.0,316,3,66,15,81,9,TRUE
crds-core,1.12.2-rc.0,1.12.2-rc.1,319,2,16,19,35,3,TRUE
crds-core,0.0.145,0.0.146,156,6,105,15,120,18,TRUE
crds-core,1.15.2-rc.0,1.15.2-rc.1,343,5,13,32,45,7,TRUE
crds-core,0.0.87,0.0.88,98,7,47,42,89,13,TRUE
crds-core,0.0.97,0.0.98,108,5,102,4,106,9,TRUE
crds-core,0.0.147,0.0.148,158,5,37,3,40,5,TRUE
crds-core,0.0.6,0.0.7,6,6,12,34685,34697,29,TRUE
crds-core,0.0.2,0.0.3,2,10,207718,2829,210547,105,TRUE
crds-core,0.0.9,0.0.10,9,5,59,13,72,11,TRUE
crds-core,1.4.2-rc.0,1.4.2-rc.1,240,5,556,41,597,8,TRUE
crds-core,1.4.2-rc.2,1.4.2-rc.3,242,6,143,29,172,7,TRUE
crds-core,0.0.125,0.0.126,136,5,203,210,413,10,TRUE
crds-core,1.3.1-rc.0,1.3.1-rc.1,230,11,518,289,807,22,TRUE
crds-core,1.3.1-rc.3,1.3.1-rc.4,233,9,475,729,1204,29,TRUE
prefix-trie-ts,0.0.1,0.0.2,1,1,35,127,162,8,FALSE
prefix-trie-ts,0.0.1,0.0.2,1,1,35,127,162,8,TRUE
digs-common,0.2.2-8,0.2.2-9,1,2,176,3,179,5,FALSE
digs-common,0.2.2-9,0.2.2-11,2,14,407,343,750,45,FALSE
digs-common,0.2.2-11,0.2.2-12,3,2,1,2,3,2,FALSE
digs-common,0.2.2-16,0.2.2-17,8,2,4,2,6,2,FALSE
digs-common,0.2.2-17,0.2.2,9,3,19,11,30,4,FALSE
digs-common,0.2.2-14,0.2.2-15,6,4,533,50,583,13,FALSE
digs-common,0.2.2-15,0.2.2-16,7,2,34,7,41,3,FALSE
digs-common,0.2.7,0.2.8,15,2,16,4,20,5,FALSE
digs-common,0.2.6,0.2.7,14,6,129,54,183,13,FALSE
digs-common,0.2.5,0.2.6,13,2,7,2,9,4,FALSE
digs-common,0.2.4,0.2.5,12,7,330,22,352,9,FALSE
digs-common,0.2.2-12,0.2.2-13,4,6,220,191,411,11,FALSE
digs-common,0.2.2,0.2.3,10,4,26,10,36,4,FALSE
digs-common,0.2.2-13,0.2.2-14,5,13,848,451,1299,45,FALSE
digs-common,0.2.3,0.2.4,11,3,7,11,18,3,FALSE
digs-common,0.2.10,0.2.11,18,3,71,14,85,6,FALSE
digs-common,0.2.9,0.2.10,17,2,4,2,6,2,FALSE
digs-common,0.2.8,0.2.9,16,5,25,12,37,5,FALSE
digs-common,0.2.2-14,0.2.2-15,6,4,533,50,583,13,TRUE
digs-common,0.2.9,0.2.10,17,2,4,2,6,2,TRUE
digs-common,0.2.8,0.2.9,16,5,25,12,37,5,TRUE
digs-common,0.2.2-16,0.2.2-17,8,2,4,2,6,2,TRUE
digs-common,0.2.3,0.2.4,11,3,7,11,18,3,TRUE
govstrap,1.0.0,1.1.0,30,3,62,46,108,13,FALSE
govstrap,0.9.1,0.10.0,13,8,3392,160,3552,75,FALSE
govstrap,0.9.0,0.9.1,12,1,13,4,17,4,FALSE
govstrap,0.7.0,0.7.1,8,3,17,3,20,6,FALSE
govstrap,0.11.3,0.11.4,18,1,5,2,7,3,FALSE
govstrap,0.10.0,0.11.0,14,3,154,19,173,9,FALSE
govstrap,0.11.4,0.11.5,19,1,12,5,17,4,FALSE
govstrap,0.11.5,0.12.0,20,2,25,15,40,7,FALSE
govstrap,0.6.0,0.7.0,7,3,143,157,300,14,FALSE
govstrap,0.11.0,0.11.1,15,3,47,29,76,8,FALSE
govstrap,0.11.1,0.11.2,16,1,12,1,13,3,FALSE
govstrap,0.11.2,0.11.3,17,5,141,43,184,8,FALSE
govstrap,0.7.1,0.8.0,9,3,121,5,126,10,FALSE
govstrap,0.12.0,0.13.0,21,1,42,16,58,8,FALSE
govstrap,0.16.0,1.0.0,29,1,12,5,17,4,FALSE
govstrap,0.5.0,0.6.0,6,4,222,59,281,15,FALSE
govstrap,0.13.0,0.14.0,22,6,78,97,175,14,FALSE
govstrap,0.15.0,0.15.1,24,1,12,5,17,4,FALSE
govstrap,0.15.1,0.15.2,25,2,17,6,23,6,FALSE
govstrap,0.15.2,0.15.3,26,1,12,5,17,4,FALSE
govstrap,0.15.3,0.15.4,27,2,50,11,61,9,FALSE
govstrap,0.15.4,0.16.0,28,2,36,12,48,8,FALSE
govstrap,0.14.0,0.15.0,23,3,203,115,318,14,FALSE
govstrap,0.8.1,0.9.0,11,3,225,41,266,12,FALSE
govstrap,0.8.0,0.8.1,10,1,25,6,31,5,FALSE
govstrap,0.15.3,0.15.4,27,2,50,11,61,9,TRUE
govstrap,0.9.1,0.10.0,13,8,3392,160,3552,75,TRUE
govstrap,0.2.0,0.2.2,1,2,7,3,10,3,FALSE
govstrap,0.3.0,0.4.0,3,2,75,49,124,39,FALSE
govstrap,0.4.1,0.5.0,5,8,901,197,1098,62,FALSE
govstrap,0.4.0,0.4.1,4,1,6,2,8,3,FALSE
govstrap,0.2.2,0.3.0,2,3,356,148,504,31,FALSE
govstrap,0.15.0,0.15.1,24,1,12,5,17,4,TRUE
govstrap,0.12.0,0.13.0,21,1,42,16,58,8,TRUE
govstrap,0.15.4,0.16.0,28,2,36,12,48,8,TRUE
govstrap,0.7.0,0.7.1,8,3,17,3,20,6,TRUE
govstrap,0.16.0,1.0.0,29,1,12,5,17,4,TRUE
govstrap,0.3.0,0.4.0,3,2,75,49,124,39,TRUE
ewancoder-angular-http,0.1.0-alpha.4,0.1.0-alpha.5,4,1,5,5,10,2,FALSE
ewancoder-angular-http,0.1.0-alpha.1,0.1.0-alpha.2,1,1,180,0,180,8,FALSE
ewancoder-angular-http,0.1.0-alpha.3,0.1.0-alpha.4,3,1,4,2,6,2,FALSE
ewancoder-angular-http,0.1.0-alpha.2,0.1.0-alpha.3,2,1,3,3,6,2,FALSE
ewancoder-angular-http,0.1.0-alpha.4,0.1.0-alpha.5,4,1,5,5,10,2,TRUE
ewancoder-angular-http,0.1.0-alpha.3,0.1.0-alpha.4,3,1,4,2,6,2,TRUE
ewancoder-angular-http,0.1.0-alpha.2,0.1.0-alpha.3,2,1,3,3,6,2,TRUE
node-architect,0.0.7,0.0.8,4,1,1,1,2,1,FALSE
node-architect,0.0.6,0.0.7,3,1,78,7,85,3,FALSE
node-architect,0.0.9,0.0.10,6,1,2,2,4,2,FALSE
node-architect,0.0.8,0.0.9,5,2,13,5,18,4,FALSE
node-architect,0.0.10,0.0.11,7,1,10,13,23,2,FALSE
node-architect,0.0.5,0.0.6,2,2,176,86,262,8,FALSE
node-architect,0.0.11,0.0.12,8,1,1,1,2,1,FALSE
node-architect,0.0.13,0.0.15,10,3,5,5,10,5,FALSE
node-architect,0.0.12,0.0.13,9,2,666,226,892,7,FALSE
node-architect,0.0.11,0.0.12,8,1,1,1,2,1,TRUE
react-nested-json-table,0.1.8,0.1.9,6,1,1,1,2,1,FALSE
react-nested-json-table,0.1.9,0.2.0,7,4,1654,1603,3257,56,FALSE
react-nested-json-table,0.1.3,0.1.4,1,2,106,6,112,6,FALSE
react-nested-json-table,0.1.4,0.1.5,2,1,4,5,9,2,FALSE
react-nested-json-table,0.1.5,0.1.6,3,2,383,3,386,8,FALSE
react-nested-json-table,0.1.6,0.1.7,4,1,733,140,873,12,FALSE
react-nested-json-table,0.1.7,0.1.8,5,2,17,3,20,4,FALSE
react-nested-json-table,0.1.7,0.1.8,5,2,17,3,20,4,TRUE
react-nested-json-table,0.1.5,0.1.6,3,2,383,3,386,8,TRUE
react-nested-json-table,0.1.6,0.1.7,4,1,733,140,873,12,TRUE
stream-item-timer,1.0.1,2.0.0,2,3,175,40,215,5,FALSE
stream-item-timer,3.0.0,3.0.1,5,2,5,4,9,2,FALSE
stream-item-timer,2.0.0,2.1.0,3,2,15,6,21,3,FALSE
stream-item-timer,3.0.1,3.0.2,6,9,27,14,41,11,FALSE
stream-item-timer,1.0.0,1.0.1,1,5,156,41,197,10,FALSE
stream-item-timer,2.1.0,3.0.0,4,2,62,50,112,4,FALSE
stream-item-timer,3.0.0,3.0.1,5,2,5,4,9,2,TRUE
stream-item-timer,1.0.0,1.0.1,1,5,156,41,197,10,TRUE
stream-item-timer,2.1.0,3.0.0,4,2,62,50,112,4,TRUE
phenix-express,0.0.1,0.0.2,1,2,8,3,11,3,FALSE
phenix-express,0.0.3,0.0.4,3,4,12,12,24,7,FALSE
phenix-express,0.0.2,0.0.3,2,1,3,28,31,3,FALSE
phenix-express,0.0.2,0.0.3,2,1,3,28,31,3,TRUE
material-ui-number-input,3.1.2,3.2.0,18,2,24,6,30,6,FALSE
material-ui-number-input,3.1.1,3.1.2,17,1,14,8,22,4,FALSE
material-ui-number-input,3.1.0,3.1.1,16,4,19,6,25,4,FALSE
material-ui-number-input,3.0.0,3.1.0,15,4,73,59,132,6,FALSE
material-ui-number-input,5.0.18,5.0.19,41,1,1,1,2,1,FALSE
material-ui-number-input,5.0.12,5.0.13,35,2,14,7,21,3,FALSE
material-ui-number-input,5.0.13,5.0.14,36,4,199,200,399,4,FALSE
material-ui-number-input,5.0.10,5.0.11,33,2,19,9,28,3,FALSE
material-ui-number-input,5.0.11,5.0.12,34,2,15,4,19,3,FALSE
material-ui-number-input,5.0.16,5.0.17,39,5,27,33,60,7,FALSE
material-ui-number-input,5.0.17,5.0.18,40,3,31,26,57,4,FALSE
material-ui-number-input,5.0.14,5.0.15,37,2,8,2,10,2,FALSE
material-ui-number-input,5.0.15,5.0.16,38,3,14,6,20,4,FALSE
material-ui-number-input,4.0.1,4.0.2,21,2,30,5,35,3,FALSE
material-ui-number-input,4.0.0,4.0.1,20,3,12,15,27,6,FALSE
material-ui-number-input,4.0.2,5.0.0,22,4,116,135,251,8,FALSE
material-ui-number-input,5.0.0,5.0.1,23,2,10,5,15,4,FALSE
material-ui-number-input,5.0.1,5.0.2,24,2,7,3,10,3,FALSE
material-ui-number-input,5.0.2,5.0.3,25,2,28,26,54,6,FALSE
material-ui-number-input,5.0.3,5.0.4,26,2,44,54,98,5,FALSE
material-ui-number-input,5.0.4,5.0.5,27,16,283,231,514,24,FALSE
material-ui-number-input,5.0.5,5.0.6,28,2,9,2,11,3,FALSE
material-ui-number-input,5.0.6,5.0.7,29,4,11,7,18,5,FALSE
material-ui-number-input,5.0.7,5.0.8,30,1,1,1,2,1,FALSE
material-ui-number-input,5.0.8,5.0.9,31,5,77,80,157,11,FALSE
material-ui-number-input,5.0.9,5.0.10,32,3,16,2,18,4,FALSE
material-ui-number-input,3.2.0,4.0.0,19,10,127,81,208,17,FALSE
material-ui-number-input,1.0.4,2.0.0,12,19,232,321,553,24,FALSE
material-ui-number-input,1.0.0,1.0.1,8,3,7,3,10,4,FALSE
material-ui-number-input,1.0.1,1.0.2,9,2,2,2,4,2,FALSE
material-ui-number-input,1.0.3,1.0.4,11,4,23,22,45,4,FALSE
material-ui-number-input,0.3.2,0.3.3,6,12,248,172,420,13,FALSE
material-ui-number-input,0.3.3,1.0.0,7,6,456,98,554,15,FALSE
material-ui-number-input,0.3.0,0.3.1,4,22,245,105,350,26,FALSE
material-ui-number-input,0.3.1,0.3.2,5,3,20,21,41,4,FALSE
material-ui-number-input,2.0.0,2.0.1,13,4,5,5,10,5,FALSE
material-ui-number-input,1.0.2,1.0.3,10,5,40,6,46,5,FALSE
material-ui-number-input,2.0.1,3.0.0,14,19,364,343,707,30,FALSE
material-ui-number-input,0.2.0,0.3.0,3,6,154,117,271,11,FALSE
material-ui-number-input,0.1.0,0.2.0,2,2,54,32,86,3,FALSE
material-ui-number-input,0.0.1,0.1.0,1,4,148,61,209,5,FALSE
material-ui-number-input,1.0.2,1.0.3,10,5,40,6,46,5,TRUE
material-ui-number-input,5.0.16,5.0.17,39,5,27,33,60,7,TRUE
material-ui-number-input,5.0.17,5.0.18,40,3,31,26,57,4,TRUE
material-ui-number-input,5.0.15,5.0.16,38,3,14,6,20,4,TRUE
material-ui-number-input,5.0.9,5.0.10,32,3,16,2,18,4,TRUE
material-ui-number-input,0.3.0,0.3.1,4,22,245,105,350,26,TRUE
material-ui-number-input,2.0.1,3.0.0,14,19,364,343,707,30,TRUE
material-ui-number-input,5.0.8,5.0.9,31,5,77,80,157,11,TRUE
stellar-sdk,0.6.0,0.6.1,38,6,43,21,64,12,FALSE
stellar-sdk,0.2.22,0.2.23,24,5,478,175,653,25,FALSE
stellar-sdk,0.2.23,0.3.0,25,6,53,20,73,10,FALSE
stellar-sdk,0.2.20,0.2.21,22,8,98,252,350,8,FALSE
stellar-sdk,0.2.21,0.2.22,23,1,1,1,2,1,FALSE
stellar-sdk,0.3.4,0.3.5,30,2,2,2,4,2,FALSE
stellar-sdk,0.7.1,0.7.2,42,2,6,2,8,3,FALSE
stellar-sdk,0.3.2,0.3.3,28,3,49,48,97,6,FALSE
stellar-sdk,0.3.3,0.3.4,29,4,115,50,165,18,FALSE
stellar-sdk,0.6.1,0.6.2,39,3,14,16,30,5,FALSE
stellar-sdk,0.3.1,0.3.2,27,9,613,25,638,24,FALSE
stellar-sdk,0.7.2,0.7.3,43,2,7,3,10,3,FALSE
stellar-sdk,0.7.0,0.7.1,41,3,25,10,35,5,FALSE
stellar-sdk,0.3.5,0.4.0,31,4,6,6,12,5,FALSE
stellar-sdk,0.4.1,0.4.2,33,36,653,329,982,64,FALSE
stellar-sdk,0.4.0,0.4.1,32,2,2,2,4,2,FALSE
stellar-sdk,0.4.3,0.5.0,35,8,60,63,123,43,FALSE
stellar-sdk,0.4.2,0.4.3,34,13,50,29,79,20,FALSE
stellar-sdk,0.5.0,0.5.1,36,3,18,2,20,4,FALSE
stellar-sdk,0.5.1,0.6.0,37,10,668,131,799,32,FALSE
stellar-sdk,0.2.19,0.2.20,21,2,3,5,8,3,FALSE
stellar-sdk,0.2.18,0.2.19,20,3,5,3,8,3,FALSE
stellar-sdk,0.2.17,0.2.18,19,1,1,1,2,1,FALSE
stellar-sdk,0.2.16,0.2.17,18,6,139,32,171,8,FALSE
stellar-sdk,0.2.15,0.2.16,17,6,136,12,148,8,FALSE
stellar-sdk,0.2.14,0.2.15,16,3,21,21,42,3,FALSE
stellar-sdk,0.6.2,0.7.0,40,6,132,96,228,11,FALSE
stellar-sdk,0.3.0,0.3.1,26,2,5,5,10,2,FALSE
stellar-sdk,0.2.7,0.2.8,9,14,69,50,119,19,FALSE
stellar-sdk,0.2.6,0.2.7,8,12,561,317,878,85,FALSE
stellar-sdk,0.2.5,0.2.6,7,6,797,321,1118,23,FALSE
stellar-sdk,0.2.3,0.2.5,6,19,1783,711,2494,97,FALSE
stellar-sdk,0.2.2,0.2.3,5,6,92,92,184,7,FALSE
stellar-sdk,0.2.1,0.2.2,4,2,5,2,7,2,FALSE
stellar-sdk,0.2.0,0.2.1,3,2,2,1,3,2,FALSE
stellar-sdk,0.2.9,0.2.10,11,5,15,16,31,5,FALSE
stellar-sdk,0.2.8,0.2.9,10,2,36,16,52,8,FALSE
stellar-sdk,0.2.13,0.2.14,15,2,8,1,9,3,FALSE
stellar-sdk,0.2.12,0.2.13,14,4,21,13,34,5,FALSE
stellar-sdk,0.2.11,0.2.12,13,18,375,355,730,30,FALSE
stellar-sdk,0.2.10,0.2.11,12,5,629,333,962,16,FALSE
stellar-sdk,0.1.10,0.2.0,2,12,507,444,951,13,FALSE
stellar-sdk,0.1.9,0.1.10,1,2,35,35,70,7,FALSE
stellar-sdk,0.6.0,0.6.1,38,6,43,21,64,12,TRUE
stellar-sdk,0.3.4,0.3.5,30,2,2,2,4,2,TRUE
stellar-sdk,0.2.3,0.2.5,6,19,1783,711,2494,97,TRUE
stellar-sdk,0.2.10,0.2.11,12,5,629,333,962,16,TRUE
stellar-sdk,0.1.10,0.2.0,2,12,507,444,951,13,TRUE
stellar-sdk,0.4.1,0.4.2,33,36,653,329,982,64,TRUE
stellar-sdk,0.2.16,0.2.17,18,6,139,32,171,8,TRUE
stellar-sdk,0.2.14,0.2.15,16,3,21,21,42,3,TRUE
stellar-sdk,0.2.13,0.2.14,15,2,8,1,9,3,TRUE
stellar-sdk,0.3.1,0.3.2,27,9,613,25,638,24,TRUE
stellar-sdk,0.3.2,0.3.3,28,3,49,48,97,6,TRUE
stellar-sdk,0.3.0,0.3.1,26,2,5,5,10,2,TRUE
stellar-sdk,0.2.6,0.2.7,8,12,561,317,878,85,TRUE
stellar-sdk,0.2.5,0.2.6,7,6,797,321,1118,23,TRUE
breach-module-manager,0.1.0,0.2.0,2,39,900,322,1222,93,FALSE
breach-module-manager,0.0.1,0.1.0,1,4,179,35,214,8,FALSE
breach-module-manager,0.1.0,0.2.0,2,39,900,322,1222,93,TRUE
serverless,1.1.0,1.2.0,47,218,21597,10051,31648,914,FALSE
serverless,1.0.0,1.0.2,44,47,1366,5429,6795,161,FALSE
serverless,1.2.0,1.2.1,48,15,2225,627,2852,245,FALSE
serverless,1.0.2,1.0.3,45,180,23755,14876,38631,1463,FALSE
serverless,1.0.3,1.1.0,46,216,42305,27568,69873,1781,FALSE
serverless,1.0.0-alpha.1,1.0.0-alpha.2,37,112,6971,3416,10387,484,FALSE
serverless,1.0.0-alpha.2,1.0.0-beta.1,38,174,11657,3780,15437,590,FALSE
serverless,1.0.0-beta.2,1.0.0-rc.1,41,219,26222,21656,47878,1339,FALSE
serverless,0.2.1,0.3.0,22,53,3646,2418,6064,114,FALSE
serverless,0.2.0,0.2.1,21,18,1235,1235,2470,53,FALSE
serverless,0.1.0,0.1.1,15,19,207,305,512,40,FALSE
serverless,0.1.1,0.1.2,16,13,1627,108,1735,41,FALSE
serverless,0.1.2,0.1.3,17,25,605,493,1098,74,FALSE
serverless,0.1.3,0.1.4,18,5,315,103,418,19,FALSE
serverless,0.1.4,0.1.5,19,21,856,112,968,30,FALSE
serverless,0.1.5,0.2.0,20,18,745,502,1247,39,FALSE
serverless,1.0.0-beta.1,1.0.0-beta.1.1,39,75,3082,658,3740,229,FALSE
serverless,0.3.2,0.3.3,25,1,224,201,425,62,FALSE
serverless,0.3.3,0.4.0,26,64,7802,4993,12795,363,FALSE
serverless,0.3.0,0.3.1,23,3,48,34,82,5,FALSE
serverless,0.3.1,0.3.2,24,138,7952,8065,16017,521,FALSE
serverless,1.9.0,1.10.0,58,54,16126,3286,19412,711,FALSE
serverless,1.6.0,1.6.1,54,4,176,18,194,12,FALSE
serverless,1.6.1,1.7.0,55,66,17160,3103,20263,700,FALSE
serverless,0.5.4,0.5.5,34,2,2,2,4,2,FALSE
serverless,0.5.5,0.5.6,35,450,40499,57086,97585,1737,FALSE
serverless,0.5.6,1.0.0-alpha.1,36,226,14459,9977,24436,940,FALSE
serverless,0.4.2,0.5.0,29,427,48620,50373,98993,2802,FALSE
serverless,0.5.0,0.5.1,30,29,1008,243,1251,41,FALSE
serverless,0.5.1,0.5.2,31,41,1071,890,1961,71,FALSE
serverless,0.5.2,0.5.3,32,42,2413,1072,3485,106,FALSE
serverless,0.5.3,0.5.4,33,25,424,282,706,38,FALSE
serverless,1.4.0,1.5.0,51,133,7243,4528,11771,496,FALSE
serverless,1.5.1,1.6.0,53,88,9385,3024,12409,449,FALSE
serverless,1.5.0,1.5.1,52,73,1991,436,2427,167,FALSE
serverless,0.4.1,0.4.2,28,11,823,98,921,30,FALSE
serverless,1.3.0,1.4.0,50,198,13392,9733,23125,651,FALSE
serverless,1.0.0-rc.2,1.0.0,43,282,29817,14573,44390,1346,FALSE
serverless,1.0.0-rc.1,1.0.0-rc.2,42,167,16698,11680,28378,792,FALSE
serverless,0.4.0,0.4.1,27,11,520,259,779,67,FALSE
serverless,1.12.0,1.12.1,63,15,694,101,795,50,FALSE
serverless,1.2.1,1.3.0,49,124,10046,4446,14492,461,FALSE
serverless,1.8.0,1.9.0,57,86,13357,4909,18266,486,FALSE
serverless,1.11.0,1.12.0,62,74,13885,5850,19735,885,FALSE
serverless,1.10.2,1.11.0,61,82,4353,2025,6378,324,FALSE
serverless,1.10.0,1.10.1,59,18,423,234,657,39,FALSE
serverless,1.10.1,1.10.2,60,9,411,143,554,32,FALSE
serverless,1.0.0-beta.1.1,1.0.0-beta.2,40,69,5764,3034,8798,405,FALSE
serverless,1.7.0,1.8.0,56,71,6390,1408,7798,303,FALSE
serverless,0.0.13,0.0.15,13,52,9948,9686,19634,123,FALSE
serverless,0.0.12,0.0.13,12,46,2625,2131,4756,198,FALSE
serverless,0.0.15,0.1.0,14,226,17132,14278,31410,1010,FALSE
serverless,0.0.11,0.0.12,11,9,12,10,22,10,FALSE
serverless,0.0.10,0.0.11,10,3,49,21,70,6,FALSE
serverless,0.0.5,0.0.6,5,1,3,2,5,2,FALSE
serverless,0.0.4,0.0.5,4,58,15681,14884,30565,483,FALSE
serverless,0.0.7,0.0.8,7,22,901,1189,2090,93,FALSE
serverless,0.0.6,0.0.7,6,38,777,398,1175,101,FALSE
serverless,0.0.3,0.0.4,3,2,5,4,9,2,FALSE
serverless,0.0.2,0.0.3,2,1,5,2,7,1,FALSE
serverless,0.0.9,0.0.10,9,4,45,60,105,4,FALSE
serverless,0.0.8,0.0.9,8,4,11,9,20,6,FALSE
serverless,1.13.1,1.13.2,66,17,7011,6705,13716,45,FALSE
serverless,1.13.0,1.13.1,65,34,4489,1425,5914,220,FALSE
serverless,1.13.2,1.14.0,67,127,16498,10363,26861,392,FALSE
serverless,1.12.1,1.13.0,64,52,8705,7189,15894,185,FALSE
serverless,0.0.15,0.1.0,14,226,17132,14278,31410,1010,TRUE
serverless,1.1.0,1.2.0,47,218,21597,10051,31648,914,TRUE
serverless,1.0.0,1.0.2,44,47,1366,5429,6795,161,TRUE
serverless,1.0.2,1.0.3,45,180,23755,14876,38631,1463,TRUE
serverless,1.0.3,1.1.0,46,216,42305,27568,69873,1781,TRUE
serverless,0.2.0,0.2.1,21,18,1235,1235,2470,53,TRUE
serverless,0.0.13,0.0.15,13,52,9948,9686,19634,123,TRUE
serverless,0.1.1,0.1.2,16,13,1627,108,1735,41,TRUE
serverless,0.1.2,0.1.3,17,25,605,493,1098,74,TRUE
serverless,1.0.0-beta.1,1.0.0-beta.1.1,39,75,3082,658,3740,229,TRUE
serverless,0.0.6,0.0.7,6,38,777,398,1175,101,TRUE
serverless,0.5.0,0.5.1,30,29,1008,243,1251,41,TRUE
serverless,0.5.1,0.5.2,31,41,1071,890,1961,71,TRUE
serverless,1.4.0,1.5.0,51,133,7243,4528,11771,496,TRUE
serverless,1.0.0-alpha.2,1.0.0-beta.1,38,174,11657,3780,15437,590,TRUE
serverless,1.5.0,1.5.1,52,73,1991,436,2427,167,TRUE
serverless,1.3.0,1.4.0,50,198,13392,9733,23125,651,TRUE
serverless,1.2.0,1.2.1,48,15,2225,627,2852,245,TRUE
serverless,0.5.5,0.5.6,35,450,40499,57086,97585,1737,TRUE
serverless,1.9.0,1.10.0,58,54,16126,3286,19412,711,TRUE
serverless,1.12.0,1.12.1,63,15,694,101,795,50,TRUE
serverless,1.2.1,1.3.0,49,124,10046,4446,14492,461,TRUE
serverless,1.13.0,1.13.1,65,34,4489,1425,5914,220,TRUE
serverless,1.8.0,1.9.0,57,86,13357,4909,18266,486,TRUE
serverless,1.10.2,1.11.0,61,82,4353,2025,6378,324,TRUE
serverless,1.13.2,1.14.0,67,127,16498,10363,26861,392,TRUE
serverless,1.7.0,1.8.0,56,71,6390,1408,7798,303,TRUE
serverless,0.5.3,0.5.4,33,25,424,282,706,38,TRUE
serverless,0.1.3,0.1.4,18,5,315,103,418,19,TRUE
serverless,1.13.1,1.13.2,66,17,7011,6705,13716,45,TRUE
serverless,1.0.0-rc.2,1.0.0,43,282,29817,14573,44390,1346,TRUE
eslint-config-stripe,1.0.4,1.0.5,5,1,23,1,24,5,FALSE
eslint-config-stripe,1.0.5,1.0.6,6,1,8,0,8,1,FALSE
eslint-config-stripe,1.0.6,1.0.7,7,2,4,20,24,7,FALSE
eslint-config-stripe,1.0.7,1.0.8,8,1,3,3,6,2,FALSE
eslint-config-stripe,1.0.0,1.0.1,1,1,5,5,10,1,FALSE
eslint-config-stripe,1.0.1,1.0.2,2,2,15,5,20,4,FALSE
eslint-config-stripe,1.0.2,1.0.3,3,1,1,1,2,1,FALSE
eslint-config-stripe,1.0.3,1.0.4,4,2,13,14,27,3,FALSE
eslint-config-stripe,1.0.8,1.0.9,9,1,7,5,12,4,TRUE
eslint-config-stripe,1.0.9,1.0.10,10,1,5,3,8,2,FALSE
eslint-config-stripe,1.0.10,1.0.11,11,1,1,1,2,1,FALSE
eslint-config-stripe,1.0.11,1.0.12,12,1,1,1,2,1,FALSE
eslint-config-stripe,1.0.8,1.0.9,9,1,7,5,12,4,FALSE
eslint-config-stripe,1.0.9,1.0.10,10,1,5,3,8,2,TRUE
eslint-config-stripe,1.0.3,1.0.4,4,2,13,14,27,3,TRUE
appuri-event-api-client,0.1.1,0.1.2,1,6,37,13,50,8,FALSE
appuri-event-api-client,0.1.2,0.1.3,2,1,2,2,4,2,FALSE
appuri-event-api-client,0.1.3,0.2.0,3,2,14,8,22,4,FALSE
appuri-event-api-client,0.1.2,0.1.3,2,1,2,2,4,2,TRUE
appuri-event-api-client,0.1.3,0.2.0,3,2,14,8,22,4,TRUE
angular-ui-router-default,0.0.5,0.0.6,5,2,114,12,126,5,FALSE
angular-ui-router-default,0.0.4,0.0.5,4,4,653,474,1127,17,FALSE
angular-ui-router-default,0.0.1,0.0.2,1,5,888,22,910,24,FALSE
angular-ui-router-default,0.0.3,0.0.4,3,5,625,198,823,16,FALSE
angular-ui-router-default,0.0.2,0.0.3,2,5,213,79,292,18,FALSE
angular-ui-router-default,0.0.5,0.0.6,5,2,114,12,126,5,TRUE
angular-ui-router-default,0.0.3,0.0.4,3,5,625,198,823,16,TRUE
babel-plugin-transform-isnil,0.0.5,0.0.6,5,2,15,16,31,3,FALSE
babel-plugin-transform-isnil,0.0.4,0.0.5,4,2,12,6,18,3,FALSE
babel-plugin-transform-isnil,0.0.7,0.0.8,7,3,19,4,23,5,FALSE
babel-plugin-transform-isnil,0.0.6,0.0.7,6,5,138,47,185,11,FALSE
babel-plugin-transform-isnil,0.0.1,0.0.2,1,4,97,27,124,11,FALSE
babel-plugin-transform-isnil,0.0.3,0.0.4,3,8,164,42,206,16,FALSE
babel-plugin-transform-isnil,0.0.2,0.0.3,2,3,129,21,150,8,FALSE
babel-plugin-transform-isnil,0.0.3,0.0.4,3,8,164,42,206,16,TRUE
kronos-service-koa,3.0.6,3.0.7,81,1,2,2,4,1,FALSE
kronos-service-koa,3.0.7,3.1.0,82,30,61,39,100,32,FALSE
kronos-service-koa,3.0.4,3.0.5,79,21,77,67,144,23,FALSE
kronos-service-koa,3.1.0,3.2.0,83,23,294,156,450,45,FALSE
kronos-service-koa,3.0.2,3.0.3,77,3,10,8,18,3,FALSE
kronos-service-koa,3.0.3,3.0.4,78,2,3,3,6,2,FALSE
kronos-service-koa,3.0.0,3.0.1,75,4,5,2,7,4,FALSE
kronos-service-koa,3.0.1,3.0.2,76,8,14,16,30,9,FALSE
kronos-service-koa,2.17.12,2.17.13,70,21,19,19,38,19,FALSE
kronos-service-koa,2.17.13,2.17.14,71,2,2,2,4,2,FALSE
kronos-service-koa,2.17.10,2.17.11,68,4,4,4,8,4,FALSE
kronos-service-koa,2.17.11,2.17.12,69,4,3,3,6,3,FALSE
kronos-service-koa,2.17.16,3.0.0,74,4,18,12,30,6,FALSE
kronos-service-koa,2.17.14,2.17.15,72,2,1,1,2,1,FALSE
kronos-service-koa,2.17.15,2.17.16,73,3,3,3,6,3,FALSE
kronos-service-koa,3.0.5,3.0.6,80,1,0,2,2,1,FALSE
kronos-service-koa,3.3.1,3.3.2,86,20,24,24,48,22,FALSE
kronos-service-koa,2.17.7,2.17.8,65,6,5,5,10,4,FALSE
kronos-service-koa,3.3.0,3.3.1,85,14,30,24,54,18,FALSE
kronos-service-koa,2.17.6,2.17.7,64,4,4,4,8,4,FALSE
kronos-service-koa,3.2.0,3.3.0,84,3,20,12,32,3,FALSE
kronos-service-koa,2.16.5,2.16.6,55,13,36,26,62,13,FALSE
kronos-service-koa,2.16.4,2.16.5,54,1,5,1,6,1,FALSE
kronos-service-koa,2.16.7,2.17.0,57,13,159,87,246,16,FALSE
kronos-service-koa,2.16.6,2.16.7,56,2,3,2,5,2,FALSE
kronos-service-koa,2.17.5,2.17.6,63,7,7,7,14,7,FALSE
kronos-service-koa,2.17.4,2.17.5,62,4,12,5,17,4,FALSE
kronos-service-koa,2.17.0,2.17.1,58,2,12,9,21,2,FALSE
kronos-service-koa,2.17.1,2.17.2,59,7,7,7,14,7,FALSE
kronos-service-koa,2.17.8,2.17.9,66,2,1,1,2,1,FALSE
kronos-service-koa,2.17.9,2.17.10,67,1,1,1,2,1,FALSE
kronos-service-koa,3.3.3,3.3.4,88,24,31,29,60,27,FALSE
kronos-service-koa,3.3.2,3.3.3,87,12,46,24,70,14,FALSE
kronos-service-koa,3.3.5,3.3.6,90,3,8,8,16,5,FALSE
kronos-service-koa,3.3.4,3.3.5,89,17,22,22,44,19,FALSE
kronos-service-koa,3.3.7,3.3.8,92,5,16,16,32,7,FALSE
kronos-service-koa,3.3.6,3.3.7,91,8,17,14,31,12,FALSE
kronos-service-koa,3.3.9,3.3.10,94,14,20,20,40,17,FALSE
kronos-service-koa,3.3.8,3.3.9,93,2,14,4,18,4,FALSE
kronos-service-koa,2.17.2,2.17.3,60,1,8,8,16,1,FALSE
kronos-service-koa,2.17.3,2.17.4,61,1,6,6,12,2,FALSE
kronos-service-koa,2.16.1,2.16.2,51,7,17,14,31,7,FALSE
kronos-service-koa,2.16.0,2.16.1,50,3,28,17,45,3,FALSE
kronos-service-koa,2.16.3,2.16.4,53,1,1,1,2,1,FALSE
kronos-service-koa,2.16.2,2.16.3,52,1,3,3,6,1,FALSE
kronos-service-koa,2.13.0,2.13.1,40,3,15,42,57,4,FALSE
kronos-service-koa,2.13.1,2.13.2,41,2,17,12,29,2,FALSE
kronos-service-koa,2.13.2,2.13.3,42,1,1,1,2,1,FALSE
kronos-service-koa,2.13.3,2.14.0,43,2,81,96,177,5,FALSE
kronos-service-koa,2.15.2,2.15.3,48,3,3,5,8,3,FALSE
kronos-service-koa,2.11.0,2.11.1,37,1,11,8,19,1,FALSE
kronos-service-koa,2.11.1,2.12.0,38,1,145,32,177,3,FALSE
kronos-service-koa,2.12.0,2.13.0,39,6,272,48,320,9,FALSE
kronos-service-koa,2.15.0,2.15.1,46,5,21,8,29,4,FALSE
kronos-service-koa,2.15.1,2.15.2,47,3,3,3,6,3,FALSE
kronos-service-koa,2.15.3,2.16.0,49,3,21,16,37,4,FALSE
kronos-service-koa,2.14.1,2.15.0,45,3,4,7,11,1,FALSE
kronos-service-koa,2.14.0,2.14.1,44,4,24,18,42,4,FALSE
kronos-service-koa,2.10.0,2.11.0,36,1,58,9,67,2,FALSE
kronos-service-koa,3.3.7,3.3.8,92,5,16,16,32,7,TRUE
kronos-service-koa,2.16.7,2.17.0,57,13,159,87,246,16,TRUE
kronos-service-koa,2.17.7,2.17.8,65,6,5,5,10,4,TRUE
kronos-service-koa,1.0.0,2.0.0,1,34,346,247,593,48,FALSE
kronos-service-koa,2.17.16,3.0.0,74,4,18,12,30,6,TRUE
kronos-service-koa,2.8.9,2.9.0,31,1,13,1,14,1,TRUE
kronos-service-koa,2.8.8,2.8.9,30,6,31,22,53,7,FALSE
kronos-service-koa,2.8.7,2.8.8,29,2,1,1,2,1,FALSE
kronos-service-koa,2.8.6,2.8.7,28,4,4,4,8,4,FALSE
kronos-service-koa,2.8.5,2.8.6,27,3,3,2,5,3,FALSE
kronos-service-koa,2.8.4,2.8.5,26,1,1,1,2,1,FALSE
kronos-service-koa,2.8.3,2.8.4,25,1,1,1,2,1,FALSE
kronos-service-koa,2.8.2,2.8.3,24,3,3,3,6,3,FALSE
kronos-service-koa,2.8.1,2.8.2,23,12,23,24,47,13,FALSE
kronos-service-koa,2.8.0,2.8.1,22,12,16,13,29,12,FALSE
kronos-service-koa,2.9.2,2.9.3,34,2,2,2,4,2,FALSE
kronos-service-koa,2.9.3,2.10.0,35,16,452,344,796,30,FALSE
kronos-service-koa,2.9.0,2.9.1,32,1,1,1,2,1,FALSE
kronos-service-koa,2.9.1,2.9.2,33,1,1,1,2,1,FALSE
kronos-service-koa,2.0.5,2.1.0,7,3,36,5,41,3,FALSE
kronos-service-koa,2.0.4,2.0.5,6,5,10,7,17,5,FALSE
kronos-service-koa,2.0.3,2.0.4,5,3,4,4,8,3,FALSE
kronos-service-koa,2.0.2,2.0.3,4,6,42,36,78,7,FALSE
kronos-service-koa,2.0.1,2.0.2,3,6,22,28,50,7,FALSE
kronos-service-koa,2.0.0,2.0.1,2,1,5,3,8,2,FALSE
kronos-service-koa,2.2.0,2.3.0,9,1,27,8,35,2,FALSE
kronos-service-koa,2.4.2,2.5.0,14,1,11,8,19,1,FALSE
kronos-service-koa,2.4.1,2.4.2,13,1,1,1,2,1,FALSE
kronos-service-koa,2.4.0,2.4.1,12,1,12,20,32,1,FALSE
kronos-service-koa,2.6.1,2.7.0,19,3,42,17,59,4,FALSE
kronos-service-koa,2.6.0,2.6.1,18,7,14,17,31,7,FALSE
kronos-service-koa,2.1.0,2.2.0,8,1,108,31,139,5,FALSE
kronos-service-koa,2.3.0,2.3.1,10,1,9,8,17,2,FALSE
kronos-service-koa,2.3.1,2.4.0,11,2,26,23,49,4,FALSE
kronos-service-koa,2.5.2,2.6.0,17,6,18,11,29,7,FALSE
kronos-service-koa,2.5.0,2.5.1,15,2,40,2,42,3,FALSE
kronos-service-koa,2.5.1,2.5.2,16,1,1,1,2,1,FALSE
kronos-service-koa,2.7.0,2.7.1,20,3,5,3,8,3,FALSE
kronos-service-koa,2.7.1,2.8.0,21,1,2,2,4,1,FALSE
kronos-service-koa,2.8.9,2.9.0,31,1,13,1,14,1,FALSE
kronos-service-koa,2.6.0,2.6.1,18,7,14,17,31,7,TRUE
kronos-service-koa,3.3.1,3.3.2,86,20,24,24,48,22,TRUE
kronos-service-koa,3.3.2,3.3.3,87,12,46,24,70,14,TRUE
kronos-service-koa,2.17.4,2.17.5,62,4,12,5,17,4,TRUE
kronos-service-koa,2.17.5,2.17.6,63,7,7,7,14,7,TRUE
kronos-service-koa,2.17.12,2.17.13,70,21,19,19,38,19,TRUE
kronos-service-koa,2.14.0,2.14.1,44,4,24,18,42,4,TRUE
magnet,1.0.0-alpha.9,1.0.0-alpha.10,35,2,3,2,5,2,FALSE
magnet,0.19.4,0.20.0,25,4,9,4,13,5,TRUE
magnet,1.0.0,1.0.1,40,2,3,3,6,2,FALSE
magnet,1.0.1,1.0.2,41,3,25,4,29,4,FALSE
magnet,1.0.0-alpha.8,1.0.0-alpha.9,34,2,19,46,65,14,FALSE
magnet,1.0.0-alpha.1,1.0.0-alpha.2,27,7,150,49,199,26,FALSE
magnet,1.0.0-alpha.3,1.0.0-alpha.4,29,2,17,1,18,2,FALSE
magnet,1.0.0-alpha.2,1.0.0-alpha.3,28,11,42,30,72,21,FALSE
magnet,1.0.0-alpha.5,1.0.0-alpha.6,31,2,2,2,4,2,FALSE
magnet,1.0.0-alpha.4,1.0.0-alpha.5,30,4,115,447,562,17,FALSE
magnet,1.0.0-alpha.7,1.0.0-alpha.8,33,2,3,2,5,2,FALSE
magnet,1.0.0-alpha.6,1.0.0-alpha.7,32,1,3,3,6,1,FALSE
magnet,0.14.0,0.15.0,16,3,13,10,23,5,FALSE
magnet,0.10.0,0.11.0,12,3,3,2,5,3,FALSE
magnet,0.11.0,0.12.0,13,17,196,162,358,30,FALSE
magnet,0.17.0,0.18.0,19,15,426,190,616,32,FALSE
magnet,0.12.0,0.13.0,14,2,6,3,9,2,FALSE
magnet,0.20.0,1.0.0-alpha.1,26,29,994,407,1401,100,FALSE
magnet,0.16.0,0.17.0,18,3,64,30,94,8,FALSE
magnet,0.13.0,0.14.0,15,7,86,77,163,11,FALSE
magnet,0.15.0,0.16.0,17,9,139,482,621,27,FALSE
magnet,0.19.0,0.19.1,21,2,6,1,7,2,FALSE
magnet,0.19.1,0.19.2,22,7,111,70,181,23,FALSE
magnet,0.19.2,0.19.3,23,2,2,2,4,2,FALSE
magnet,0.19.3,0.19.4,24,2,7,7,14,7,FALSE
magnet,0.18.0,0.19.0,20,2,2,2,4,2,FALSE
magnet,1.0.0-alpha.11,1.0.0-alpha.12,37,4,17,18,35,10,FALSE
magnet,1.0.0-alpha.10,1.0.0-alpha.11,36,2,3,110,113,5,FALSE
magnet,1.0.0-alpha.13,1.0.0,39,6,150,62,212,17,FALSE
magnet,1.0.0-alpha.12,1.0.0-alpha.13,38,2,4,4,8,4,FALSE
magnet,0.19.4,0.20.0,25,4,9,4,13,5,FALSE
magnet,0.9.0,0.10.0,11,28,830,574,1404,102,FALSE
magnet,0.2.0,0.3.0,4,4,15,11,26,4,FALSE
magnet,0.3.0,0.4.0,5,3,139,23,162,13,FALSE
magnet,0.6.0,0.7.0,8,2,3,2,5,2,FALSE
magnet,0.7.0,0.8.0,9,31,346,162,508,61,FALSE
magnet,0.4.0,0.5.0,6,3,20,4,24,3,FALSE
magnet,0.5.0,0.6.0,7,36,667,59,726,46,FALSE
magnet,0.8.0,0.9.0,10,2,7,4,11,2,FALSE
magnet,0.18.0,0.19.0,20,2,2,2,4,2,TRUE
magnet,1.0.0-alpha.3,1.0.0-alpha.4,29,2,17,1,18,2,TRUE
magnet,1.0.0-alpha.8,1.0.0-alpha.9,34,2,19,46,65,14,TRUE
magnet,1.0.0-alpha.12,1.0.0-alpha.13,38,2,4,4,8,4,TRUE
magnet,1.0.0-alpha.1,1.0.0-alpha.2,27,7,150,49,199,26,TRUE
eventorjs,0.16.17,0.16.18,38,2,9,1,10,2,FALSE
eventorjs,0.16.16,0.16.17,37,2,39,39,78,2,FALSE
eventorjs,0.16.15,0.16.16,36,2,2,2,4,2,FALSE
eventorjs,0.16.14,0.16.15,35,2,2,2,4,2,FALSE
eventorjs,0.16.13,0.16.14,34,2,1204,30,1234,19,FALSE
eventorjs,0.16.12,0.16.13,33,2,41,15,56,4,FALSE
eventorjs,0.16.11,0.16.12,32,2,3,1,4,2,FALSE
eventorjs,0.16.10,0.16.11,31,2,8,8,16,2,FALSE
eventorjs,0.16.19,0.16.20,40,2,71,52,123,5,FALSE
eventorjs,0.16.18,0.16.19,39,2,66,7852,7918,7,FALSE
eventorjs,0.16.7,0.16.8,28,2,167,80,247,7,FALSE
eventorjs,0.16.5,0.16.7,27,4,29,24,53,7,FALSE
eventorjs,0.16.4,0.16.5,26,2,2,2,4,2,FALSE
eventorjs,0.16.3,0.16.4,25,4,78,2,80,5,FALSE
eventorjs,0.16.1,0.16.2,23,2,35,30,65,17,FALSE
eventorjs,0.16.0,0.16.1,22,5,50,39,89,5,FALSE
eventorjs,0.16.8,0.16.9,29,3,2710,2994,5704,9,FALSE
eventorjs,0.16.9,0.16.10,30,3,100,11,111,5,FALSE
eventorjs,0.16.2,0.16.3,24,2,29,29,58,17,FALSE
eventorjs,0.10.1,0.10.2,13,4,50,13,63,4,FALSE
eventorjs,0.10.3,0.10.4,15,2,53,86,139,6,FALSE
eventorjs,0.10.2,0.10.3,14,3,333,21,354,4,FALSE
eventorjs,0.10.5,0.10.6,17,4,277,86,363,9,FALSE
eventorjs,0.10.4,0.10.5,16,4,253,703,956,13,FALSE
eventorjs,0.10.6,0.11.1,18,10,3655,1001,4656,16,FALSE
eventorjs,0.11.1,0.11.2,19,3,106,24,130,4,FALSE
eventorjs,0.11.2,0.11.4,20,5,40,50,90,8,FALSE
eventorjs,0.9.12,0.9.13,9,3,50,6057,6107,8,FALSE
eventorjs,0.9.13,0.9.14,10,2,415,35,450,17,FALSE
eventorjs,0.9.14,0.9.15,11,2,2,3,5,2,FALSE
eventorjs,0.9.15,0.10.1,12,3,453,65,518,6,FALSE
eventorjs,0.11.4,0.16.0,21,41,18984,5253,24237,113,FALSE
eventorjs,0.16.14,0.16.15,35,2,2,2,4,2,TRUE
eventorjs,0.16.9,0.16.10,30,3,100,11,111,5,TRUE
eventorjs,0.9.0,0.9.5,1,8,427,365,792,24,FALSE
eventorjs,0.9.5,0.9.6,2,3,37,29,66,3,FALSE
eventorjs,0.9.6,0.9.7,3,2,23,1,24,2,FALSE
eventorjs,0.9.7,0.9.8,4,2,111,131,242,2,FALSE
eventorjs,0.9.8,0.9.9,5,2,15,8,23,2,FALSE
eventorjs,0.9.9,0.9.10,6,2,3,3,6,2,FALSE
eventorjs,0.9.10,0.9.11,7,2,2,2,4,2,FALSE
eventorjs,0.9.11,0.9.12,8,6,7218,783,8001,33,FALSE
eventorjs,0.11.1,0.11.2,19,3,106,24,130,4,TRUE
eventorjs,0.16.17,0.16.18,38,2,9,1,10,2,TRUE
yomo,1.1.1,1.1.2,4,2,116,28,144,7,TRUE
yomo,1.1.0,1.1.1,3,2,80,109,189,2,FALSE
yomo,1.1.2,1.2.0,5,4,303,178,481,20,FALSE
yomo,1.0.0,1.0.1,1,3,590,5,595,19,FALSE
yomo,1.0.1,1.1.0,2,8,555,344,899,29,FALSE
yomo,1.4.1,1.5.0,9,2,51,2,53,5,FALSE
yomo,1.5.0,1.5.1,10,2,96,33,129,4,FALSE
yomo,1.3.0,1.4.0,7,2,54,5,59,7,FALSE
yomo,1.2.0,1.3.0,6,1,1,1,2,1,FALSE
yomo,1.4.0,1.4.1,8,3,9,2,11,4,FALSE
yomo,1.1.1,1.1.2,4,2,116,28,144,7,FALSE
yomo,1.4.1,1.5.0,9,2,51,2,53,5,TRUE
dataframe-js,1.1.0,1.1.2,13,12,18803,18718,37521,116,FALSE
dataframe-js,1.1.3,1.1.4,15,3,420,369,789,39,FALSE
dataframe-js,1.1.2,1.1.3,14,3,408,360,768,36,FALSE
dataframe-js,1.0.0,1.0.2,11,10,486,408,894,40,FALSE
dataframe-js,1.1.4,1.1.5,16,3,54,60,114,21,FALSE
dataframe-js,1.0.2,1.1.0,12,4,1239,864,2103,51,FALSE
dataframe-js,1.2.0,1.2.1,18,3,288,219,507,12,FALSE
dataframe-js,1.2.1,1.2.2,19,7,704,524,1228,33,FALSE
dataframe-js,1.1.5,1.2.0,17,19,24029,42200,66229,204,FALSE
dataframe-js,0.2.9,1.0.0,10,56,91292,24964,116256,632,FALSE
dataframe-js,0.2.7,0.2.8,8,3,21,15,36,6,FALSE
dataframe-js,0.2.6,0.2.7,7,3,60,15,75,9,FALSE
dataframe-js,0.2.5,0.2.6,6,3,48,9,57,9,FALSE
dataframe-js,0.2.4,0.2.5,5,3,5259,18765,24024,24,FALSE
dataframe-js,0.2.3,0.2.4,4,3,38643,6963,45606,57,FALSE
dataframe-js,0.2.2,0.2.3,3,7,2460,2854,5314,38,FALSE
dataframe-js,0.2.1,0.2.2,2,4,43,13,56,10,FALSE
dataframe-js,0.2.0,0.2.1,1,7,78,32,110,11,FALSE
dataframe-js,0.2.8,0.2.9,9,18,12585,4016,16601,63,FALSE
dataframe-js,0.2.8,0.2.9,9,18,12585,4016,16601,63,TRUE
airdcpp-webui,0.6.0,0.6.1,42,5,338,249,587,62,FALSE
airdcpp-webui,0.3.6,0.3.7,30,1,10,4,14,2,FALSE
airdcpp-webui,0.3.7,0.3.8,31,3,250,63,313,19,FALSE
airdcpp-webui,0.2.7,0.2.8,20,2,28,13,41,7,FALSE
airdcpp-webui,0.2.6,0.2.7,19,1,58,7,65,8,FALSE
airdcpp-webui,0.2.5,0.2.6,18,1,27,4,31,5,FALSE
airdcpp-webui,0.2.4,0.2.5,17,1,82,88,170,10,FALSE
airdcpp-webui,0.2.3,0.2.4,16,1,28,2,30,2,FALSE
airdcpp-webui,0.0.10,0.1.0,10,4,105,31,136,15,FALSE
airdcpp-webui,0.2.1,0.2.2,14,1,34,11,45,3,FALSE
airdcpp-webui,0.2.0,0.2.1,13,7,200,132,332,24,FALSE
airdcpp-webui,0.1.0,0.1.1,11,1,7,4,11,4,FALSE
airdcpp-webui,0.1.1,0.2.0,12,20,3728,1366,5094,222,FALSE
airdcpp-webui,0.6.4,0.7.0,46,2,64,22,86,11,FALSE
airdcpp-webui,0.2.9,0.2.10,22,1,4,4,8,2,FALSE
airdcpp-webui,0.2.8,0.2.9,21,1,12,22,34,4,FALSE
airdcpp-webui,0.0.5,0.0.6,5,10,531,423,954,117,FALSE
airdcpp-webui,0.0.4,0.0.5,4,1,75,15,90,5,FALSE
airdcpp-webui,0.0.7,0.0.8,7,1,213,201,414,24,FALSE
airdcpp-webui,0.3.9,0.4.0,33,8,2164,1499,3663,123,FALSE
airdcpp-webui,0.0.1,0.0.2,1,1,5,13,18,4,FALSE
airdcpp-webui,0.0.3,0.0.4,3,1,41,31,72,15,FALSE
airdcpp-webui,0.0.2,0.0.3,2,2,69,48,117,16,FALSE
airdcpp-webui,0.3.2,0.3.3,26,2,136,142,278,12,FALSE
airdcpp-webui,0.3.3,0.3.4,27,1,5,13,18,4,FALSE
airdcpp-webui,0.3.0,0.3.1,24,3,214,139,353,41,FALSE
airdcpp-webui,0.3.1,0.3.2,25,2,60,73,133,4,FALSE
airdcpp-webui,0.0.9,0.0.10,9,1,18,3,21,3,FALSE
airdcpp-webui,0.0.8,0.0.9,8,1,5,13,18,4,FALSE
airdcpp-webui,0.3.4,0.3.5,28,1,7,2,9,2,FALSE
airdcpp-webui,0.3.5,0.3.6,29,4,235,168,403,29,FALSE
airdcpp-webui,0.4.1,0.4.2,35,2,598,572,1170,31,FALSE
airdcpp-webui,0.4.0,0.4.1,34,1,14,10,24,6,FALSE
airdcpp-webui,0.4.3,0.4.4,37,4,329,294,623,30,FALSE
airdcpp-webui,0.4.2,0.4.3,36,1,169,177,346,11,FALSE
airdcpp-webui,0.4.5,0.4.6,39,3,94,31,125,14,FALSE
airdcpp-webui,0.4.4,0.4.5,38,1,40,26,66,6,FALSE
airdcpp-webui,0.4.6,0.5.0,40,9,528,369,897,48,FALSE
airdcpp-webui,0.3.8,0.3.9,32,1,9,4,13,3,FALSE
airdcpp-webui,0.2.10,0.3.0,23,22,3155,2112,5267,186,FALSE
airdcpp-webui,0.0.6,0.0.7,6,4,116,89,205,17,FALSE
airdcpp-webui,0.6.2,0.6.3,44,1,25,11,36,6,FALSE
airdcpp-webui,0.5.0,0.6.0,41,13,2085,972,3057,233,FALSE
airdcpp-webui,0.6.3,0.6.4,45,5,85,35,120,9,FALSE
airdcpp-webui,0.6.1,0.6.2,43,2,16,7,23,2,FALSE
airdcpp-webui,0.2.2,0.2.3,15,1,11,6,17,3,FALSE
airdcpp-webui,1.0.4,1.0.5,89,16,144,111,255,36,FALSE
airdcpp-webui,1.0.5,1.0.6,90,7,21,66,87,14,FALSE
airdcpp-webui,1.0.6,1.0.7,91,3,8,20,28,5,FALSE
airdcpp-webui,1.0.7,1.0.8,92,15,168,155,323,68,FALSE
airdcpp-webui,1.0.0,1.0.1,85,3,13,5,18,3,FALSE
airdcpp-webui,1.0.1,1.0.2,86,2,3,4,7,2,FALSE
airdcpp-webui,1.0.2,1.0.3,87,7,169,101,270,23,FALSE
airdcpp-webui,1.0.3,1.0.4,88,16,355,175,530,60,FALSE
airdcpp-webui,1.0.8,1.1.0-beta1,93,6,91,17,108,13,FALSE
airdcpp-webui,1.3.0-beta4,1.3.0,121,2,96,24,120,5,FALSE
airdcpp-webui,1.3.0-beta1,1.3.0-beta2,118,16,235,213,448,27,FALSE
airdcpp-webui,0.12.4,0.13.0,63,3,257,86,343,20,FALSE
airdcpp-webui,1.2.0-beta4,1.2.0,110,5,19,9,28,7,FALSE
airdcpp-webui,1.2.0-beta1,1.2.0-beta2,107,4,41,29,70,9,FALSE
airdcpp-webui,1.2.0-beta3,1.2.0-beta4,109,3,201,91,292,12,FALSE
airdcpp-webui,1.2.0-beta2,1.2.0-beta3,108,3,21,8,29,5,FALSE
airdcpp-webui,1.3.2-beta2,1.3.2-beta3,125,7,290,179,469,28,FALSE
airdcpp-webui,1.3.2-beta3,1.3.2-beta4,126,10,195,257,452,51,FALSE
airdcpp-webui,1.3.2-beta1,1.3.2-beta2,124,3,94,82,176,10,FALSE
airdcpp-webui,1.3.2-beta6,1.3.2,129,2,17,2,19,3,FALSE
airdcpp-webui,1.3.2-beta4,1.3.2-beta5,127,12,259,147,406,38,FALSE
airdcpp-webui,1.3.2-beta5,1.3.2-beta6,128,5,149,51,200,17,FALSE
airdcpp-webui,1.4.0,2.0.0-beta1,135,26,541,486,1027,192,FALSE
airdcpp-webui,1.2.1-beta1,1.2.1-beta2,112,3,5,3,8,4,FALSE
airdcpp-webui,1.2.1-beta2,1.2.1-beta3,113,8,451,259,710,23,FALSE
airdcpp-webui,1.2.1-beta3,1.2.1-beta4,114,2,4,4,8,2,FALSE
airdcpp-webui,1.2.1-beta4,1.2.1,115,2,35,32,67,14,FALSE
airdcpp-webui,2.0.3-beta.1,2.0.3,156,2,8,5,13,3,FALSE
airdcpp-webui,1.0.0-beta3,1.0.0-beta4,82,7,441,327,768,60,FALSE
airdcpp-webui,1.0.0-beta2,1.0.0-beta3,81,6,138,100,238,24,FALSE
airdcpp-webui,1.0.0-beta1,1.0.0-beta2,80,4,44,31,75,9,FALSE
airdcpp-webui,1.0.0-beta5,1.0.0,84,2,7,2,9,2,FALSE
airdcpp-webui,1.0.0-beta4,1.0.0-beta5,83,5,32,27,59,10,FALSE
airdcpp-webui,0.16.2,1.0.0-beta1,79,25,1379,1440,2819,161,FALSE
airdcpp-webui,0.16.1,0.16.2,78,4,110,14,124,11,FALSE
airdcpp-webui,0.16.0,0.16.1,77,2,21,7,28,9,TRUE
airdcpp-webui,0.15.0,0.16.0,76,3,161,64,225,23,FALSE
airdcpp-webui,2.0.0-beta8,2.0.0-beta9,150,4,97,30,127,14,FALSE
airdcpp-webui,2.0.0-beta9,2.0.0,151,72,3290,2489,5779,289,FALSE
airdcpp-webui,2.0.3,2.0.4,157,22,1246,917,2163,114,FALSE
airdcpp-webui,2.0.2,2.0.3-beta.1,155,10,765,665,1430,149,FALSE
airdcpp-webui,2.0.1,2.0.2-beta1,153,6,86,28,114,15,FALSE
airdcpp-webui,2.0.0,2.0.1,152,2,10,4,14,4,FALSE
airdcpp-webui,2.0.0-beta1,2.0.0-beta10,136,40,882,535,1417,118,FALSE
airdcpp-webui,2.0.0-beta2,2.0.0-beta3,144,2,2,2,4,2,FALSE
airdcpp-webui,2.0.0-beta3,2.0.0-beta4,145,2,2,2,4,2,FALSE
airdcpp-webui,2.0.0-beta4,2.0.0-beta5,146,7,57,17,74,14,FALSE
airdcpp-webui,2.0.0-beta5,2.0.0-beta6,147,4,255,57,312,17,FALSE
airdcpp-webui,2.0.0-beta6,2.0.0-beta7,148,8,346,326,672,44,FALSE
airdcpp-webui,2.0.0-beta7,2.0.0-beta8,149,2,5,5,10,3,FALSE
airdcpp-webui,0.11.0,0.11.1,56,3,229,221,450,18,FALSE
airdcpp-webui,0.11.1,0.11.2,57,4,199,108,307,18,FALSE
airdcpp-webui,0.11.2,0.12.0,58,2,67,25,92,5,FALSE
airdcpp-webui,1.2.2-beta1,1.3.0-beta1,117,9,473,401,874,30,FALSE
airdcpp-webui,0.13.2,0.13.3,66,1,10,9,19,3,FALSE
airdcpp-webui,0.13.0,0.13.1,64,2,17,11,28,7,FALSE
airdcpp-webui,0.14.4,0.15.0,75,9,589,147,736,43,FALSE
airdcpp-webui,0.14.1,0.14.2,72,1,17,5,22,3,FALSE
airdcpp-webui,0.14.0,0.14.1,71,4,248,80,328,15,FALSE
airdcpp-webui,0.14.3,0.14.4,74,1,5,13,18,4,FALSE
airdcpp-webui,0.14.2,0.14.3,73,1,5,13,18,4,FALSE
airdcpp-webui,0.8.0,0.9.0,52,15,1388,628,2016,152,FALSE
airdcpp-webui,1.3.3,1.4.0-beta1,131,17,117,140,257,55,FALSE
airdcpp-webui,0.13.6,0.13.7,69,3,70,34,104,8,FALSE
airdcpp-webui,1.3.1,1.3.2-beta1,123,6,396,108,504,42,FALSE
airdcpp-webui,1.3.0,1.3.1,122,6,102,35,137,9,FALSE
airdcpp-webui,0.13.7,0.14.0,70,14,612,298,910,70,FALSE
airdcpp-webui,0.13.4,0.13.6,68,5,226,106,332,32,FALSE
airdcpp-webui,1.1.2-beta2,1.1.2-beta3,102,2,44,29,73,7,FALSE
airdcpp-webui,1.1.2-beta3,1.1.2-beta4,103,5,143,340,483,31,TRUE
airdcpp-webui,0.13.3,0.13.4,67,3,102,45,147,20,FALSE
airdcpp-webui,0.13.1,0.13.2,65,1,2,2,4,2,FALSE
airdcpp-webui,1.3.2,1.3.3,130,4,173,14,187,12,FALSE
airdcpp-webui,1.1.1,1.1.2-beta1,100,6,1601,541,2142,67,FALSE
airdcpp-webui,1.1.0,1.1.1,99,10,659,568,1227,76,FALSE
airdcpp-webui,1.1.2,1.2.0-beta1,106,10,353,104,457,42,FALSE
airdcpp-webui,1.4.0-beta3,1.4.0,134,2,4,4,8,2,FALSE
airdcpp-webui,1.4.0-beta2,1.4.0-beta3,133,1,15,1,16,1,FALSE
airdcpp-webui,0.10.0,0.10.1,54,1,102,125,227,11,FALSE
airdcpp-webui,2.0.2-beta1,2.0.2,154,1,1,1,2,1,FALSE
airdcpp-webui,0.7.4,0.8.0,51,5,615,374,989,38,FALSE
airdcpp-webui,0.7.2,0.7.3,49,1,5,6,11,2,FALSE
airdcpp-webui,0.7.3,0.7.4,50,2,78,65,143,7,FALSE
airdcpp-webui,0.7.0,0.7.1,47,4,776,640,1416,48,FALSE
airdcpp-webui,0.7.1,0.7.2,48,1,26,12,38,7,FALSE
airdcpp-webui,0.12.3,0.12.4,62,1,4,3,7,2,FALSE
airdcpp-webui,0.12.2,0.12.3,61,1,15,4,19,3,FALSE
airdcpp-webui,0.12.1,0.12.2,60,1,16,12,28,5,FALSE
airdcpp-webui,0.12.0,0.12.1,59,1,82,44,126,9,FALSE
airdcpp-webui,1.4.0-beta1,1.4.0-beta2,132,7,207,183,390,19,FALSE
airdcpp-webui,1.3.0-beta2,1.3.0-beta3,119,2,34,14,48,6,FALSE
airdcpp-webui,1.3.0-beta3,1.3.0-beta4,120,6,62,40,102,14,FALSE
airdcpp-webui,2.0.0-beta12,2.0.0-beta13,139,18,1660,1837,3497,136,FALSE
airdcpp-webui,2.0.0-beta13,2.0.0-beta14,140,13,297,261,558,49,FALSE
airdcpp-webui,2.0.0-beta10,2.0.0-beta11,137,3,50,32,82,8,FALSE
airdcpp-webui,2.0.0-beta11,2.0.0-beta12,138,10,692,61,753,33,FALSE
airdcpp-webui,2.0.0-beta14,2.0.0-beta15,141,3,17,24,41,12,FALSE
airdcpp-webui,2.0.0-beta15,2.0.0-beta16,142,7,354,198,552,22,FALSE
airdcpp-webui,0.9.0,0.10.0,53,11,1230,670,1900,125,TRUE
airdcpp-webui,0.10.1,0.11.0,55,6,607,379,986,45,FALSE
airdcpp-webui,1.1.2-beta4,1.1.2-beta5,104,4,21,19,40,14,FALSE
airdcpp-webui,1.2.0,1.2.1-beta1,111,18,194,1648,1842,56,FALSE
airdcpp-webui,1.2.1,1.2.2-beta1,116,3,83,26,109,6,FALSE
airdcpp-webui,1.1.0-beta2,1.1.0-beta3,95,6,785,240,1025,61,FALSE
airdcpp-webui,1.1.0-beta3,1.1.0-beta4,96,4,258,228,486,37,FALSE
airdcpp-webui,1.1.0-beta1,1.1.0-beta2,94,8,748,274,1022,58,FALSE
airdcpp-webui,1.1.2-beta1,1.1.2-beta2,101,1,41,23,64,9,FALSE
airdcpp-webui,1.1.0-beta4,1.1.0-beta5,97,2,349,18,367,15,FALSE
airdcpp-webui,1.1.0-beta5,1.1.0,98,2,7,11,18,6,FALSE
airdcpp-webui,1.1.2-beta5,1.1.2,105,2,18,13,31,5,FALSE
airdcpp-webui,0.16.0,0.16.1,77,2,21,7,28,9,FALSE
airdcpp-webui,1.1.2-beta3,1.1.2-beta4,103,5,143,340,483,31,FALSE
airdcpp-webui,0.7.2,0.7.3,49,1,5,6,11,2,TRUE
airdcpp-webui,0.9.0,0.10.0,53,11,1230,670,1900,125,FALSE
airdcpp-webui,1.0.0,1.0.1,85,3,13,5,18,3,TRUE
airdcpp-webui,0.3.9,0.4.0,33,8,2164,1499,3663,123,TRUE
airdcpp-webui,0.3.0,0.3.1,24,3,214,139,353,41,TRUE
airdcpp-webui,0.3.1,0.3.2,25,2,60,73,133,4,TRUE
airdcpp-webui,1.3.2-beta3,1.3.2-beta4,126,10,195,257,452,51,TRUE
airdcpp-webui,0.6.4,0.7.0,46,2,64,22,86,11,TRUE
airdcpp-webui,0.2.10,0.3.0,23,22,3155,2112,5267,186,TRUE
airdcpp-webui,0.13.7,0.14.0,70,14,612,298,910,70,TRUE
airdcpp-webui,1.1.1,1.1.2-beta1,100,6,1601,541,2142,67,TRUE
airdcpp-webui,1.3.0-beta3,1.3.0-beta4,120,6,62,40,102,14,TRUE
airdcpp-webui,1.0.6,1.0.7,91,3,8,20,28,5,TRUE
airdcpp-webui,1.4.0,2.0.0-beta1,135,26,541,486,1027,192,TRUE
airdcpp-webui,1.3.0,1.3.1,122,6,102,35,137,9,TRUE
airdcpp-webui,1.3.2-beta2,1.3.2-beta3,125,7,290,179,469,28,TRUE
airdcpp-webui,1.3.3,1.4.0-beta1,131,17,117,140,257,55,TRUE
airdcpp-webui,1.3.2-beta4,1.3.2-beta5,127,12,259,147,406,38,TRUE
airdcpp-webui,1.3.2-beta1,1.3.2-beta2,124,3,94,82,176,10,TRUE
airdcpp-webui,0.14.3,0.14.4,74,1,5,13,18,4,TRUE
airdcpp-webui,0.2.4,0.2.5,17,1,82,88,170,10,TRUE
airdcpp-webui,0.10.1,0.11.0,55,6,607,379,986,45,TRUE
airdcpp-webui,0.15.0,0.16.0,76,3,161,64,225,23,TRUE
airdcpp-webui,1.0.0-beta2,1.0.0-beta3,81,6,138,100,238,24,TRUE
airdcpp-webui,0.16.2,1.0.0-beta1,79,25,1379,1440,2819,161,TRUE
airdcpp-webui,0.14.0,0.14.1,71,4,248,80,328,15,TRUE
airdcpp-webui,2.0.0-beta13,2.0.0-beta14,140,13,297,261,558,49,TRUE
airdcpp-webui,1.3.2-beta5,1.3.2-beta6,128,5,149,51,200,17,TRUE
airdcpp-webui,1.1.0-beta2,1.1.0-beta3,95,6,785,240,1025,61,TRUE
airdcpp-webui,1.3.0-beta1,1.3.0-beta2,118,16,235,213,448,27,TRUE
airdcpp-webui,2.0.0-beta7,2.0.0-beta8,149,2,5,5,10,3,TRUE
airdcpp-webui,0.2.0,0.2.1,13,7,200,132,332,24,TRUE
airdcpp-webui,0.13.6,0.13.7,69,3,70,34,104,8,TRUE
airdcpp-webui,0.0.6,0.0.7,6,4,116,89,205,17,TRUE
airdcpp-webui,2.0.0-beta12,2.0.0-beta13,139,18,1660,1837,3497,136,TRUE
airdcpp-webui,0.11.0,0.11.1,56,3,229,221,450,18,TRUE
airdcpp-webui,1.1.0,1.1.1,99,10,659,568,1227,76,TRUE
airdcpp-webui,1.3.0-beta2,1.3.0-beta3,119,2,34,14,48,6,TRUE
airdcpp-webui,1.0.3,1.0.4,88,16,355,175,530,60,TRUE
airdcpp-webui,0.4.1,0.4.2,35,2,598,572,1170,31,TRUE
airdcpp-webui,0.4.5,0.4.6,39,3,94,31,125,14,TRUE
airdcpp-webui,2.0.0-beta10,2.0.0-beta11,137,3,50,32,82,8,TRUE
airdcpp-webui,1.0.0-beta5,1.0.0,84,2,7,2,9,2,TRUE
airdcpp-webui,0.14.4,0.15.0,75,9,589,147,736,43,TRUE
airdcpp-webui,0.1.0,0.1.1,11,1,7,4,11,4,TRUE
airdcpp-webui,0.0.5,0.0.6,5,10,531,423,954,117,TRUE
airdcpp-webui,2.0.0-beta15,2.0.0-beta16,142,7,354,198,552,22,TRUE
airdcpp-webui,2.0.3,2.0.4,157,22,1246,917,2163,114,TRUE
airdcpp-webui,1.0.4,1.0.5,89,16,144,111,255,36,TRUE
airdcpp-webui,1.0.7,1.0.8,92,15,168,155,323,68,TRUE
airdcpp-webui,1.1.2,1.2.0-beta1,106,10,353,104,457,42,TRUE
airdcpp-webui,0.5.0,0.6.0,41,13,2085,972,3057,233,TRUE
airdcpp-webui,0.16.1,0.16.2,78,4,110,14,124,11,TRUE
airdcpp-webui,0.6.1,0.6.2,43,2,16,7,23,2,TRUE
airdcpp-webui,1.4.0-beta3,1.4.0,134,2,4,4,8,2,TRUE
airdcpp-webui,1.1.0-beta3,1.1.0-beta4,96,4,258,228,486,37,TRUE
airdcpp-webui,2.0.1,2.0.2-beta1,153,6,86,28,114,15,TRUE
airdcpp-webui,2.0.0-beta1,2.0.0-beta10,136,40,882,535,1417,118,TRUE
airdcpp-webui,1.2.2-beta1,1.3.0-beta1,117,9,473,401,874,30,TRUE
airdcpp-webui,1.3.2,1.3.3,130,4,173,14,187,12,TRUE
airdcpp-webui,0.2.9,0.2.10,22,1,4,4,8,2,TRUE
airdcpp-webui,0.6.0,0.6.1,42,5,338,249,587,62,TRUE
airdcpp-webui,0.3.2,0.3.3,26,2,136,142,278,12,TRUE
airdcpp-webui,0.6.2,0.6.3,44,1,25,11,36,6,TRUE
airdcpp-webui,0.7.3,0.7.4,50,2,78,65,143,7,TRUE
airdcpp-webui,1.3.0-beta4,1.3.0,121,2,96,24,120,5,TRUE
airdcpp-webui,0.3.5,0.3.6,29,4,235,168,403,29,TRUE
airdcpp-webui,2.0.0-beta8,2.0.0-beta9,150,4,97,30,127,14,TRUE
airdcpp-webui,1.3.1,1.3.2-beta1,123,6,396,108,504,42,TRUE
airdcpp-webui,1.0.0-beta1,1.0.0-beta2,80,4,44,31,75,9,TRUE
redux-saga-models,0.0.5,0.0.6,3,7,316,172,488,17,FALSE
redux-saga-models,0.0.4,0.0.5,2,5,146,18,164,7,FALSE
redux-saga-models,0.0.7,0.0.8,5,5,116,59,175,8,FALSE
redux-saga-models,0.0.6,0.0.7,4,3,104,11,115,5,FALSE
redux-saga-models,0.0.3,0.0.4,1,4,1434,2,1436,24,FALSE
redux-saga-models,0.0.9,0.1.0,7,2,45,45,90,6,FALSE
redux-saga-models,0.0.8,0.0.9,6,4,6,3,9,4,FALSE
redux-saga-models,0.1.0,0.1.1,8,2,1,5,6,2,FALSE
redux-saga-models,0.0.6,0.0.7,4,3,104,11,115,5,TRUE
45,1.4.0,1.5.0,7,3,84,19,103,9,FALSE
45,1.1.0,1.2.0,4,3,109,13,122,13,FALSE
45,1.5.0,1.6.0,8,3,12,2,14,3,FALSE
45,1.6.0,1.7.0,9,10,447,76,523,20,FALSE
45,1.3.0,1.4.0,6,3,13,3,16,4,FALSE
45,1.2.0,1.3.0,5,3,141,43,184,10,FALSE
45,0.1.0,0.1.1,1,4,51,30,81,6,FALSE
45,1.0.0,1.1.0,3,6,1059,362,1421,12,FALSE
45,0.1.1,1.0.0,2,4,320,455,775,33,FALSE
45,1.0.0,1.1.0,3,6,1059,362,1421,12,TRUE
45,1.6.0,1.7.0,9,10,447,76,523,20,TRUE
45,0.1.1,1.0.0,2,4,320,455,775,33,TRUE
talkiejs,0.9.0,0.9.1,13,6,1710,13823,15533,62,FALSE
talkiejs,0.9.1,0.10.0,14,20,474,98,572,55,FALSE
talkiejs,0.11.2,0.12.0,18,22,344,367,711,46,FALSE
talkiejs,0.10.0,0.11.0,15,15,469,151,620,30,FALSE
talkiejs,0.6.3,0.6.4,4,5,274,99,373,14,FALSE
talkiejs,0.7.2,0.7.3,7,4,397,265,662,12,FALSE
talkiejs,0.7.4,0.8.0,9,4,35,5838,5873,9,FALSE
talkiejs,0.8.1,0.8.3,11,6,170,160,330,9,FALSE
talkiejs,0.11.1,0.11.2,17,21,162,252,414,81,FALSE
talkiejs,0.7.0,0.7.2,6,11,301,250,551,39,FALSE
talkiejs,0.6.4,0.7.0,5,5,254,124,378,26,FALSE
talkiejs,0.12.0,0.12.1,19,3,222,10,232,4,FALSE
talkiejs,0.8.3,0.9.0,12,33,1917,14038,15955,138,FALSE
talkiejs,0.8.0,0.8.1,10,8,12123,58,12181,12,FALSE
talkiejs,0.7.3,0.7.4,8,4,113,83,196,23,FALSE
talkiejs,0.11.0,0.11.1,16,3,19,13,32,5,FALSE
talkiejs,0.6.2,0.6.3,3,21,598,221,819,57,TRUE
talkiejs,0.6.1,0.6.2,2,1,2,2,4,1,FALSE
talkiejs,0.6.0,0.6.1,1,1,5,4,9,2,FALSE
talkiejs,0.8.0,0.8.1,10,8,12123,58,12181,12,TRUE
talkiejs,0.6.2,0.6.3,3,21,598,221,819,57,FALSE
talkiejs,0.10.0,0.11.0,15,15,469,151,620,30,TRUE
talkiejs,0.6.3,0.6.4,4,5,274,99,373,14,TRUE
talkiejs,0.7.4,0.8.0,9,4,35,5838,5873,9,TRUE
talkiejs,0.11.1,0.11.2,17,21,162,252,414,81,TRUE
talkiejs,0.11.2,0.12.0,18,22,344,367,711,46,TRUE
retext-pos,1.0.0,2.0.0,12,5,204,299022,299226,22,FALSE
retext-pos,0.1.8,0.1.9,8,8,116,15,131,13,FALSE
retext-pos,0.1.9,0.2.0,9,15,87,42,129,18,FALSE
retext-pos,0.2.1,1.0.0,11,2,298768,450,299218,22,FALSE
retext-pos,0.2.0,0.2.1,10,11,104,9,113,13,FALSE
retext-pos,0.1.0,0.1.1,1,7,92,17,109,9,TRUE
retext-pos,0.1.1,0.1.2,2,3,20,3,23,5,FALSE
retext-pos,0.1.2,0.1.3,3,13,201,160,361,16,FALSE
retext-pos,0.1.3,0.1.5,4,10,54,24,78,15,FALSE
retext-pos,0.1.5,0.1.6,5,5,147,146,293,6,FALSE
retext-pos,0.1.6,0.1.7,6,6,21,29,50,8,FALSE
retext-pos,0.1.7,0.1.8,7,10,75,28,103,12,FALSE
retext-pos,0.1.0,0.1.1,1,7,92,17,109,9,FALSE
retext-pos,0.1.3,0.1.5,4,10,54,24,78,15,TRUE
meanify,0.1.0,0.1.1,1,1,2,2,4,1,FALSE
meanify,0.1.1,0.1.2,2,3,324,20,344,14,FALSE
meanify,0.1.2,0.1.3,3,1,25,11,36,5,FALSE
meanify,0.1.3,0.1.4,4,1,128,6,134,5,FALSE
meanify,0.1.4,0.1.5,5,2,422,7,429,9,FALSE
meanify,0.1.5,0.1.6,6,1,39,27,66,5,FALSE
meanify,0.1.6,0.1.7,7,2,36,15,51,4,FALSE
meanify,0.1.7,0.1.8,8,1,388,127,515,4,FALSE
meanify,0.1.7,0.1.8,8,1,388,127,515,4,TRUE
meanify,0.1.4,0.1.5,5,2,422,7,429,9,TRUE
meanify,0.1.2,0.1.3,3,1,25,11,36,5,TRUE
autotrack,1.0.0,1.0.1,12,5,31,25,56,8,FALSE
autotrack,1.0.1,1.0.2,13,11,62,34,96,26,FALSE
autotrack,1.0.2,1.0.3,14,1,2,2,4,1,FALSE
autotrack,1.0.3,1.1.0,15,64,6002,6383,12385,206,FALSE
autotrack,2.0.4,2.1.0,21,22,2200,680,2880,78,FALSE
autotrack,2.0.1,2.0.4,20,15,109,79,188,27,FALSE
autotrack,2.0.0,2.0.1,19,3,99,74,173,21,FALSE
autotrack,2.3.0,2.3.1,25,2,33,25,58,10,FALSE
autotrack,2.3.1,2.3.2,26,6,611,182,793,24,FALSE
autotrack,2.3.2,2.3.3,27,6,763,635,1398,36,FALSE
autotrack,2.2.0,2.3.0,24,13,923,190,1113,52,FALSE
autotrack,2.0.0-rc.2,2.0.0,18,5,7297,3108,10405,107,FALSE
autotrack,2.1.0,2.1.1,22,5,33,27,60,11,FALSE
autotrack,2.0.0-rc.1,2.0.0-rc.2,17,2,5,4,9,5,FALSE
autotrack,2.1.1,2.2.0,23,6,365,102,467,35,FALSE
autotrack,0.6.3,0.6.4,9,34,2045,2622,4667,143,FALSE
autotrack,0.6.2,0.6.3,8,6,28,8,36,9,FALSE
autotrack,0.3.0,0.4.0,3,1,3795,0,3795,45,FALSE
autotrack,0.6.0,0.6.1,6,8,240,22,262,18,FALSE
autotrack,0.6.5,1.0.0,11,76,16360,3485,19845,413,FALSE
autotrack,0.6.4,0.6.5,10,16,1523,1193,2716,88,FALSE
autotrack,0.2.0,0.3.0,2,1,2,2,4,1,FALSE
autotrack,0.1.0,0.2.0,1,1,2,2,4,1,FALSE
autotrack,0.4.0,0.5.0,4,13,628,205,833,30,FALSE
autotrack,0.5.0,0.6.0,5,18,478,914,1392,59,FALSE
autotrack,0.6.1,0.6.2,7,7,172,58,230,20,FALSE
autotrack,2.1.0,2.1.1,22,5,33,27,60,11,TRUE
autotrack,0.6.2,0.6.3,8,6,28,8,36,9,TRUE
autotrack,2.2.0,2.3.0,24,13,923,190,1113,52,TRUE
autotrack,1.1.0,2.0.0-rc.1,16,89,14031,9470,23501,395,FALSE
autotrack,2.0.4,2.1.0,21,22,2200,680,2880,78,TRUE
autotrack,0.6.4,0.6.5,10,16,1523,1193,2716,88,TRUE
base-components,0.1.10,0.1.11,10,2,444,515,959,14,FALSE
base-components,0.1.11,0.1.12,11,1,9,8,17,4,FALSE
base-components,0.1.8,0.1.9,8,2,4,4,8,12,FALSE
base-components,0.1.9,0.1.10,9,1,444,514,958,13,FALSE
base-components,0.1.0,0.1.2,1,7,652,369,1021,27,FALSE
base-components,0.1.2,0.1.3,2,1,4,2,6,2,FALSE
base-components,0.1.3,0.1.4,3,1,75,15,90,6,FALSE
base-components,0.1.4,0.1.5,4,1,9,8,17,4,FALSE
base-components,0.1.5,0.1.6,5,1,9,8,17,4,FALSE
base-components,0.1.6,0.1.7,6,1,20,136,156,5,FALSE
base-components,0.1.7,0.1.8,7,1,5,7,12,2,FALSE
base-components,0.1.4,0.1.5,4,1,9,8,17,4,TRUE
base-components,0.1.10,0.1.11,10,2,444,515,959,14,TRUE
generator-cartodb,0.0.5,0.0.6,5,4,24,8,32,4,FALSE
generator-cartodb,0.0.4,0.0.5,4,11,432,240,672,41,FALSE
generator-cartodb,0.0.7,0.0.8,7,6,250,52,302,24,FALSE
generator-cartodb,0.0.6,0.0.7,6,3,26,34,60,7,FALSE
generator-cartodb,0.0.1,0.0.2,1,7,29,59,88,8,FALSE
generator-cartodb,0.0.3,0.0.4,3,2,2,2,4,3,FALSE
generator-cartodb,0.0.2,0.0.3,2,3,3,4,7,3,FALSE
generator-cartodb,0.0.8,0.0.9,8,2,1,6,7,2,FALSE
generator-cartodb,0.0.5,0.0.6,5,4,24,8,32,4,TRUE
oakdatastore,0.3.0,0.3.1,10,2,73,97,170,5,FALSE
oakdatastore,0.3.1,0.4.0,11,3,60,51,111,9,FALSE
oakdatastore,0.1.8,0.2.0,8,2,32,24,56,5,FALSE
oakdatastore,0.2.0,0.3.0,9,3,47,32,79,10,FALSE
oakdatastore,0.1.1,0.1.2,1,2,9,3,12,4,FALSE
oakdatastore,0.1.2,0.1.3,2,5,38,30,68,8,FALSE
oakdatastore,0.1.3,0.1.4,3,3,4,5,9,4,FALSE
oakdatastore,0.1.4,0.1.5,4,2,7,4,11,3,FALSE
oakdatastore,0.1.5,0.1.6,5,2,5,5,10,3,FALSE
oakdatastore,0.1.6,0.1.7,6,2,8,8,16,3,FALSE
oakdatastore,0.1.7,0.1.8,7,2,6,6,12,4,FALSE
oakdatastore,0.2.0,0.3.0,9,3,47,32,79,10,TRUE
oakdatastore,0.1.5,0.1.6,5,2,5,5,10,3,TRUE
oakdatastore,0.1.6,0.1.7,6,2,8,8,16,3,TRUE
oakdatastore,0.3.0,0.3.1,10,2,73,97,170,5,TRUE
oakdatastore,0.3.1,0.4.0,11,3,60,51,111,9,TRUE
trail-instrument-bluebird-main,1.0.1,2.0.0,1,1,1,1,2,1,FALSE
trail-instrument-bluebird-main,2.0.0,2.1.0,2,1,1,1,2,1,FALSE
trail-instrument-bluebird-main,2.3.0,2.4.0,5,1,1,1,2,1,FALSE
trail-instrument-bluebird-main,2.2.0,2.3.0,4,1,1,1,2,1,FALSE
trail-instrument-bluebird-main,2.1.0,2.2.0,3,1,1,1,2,1,FALSE
trail-instrument-bluebird-main,2.2.0,2.3.0,4,1,1,1,2,1,TRUE
teasim-tools,3.0.0-0,3.0.0-1,29,1,72,83,155,9,FALSE
teasim-tools,0.6.11,0.6.15,2,1,72,83,155,9,FALSE
teasim-tools,0.6.10,0.6.11,1,1,72,83,155,9,FALSE
teasim-tools,0.6.15,0.6.16,3,1,72,83,155,9,FALSE
teasim-tools,0.8.4,1.0.0,10,1,18625,0,18625,326,FALSE
teasim-tools,0.7.2,0.8.0,6,1,72,83,155,9,FALSE
teasim-tools,0.8.0,0.8.1,7,1,31,0,31,2,FALSE
teasim-tools,0.8.3,0.8.4,9,1,72,83,155,9,FALSE
teasim-tools,0.7.1,0.7.2,5,1,72,83,155,9,FALSE
teasim-tools,0.8.1,0.8.3,8,1,72,83,155,9,FALSE
teasim-tools,0.6.16,0.7.1,4,1,72,83,155,9,FALSE
teasim-tools,2.1.0-0,3.0.0-0,28,1,72,83,155,9,FALSE
teasim-tools,1.0.4,1.0.6,15,1,72,83,155,9,FALSE
teasim-tools,1.1.1,1.1.2,20,1,72,83,155,9,FALSE
teasim-tools,1.0.6,1.0.7,16,1,72,83,155,9,FALSE
teasim-tools,1.0.7,1.0.8,17,1,72,83,155,9,FALSE
teasim-tools,1.0.0,1.0.1,11,6,545,30,575,15,FALSE
teasim-tools,1.0.1,1.0.2,12,3,5312,5610,10922,263,FALSE
teasim-tools,1.0.2,1.0.3,13,2,807,695,1502,79,FALSE
teasim-tools,1.0.3,1.0.4,14,1,72,83,155,9,FALSE
teasim-tools,1.0.8,1.0.9,18,1,72,83,155,9,FALSE
teasim-tools,1.0.9,1.1.1,19,1,72,83,155,9,FALSE
teasim-tools,1.1.2,1.1.4,21,1,72,83,155,9,FALSE
teasim-tools,2.0.0-alpha.0,2.0.0-alpha.1,24,1,72,83,155,9,FALSE
teasim-tools,1.1.5,2.0.0-alpha.0,23,8,55116,12112,67228,433,FALSE
teasim-tools,1.1.4,1.1.5,22,1,72,83,155,9,FALSE
teasim-tools,1.0.2,1.0.3,13,2,807,695,1502,79,TRUE
teasim-tools,0.7.1,0.7.2,5,1,72,83,155,9,TRUE
teasim-tools,1.0.0,1.0.1,11,6,545,30,575,15,TRUE
teasim-tools,1.1.4,1.1.5,22,1,72,83,155,9,TRUE
teasim-tools,1.0.3,1.0.4,14,1,72,83,155,9,TRUE
teasim-tools,2.0.0-alpha.0,2.0.0-alpha.1,24,1,72,83,155,9,TRUE
teasim-tools,3.0.0-0,3.0.0-1,29,1,72,83,155,9,TRUE
teasim-tools,0.8.0,0.8.1,7,1,31,0,31,2,TRUE
teasim-tools,1.0.1,1.0.2,12,3,5312,5610,10922,263,TRUE
teasim-tools,0.8.4,1.0.0,10,1,18625,0,18625,326,TRUE
business-error,0.0.5,0.0.6,4,4,18,20,38,6,FALSE
business-error,0.0.6,0.0.7,5,4,8,8,16,7,TRUE
angular2-cli,0.1.27,0.1.28,28,1,13,10,23,6,FALSE
angular2-cli,0.1.28,0.2.0,29,1,181,54,235,17,FALSE
angular2-cli,0.1.16,0.1.17,17,4,495,598,1093,44,FALSE
angular2-cli,0.1.17,0.1.18,18,2,61,9,70,7,FALSE
angular2-cli,0.1.15,0.1.16,16,14,2920,1607,4527,264,FALSE
angular2-cli,0.1.23,0.1.24,24,2,65,26,91,12,FALSE
angular2-cli,0.1.22,0.1.23,23,1,11,11,22,3,FALSE
angular2-cli,0.3.0,0.3.1,33,2,80,116,196,13,FALSE
angular2-cli,0.3.1,0.4.1,34,5,691,557,1248,92,FALSE
angular2-cli,0.1.20,0.1.21,21,4,153,108,261,28,FALSE
angular2-cli,0.1.26,0.1.27,27,1,25,4,29,4,FALSE
angular2-cli,0.1.25,0.1.26,26,2,27,7,34,13,FALSE
angular2-cli,0.1.19,0.1.20,20,1,57,96,153,7,FALSE
angular2-cli,0.1.18,0.1.19,19,2,73,13,86,7,FALSE
angular2-cli,0.2.3,0.3.0,32,4,478,108,586,46,FALSE
angular2-cli,0.2.1,0.2.3,31,2,52,18,70,12,FALSE
angular2-cli,0.2.0,0.2.1,30,1,28,11,39,3,FALSE
angular2-cli,0.4.1,0.4.2,35,3,156,121,277,17,FALSE
angular2-cli,0.1.24,0.1.25,25,2,116,123,239,19,FALSE
angular2-cli,0.1.21,0.1.22,22,2,24,7,31,4,FALSE
angular2-cli,1.0.0-alpha.1,1.0.0-alpha.2,37,1,153,207,360,24,FALSE
angular2-cli,1.0.0-alpha.3,1.0.0-alpha.4,39,1,2,2,4,2,FALSE
angular2-cli,1.0.0-alpha.2,1.0.0-alpha.3,38,1,14,15,29,4,FALSE
angular2-cli,1.0.0-alpha.5,1.0.0-alpha.6,41,1,57,96,153,7,FALSE
angular2-cli,1.0.0-alpha.4,1.0.0-alpha.5,40,1,80,218,298,11,FALSE
angular2-cli,0.1.8,0.1.9,9,2,141,53,194,11,FALSE
angular2-cli,0.1.9,0.1.10,10,3,255,70,325,19,FALSE
angular2-cli,0.1.2,0.1.3,3,6,440,236,676,37,FALSE
angular2-cli,0.1.3,0.1.4,4,8,267,156,423,41,FALSE
angular2-cli,0.1.4,0.1.5,5,3,63,25,88,8,FALSE
angular2-cli,0.1.5,0.1.6,6,3,170,87,257,13,FALSE
angular2-cli,0.1.6,0.1.7,7,4,206,38,244,18,FALSE
angular2-cli,0.1.7,0.1.8,8,3,252,69,321,37,FALSE
angular2-cli,0.4.2,1.0.0-alpha.1,36,3,151,277,428,22,FALSE
angular2-cli,0.1.12,0.1.13,13,4,629,913,1542,45,FALSE
angular2-cli,0.1.13,0.1.14,14,7,897,957,1854,94,FALSE
angular2-cli,0.1.10,0.1.11,11,1,28,38,66,5,FALSE
angular2-cli,0.1.11,0.1.12,12,2,56,71,127,3,FALSE
angular2-cli,0.1.14,0.1.15,15,12,936,777,1713,165,FALSE
angular2-cli,0.1.1,0.1.2,2,7,711,137,848,42,FALSE
angular2-cli,0.1.27,0.1.28,28,1,13,10,23,6,TRUE
angular2-cli,0.1.15,0.1.16,16,14,2920,1607,4527,264,TRUE
angular2-cli,0.1.18,0.1.19,19,2,73,13,86,7,TRUE
angular2-cli,0.2.3,0.3.0,32,4,478,108,586,46,TRUE
angular2-cli,1.0.0-alpha.1,1.0.0-alpha.2,37,1,153,207,360,24,TRUE
angular2-cli,1.0.0-alpha.5,1.0.0-alpha.6,41,1,57,96,153,7,TRUE
angular2-cli,1.0.0-alpha.4,1.0.0-alpha.5,40,1,80,218,298,11,TRUE
angular2-cli,0.4.2,1.0.0-alpha.1,36,3,151,277,428,22,TRUE
angular2-cli,0.1.26,0.1.27,27,1,25,4,29,4,TRUE
angular2-cli,0.1.23,0.1.24,24,2,65,26,91,12,TRUE
angular2-cli,0.3.1,0.4.1,34,5,691,557,1248,92,TRUE
angular2-cli,0.1.14,0.1.15,15,12,936,777,1713,165,TRUE
angular2-cli,0.1.1,0.1.2,2,7,711,137,848,42,TRUE
angular2-cli,0.1.4,0.1.5,5,3,63,25,88,8,TRUE
angular2-cli,0.1.21,0.1.22,22,2,24,7,31,4,TRUE
angular2-cli,0.2.1,0.2.3,31,2,52,18,70,12,TRUE
angular2-cli,0.1.17,0.1.18,18,2,61,9,70,7,TRUE
chip-utils,0.2.7,0.2.8,9,1,1,1,2,1,FALSE
chip-utils,0.2.6,0.2.7,8,5,68,53,121,8,FALSE
chip-utils,0.2.5,0.2.6,7,1,2,1,3,2,FALSE
chip-utils,0.2.4,0.2.5,6,1,2,2,4,2,FALSE
chip-utils,0.2.3,0.2.4,5,1,1,1,2,1,FALSE
chip-utils,0.2.2,0.2.3,4,1,6,3,9,2,FALSE
chip-utils,0.2.1,0.2.2,3,1,25,8,33,3,FALSE
chip-utils,0.2.0,0.2.1,2,1,100,1,101,2,FALSE
chip-utils,0.1.0,0.2.0,1,1,3,3,6,2,FALSE
chip-utils,0.2.8,0.3.0,10,3,238,34,272,7,FALSE
chip-utils,0.2.4,0.2.5,6,1,2,2,4,2,TRUE
chip-utils,0.2.1,0.2.2,3,1,25,8,33,3,TRUE
servicenow-rest,0.0.5,0.1.2,4,2,294,321,615,13,FALSE
servicenow-rest,1.1.0,1.2.0,10,1,62067,341,62408,343,FALSE
servicenow-rest,0.0.1,0.0.2,1,1,71387,54249,125636,1015,FALSE
servicenow-rest,1.0.1,1.0.9,8,6,53,31,84,9,FALSE
servicenow-rest,0.0.3,0.0.5,3,2,7,9,16,2,FALSE
servicenow-rest,0.0.2,0.0.3,2,6,124344,41,124385,888,FALSE
servicenow-rest,1.0.9,1.1.0,9,2,4,4,8,2,FALSE
servicenow-rest,0.2.3,1.0.0,6,3,742,65,807,18,FALSE
servicenow-rest,1.2.0,1.2.1,11,2,1,4,5,2,FALSE
servicenow-rest,1.2.1,1.2.2,12,2,4,4,8,2,FALSE
servicenow-rest,1.0.0,1.0.1,7,2,60,4,64,4,TRUE
servicenow-rest,0.1.2,0.2.3,5,2,160,50,210,7,FALSE
servicenow-rest,0.2.3,1.0.0,6,3,742,65,807,18,TRUE
servicenow-rest,1.0.0,1.0.1,7,2,60,4,64,4,FALSE
baobab-react,2.0.0,2.1.0,12,7,759,2357,3116,32,FALSE
baobab-react,2.0.0-rc2,2.0.0,11,3,13,5,18,3,FALSE
baobab-react,2.0.0-rc1,2.0.0-rc2,10,2,5,7,12,4,FALSE
baobab-react,2.1.0,2.1.1,13,3,45,17,62,5,FALSE
baobab-react,2.1.1,2.1.2,14,6,40,30,70,7,FALSE
baobab-react,1.0.0,1.0.1,8,5,30,8,38,5,FALSE
baobab-react,1.0.0-dev3,1.0.0-dev4,6,1,11,5,16,4,FALSE
baobab-react,1.0.0-dev2,1.0.0-dev3,5,18,1894,320,2214,50,TRUE
baobab-react,1.0.0-dev1,1.0.0-dev2,4,3,23,206,229,9,FALSE
baobab-react,1.0.0-dev4,1.0.0,7,1,2,2,4,1,FALSE
baobab-react,1.0.0-dev,1.0.0-dev1,3,7,172,550,722,16,FALSE
baobab-react,0.1.0,0.1.1,1,13,224,608,832,42,FALSE
baobab-react,0.1.1,1.0.0-dev,2,10,389,405,794,25,FALSE
baobab-react,1.0.1,2.0.0-rc1,9,25,989,2628,3617,73,FALSE
baobab-react,2.1.0,2.1.1,13,3,45,17,62,5,TRUE
baobab-react,1.0.0-dev2,1.0.0-dev3,5,18,1894,320,2214,50,FALSE
baobab-react,0.1.1,1.0.0-dev,2,10,389,405,794,25,TRUE
react-autosuggest,1.0.4,1.0.5,5,2,3,3,6,3,FALSE
react-autosuggest,1.0.5,1.0.6,6,1,1745,1742,3487,2,FALSE
react-autosuggest,1.0.6,1.0.7,7,1,26,10,36,5,FALSE
react-autosuggest,1.0.7,1.0.8,8,3,67,26,93,6,FALSE
react-autosuggest,1.0.0,1.0.1,1,2,19311,14091,33402,5,FALSE
react-autosuggest,1.0.1,1.0.2,2,1,2034,2001,4035,7,FALSE
react-autosuggest,1.0.2,1.0.3,3,3,863,821,1684,5,FALSE
react-autosuggest,1.0.3,1.0.4,4,1,2231,2123,4354,7,FALSE
react-autosuggest,1.0.8,1.0.9,9,6,1758,1429,3187,13,FALSE
react-autosuggest,1.0.9,1.1.0,10,5,2103,2021,4124,17,FALSE
react-autosuggest,1.1.2,1.1.3,13,8,6048,5545,11593,23,FALSE
react-autosuggest,1.6.0,1.6.1,27,1,4,2,6,2,FALSE
react-autosuggest,1.6.1,1.7.0,28,5,5527,5319,10846,13,FALSE
react-autosuggest,1.9.0,1.10.0,32,10,273,183,456,27,FALSE
react-autosuggest,1.8.0,1.9.0,31,1,243,65,308,7,FALSE
react-autosuggest,1.7.1,1.8.0,30,2,195,45,240,15,FALSE
react-autosuggest,1.7.0,1.7.1,29,1,2,2,4,2,FALSE
react-autosuggest,1.4.0,1.4.1,22,1,9,1,10,2,FALSE
react-autosuggest,1.4.1,1.5.0,23,18,38766,24060,62826,60,FALSE
react-autosuggest,1.1.1,1.1.2,12,4,14346,14609,28955,4,FALSE
react-autosuggest,1.5.1,1.5.2,25,1,21,11,32,3,FALSE
react-autosuggest,1.5.0,1.5.1,24,3,20,18,38,4,FALSE
react-autosuggest,1.5.2,1.6.0,26,2,107,32,139,12,FALSE
react-autosuggest,1.13.0,1.13.1,41,1,2009,1713,3722,5,FALSE
react-autosuggest,1.2.4,1.2.5,19,1,470,448,918,6,FALSE
react-autosuggest,1.2.5,1.3.0,20,1,388,406,794,7,FALSE
react-autosuggest,1.2.2,1.2.3,17,1,658,660,1318,4,FALSE
react-autosuggest,1.2.3,1.2.4,18,1,1062,1179,2241,5,FALSE
react-autosuggest,1.2.0,1.2.1,15,1,4009,4006,8015,4,FALSE
react-autosuggest,1.2.1,1.2.2,16,1,1223,1101,2324,10,FALSE
react-autosuggest,1.12.0,1.12.1,37,2,32,26,58,5,FALSE
react-autosuggest,1.12.1,1.12.2,38,1,287,209,496,9,FALSE
react-autosuggest,1.12.2,1.12.3,39,7,26745,24833,51578,44,FALSE
react-autosuggest,1.12.3,1.13.0,40,1,773,761,1534,10,FALSE
react-autosuggest,1.1.0,1.1.1,11,2,2,2,4,2,FALSE
react-autosuggest,1.11.0,1.12.0,36,1,176,69,245,16,FALSE
react-autosuggest,1.10.2,1.11.0,35,33,1732,836,2568,69,FALSE
react-autosuggest,1.10.0,1.10.1,33,6,664,566,1230,29,FALSE
react-autosuggest,1.10.1,1.10.2,34,2,176,30,206,9,FALSE
react-autosuggest,1.3.0,1.4.0,21,2,441,392,833,6,FALSE
react-autosuggest,1.1.3,1.2.0,14,8,9720,8548,18268,26,FALSE
react-autosuggest,2.0.0,2.1.0,52,9,2146,1604,3750,32,FALSE
react-autosuggest,2.2.4,2.2.5,59,22,191,3178,3369,42,FALSE
react-autosuggest,2.2.1,2.2.2,56,7,371,100,471,31,FALSE
react-autosuggest,2.2.0,2.2.1,55,30,7687,3430,11117,106,FALSE
react-autosuggest,2.2.3,2.2.4,58,9,956,454,1410,48,FALSE
react-autosuggest,2.2.2,2.2.3,57,4,94,86,180,11,FALSE
react-autosuggest,2.1.0,2.1.1,53,6,629,55,684,12,FALSE
react-autosuggest,2.1.1,2.2.0,54,26,7609,27126,34735,125,FALSE
react-autosuggest,1.14.0,1.14.1,43,1,1378,1604,2982,12,FALSE
react-autosuggest,1.14.1,1.15.0,44,6,473,160,633,22,FALSE
react-autosuggest,1.15.0,1.16.0,45,7,289,164,453,28,FALSE
react-autosuggest,1.18.2,1.18.3,50,4,271,136,407,19,FALSE
react-autosuggest,1.18.3,2.0.0,51,42,39903,68952,108855,269,FALSE
react-autosuggest,1.18.0,1.18.2,49,12,379,197,576,37,FALSE
react-autosuggest,1.13.1,1.14.0,42,4,38151,38130,76281,9,FALSE
react-autosuggest,1.16.0,1.16.1,46,2,203,17,220,16,FALSE
react-autosuggest,1.16.1,1.17.0,47,3,120,56,176,33,FALSE
react-autosuggest,1.17.0,1.18.0,48,18,259,209,468,76,FALSE
react-autosuggest,6.0.3,6.0.4,101,7,1465,113,1578,27,FALSE
react-autosuggest,3.0.0-alpha.6,3.0.0-beta.1,66,3,55,37,92,12,FALSE
react-autosuggest,6.0.1,6.0.2,99,6,198,17,215,11,FALSE
react-autosuggest,3.1.0,3.2.0,72,3,209,221,430,16,FALSE
react-autosuggest,3.0.0-alpha.3,3.0.0-alpha.4,63,2,2,2,4,2,FALSE
react-autosuggest,3.0.0-alpha.2,3.0.0-alpha.3,62,8,32,3127,3159,15,TRUE
react-autosuggest,3.0.0,3.1.0,71,4,127,25,152,15,FALSE
react-autosuggest,6.0.2,6.0.3,100,13,275,214,489,15,FALSE
react-autosuggest,3.0.0-beta.4,3.0.0,70,31,1203,1844,3047,124,FALSE
react-autosuggest,3.0.0-beta.1,3.0.0-beta.2,67,4,71,32,103,11,FALSE
react-autosuggest,3.0.0-beta.2,3.0.0-beta.3,68,10,853,214,1067,64,FALSE
react-autosuggest,3.0.0-beta.3,3.0.0-beta.4,69,5,90,42,132,8,FALSE
react-autosuggest,6.0.0,6.0.1,98,3,50,18,68,6,FALSE
react-autosuggest,3.5.0,3.5.1,81,5,68,45,113,11,FALSE
react-autosuggest,3.0.0-alpha.5,3.0.0-alpha.6,65,3,8,4,12,4,TRUE
react-autosuggest,4.0.0,5.0.0,91,2,178,84,262,15,FALSE
react-autosuggest,3.0.0-alpha.1,3.0.0-alpha.2,61,4,72,6,78,6,FALSE
react-autosuggest,6.0.4,6.1.0,102,9,458,355,813,50,FALSE
react-autosuggest,3.3.5,3.4.0,79,3,24,13,37,5,FALSE
react-autosuggest,3.0.0-alpha.4,3.0.0-alpha.5,64,2,14,1,15,3,FALSE
react-autosuggest,5.0.0,5.0.1,92,2,37,15,52,5,FALSE
react-autosuggest,5.0.2,5.1.0,94,8,157,144,301,25,FALSE
react-autosuggest,3.7.4,3.8.0,88,13,666,371,1037,29,FALSE
react-autosuggest,3.9.0,4.0.0,90,9,754,511,1265,39,FALSE
react-autosuggest,3.8.0,3.9.0,89,8,328,235,563,36,FALSE
react-autosuggest,7.0.2,7.1.0,106,3,8,4,12,7,FALSE
react-autosuggest,5.0.1,5.0.2,93,3,137,62,199,17,FALSE
react-autosuggest,7.0.0,7.0.1,104,4,461,479,940,40,FALSE
react-autosuggest,7.0.1,7.0.2,105,9,202,81,283,22,FALSE
react-autosuggest,6.1.0,7.0.0,103,4,194,177,371,16,FALSE
react-autosuggest,5.1.1,5.1.2,96,2,39,13,52,4,FALSE
react-autosuggest,5.1.0,5.1.1,95,11,266,95,361,25,FALSE
react-autosuggest,3.5.1,3.6.0,82,2,6,6,12,2,FALSE
react-autosuggest,5.1.2,6.0.0,97,4,390,255,645,24,FALSE
react-autosuggest,3.6.0,3.7.0,83,4,44,20,64,8,FALSE
react-autosuggest,3.3.0,3.3.1,74,2,2,2,4,2,FALSE
react-autosuggest,3.3.3,3.3.4,77,3,17,55,72,7,FALSE
react-autosuggest,3.3.2,3.3.3,76,8,51,13,64,12,FALSE
react-autosuggest,3.2.0,3.3.0,73,2,94,52,146,12,FALSE
react-autosuggest,3.3.4,3.3.5,78,4,6,5,11,4,FALSE
react-autosuggest,3.4.0,3.5.0,80,7,64,50,114,10,FALSE
react-autosuggest,3.3.1,3.3.2,75,2,33,6,39,6,FALSE
react-autosuggest,3.7.1,3.7.2,85,2,4,4,8,3,FALSE
react-autosuggest,3.7.0,3.7.1,84,3,36,23,59,6,FALSE
react-autosuggest,3.7.3,3.7.4,87,5,28,25,53,15,FALSE
react-autosuggest,3.7.2,3.7.3,86,2,16,18,34,2,FALSE
react-autosuggest,3.0.0-alpha.2,3.0.0-alpha.3,62,8,32,3127,3159,15,FALSE
react-autosuggest,3.0.0-alpha.5,3.0.0-alpha.6,65,3,8,4,12,4,FALSE
react-autosuggest,3.7.0,3.7.1,84,3,36,23,59,6,TRUE
react-autosuggest,8.0.1,9.0.0,109,5,570,360,930,31,FALSE
react-autosuggest,9.0.0,9.0.1,110,14,125,116,241,39,FALSE
react-autosuggest,8.0.0,8.0.1,108,5,27,22,49,6,FALSE
react-autosuggest,7.1.0,8.0.0,107,3,272,474,746,25,FALSE
react-autosuggest,3.3.1,3.3.2,75,2,33,6,39,6,TRUE
react-autosuggest,3.8.0,3.9.0,89,8,328,235,563,36,TRUE
react-autosuggest,5.1.1,5.1.2,96,2,39,13,52,4,TRUE
react-autosuggest,1.0.0,1.0.1,1,2,19311,14091,33402,5,TRUE
react-autosuggest,3.6.0,3.7.0,83,4,44,20,64,8,TRUE
react-autosuggest,1.15.0,1.16.0,45,7,289,164,453,28,TRUE
react-autosuggest,1.12.3,1.13.0,40,1,773,761,1534,10,TRUE
react-autosuggest,3.3.5,3.4.0,79,3,24,13,37,5,TRUE
react-autosuggest,3.7.3,3.7.4,87,5,28,25,53,15,TRUE
react-autosuggest,1.18.2,1.18.3,50,4,271,136,407,19,TRUE
react-autosuggest,5.0.2,5.1.0,94,8,157,144,301,25,TRUE
react-autosuggest,7.0.1,7.0.2,105,9,202,81,283,22,TRUE
react-autosuggest,1.1.2,1.1.3,13,8,6048,5545,11593,23,TRUE
react-autosuggest,3.0.0-beta.4,3.0.0,70,31,1203,1844,3047,124,TRUE
react-autosuggest,3.1.0,3.2.0,72,3,209,221,430,16,TRUE
react-autosuggest,3.0.0-alpha.6,3.0.0-beta.1,66,3,55,37,92,12,TRUE
react-autosuggest,2.2.4,2.2.5,59,22,191,3178,3369,42,TRUE
react-autosuggest,2.1.1,2.2.0,54,26,7609,27126,34735,125,TRUE
react-autosuggest,3.5.0,3.5.1,81,5,68,45,113,11,TRUE
react-autosuggest,1.18.3,2.0.0,51,42,39903,68952,108855,269,TRUE
react-autosuggest,5.0.1,5.0.2,93,3,137,62,199,17,TRUE
react-autosuggest,1.14.0,1.14.1,43,1,1378,1604,2982,12,TRUE
react-autosuggest,1.10.2,1.11.0,35,33,1732,836,2568,69,TRUE
react-autosuggest,1.2.1,1.2.2,16,1,1223,1101,2324,10,TRUE
react-autosuggest,1.0.9,1.1.0,10,5,2103,2021,4124,17,TRUE
react-autosuggest,1.6.1,1.7.0,28,5,5527,5319,10846,13,TRUE
react-autosuggest,1.10.0,1.10.1,33,6,664,566,1230,29,TRUE
react-autosuggest,1.7.0,1.7.1,29,1,2,2,4,2,TRUE
react-autosuggest,6.0.2,6.0.3,100,13,275,214,489,15,TRUE
react-autosuggest,9.0.0,9.0.1,110,14,125,116,241,39,TRUE
react-autosuggest,1.0.1,1.0.2,2,1,2034,2001,4035,7,TRUE
react-autosuggest,1.0.2,1.0.3,3,3,863,821,1684,5,TRUE
react-autosuggest,1.1.1,1.1.2,12,4,14346,14609,28955,4,TRUE
react-autosuggest,1.0.8,1.0.9,9,6,1758,1429,3187,13,TRUE
react-autosuggest,1.13.1,1.14.0,42,4,38151,38130,76281,9,TRUE
react-autosuggest,3.0.0-alpha.1,3.0.0-alpha.2,61,4,72,6,78,6,TRUE
react-autosuggest,5.1.0,5.1.1,95,11,266,95,361,25,TRUE
react-autosuggest,1.1.3,1.2.0,14,8,9720,8548,18268,26,TRUE
react-autosuggest,1.12.1,1.12.2,38,1,287,209,496,9,TRUE
react-autosuggest,1.0.3,1.0.4,4,1,2231,2123,4354,7,TRUE
react-autosuggest,3.0.0-beta.1,3.0.0-beta.2,67,4,71,32,103,11,TRUE
react-autosuggest,3.0.0-beta.2,3.0.0-beta.3,68,10,853,214,1067,64,TRUE
react-autosuggest,6.0.4,6.1.0,102,9,458,355,813,50,TRUE
react-autosuggest,6.1.0,7.0.0,103,4,194,177,371,16,TRUE
react-autosuggest,5.1.2,6.0.0,97,4,390,255,645,24,TRUE
react-autosuggest,1.2.0,1.2.1,15,1,4009,4006,8015,4,TRUE
spica,0.0.73,0.0.74,73,8,91,69,160,14,FALSE
spica,0.0.72,0.0.73,72,2,1,2,3,2,FALSE
spica,0.0.71,0.0.72,71,3,59,41,100,6,FALSE
spica,0.0.70,0.0.71,70,2,3,3,6,3,FALSE
spica,0.0.77,0.0.78,77,7,6689,148,6837,22,FALSE
spica,0.0.13,0.0.14,13,2,31,2,33,5,FALSE
spica,0.0.75,0.0.76,75,4,37,15,52,4,FALSE
spica,0.0.74,0.0.75,74,5,49,11,60,11,FALSE
spica,0.0.12,0.0.13,12,5,255,60,315,23,FALSE
spica,0.0.15,0.0.16,15,5,109,89,198,12,FALSE
spica,0.0.14,0.0.15,14,3,10,10,20,7,FALSE
spica,0.0.17,0.0.18,17,6,139,91,230,16,FALSE
spica,0.0.16,0.0.17,16,4,60,40,100,13,FALSE
spica,0.0.11,0.0.12,11,6,183,38,221,26,FALSE
spica,0.0.10,0.0.11,10,24,846,449,1295,97,FALSE
spica,0.0.39,0.0.40,39,6,100,101,201,9,FALSE
spica,0.0.38,0.0.39,38,16,99,80,179,27,FALSE
spica,0.0.37,0.0.38,37,2,3,3,6,2,FALSE
spica,0.0.36,0.0.37,36,3,20,6,26,5,FALSE
spica,0.0.35,0.0.36,35,5,9,7,16,7,FALSE
spica,0.0.34,0.0.35,34,9,456,143,599,28,FALSE
spica,0.0.55,0.0.56,55,5,42,51,93,21,FALSE
spica,0.0.54,0.0.55,54,2,16,9,25,3,FALSE
spica,0.0.31,0.0.32,31,8,97,55,152,22,FALSE
spica,0.0.30,0.0.31,30,24,438,466,904,77,FALSE
spica,0.0.5,0.0.6,5,11,1424,38,1462,27,FALSE
spica,0.0.4,0.0.5,4,5,115,57,172,17,FALSE
spica,0.0.7,0.0.8,7,19,388,194,582,89,FALSE
spica,0.0.6,0.0.7,6,8,2238,1411,3649,61,FALSE
spica,0.0.1,0.0.2,1,5,208,74,282,17,FALSE
spica,0.0.3,0.0.4,3,5,245,838,1083,33,FALSE
spica,0.0.2,0.0.3,2,1,1,1,2,1,FALSE
spica,0.0.19,0.0.20,19,5,181,25,206,12,FALSE
spica,0.0.9,0.0.10,9,12,276,166,442,34,FALSE
spica,0.0.8,0.0.9,8,14,273,199,472,32,FALSE
spica,0.0.32,0.0.33,32,6,491,543,1034,19,FALSE
spica,0.0.53,0.0.54,53,4,44,54,98,6,FALSE
spica,0.0.57,0.0.58,57,5,34,32,66,10,FALSE
spica,0.0.56,0.0.57,56,2,2,1,3,2,FALSE
spica,0.0.64,0.0.65,64,3,44,14,58,4,FALSE
spica,0.0.65,0.0.66,65,3,51,50,101,6,FALSE
spica,0.0.66,0.0.67,66,4,14,10,24,6,FALSE
spica,0.0.67,0.0.68,67,4,27,14,41,4,FALSE
spica,0.0.60,0.0.61,60,4,16,19,35,5,FALSE
spica,0.0.61,0.0.62,61,2,3,3,6,2,FALSE
spica,0.0.62,0.0.63,62,2,10,3,13,3,FALSE
spica,0.0.63,0.0.64,63,3,21,6,27,5,FALSE
spica,0.0.33,0.0.34,33,6,43,27,70,9,FALSE
spica,0.0.68,0.0.69,68,2,14,10,24,3,FALSE
spica,0.0.69,0.0.70,69,6,56,28,84,8,FALSE
spica,0.0.20,0.0.21,20,6,28,24,52,11,FALSE
spica,0.0.21,0.0.22,21,2,4,3,7,3,FALSE
spica,0.0.22,0.0.23,22,3,4,4,8,3,FALSE
spica,0.0.23,0.0.24,23,5,26,37,63,9,FALSE
spica,0.0.24,0.0.25,24,4,8,16,24,4,FALSE
spica,0.0.25,0.0.26,25,6,64,56,120,14,FALSE
spica,0.0.26,0.0.27,26,3,219,219,438,46,FALSE
spica,0.0.27,0.0.28,27,4,35,16,51,6,FALSE
spica,0.0.28,0.0.29,28,4,26,28,54,6,FALSE
spica,0.0.43,0.0.44,43,2,1,3,4,3,FALSE
spica,0.0.40,0.0.41,40,7,79,99,178,14,FALSE
spica,0.0.41,0.0.42,41,2,3,1,4,3,FALSE
spica,0.0.46,0.0.47,46,10,329,421,750,178,FALSE
spica,0.0.47,0.0.48,47,2,110,141,251,2,FALSE
spica,0.0.29,0.0.30,29,6,584,990,1574,86,FALSE
spica,0.0.45,0.0.46,45,8,186,36,222,29,FALSE
spica,0.0.76,0.0.77,76,11,194,195,389,26,FALSE
spica,0.0.59,0.0.60,59,6,71,43,114,10,FALSE
spica,0.0.78,0.0.79,78,5,2209,1331,3540,8,FALSE
spica,0.0.42,0.0.43,42,3,16,2,18,4,FALSE
spica,0.0.58,0.0.59,58,2,6,3,9,3,FALSE
spica,0.0.48,0.0.49,48,2,51,62,113,2,FALSE
spica,0.0.52,0.0.53,52,2,3,3,6,3,FALSE
spica,0.0.18,0.0.19,18,12,352,89,441,30,FALSE
spica,0.0.49,0.0.50,49,2,503,511,1014,21,FALSE
spica,0.0.51,0.0.52,51,8,62,30,92,13,FALSE
spica,0.0.50,0.0.51,50,5,87,63,150,9,FALSE
spica,0.0.44,0.0.45,44,3,6,13,19,4,FALSE
spica,0.0.64,0.0.65,64,3,44,14,58,4,TRUE
spica,0.0.67,0.0.68,67,4,27,14,41,4,TRUE
spica,0.0.25,0.0.26,25,6,64,56,120,14,TRUE
spica,0.0.38,0.0.39,38,16,99,80,179,27,TRUE
spica,0.0.35,0.0.36,35,5,9,7,16,7,TRUE
spica,0.0.34,0.0.35,34,9,456,143,599,28,TRUE
spica,0.0.30,0.0.31,30,24,438,466,904,77,TRUE
spica,0.0.32,0.0.33,32,6,491,543,1034,19,TRUE
spica,0.0.57,0.0.58,57,5,34,32,66,10,TRUE
spica,0.0.65,0.0.66,65,3,51,50,101,6,TRUE
spica,0.0.33,0.0.34,33,6,43,27,70,9,TRUE
spica,0.0.44,0.0.45,44,3,6,13,19,4,TRUE
spica,0.0.27,0.0.28,27,4,35,16,51,6,TRUE
spica,0.0.69,0.0.70,69,6,56,28,84,8,TRUE
spica,0.0.46,0.0.47,46,10,329,421,750,178,TRUE
spica,0.0.54,0.0.55,54,2,16,9,25,3,TRUE
spica,0.0.5,0.0.6,5,11,1424,38,1462,27,TRUE
spica,0.0.9,0.0.10,9,12,276,166,442,34,TRUE
spica,0.0.50,0.0.51,50,5,87,63,150,9,TRUE
spica,0.0.3,0.0.4,3,5,245,838,1083,33,TRUE
trip-finder-driveback,0.1.0,0.1.1,1,3,94,2,96,4,FALSE
trip-finder-driveback,0.1.0,0.1.1,1,3,94,2,96,4,TRUE
trip-finder-driveback,0.1.1,0.1.2,2,2,13,5,18,3,FALSE
remark-bemjson,0.1.0,0.1.1,3,2,8,2,10,3,FALSE
remark-bemjson,0.1.1,0.2.0,4,4,36,26,62,10,FALSE
remark-bemjson,0.2.0,0.3.0,5,2,33,5,38,7,FALSE
remark-bemjson,0.0.4,0.1.0,2,2,226,8,234,12,FALSE
remark-bemjson,0.0.2,0.0.4,1,10,550,43,593,20,FALSE
remark-bemjson,0.1.1,0.2.0,4,4,36,26,62,10,TRUE
zeroconf-redux,0.6.0,0.7.0,9,13,13,13,26,13,FALSE
zeroconf-redux,0.8.1,0.8.2,12,3,3,3,6,3,FALSE
zeroconf-redux,0.8.0,0.8.1,11,2,12,12,24,2,FALSE
zeroconf-redux,0.7.0,0.8.0,10,3,24,24,48,4,FALSE
zeroconf-redux,0.4.1,0.4.2,6,6,10,10,20,6,FALSE
zeroconf-redux,0.4.0,0.4.1,5,7,15,10,25,7,FALSE
zeroconf-redux,0.4.2,0.5.0,7,6,52,41,93,7,FALSE
zeroconf-redux,0.5.0,0.6.0,8,13,10,19,29,12,FALSE
zeroconf-redux,1.0.0,1.0.1,26,2,20,7,27,2,FALSE
zeroconf-redux,1.0.1,1.0.2,27,3,4,4,8,3,FALSE
zeroconf-redux,0.2.1,0.3.0,3,16,122,59,181,19,FALSE
zeroconf-redux,0.2.0,0.2.1,2,2,3,3,6,2,FALSE
zeroconf-redux,0.1.0,0.2.0,1,5,34,37,71,8,FALSE
zeroconf-redux,0.10.0,0.11.0,17,6,21,41,62,15,TRUE
zeroconf-redux,0.3.0,0.4.0,4,8,9,8,17,8,FALSE
zeroconf-redux,0.11.0,0.11.1,18,9,9,9,18,9,FALSE
zeroconf-redux,0.11.1,0.12.0,19,8,94,23,117,16,FALSE
zeroconf-redux,0.12.3,0.12.4,23,21,34,20,54,21,FALSE
zeroconf-redux,0.12.2,0.12.3,22,2,2,2,4,2,FALSE
zeroconf-redux,0.12.1,0.12.2,21,8,23,11,34,14,FALSE
zeroconf-redux,0.12.0,0.12.1,20,2,2,2,4,2,FALSE
zeroconf-redux,0.12.4,0.14.0,24,11,69,45,114,16,FALSE
zeroconf-redux,0.9.0,0.9.1,14,10,10,9,19,10,FALSE
zeroconf-redux,0.9.1,0.9.2,15,6,12,11,23,8,FALSE
zeroconf-redux,0.9.2,0.10.0,16,6,6,7,13,7,FALSE
zeroconf-redux,0.14.0,1.0.0,25,2,9,15,24,2,FALSE
zeroconf-redux,0.8.2,0.9.0,13,7,123,24,147,13,FALSE
zeroconf-redux,0.10.0,0.11.0,17,6,21,41,62,15,FALSE
zeroconf-redux,0.12.3,0.12.4,23,21,34,20,54,21,TRUE
zeroconf-redux,0.5.0,0.6.0,8,13,10,19,29,12,TRUE
zeroconf-redux,0.12.1,0.12.2,21,8,23,11,34,14,TRUE
zeroconf-redux,0.4.0,0.4.1,5,7,15,10,25,7,TRUE
waves.js,0.0.4,0.0.6-1,4,6,74,26,100,10,FALSE
waves.js,0.0.6-1,0.0.7-0,5,4,24,15,39,5,FALSE
waves.js,0.0.7-12,0.0.7-13,18,1,18,25,43,5,FALSE
waves.js,0.0.7-11,0.0.7-12,17,1,18,25,43,5,FALSE
waves.js,0.0.7-10,0.0.7-11,16,2,15,1,16,2,FALSE
waves.js,0.0.7-1,0.0.7-2,7,5,396,42,438,25,FALSE
waves.js,0.0.7-9,0.0.7-10,15,2,14,3,17,3,FALSE
waves.js,0.0.7-8,0.0.7-9,14,2,6,1,7,3,FALSE
waves.js,0.0.7-7,0.0.7-8,13,2,38,27,65,3,FALSE
waves.js,0.0.7-6,0.0.7-7,12,2,47,5,52,4,FALSE
waves.js,0.0.7-5,0.0.7-6,11,2,24,1,25,3,FALSE
waves.js,0.0.7-4,0.0.7-5,10,3,10,2,12,3,FALSE
waves.js,0.0.7-3,0.0.7-4,9,2,289,59,348,14,FALSE
waves.js,0.0.7-2,0.0.7-3,8,2,11,5,16,3,FALSE
waves.js,0.0.3-5,0.0.4,3,9,183,119,302,29,FALSE
waves.js,0.0.7-0,0.0.7-1,6,2,19,3,22,3,FALSE
waves.js,0.0.7-4,0.0.7-5,10,3,10,2,12,3,TRUE
waves.js,0.0.3-4,0.0.3-5,2,5,480,375,855,35,FALSE
waves.js,0.0.3-3,0.0.3-4,1,3,63,43,106,9,FALSE
waves.js,0.0.6-1,0.0.7-0,5,4,24,15,39,5,TRUE
waves.js,0.0.7-8,0.0.7-9,14,2,6,1,7,3,TRUE
waves.js,0.0.7-3,0.0.7-4,9,2,289,59,348,14,TRUE
layer-websdk,1.0.4,1.0.6,9,12,11829,4746,16575,137,FALSE
layer-websdk,1.1.0,1.2.1,18,1,7,260,267,3,FALSE
layer-websdk,1.0.6,1.0.7,10,1,779,215,994,23,FALSE
layer-websdk,1.0.7,1.0.8,11,2,86,6,92,5,FALSE
layer-websdk,1.0.0,1.0.1,5,6,1546,958,2504,63,FALSE
layer-websdk,1.0.1,1.0.2,6,1,1,1,2,1,FALSE
layer-websdk,1.0.2,1.0.3,7,1,1,1,2,1,FALSE
layer-websdk,1.0.3,1.0.4,8,1,1,1,2,1,FALSE
layer-websdk,1.0.8,1.0.9,12,12,2398,1835,4233,104,FALSE
layer-websdk,1.0.9,1.0.10,13,5,243,85,328,24,FALSE
layer-websdk,3.1.1,3.2.0,33,1,4374,2451,6825,65,FALSE
layer-websdk,3.1.0,3.1.1,32,4,16090,8865,24955,100,FALSE
layer-websdk,2.0.3,2.0.4,25,3,135,148,283,13,FALSE
layer-websdk,3.0.2,3.0.3,30,2,149,19,168,10,FALSE
layer-websdk,2.0.2,2.0.3,24,8,1032,463,1495,48,FALSE
layer-websdk,2.0.1,2.0.2,23,1,7,260,267,3,FALSE
layer-websdk,2.0.0-beta.3,2.0.1,22,5,193,91,284,9,FALSE
layer-websdk,2.0.0-beta.1,2.0.0-beta.3,21,13,1546,562,2108,71,FALSE
layer-websdk,3.0.1,3.0.2,29,1,5,1,6,2,FALSE
layer-websdk,3.0.0,3.0.1,28,1,59,13,72,6,FALSE
layer-websdk,1.0.12,1.0.14,16,26,2251,1636,3887,106,FALSE
layer-websdk,1.0.10,1.0.11,14,1,1,1,2,1,FALSE
layer-websdk,1.0.11,1.0.12,15,8,1303,477,1780,47,FALSE
layer-websdk,0.9.0,0.9.1,1,27,4900,2648,7548,136,FALSE
layer-websdk,0.9.1,0.9.2,2,20,5647,2826,8473,281,FALSE
layer-websdk,0.9.2,0.9.3,3,6,245,79,324,19,FALSE
layer-websdk,0.9.3,1.0.0,4,1,301,29,330,6,FALSE
layer-websdk,3.0.0-beta.1,3.0.0,27,11,992,812,1804,40,FALSE
layer-websdk,1.2.1,1.2.2,19,20,2051,1285,3336,94,FALSE
layer-websdk,3.3.0,3.3.1,38,1,268,172,440,14,FALSE
layer-websdk,3.2.0,3.2.1,34,1,105,5,110,6,FALSE
layer-websdk,3.2.1,3.2.2,35,1,220,31,251,12,FALSE
layer-websdk,3.2.2,3.2.3,36,1,3617,273,3890,20,FALSE
layer-websdk,3.2.3,3.3.0,37,1,1408,60,1468,29,FALSE
layer-websdk,1.0.2,1.0.3,7,1,1,1,2,1,TRUE
layer-websdk,3.0.0-beta.1,3.0.0,27,11,992,812,1804,40,TRUE
nodebb-plugin-calendar,1.0.0-alpha.9,1.0.0-alpha.10,22,2,5,1,6,2,FALSE
nodebb-plugin-calendar,1.0.0-alpha.8,1.0.0-alpha.9,21,13,598,236,834,58,FALSE
nodebb-plugin-calendar,1.0.0-alpha.3,1.0.0-alpha.4,16,5,18,27,45,7,FALSE
nodebb-plugin-calendar,1.0.0-alpha.2,1.0.0-alpha.3,15,4,51,100,151,13,FALSE
nodebb-plugin-calendar,1.0.0-alpha.5,1.0.0-alpha.6,18,5,390,15945,16335,23,TRUE
nodebb-plugin-calendar,1.0.0-alpha.4,1.0.0-alpha.5,17,2,129,77,206,11,FALSE
nodebb-plugin-calendar,1.0.0-alpha.7,1.0.0-alpha.8,20,2,80,13,93,3,FALSE
nodebb-plugin-calendar,1.0.0-alpha.6,1.0.0-alpha.7,19,7,278,193,471,47,FALSE
nodebb-plugin-calendar,1.0.0-alpha.28,1.0.0-alpha.29,40,2,3392,31,3423,5,FALSE
nodebb-plugin-calendar,1.0.0-alpha.29,1.0.0-alpha.30,41,2,36,3384,3420,12,FALSE
nodebb-plugin-calendar,1.0.0-alpha.24,1.0.0-alpha.25,36,2,2,2,4,2,FALSE
nodebb-plugin-calendar,1.0.0-alpha.25,1.0.0-alpha.26,37,2,10,2,12,2,FALSE
nodebb-plugin-calendar,1.0.0-alpha.26,1.0.0-alpha.27,38,2,2,2,4,2,FALSE
nodebb-plugin-calendar,1.0.0-alpha.27,1.0.0-alpha.28,39,10,187,84,271,23,FALSE
nodebb-plugin-calendar,1.0.0-alpha.20,1.0.0-alpha.21,32,2,9,12,21,4,FALSE
nodebb-plugin-calendar,1.0.0-alpha.21,1.0.0-alpha.22,33,4,110,84,194,19,FALSE
nodebb-plugin-calendar,1.0.0-alpha.22,1.0.0-alpha.23,34,2,41,18,59,10,FALSE
nodebb-plugin-calendar,1.0.0-alpha.23,1.0.0-alpha.24,35,3,15,12,27,4,FALSE
nodebb-plugin-calendar,1.0.0-alpha.33,1.0.0-alpha.34,45,2,5,5,10,2,FALSE
nodebb-plugin-calendar,1.0.0-alpha.32,1.0.0-alpha.33,44,2,8,1,9,2,FALSE
nodebb-plugin-calendar,1.0.0-alpha.31,1.0.0-alpha.32,43,2,3,3,6,2,FALSE
nodebb-plugin-calendar,1.0.0-alpha.30,1.0.0-alpha.31,42,5,499,473,972,35,FALSE
nodebb-plugin-calendar,1.0.0-alpha.11,1.0.0-alpha.12,24,2,41,48,89,2,FALSE
nodebb-plugin-calendar,1.0.0-alpha.10,1.0.0-alpha.11,23,2,23,17,40,7,FALSE
nodebb-plugin-calendar,1.0.0-alpha.13,1.0.0-alpha.14,26,5,185,177,362,18,FALSE
nodebb-plugin-calendar,1.0.0-alpha.12,1.0.0-alpha.13,25,2,179,208,387,18,FALSE
nodebb-plugin-calendar,1.0.0-alpha.15,1.0.0-alpha.17,28,4,919,284,1203,30,FALSE
nodebb-plugin-calendar,1.0.0-alpha.14,1.0.0-alpha.15,27,2,2,2,4,2,FALSE
nodebb-plugin-calendar,1.0.0-alpha.17,1.0.0-alpha.18,29,4,323,307,630,10,FALSE
nodebb-plugin-calendar,1.0.0-alpha.19,1.0.0-alpha.20,31,3,20,21,41,3,FALSE
nodebb-plugin-calendar,1.0.0-alpha.18,1.0.0-alpha.19,30,2,16,12,28,2,FALSE
nodebb-plugin-calendar,1.0.0-alpha.22,1.0.0-alpha.23,34,2,41,18,59,10,TRUE
nodebb-plugin-calendar,1.0.0-alpha.11,1.0.0-alpha.12,24,2,41,48,89,2,TRUE
nodebb-plugin-calendar,1.0.0-alpha.1,1.0.0-alpha.2,14,5,106,16,122,13,FALSE
nodebb-plugin-calendar,1.0.0-alpha.5,1.0.0-alpha.6,18,5,390,15945,16335,23,FALSE
nodebb-plugin-calendar,0.0.5,0.0.6,7,1,1,1,2,1,FALSE
nodebb-plugin-calendar,0.0.7,0.0.8,9,1,1,1,2,1,FALSE
nodebb-plugin-calendar,0.0.6,0.0.7,8,1,1,1,2,1,FALSE
nodebb-plugin-calendar,0.0.4,0.0.5,6,1,1,1,2,1,FALSE
nodebb-plugin-calendar,0.0.2,0.0.4,5,1,1,1,2,1,FALSE
nodebb-plugin-calendar,0.0.9,0.1.0,11,1,1,1,2,1,FALSE
nodebb-plugin-calendar,0.0.8,0.0.9,10,1,1,1,2,1,FALSE
nodebb-plugin-calendar,0.1.0,0.1.1,12,1,1,1,2,1,FALSE
nodebb-plugin-calendar,0.1.1,1.0.0-alpha.1,13,13,19943,1420,21363,210,FALSE
nodebb-plugin-calendar,0.0.1-r1,0.0.1-r2,1,1,1,1,2,1,FALSE
nodebb-plugin-calendar,0.0.1,0.0.2-r1,3,1,1,1,2,1,FALSE
nodebb-plugin-calendar,1.0.0-alpha.2,1.0.0-alpha.3,15,4,51,100,151,13,TRUE
nodebb-plugin-calendar,1.0.0-alpha.8,1.0.0-alpha.9,21,13,598,236,834,58,TRUE
nodebb-plugin-calendar,1.0.0-alpha.19,1.0.0-alpha.20,31,3,20,21,41,3,TRUE
nodebb-plugin-calendar,1.0.0-alpha.13,1.0.0-alpha.14,26,5,185,177,362,18,TRUE
nodebb-plugin-calendar,1.0.0-alpha.17,1.0.0-alpha.18,29,4,323,307,630,10,TRUE
nodebb-plugin-calendar,1.0.0-alpha.1,1.0.0-alpha.2,14,5,106,16,122,13,TRUE
sacl,0.2.12,0.2.13,13,3,935,922,1857,18,FALSE
sacl,0.2.11,0.2.12,12,2,20,34,54,4,TRUE
sacl,0.2.10,0.2.11,11,2,32,24,56,3,FALSE
sacl,0.2.7,0.2.8,8,2,9,1,10,2,FALSE
sacl,0.2.6,0.2.7,7,2,23,3,26,4,FALSE
sacl,0.2.5,0.2.6,6,3,24,15,39,5,FALSE
sacl,0.2.4,0.2.5,5,3,174,97,271,9,FALSE
sacl,0.2.3,0.2.4,4,2,5,12,17,3,FALSE
sacl,0.2.2,0.2.3,3,2,272,25,297,6,FALSE
sacl,0.2.1,0.2.2,2,2,15,9,24,2,FALSE
sacl,0.2.0,0.2.1,1,3,31,20,51,7,FALSE
sacl,0.2.9,0.2.10,10,2,38,8,46,3,FALSE
sacl,0.2.8,0.2.9,9,3,24,8,32,3,TRUE
sacl,0.2.11,0.2.12,12,2,20,34,54,4,FALSE
sacl,0.2.8,0.2.9,9,3,24,8,32,3,FALSE
sacl,0.2.5,0.2.6,6,3,24,15,39,5,TRUE
react-redux-scroll,0.0.5,0.0.6,4,5,770,3502,4272,39,FALSE
react-redux-scroll,0.0.4,0.0.5,3,2,7656,46,7702,41,FALSE
react-redux-scroll,0.0.7,0.0.9,6,3,26,35,61,11,FALSE
react-redux-scroll,0.0.6,0.0.7,5,2,6045,115,6160,22,FALSE
react-redux-scroll,0.0.1,0.0.2,1,5,11127,31,11158,36,FALSE
react-redux-scroll,0.0.2,0.0.4,2,1,82,146,228,9,FALSE
react-redux-scroll,0.0.9,0.0.10,7,2,475,483,958,6,FALSE
react-redux-scroll,0.0.1,0.0.2,1,5,11127,31,11158,36,TRUE
react-redux-scroll,0.0.7,0.0.9,6,3,26,35,61,11,TRUE
react-redux-scroll,0.0.5,0.0.6,4,5,770,3502,4272,39,TRUE
react-redux-scroll,0.0.2,0.0.4,2,1,82,146,228,9,TRUE
composer-playground,0.4.4-20170223121522,0.4.4-20170223141017,23,3,1547,358,1905,202,FALSE
composer-playground,0.4.4-20170223164152,0.4.4-20170224133853,25,5,1715,447,2162,390,FALSE
composer-playground,0.4.4-20170223103517,0.4.4-20170223121522,22,4,3345,855,4200,435,FALSE
composer-playground,0.4.4-20170223141017,0.4.4-20170223164152,24,1,26,26,52,26,FALSE
composer-playground,0.4.4,0.4.5-20170224153926,27,1,578,1014,1592,39,FALSE
composer-playground,0.4.4-20170224133853,0.4.4,26,6,866,1296,2162,121,FALSE
composer-playground,0.7.4-20170530142459,0.7.4-20170530143521,497,1,35,37,72,3,FALSE
composer-playground,0.4.4-20170222181333,0.4.4-20170222230901,16,4,88339,119,88458,394,FALSE
composer-playground,0.5.7-20170403153420,0.5.7-20170403223455,281,1,3,0,3,3,FALSE
composer-playground,0.7.1-20170502142052,0.7.1-20170502151544,379,1,34,34,68,20,FALSE
composer-playground,0.5.2-20170313115127,0.5.2-20170313120948,155,1,20,17,37,3,FALSE
composer-playground,0.4.5-20170309172415,0.4.5-20170309201406,135,4,279,35,314,20,FALSE
composer-playground,0.4.5-20170226224342,0.4.5-20170226235234,29,7,1588,1022,2610,67,FALSE
composer-playground,0.5.8-20170407092318,0.5.8-20170407140006,300,1,144,21,165,4,FALSE
composer-playground,0.5.2-20170314152048,0.5.2-20170314164109,173,13,1017,531,1548,59,FALSE
composer-playground,0.5.6-20170328172301,0.5.6-20170329065851,263,1,293,1,294,7,FALSE
composer-playground,0.5.6-20170330083135,0.5.6-20170330093909,268,1,114,5,119,2,FALSE
composer-playground,0.4.5-20170227095701,0.4.5-20170227130557,32,8,6584,1315,7899,1419,FALSE
composer-playground,0.5.2-20170314142206,0.5.2-20170314152048,172,6,668,280,948,49,FALSE
composer-playground,0.7.4-20170531193135,0.7.4-20170531202043,507,1,1670,1590,3260,86,FALSE
composer-playground,0.7.4-20170525234800,0.7.4-20170526042055,481,1,26,1,27,2,FALSE
composer-playground,0.4.5-20170307114907,0.4.5-20170307131531,88,5,1018,266,1284,44,FALSE
composer-playground,0.7.3-20170525082746,0.7.3-20170525092654,477,1,2,8,10,1,FALSE
composer-playground,0.7.4-20170531221058,0.7.4-20170531224226,510,1,35,37,72,3,FALSE
composer-playground,0.5.11-20170417112232,0.5.11-20170417175551,327,1,23,14,37,3,FALSE
composer-playground,0.5.11-20170414140455,0.5.11-20170414172920,325,1,63,137,200,5,FALSE
composer-playground,0.7.4-20170601142718,0.7.4-20170601145149,512,1,35,37,72,3,FALSE
composer-playground,0.5.2-20170313164109,0.5.2-20170313164734,164,1,35,37,72,3,FALSE
composer-playground,0.7.4-20170531224226,0.7.4-20170601142718,511,1,35,37,72,3,FALSE
composer-playground,0.7.1-20170505151238,0.7.1,400,1,35,37,72,3,FALSE
composer-playground,0.5.9-20170409215918,0.5.9,306,1,35,37,72,3,FALSE
composer-playground,0.5.11-20170418064625,0.5.11-20170418105809,329,1,4,7,11,3,FALSE
composer-playground,0.7.4-20170530092927,0.7.4-20170530105630,494,1,0,75,75,1,FALSE
composer-playground,0.5.6-20170327224800,0.5.6-20170328000248,258,1,164,14,178,10,FALSE
composer-playground,0.4.4-20170222170514,0.4.4-20170222181333,15,4,207,27,234,8,FALSE
composer-playground,0.5.6-20170403092355,0.5.6-20170403140747,278,1,15,3,18,2,FALSE
composer-playground,0.4.5-20170308143124,0.4.5-20170308143910,105,1,35,37,72,3,FALSE
composer-playground,0.4.5-20170304165445,0.4.5-20170304194231,75,2,70,14,84,10,FALSE
composer-playground,0.7.3-20170517144754,0.7.3-20170517163408,452,1,822,48,870,16,FALSE
composer-playground,0.7.3-20170512193834,0.7.3-20170513063455,440,2,30,4,34,5,FALSE
composer-playground,0.5.2-20170314100110,0.5.2-20170314104849,168,6,569,337,906,36,FALSE
composer-playground,0.7.3-20170517094659,0.7.3-20170517105923,448,1,14,2,16,2,FALSE
composer-playground,0.7.2-20170508113734,0.7.2-20170508135105,409,1,54,54,108,29,FALSE
composer-playground,0.5.6-20170322133654,0.5.6-20170322144011,239,1,268,21,289,9,FALSE
composer-playground,0.4.5-20170228171523,0.4.5-20170301073428,54,6,8903,2710,11613,703,FALSE
composer-playground,0.7.1-20170503192825,0.7.1-20170503210021,385,1,14,14,28,3,FALSE
composer-playground,0.7.4-20170528142626,0.7.4-20170529161140,489,1,35,37,72,3,FALSE
composer-playground,0.5.6-20170320091921,0.5.6-20170320102223,225,1,15,4,19,4,FALSE
composer-playground,0.7.2-20170511073210,0.7.2-20170511081458,428,1,1,2,3,3,FALSE
composer-playground,0.5.2-20170315145417,0.5.2-20170315155558,189,11,1058,460,1518,78,FALSE
composer-playground,0.7.3-20170524145629,0.7.3-20170524154239,472,1,46,578,624,19,FALSE
composer-playground,0.4.5-20170228164847,0.4.5-20170228171523,53,1,107,21,128,6,FALSE
composer-playground,0.4.5-20170305165559,0.4.5-20170306081940,78,4,8,8,16,2,TRUE
composer-playground,0.4.5-20170228095129,0.4.5-20170228123838,48,3,22,28,50,2,FALSE
composer-playground,0.5.2-20170315095743,0.5.2-20170315102717,183,5,2017,667,2684,120,FALSE
composer-playground,0.4.5-20170308223548,0.4.5-20170308224616,120,1,35,37,72,3,FALSE
composer-playground,0.4.5-20170308134235,0.4.5-20170308140018,103,3,189,122,311,19,FALSE
composer-playground,0.5.2-20170316191301,0.5.2-20170316201319,207,2,2,2,4,2,FALSE
composer-playground,0.5.2-20170312203244,0.5.2-20170312210923,150,3,1653,1512,3165,21,FALSE
composer-playground,0.4.5-20170308162902,0.4.5-20170308163844,112,1,35,37,72,3,FALSE
composer-playground,0.5.2-20170316144946,0.5.2-20170316152340,201,6,825,649,1474,40,FALSE
composer-playground,0.5.11-20170412161822,0.5.11-20170413081721,322,1,11,10,21,3,FALSE
composer-playground,0.5.2-20170313142435,0.5.2-20170313154525,159,9,6484,5053,11537,368,FALSE
composer-playground,0.4.5-20170308182803,0.4.5-20170308194911,116,1,500,13,513,15,FALSE
composer-playground,0.5.2-20170314211349,0.5.2-20170314220420,179,2,456,122,578,18,FALSE
composer-playground,0.7.3-20170517163408,0.7.3-20170517185539,453,1,95,52,147,9,FALSE
composer-playground,0.5.13-20170422110932,0.5.13-20170424101321,345,1,41,24,65,3,FALSE
composer-playground,0.5.7-20170405225116,0.5.7-20170406092009,290,1,6,9,15,4,FALSE
composer-playground,0.5.10-20170410133745,0.5.10-20170410145627,310,1,53,2,55,2,FALSE
composer-playground,0.7.4-20170601151520,0.7.4-20170601161655,514,1,348,276,624,10,FALSE
composer-playground,0.5.11-20170420160816,0.5.11-20170420171417,335,1,32,75,107,1,FALSE
composer-playground,0.5.6-20170327135819,0.5.6-20170327152530,255,1,20,4,24,3,FALSE
composer-playground,0.5.8-20170406224000,0.5.8-20170406224305,298,1,35,37,72,3,FALSE
composer-playground,0.5.6-20170322095319,0.5.6-20170322133654,238,1,44,26,70,3,FALSE
composer-playground,0.5.9-20170409091911,0.5.9-20170409215918,305,1,0,0,0,0,FALSE
composer-playground,0.7.4-20170531092210,0.7.4-20170531103935,500,1,1,0,1,1,FALSE
composer-playground,0.5.2-20170314194114,0.5.2-20170314211349,178,3,314,55,369,12,FALSE
composer-playground,0.5.6-20170402192220,0.5.6-20170403084448,276,1,6193,1611,7804,64,FALSE
composer-playground,0.7.3-20170524104159,0.7.3-20170524104708,468,1,35,37,72,3,FALSE
composer-playground,0.5.6-20170319165038,0.5.6-20170320091921,224,1,46,5,51,1,FALSE
composer-playground,0.7.3-20170524225241,0.7.3-20170524235951,475,1,86,10,96,4,FALSE
composer-playground,0.5.13-20170424145000,0.5.13-20170424155417,347,1,18,8,26,3,FALSE
composer-playground,0.7.2-20170509150231,0.7.2-20170509215115,416,1,8,8,16,1,FALSE
composer-playground,0.4.5-20170309155736,0.4.5-20170309165943,133,7,829,98,927,49,FALSE
composer-playground,0.4.5-20170308131738,0.4.5-20170308133243,101,3,336,172,508,28,FALSE
composer-playground,0.4.5-20170228133305,0.4.5-20170228151858,50,5,1970,1153,3123,78,FALSE
composer-playground,0.7.2-20170508201056,0.7.2-20170509102910,413,1,11257,11252,22509,94,FALSE
composer-playground,0.4.5-20170309140844,0.4.5-20170309143407,130,1,35,37,72,3,FALSE
composer-playground,0.5.13-20170426092503,0.5.13-20170426100536,353,1,497,280,777,79,FALSE
composer-playground,0.7.2-20170509102910,0.7.2-20170509132635,414,1,147,15,162,2,FALSE
composer-playground,0.4.5-20170228163435,0.4.5-20170228164847,52,1,35,37,72,3,FALSE
composer-playground,0.4.5-20170228000104,0.4.5-20170228003553,43,1,12,5,17,4,FALSE
composer-playground,0.5.6-20170321114011,0.5.6-20170321132516,233,1,0,2,2,1,FALSE
composer-playground,0.5.6-20170331161339,0.5.6-20170401084624,273,1,1,1,2,1,FALSE
composer-playground,0.5.0-20170311090653,0.5.0-20170311165758,143,2,158,127,285,33,FALSE
composer-playground,0.5.6-20170327162514,0.5.6-20170327224800,257,1,1,1,2,1,FALSE
composer-playground,0.7.4-20170531183904,0.7.4-20170531193135,506,1,35,37,72,3,FALSE
composer-playground,0.5.5,0.5.6-20170317171321,221,1,86,86,172,25,FALSE
composer-playground,0.4.5-20170306190519,0.4.5-20170306204926,85,1,111,204734,204845,462,FALSE
composer-playground,0.7.0-20170429134507,0.7.0-20170430150534,370,1,5197,428,5625,56,FALSE
composer-playground,0.5.6-20170321102551,0.5.6-20170321114011,232,1,2,1,3,1,FALSE
composer-playground,0.5.11-20170414131345,0.5.11-20170414140455,324,1,1120,117,1237,11,FALSE
composer-playground,0.7.4-20170531103935,0.7.4-20170531112809,501,1,4,4,8,3,FALSE
composer-playground,0.7.2,0.7.3-20170512105624,437,3,125,99,224,26,FALSE
composer-playground,0.7.3,0.7.4-20170525193844,479,1,92,92,184,24,FALSE
composer-playground,0.7.0,0.7.1-20170501205612,373,3,5300,531,5831,82,FALSE
composer-playground,0.7.1,0.7.2-20170505194144,401,1,88,88,176,24,FALSE
composer-playground,0.7.2-20170510170851,0.7.2-20170510224135,425,1,104,75,179,2,FALSE
composer-playground,0.7.3-20170513063455,0.7.3-20170513161412,441,1,15,18,33,3,FALSE
composer-playground,0.5.8,0.5.9-20170409091911,304,1,95,95,190,25,FALSE
composer-playground,0.5.9,0.5.10-20170409232614,307,1,95,95,190,25,FALSE
composer-playground,0.5.4,0.5.5-20170317165420,219,2,117,360,477,35,FALSE
composer-playground,0.5.2-20170313154525,0.5.2-20170313155056,160,1,35,37,72,3,FALSE
composer-playground,0.5.6,0.5.7-20170403153420,280,1,93,93,186,25,FALSE
composer-playground,0.4.5-20170309150353,0.4.5-20170309155736,132,10,984,189,1173,73,FALSE
composer-playground,0.5.0,0.5.1,146,11,629,472,1101,130,FALSE
composer-playground,0.5.1,0.5.2-20170312003519,147,1,86,86,172,25,FALSE
composer-playground,0.7.3-20170518201536,0.7.3-20170519124107,460,1,5,1,6,1,FALSE
composer-playground,0.5.3,0.5.4-20170317010639,212,1,86,86,172,25,FALSE
composer-playground,0.7.4-20170531212938,0.7.4-20170531221058,509,1,232,122,354,31,FALSE
composer-playground,0.7.3-20170515142750,0.7.3-20170516211022,446,1,488,40,528,11,FALSE
composer-playground,0.4.5-20170304144245,0.4.5-20170304165445,74,1,35,37,72,3,FALSE
composer-playground,0.7.1-20170503235534,0.7.1-20170504100253,389,1,1036,767,1803,32,FALSE
composer-playground,0.5.2-20170313164734,0.5.2-20170313181004,165,6,793,427,1220,51,FALSE
composer-playground,0.5.11-20170417175551,0.5.11-20170418064625,328,1,715,748,1463,20,FALSE
composer-playground,0.4.5-20170308154526,0.4.5-20170308155525,109,1,35,37,72,3,FALSE
composer-playground,0.4.5-20170308143910,0.4.5-20170308152046,106,5,106,38,144,14,FALSE
composer-playground,0.7.2-20170512065403,0.7.2-20170512091332,435,1,0,0,0,0,FALSE
composer-playground,0.7.3-20170525092654,0.7.3,478,1,35,37,72,3,FALSE
composer-playground,0.5.10-20170410155533,0.5.10,312,1,35,37,72,3,FALSE
composer-playground,0.4.5-20170307172449,0.4.5-20170307195014,94,4,2112,3438,5550,175,FALSE
composer-playground,0.4.4-20170220133531,0.4.4-20170220163845,2,2,14969,863,15832,400,FALSE
composer-playground,0.5.13-20170427200328,0.5.13-20170427230055,360,1,37,23,60,9,FALSE
composer-playground,0.4.5-20170307231805,0.4.5-20170308102441,98,4,3076,1128,4204,72,FALSE
composer-playground,0.5.2-20170316085350,0.5.2-20170316100248,194,6,861,347,1208,80,FALSE
composer-playground,0.5.6-20170320143610,0.5.6-20170320165206,228,1,35,37,72,3,FALSE
composer-playground,0.7.4-20170531145655,0.7.4-20170531175620,504,1,846,733,1579,11,FALSE
composer-playground,0.4.5-20170303220536,0.4.5-20170304144245,73,2,2,8,10,6,FALSE
composer-playground,0.7.3-20170518103321,0.7.3-20170518123305,455,1,1132,60,1192,53,FALSE
composer-playground,0.5.2-20170314224640,0.5.2-20170315092953,181,9,5935,1549,7484,223,FALSE
composer-playground,0.7.3-20170514112333,0.7.3-20170515083534,443,1,10,10,20,2,FALSE
composer-playground,0.5.4-20170317144845,0.5.4-20170317150754,216,1,35,37,72,3,FALSE
composer-playground,0.4.5-20170301170106,0.4.5-20170302031641,61,1,269,36,305,8,TRUE
composer-playground,0.5.7-20170404205452,0.5.7-20170405074925,284,1,102,30,132,5,FALSE
composer-playground,0.5.11-20170411145259,0.5.11-20170411155746,315,1,43,4,47,3,FALSE
composer-playground,0.5.8-20170408203136,0.5.8,303,1,35,37,72,3,FALSE
composer-playground,0.5.10-20170410103131,0.5.10-20170410133745,309,1,13,22,35,5,FALSE
composer-playground,0.4.5-20170228075050,0.4.5-20170228092014,46,4,497,448,945,53,FALSE
composer-playground,0.5.6-20170321165404,0.5.6-20170322091842,236,1,19,447,466,6,FALSE
composer-playground,0.4.5-20170227165138,0.4.5-20170227165156,36,1,35,37,72,3,FALSE
composer-playground,0.7.3-20170517125550,0.7.3-20170517144754,451,1,288,268,556,12,TRUE
composer-playground,0.5.13-20170427130946,0.5.13-20170427143854,357,1,78,117,195,7,FALSE
composer-playground,0.5.6-20170328000248,0.5.6-20170328110516,259,1,285,35,320,2,FALSE
composer-playground,0.5.2-20170314091451,0.5.2-20170314100110,167,4,470,264,734,28,FALSE
composer-playground,0.4.5-20170228123838,0.4.5-20170228133305,49,2,1388,792,2180,55,FALSE
composer-playground,0.4.5-20170306204926,0.4.5-20170307102840,86,15,2433,1239226,1241659,3219,FALSE
composer-playground,0.7.1-20170502151544,0.7.1-20170502172623,380,1,13,13,26,9,FALSE
composer-playground,0.7.1-20170502072833,0.7.1-20170502083132,375,1,249,34,283,8,FALSE
composer-playground,0.7.4-20170525193844,0.7.4-20170525234800,480,1,22,17,39,4,FALSE
composer-playground,0.4.5-20170307222427,0.4.5-20170307231805,97,2,223,144,367,5,FALSE
composer-playground,0.7.2-20170506190618,0.7.2-20170507111349,405,1,445,6,451,11,FALSE
composer-playground,0.4.5-20170308165354,0.4.5-20170308171031,114,3,86,11,97,9,FALSE
composer-playground,0.4.5-20170303110503,0.4.5-20170303130657,68,2,420,176,596,12,FALSE
composer-playground,0.4.5-20170301164949,0.4.5-20170301170106,60,1,148,114,262,4,FALSE
composer-playground,0.7.1-20170503091344,0.7.1-20170503100703,382,1,93,0,93,1,FALSE
composer-playground,0.7.2-20170509215115,0.7.2-20170509222126,417,1,35,37,72,3,FALSE
composer-playground,0.5.13-20170425101322,0.5.13-20170425144442,349,1,2,1,3,2,FALSE
composer-playground,0.7.3-20170513161412,0.7.3-20170514112333,442,1,376,2,378,4,FALSE
composer-playground,0.4.4-20170222155234,0.4.4-20170222164618,13,2,88372,167,88539,423,FALSE
composer-playground,0.4.5-20170308230249,0.4.5-20170308233418,122,1,35,37,72,3,FALSE
composer-playground,0.7.2-20170507130651,0.7.2-20170508093534,407,1,220,135,355,11,FALSE
composer-playground,0.7.2-20170506073514,0.7.2-20170506084056,403,1,448,24,472,7,FALSE
composer-playground,0.5.2-20170313163500,0.5.2-20170313164059,162,1,35,37,72,3,FALSE
composer-playground,0.4.5-20170227143707,0.4.5-20170227165138,35,14,6690,785,7475,204,FALSE
composer-playground,0.7.3-20170512143234,0.7.3-20170512193834,439,1,32,13,45,4,FALSE
composer-playground,0.5.2-20170315221517,0.5.2-20170315224329,192,1,35,37,72,3,FALSE
composer-playground,0.5.2-20170313111819,0.5.2-20170313115127,154,3,156,113,269,17,FALSE
composer-playground,0.7.3-20170524124715,0.7.3-20170524134549,470,1,0,0,0,1,FALSE
composer-playground,0.7.3-20170515093334,0.7.3-20170515142750,445,1,1,1,2,1,FALSE
composer-playground,0.4.4-20170220163845,0.4.4-20170221140404,3,16,43055,203931,246986,2412,FALSE
composer-playground,0.4.5-20170308112144,0.4.5-20170308131738,100,5,3635,1417,5052,129,FALSE
composer-playground,0.7.4-20170527212230,0.7.4-20170528142626,488,1,35,37,72,3,FALSE
composer-playground,0.4.5-20170227224333,0.4.5-20170227230120,41,1,35,37,72,3,FALSE
composer-playground,0.5.2-20170316100248,0.5.2-20170316110451,195,3,333,123,456,42,FALSE
composer-playground,0.5.7-20170406203424,0.5.7-20170406212740,295,1,134,40,174,11,FALSE
composer-playground,0.5.6-20170327152530,0.5.6-20170327162514,256,1,16,3,19,1,FALSE
composer-playground,0.7.2-20170508143222,0.7.2-20170508150422,411,1,93,24,117,8,FALSE
composer-playground,0.5.6-20170320175009,0.5.6-20170321093733,230,1,246,122,368,12,FALSE
composer-playground,0.7.3-20170512105624,0.7.3-20170512143234,438,1,11,11,22,1,FALSE
composer-playground,0.5.2-20170313083042,0.5.2-20170313092430,152,1,2,2,4,2,FALSE
composer-playground,0.5.13-20170425174559,0.5.13-20170426092503,352,1,50,5,55,6,FALSE
composer-playground,0.7.4-20170531175620,0.7.4-20170531183904,505,1,20,16,36,2,FALSE
composer-playground,0.4.4-20170223095537,0.4.4-20170223103517,21,5,3345,787,4132,90,FALSE
composer-playground,0.7.3-20170524104708,0.7.3-20170524124715,469,1,35,37,72,3,FALSE
composer-playground,0.5.7-20170406193752,0.5.7-20170406203424,294,1,76,0,76,2,FALSE
composer-playground,0.5.2-20170316110451,0.5.2-20170316120427,196,8,312,331,643,51,FALSE
composer-playground,0.5.6-20170330070544,0.5.6-20170330083135,267,1,211,12,223,5,FALSE
composer-playground,0.5.2-20170314173438,0.5.2-20170314175605,175,1,35,37,72,3,FALSE
composer-playground,0.7.4-20170530043839,0.7.4-20170530052600,491,1,13,15,28,13,FALSE
composer-playground,0.4.5-20170302170551,0.4.5-20170302190028,64,2,273,88531,88804,196,FALSE
composer-playground,0.4.5-20170226235234,0.4.5-20170227091408,30,3,6300,1077,7377,211,FALSE
composer-playground,0.7.0-20170428141114,0.7.0-20170428144416,365,1,2,2,4,1,FALSE
composer-playground,0.5.2-20170316163815,0.5.2-20170316170252,203,1,35,37,72,3,FALSE
composer-playground,0.7.2-20170510224135,0.7.2-20170511000120,426,1,545,0,545,27,FALSE
composer-playground,0.5.11-20170413081721,0.5.11-20170414131345,323,1,494,35,529,9,FALSE
composer-playground,0.5.6-20170327100206,0.5.6-20170327131316,253,1,35,37,72,3,FALSE
composer-playground,0.4.5-20170302225038,0.4.5-20170303100755,66,3,62,16,78,2,FALSE
composer-playground,0.5.2-20170316170252,0.5.2-20170316172111,204,2,66,60,126,15,FALSE
composer-playground,0.5.6-20170328152710,0.5.6-20170328172301,262,1,408,39,447,2,FALSE
composer-playground,0.5.12,0.5.13-20170420203045,338,1,97,97,194,25,FALSE
composer-playground,0.5.10,0.5.11-20170411102332,313,1,96,96,192,25,FALSE
composer-playground,0.5.11,0.5.12,337,3,157,185,342,48,FALSE
composer-playground,0.5.6-20170403084448,0.5.6-20170403092355,277,1,1,6,7,1,FALSE
composer-playground,0.5.2-20170313131302,0.5.2-20170313142026,157,5,192,157,349,24,FALSE
composer-playground,0.7.2-20170511142719,0.7.2-20170511174126,432,2,221,41,262,5,FALSE
composer-playground,0.7.3-20170524092303,0.7.3-20170524104159,467,1,214,56,270,37,FALSE
composer-playground,0.4.5-20170303193345,0.4.5-20170303211223,71,1,204314,15,204329,469,FALSE
composer-playground,0.4.5-20170302031641,0.4.5-20170302165055,62,3,393,84,477,12,FALSE
composer-playground,0.4.5-20170301073428,0.4.5-20170301102843,55,5,317,198,515,10,FALSE
composer-playground,0.5.6-20170322153455,0.5.6-20170322165404,241,1,35,37,72,3,FALSE
composer-playground,0.4.4-20170222152544,0.4.4-20170222155234,12,2,101054,1229,102283,1481,FALSE
composer-playground,0.4.5-20170301143921,0.4.5-20170301153907,58,2,0,1,1,1,FALSE
composer-playground,0.7.0-20170428204746,0.7.0-20170429134507,369,1,4,35,39,5,FALSE
composer-playground,0.7.1-20170504100253,0.7.1-20170504110951,390,1,466,162,628,19,FALSE
composer-playground,0.4.5-20170309112355,0.4.5-20170309133051,128,1,35,37,72,3,FALSE
composer-playground,0.5.13-20170421192031,0.5.13-20170422071634,343,1,124,3,127,10,FALSE
composer-playground,0.5.11-20170418155913,0.5.11-20170420063536,332,4,199,1948,2147,50,FALSE
composer-playground,0.4.5-20170309143407,0.4.5-20170309150353,131,2,183,6,189,16,FALSE
composer-playground,0.5.13-20170426100536,0.5.13-20170426161821,354,1,1,1,2,1,FALSE
composer-playground,0.5.6-20170401095849,0.5.6-20170402192220,275,1,13,0,13,2,FALSE
composer-playground,0.7.1-20170504110951,0.7.1-20170504123539,391,1,23,6,29,3,FALSE
composer-playground,0.4.5-20170309212740,0.4.5-20170310112516,137,2,190,198,388,50,FALSE
composer-playground,0.7.1-20170503231020,0.7.1-20170503235534,388,1,1788,464,2252,53,FALSE
composer-playground,0.4.5-20170308171031,0.4.5-20170308182803,115,3,141,3,144,9,FALSE
composer-playground,0.7.3-20170524134549,0.7.3-20170524145629,471,1,46,65,111,6,FALSE
composer-playground,0.7.0-20170428000725,0.7.0-20170428090650,362,1,137,142,279,27,FALSE
composer-playground,0.5.11-20170411155746,0.5.11-20170411171848,316,1,1,1,2,1,FALSE
composer-playground,0.4.4-20170221160317,0.4.4-20170221163852,7,2,11407,227,11634,1059,FALSE
composer-playground,0.5.6-20170324122620,0.5.6-20170325121708,249,2,539,102,641,28,FALSE
composer-playground,0.5.2-20170313142026,0.5.2-20170313142435,158,1,26,23,49,5,FALSE
composer-playground,0.7.2-20170509222126,0.7.2-20170510080340,418,1,7,7,14,3,FALSE
composer-playground,0.5.2-20170316152340,0.5.2-20170316163815,202,7,172,437,609,23,FALSE
composer-playground,0.5.7-20170406092009,0.5.7-20170406105358,291,1,59,44,103,4,FALSE
composer-playground,0.7.2-20170508150422,0.7.2-20170508201056,412,1,86,13,99,4,FALSE
composer-playground,0.4.4-20170221140404,0.4.4-20170221145846,4,5,2843,508,3351,2408,FALSE
composer-playground,0.5.2-20170315155558,0.5.2-20170315164951,190,3,805,278,1083,50,FALSE
composer-playground,0.7.3-20170518142623,0.7.3-20170518201536,459,1,364,154,518,9,FALSE
composer-playground,0.5.2-20170314164109,0.5.2-20170314173438,174,3,30,10,40,5,FALSE
composer-playground,0.7.3-20170524154239,0.7.3-20170524214122,473,1,373,3,376,7,FALSE
composer-playground,0.4.5-20170228151858,0.4.5-20170228163435,51,4,8077,2277,10354,671,FALSE
composer-playground,0.5.6-20170320102223,0.5.6-20170320125116,226,1,73,1,74,2,FALSE
composer-playground,0.7.2-20170510092802,0.7.2-20170510103407,420,1,6,6,12,2,FALSE
composer-playground,0.5.13-20170425144442,0.5.13-20170425165811,350,1,25,6,31,7,FALSE
composer-playground,0.5.13-20170427162249,0.5.13-20170427200328,359,1,262,1,263,8,FALSE
composer-playground,0.5.2-20170314220420,0.5.2-20170314224640,180,1,2,7,9,2,FALSE
composer-playground,0.4.5-20170303211223,0.4.5-20170303220536,72,1,35,37,72,3,FALSE
composer-playground,0.5.4-20170317120624,0.5.4-20170317144845,215,5,13,10,23,10,FALSE
composer-playground,0.5.4-20170317095054,0.5.4-20170317120624,214,9,169,415,584,51,FALSE
composer-playground,0.7.4-20170530074729,0.7.4-20170530092927,493,1,93,29,122,2,FALSE
composer-playground,0.4.5-20170301125302,0.4.5-20170301143921,57,4,226,126,352,17,FALSE
composer-playground,0.4.5-20170307102840,0.4.5-20170307114907,87,9,902,5288,6190,205,FALSE
composer-playground,0.7.0-20170428194216,0.7.0-20170428201639,367,1,4,4,8,4,FALSE
composer-playground,0.7.2-20170511000120,0.7.2-20170511073210,427,1,155,54,209,9,FALSE
composer-playground,0.5.6-20170323152728,0.5.6-20170323162551,246,1,1857,572,2429,22,FALSE
composer-playground,0.7.1-20170505135229,0.7.1-20170505151238,399,1,48,19,67,1,FALSE
composer-playground,0.7.4-20170526142254,0.7.4-20170527112128,484,1,504,9,513,8,FALSE
composer-playground,0.5.2-20170316120427,0.5.2-20170316123938,197,7,6723,3435,10158,268,FALSE
composer-playground,0.4.5-20170308223539,0.4.5-20170308223548,119,1,35,37,72,3,FALSE
composer-playground,0.4.4-20170221152406,0.4.4-20170221160317,6,2,225,204,429,6,FALSE
composer-playground,0.5.6-20170325121708,0.5.6-20170326213853,250,1,1,1,2,1,FALSE
composer-playground,0.4.5-20170309014012,0.4.5-20170309090031,125,2,2231,120,2351,46,FALSE
composer-playground,0.5.2-20170313092430,0.5.2-20170313111819,153,9,5796,4799,10595,276,FALSE
composer-playground,0.4.5-20170308133243,0.4.5-20170308134235,102,1,35,37,72,3,FALSE
composer-playground,0.5.7-20170405191000,0.5.7-20170405195758,288,1,205,12,217,41,FALSE
composer-playground,0.5.2-20170315105805,0.5.2-20170315112253,185,2,111,15,126,7,FALSE
composer-playground,0.7.2-20170511174126,0.7.2-20170511184348,433,1,55,11,66,3,FALSE
composer-playground,0.4.5-20170308155525,0.4.5-20170308162049,110,3,2346,947,3293,86,FALSE
composer-playground,0.4.5-20170307195014,0.4.5-20170307210010,95,3,580,324,904,40,FALSE
composer-playground,0.5.2-20170315164951,0.5.2-20170315221517,191,4,87,32,119,16,FALSE
composer-playground,0.5.6-20170323112438,0.5.6-20170323145047,244,1,1,1,2,1,FALSE
composer-playground,0.5.3-20170317003003,0.5.3,211,1,35,37,72,3,FALSE
composer-playground,0.5.6-20170326213853,0.5.6-20170327062813,251,1,0,1,1,1,FALSE
composer-playground,0.5.4-20170317010639,0.5.4-20170317095054,213,3,1562,1129,2691,150,FALSE
composer-playground,0.5.7-20170406120956,0.5.7-20170406193752,293,1,1,0,1,1,FALSE
composer-playground,0.5.13-20170427143854,0.5.13-20170427162249,358,1,117,10,127,2,FALSE
composer-playground,0.7.2-20170511103750,0.7.2-20170511133356,430,1,126,43,169,4,FALSE
composer-playground,0.4.5-20170309090031,0.4.5-20170309103452,126,11,5179,493,5672,154,FALSE
composer-playground,0.5.11-20170412142640,0.5.11-20170412150650,320,1,6,18,24,1,FALSE
composer-playground,0.5.2-20170315120404,0.5.2-20170315133233,187,1,84,53,137,9,FALSE
composer-playground,0.5.11-20170412105027,0.5.11-20170412130723,318,1,263,137,400,7,FALSE
composer-playground,0.5.2-20170313155056,0.5.2-20170313163500,161,4,485,286,771,56,FALSE
composer-playground,0.5.6-20170328132842,0.5.6-20170328152710,261,1,440,79,519,5,FALSE
composer-playground,0.7.0-20170430150534,0.7.0-20170501193650,371,1,1,1,2,1,FALSE
composer-playground,0.4.4-20170222142641,0.4.4-20170222145515,10,2,12,12,24,4,FALSE
composer-playground,0.5.13-20170425165811,0.5.13-20170425174559,351,1,1,0,1,1,FALSE
composer-playground,0.7.2-20170508093534,0.7.2-20170508113734,408,2,66,65,131,5,FALSE
composer-playground,0.7.3-20170519155658,0.7.3-20170519191537,462,1,120,90,210,7,FALSE
composer-playground,0.5.13-20170420210947,0.5.13-20170421093118,340,1,1,1,2,1,FALSE
composer-playground,0.5.8-20170407140006,0.5.8-20170407163302,301,1,5,2,7,3,FALSE
composer-playground,0.5.6-20170327062813,0.5.6-20170327100206,252,1,328,42,370,2,FALSE
composer-playground,0.5.2-20170315224329,0.5.2-20170316085350,193,2,4,16,20,6,FALSE
composer-playground,0.5.13-20170424101321,0.5.13-20170424145000,346,1,55,37,92,3,FALSE
composer-playground,0.4.5-20170302165055,0.4.5-20170302170551,63,1,35,37,72,3,FALSE
composer-playground,0.5.10-20170410145627,0.5.10-20170410155533,311,1,10,10,20,3,FALSE
composer-playground,0.7.3-20170515083534,0.7.3-20170515093334,444,1,6,6,12,4,FALSE
composer-playground,0.7.4-20170531112809,0.7.4-20170531140019,502,1,42,49,91,3,FALSE
composer-playground,0.5.2-20170316172111,0.5.2-20170316175024,205,1,14,14,28,2,FALSE
composer-playground,0.7.3-20170524214122,0.7.3-20170524225241,474,1,1720,24,1744,36,FALSE
composer-playground,0.7.4-20170531202043,0.7.4-20170531212938,508,1,1,1,2,1,FALSE
composer-playground,0.4.5-20170308152715,0.4.5-20170308154526,108,2,171,76,247,13,FALSE
composer-playground,0.4.5-20170307142217,0.4.5-20170307153350,90,6,5211,94239,99450,465,FALSE
composer-playground,0.7.2-20170511133356,0.7.2-20170511142719,431,1,326,93,419,13,FALSE
composer-playground,0.5.11-20170411102332,0.5.11-20170411145259,314,1,21,21,42,1,FALSE
composer-playground,0.4.5-20170307161757,0.4.5-20170307172308,92,11,4047,209065,213112,696,FALSE
composer-playground,0.5.6-20170323145047,0.5.6-20170323152728,245,1,2,0,2,1,FALSE
composer-playground,0.5.7-20170406212740,0.5.7,296,1,35,37,72,3,FALSE
composer-playground,0.7.2-20170508135105,0.7.2-20170508143222,410,1,91,91,182,3,FALSE
composer-playground,0.7.2-20170510145522,0.7.2-20170510162533,423,1,239,185,424,10,FALSE
composer-playground,0.7.2-20170511081458,0.7.2-20170511103750,429,1,246,94,340,4,FALSE
composer-playground,0.5.6-20170328110516,0.5.6-20170328132842,260,1,24,3,27,2,FALSE
composer-playground,0.5.11-20170414172920,0.5.11-20170417112232,326,1,923,225,1148,12,FALSE
composer-playground,0.5.11-20170420145917,0.5.11-20170420160816,334,1,27,8,35,22,FALSE
composer-playground,0.5.7-20170405122348,0.5.7-20170405154329,286,1,352,2,354,11,FALSE
composer-playground,0.5.11-20170418124512,0.5.11-20170418155913,331,1,98,45,143,9,FALSE
composer-playground,0.5.2-20170314191345,0.5.2-20170314194114,177,1,47,61,108,4,FALSE
composer-playground,0.7.1-20170502172623,0.7.1-20170503091344,381,1,5,5,10,2,FALSE
composer-playground,0.5.2-20170313120948,0.5.2-20170313131302,156,2,10,10,20,2,FALSE
composer-playground,0.4.5-20170227130557,0.4.5-20170227140500,33,4,7,864,871,82,FALSE
composer-playground,0.4.5-20170306081940,0.4.5-20170306113142,79,3,205709,329,206038,511,FALSE
composer-playground,0.4.4-20170221145846,0.4.4-20170221152406,5,2,982,201,1183,805,FALSE
composer-playground,0.5.2-20170315102717,0.5.2-20170315105805,184,2,2,2,4,2,FALSE
composer-playground,0.4.5-20170227140500,0.4.5-20170227143707,34,3,542,698,1240,435,FALSE
composer-playground,0.4.5-20170308102441,0.4.5-20170308112144,99,1,41,64,105,6,FALSE
composer-playground,0.5.7-20170404193825,0.5.7-20170404205452,283,1,299,1,300,4,FALSE
composer-playground,0.7.1-20170505075003,0.7.1-20170505082916,396,1,6,9325,9331,216,FALSE
composer-playground,0.4.4-20170222145515,0.4.4-20170222152544,11,3,176054,46,176100,766,FALSE
composer-playground,0.4.4-20170222164618,0.4.4-20170222170514,14,4,88336,132,88468,422,FALSE
composer-playground,0.4.5-20170301153907,0.4.5-20170301164949,59,4,450,220,670,22,FALSE
composer-playground,0.4.5,0.5.0-20170310095413,139,238,590753,2249232,2839985,9949,FALSE
composer-playground,0.7.4-20170527142420,0.7.4-20170527212230,487,1,21,13,34,4,FALSE
composer-playground,0.4.5-20170307172308,0.4.5-20170307172449,93,1,3981,91530,95511,343,FALSE
composer-playground,0.4.5-20170308210152,0.4.5-20170308223539,118,7,2493,159,2652,101,FALSE
composer-playground,0.5.6-20170403140747,0.5.6,279,1,35,37,72,3,FALSE
composer-playground,0.4.5-20170308194911,0.4.5-20170308210152,117,2,703,32,735,24,FALSE
composer-playground,0.7.3-20170520185533,0.7.3-20170523201332,464,1,4,4,8,4,FALSE
composer-playground,0.5.11-20170412130723,0.5.11-20170412142640,319,1,7,1,8,3,FALSE
composer-playground,0.7.2-20170511184348,0.7.2-20170512065403,434,1,35,37,72,3,FALSE
composer-playground,0.5.8-20170406224305,0.5.8-20170407092318,299,1,32,14247,14279,4,FALSE
composer-playground,0.7.1-20170504160025,0.7.1-20170504194131,393,2,84,27,111,9,FALSE
composer-playground,0.4.5-20170227220209,0.4.5-20170227224333,40,4,31,13,44,15,FALSE
composer-playground,0.7.1-20170503220610,0.7.1-20170503231020,387,1,8,3,11,2,FALSE
composer-playground,0.5.6-20170322091842,0.5.6-20170322095319,237,1,147,46,193,3,FALSE
composer-playground,0.5.13-20170426161821,0.5.13-20170427111149,355,1,35,37,72,3,FALSE
composer-playground,0.4.5-20170307210010,0.4.5-20170307222427,96,6,2554,793,3347,55,FALSE
composer-playground,0.7.3-20170517115303,0.7.3-20170517125550,450,1,33,29,62,2,FALSE
composer-playground,0.4.5-20170302190028,0.4.5-20170302225038,65,2,273,88531,88804,196,FALSE
composer-playground,0.4.5-20170307153350,0.4.5-20170307161757,91,7,622,339,961,40,FALSE
composer-playground,0.7.3-20170519124107,0.7.3-20170519155658,461,1,574,99,673,11,FALSE
composer-playground,0.7.0-20170428144416,0.7.0-20170428194216,366,1,5,6,11,2,FALSE
composer-playground,0.7.1-20170505082916,0.7.1-20170505101424,397,1,32,37,69,18,FALSE
composer-playground,0.4.5-20170227091408,0.4.5-20170227095701,31,2,6042,1063,7105,201,FALSE
composer-playground,0.5.4-20170317150754,0.5.4-20170317153753,217,1,31,274,305,10,FALSE
composer-playground,0.5.2-20170314115729,0.5.2-20170314132030,170,9,6593,899,7492,124,FALSE
composer-playground,0.7.1-20170503100703,0.7.1-20170503150054,383,1,7,5,12,6,FALSE
composer-playground,0.7.3-20170518123305,0.7.3-20170518131232,456,1,23,16,39,5,FALSE
composer-playground,0.4.5-20170309002603,0.4.5-20170309014012,124,2,680,32,712,8,FALSE
composer-playground,0.7.3-20170519191537,0.7.3-20170520185533,463,1,29,0,29,1,FALSE
composer-playground,0.5.2-20170316175024,0.5.2-20170316191301,206,2,32,28,60,10,FALSE
composer-playground,0.5.11-20170412150650,0.5.11-20170412161822,321,1,94,2,96,4,FALSE
composer-playground,0.7.1-20170503210021,0.7.1-20170503220610,386,1,12,3,15,6,FALSE
composer-playground,0.4.4-20170221163852,0.4.4-20170221173204,8,3,1256,273,1529,822,FALSE
composer-playground,0.5.11-20170418105809,0.5.11-20170418124512,330,1,16,6,22,6,FALSE
composer-playground,0.7.4-20170530143521,0.7.4-20170531082238,498,4,151,26,177,26,FALSE
composer-playground,0.7.1-20170502132911,0.7.1-20170502142052,378,1,1,1,2,1,FALSE
composer-playground,0.4.5-20170303140812,0.4.5-20170303193345,70,2,557,201,758,34,FALSE
composer-playground,0.7.2-20170509132635,0.7.2-20170509150231,415,1,77,53,130,7,FALSE
composer-playground,0.4.5-20170304194231,0.4.5-20170304220145,76,2,920,502,1422,24,FALSE
composer-playground,0.7.3-20170518135130,0.7.3-20170518142623,458,1,289,34,323,11,FALSE
composer-playground,0.5.0-20170311165758,0.5.0-20170311181018,144,5,144,49,193,17,FALSE
composer-playground,0.5.7-20170403223455,0.5.7-20170404193825,282,1,29,1,30,1,FALSE
composer-playground,0.4.5-20170303130657,0.4.5-20170303140812,69,1,213,97,310,18,FALSE
composer-playground,0.5.6-20170323175120,0.5.6-20170324122620,248,1,326,46,372,15,FALSE
composer-playground,0.7.1-20170504194131,0.7.1-20170504214639,394,1,81,42,123,3,FALSE
composer-playground,0.4.5-20170228092014,0.4.5-20170228095129,47,1,440,15,455,2,FALSE
composer-playground,0.5.6-20170327131316,0.5.6-20170327135819,254,1,79,11,90,5,FALSE
composer-playground,0.7.3-20170524235951,0.7.3-20170525082746,476,1,3,3,6,1,FALSE
composer-playground,0.7.3-20170517105923,0.7.3-20170517115303,449,1,21,3,24,3,FALSE
composer-playground,0.5.6-20170330150253,0.5.6-20170331093508,271,1,4,4,8,1,FALSE
composer-playground,0.5.2-20170314175605,0.5.2-20170314191345,176,3,81,77,158,18,FALSE
composer-playground,0.4.5-20170308140018,0.4.5-20170308143124,104,3,345,172,517,24,FALSE
composer-playground,0.5.6-20170323162551,0.5.6-20170323175120,247,1,119,14,133,7,FALSE
composer-playground,0.5.13-20170427111149,0.5.13-20170427130946,356,1,1,2,3,2,FALSE
composer-playground,0.4.5-20170308152046,0.4.5-20170308152715,107,6,135,40,175,20,FALSE
composer-playground,0.5.2-20170314104849,0.5.2-20170314115729,169,3,2548,298,2846,34,FALSE
composer-playground,0.7.2-20170507111349,0.7.2-20170507130651,406,1,35,37,72,3,FALSE
composer-playground,0.7.1-20170502123250,0.7.1-20170502132911,377,1,171,185,356,17,FALSE
composer-playground,0.4.4-20170219230928,0.4.4-20170220133531,1,3,26,12,38,4,FALSE
composer-playground,0.7.1-20170503150054,0.7.1-20170503192825,384,1,613,358,971,2,FALSE
composer-playground,0.4.5-20170224153926,0.4.5-20170226224342,28,17,12269,4322,16591,479,FALSE
composer-playground,0.5.6-20170329065851,0.5.6-20170329161359,264,1,359,34,393,16,FALSE
composer-playground,0.5.6-20170321132516,0.5.6-20170321163402,234,1,247,140,387,7,FALSE
composer-playground,0.7.2-20170510103407,0.7.2-20170510135245,421,1,605,379,984,22,FALSE
composer-playground,0.5.2-20170316201319,0.5.2,208,1,35,37,72,3,FALSE
composer-playground,0.4.4-20170222230901,0.4.4-20170223011633,17,4,203,47,250,7,FALSE
composer-playground,0.4.5-20170228053246,0.4.5-20170228075050,45,2,19,10,29,11,FALSE
composer-playground,0.4.4-20170223092750,0.4.4-20170223095537,20,4,90798,754,91552,482,FALSE
composer-playground,0.7.0-20170428090650,0.7.0-20170428111102,363,1,9,5,14,3,FALSE
composer-playground,0.4.5-20170306125832,0.4.5-20170306153357,81,7,752,574,1326,66,TRUE
composer-playground,0.7.4-20170530115441,0.7.4-20170530142459,496,1,200,59,259,1,FALSE
composer-playground,0.5.2-20170312003519,0.5.2-20170312170113,148,2,51595,227115,278710,2201,FALSE
composer-playground,0.4.5-20170227182015,0.4.5-20170227193120,38,3,848,818,1666,42,FALSE
composer-playground,0.7.4-20170530105630,0.7.4-20170530115441,495,1,41,3,44,2,FALSE
composer-playground,0.7.4-20170530052600,0.7.4-20170530074729,492,1,40,17,57,2,FALSE
composer-playground,0.4.5-20170309103452,0.4.5-20170309112355,127,3,135,104,239,15,FALSE
composer-playground,0.4.4-20170223080308,0.4.4-20170223092750,19,2,703,230,933,20,FALSE
composer-playground,0.5.13-20170420203045,0.5.13-20170420210947,339,1,233,2,235,2,FALSE
composer-playground,0.7.4-20170527112128,0.7.4-20170527115320,485,1,85,107,192,5,FALSE
composer-playground,0.5.2-20170315112253,0.5.2-20170315120404,186,1,13,13,26,4,FALSE
composer-playground,0.4.4-20170221173204,0.4.4-20170222142641,9,15,88720,309,89029,452,FALSE
composer-playground,0.7.4-20170526042055,0.7.4-20170526142135,482,1,11,0,11,2,FALSE
composer-playground,0.5.11-20170420063536,0.5.11-20170420145917,333,1,185,8,193,30,FALSE
composer-playground,0.5.6-20170317171321,0.5.6-20170318165009,222,1,35,37,72,3,FALSE
composer-playground,0.4.5-20170308233418,0.4.5-20170309002603,123,1,3,2,5,2,FALSE
composer-playground,0.5.7-20170405154329,0.5.7-20170405191000,287,1,100,1,101,13,FALSE
composer-playground,0.7.2-20170510135245,0.7.2-20170510145522,422,1,31,24,55,83,FALSE
composer-playground,0.5.2-20170316141355,0.5.2-20170316144946,200,6,1402,1000,2402,119,FALSE
composer-playground,0.5.8-20170407163302,0.5.8-20170408203136,302,1,2,2,4,1,FALSE
composer-playground,0.4.5-20170227165156,0.4.5-20170227182015,37,3,423,408,831,22,FALSE
composer-playground,0.7.4-20170601145149,0.7.4-20170601151520,513,1,12,18,30,5,FALSE
composer-playground,0.5.6-20170322165404,0.5.6-20170323082204,242,1,712,11,723,27,FALSE
composer-playground,0.7.1-20170504214639,0.7.1-20170505075003,395,2,37,37,74,11,FALSE
composer-playground,0.5.7-20170405195758,0.5.7-20170405225116,289,1,658,68,726,14,FALSE
composer-playground,0.7.4-20170527115320,0.7.4-20170527142420,486,1,35,37,72,3,FALSE
composer-playground,0.4.5-20170307131531,0.4.5-20170307142217,89,11,2916,208084,211000,671,FALSE
composer-playground,0.7.2-20170510080340,0.7.2-20170510092802,419,1,1707,449,2156,9,FALSE
composer-playground,0.5.6-20170321163402,0.5.6-20170321165404,235,1,35,37,72,3,FALSE
composer-playground,0.5.6-20170330105333,0.5.6-20170330150253,270,1,3,1,4,2,FALSE
composer-playground,0.5.13-20170421141512,0.5.13-20170421192031,342,1,97,99,196,9,FALSE
composer-playground,0.4.5-20170304220145,0.4.5-20170305165559,77,1,35,37,72,3,FALSE
composer-playground,0.5.6-20170330093909,0.5.6-20170330105333,269,1,5,3,8,3,FALSE
composer-playground,0.4.5-20170306113142,0.4.5-20170306125832,80,2,165,36,201,7,FALSE
composer-playground,0.5.7,0.5.8-20170406224000,297,1,96,97,193,25,FALSE
composer-playground,0.7.1-20170504123539,0.7.1-20170504160025,392,1,80,11,91,1,FALSE
composer-playground,0.4.5-20170227193120,0.4.5-20170227220209,39,4,7760,12,7772,18,FALSE
composer-playground,0.5.6-20170329172715,0.5.6-20170330070544,266,1,292,299,591,16,FALSE
composer-playground,0.4.5-20170308224616,0.4.5-20170308230249,121,1,35,37,72,3,FALSE
composer-playground,0.5.2-20170316132748,0.5.2-20170316141355,199,3,3002,1768,4770,238,FALSE
composer-playground,0.5.2-20170313181004,0.5.2-20170314091451,166,2,440,260,700,29,FALSE
composer-playground,0.5.0-20170310140811,0.5.0-20170310165801,141,9,707,251,958,83,FALSE
composer-playground,0.5.7-20170406105358,0.5.7-20170406120956,292,1,1669,516,2185,56,FALSE
composer-playground,0.5.2-20170314132030,0.5.2-20170314142206,171,3,1300,89,1389,17,FALSE
composer-playground,0.4.5-20170308162049,0.4.5-20170308162902,111,1,27,8,35,4,FALSE
composer-playground,0.4.5-20170306165425,0.4.5-20170306171700,83,4,121215,3952,125167,679,FALSE
composer-playground,0.4.5-20170308163844,0.4.5-20170308165354,113,1,35,37,72,3,FALSE
composer-playground,0.5.6-20170329161359,0.5.6-20170329172715,265,1,66,29,95,6,FALSE
composer-playground,0.5.13-20170424155417,0.5.13-20170425101322,348,1,147,113,260,12,FALSE
composer-playground,0.4.5-20170303100755,0.4.5-20170303110503,67,3,1016,1976,2992,78,FALSE
composer-playground,0.7.3-20170517185539,0.7.3-20170518103321,454,1,93,80,173,4,FALSE
composer-playground,0.7.4-20170529161140,0.7.4-20170530043839,490,1,2184,25,2209,41,FALSE
composer-playground,0.5.11-20170411171848,0.5.11-20170412105027,317,1,75,31,106,1,FALSE
composer-playground,0.5.13-20170421093118,0.5.13-20170421141512,341,1,68,38,106,1,FALSE
composer-playground,0.5.2-20170315133233,0.5.2-20170315145417,188,3,556,286,842,47,FALSE
composer-playground,0.7.4-20170531082238,0.7.4-20170531092210,499,1,0,1,1,1,FALSE
composer-playground,0.5.2-20170312170113,0.5.2-20170312203244,149,4,2436,1765,4201,247,FALSE
composer-playground,0.5.2-20170316123938,0.5.2-20170316132748,198,2,1187,719,1906,92,FALSE
composer-playground,0.5.2,0.5.3-20170316223823,209,2,174,174,348,50,FALSE
composer-playground,0.5.0-20170310095413,0.5.0-20170310140811,140,1,35,37,72,3,FALSE
composer-playground,0.4.5-20170228003553,0.4.5-20170228053246,44,1,35,37,72,3,FALSE
composer-playground,0.5.7-20170405074925,0.5.7-20170405122348,285,1,2,2,4,1,FALSE
composer-playground,0.5.2-20170312210923,0.5.2-20170313083042,151,6,2648,2230,4878,118,FALSE
composer-playground,0.7.0-20170428111102,0.7.0-20170428141114,364,1,124,130,254,12,FALSE
composer-playground,0.5.6-20170331093508,0.5.6-20170331161339,272,1,758,19,777,9,FALSE
composer-playground,0.7.2-20170506084056,0.7.2-20170506190618,404,1,87,10,97,4,FALSE
composer-playground,0.5.13-20170427230055,0.7.0-20170428000725,361,1,218,1880,2098,53,FALSE
composer-playground,0.7.0-20170428201639,0.7.0-20170428204746,368,1,8,1,9,1,FALSE
composer-playground,0.4.5-20170227230120,0.4.5-20170228000104,42,2,14,5,19,5,FALSE
composer-playground,0.4.5-20170309165943,0.4.5-20170309172415,134,1,35,37,72,3,FALSE
composer-playground,0.7.2-20170510162533,0.7.2-20170510170851,424,1,11,4,15,2,FALSE
composer-playground,0.7.4-20170531140019,0.7.4-20170531145655,503,1,35,37,72,3,FALSE
composer-playground,0.5.6-20170318165009,0.5.6-20170319165038,223,1,35,37,72,3,FALSE
composer-playground,0.4.4-20170223011633,0.4.4-20170223080308,18,2,37,13,50,4,FALSE
composer-playground,0.4.5-20170301102843,0.4.5-20170301125302,56,8,42,134,176,16,FALSE
composer-playground,0.5.2-20170315092953,0.5.2-20170315095743,182,7,865,270,1135,56,FALSE
composer-playground,0.5.6-20170320125116,0.5.6-20170320143610,227,1,397,38,435,7,FALSE
composer-playground,0.5.6-20170322144011,0.5.6-20170322153455,240,1,360,74,434,11,FALSE
composer-playground,0.5.6-20170323082204,0.5.6-20170323112438,243,1,91,9,100,1,FALSE
composer-playground,0.7.1-20170502083132,0.7.1-20170502123250,376,1,4,4,8,2,FALSE
composer-playground,0.5.6-20170321093733,0.5.6-20170321102551,231,1,0,16,16,2,FALSE
composer-playground,0.7.1-20170501205612,0.7.1-20170502072833,374,1,36,36,72,3,FALSE
composer-playground,0.5.10-20170409232614,0.5.10-20170410103131,308,1,78,32,110,5,FALSE
composer-playground,0.7.3-20170523204533,0.7.3-20170524092303,466,1,117,16,133,7,FALSE
composer-playground,0.5.3-20170316223823,0.5.3-20170317003003,210,3,52,54,106,8,FALSE
composer-playground,0.7.3-20170523201332,0.7.3-20170523204533,465,1,0,151,151,9,FALSE
composer-playground,0.5.13-20170422071634,0.5.13-20170422110932,344,1,648,144,792,20,FALSE
composer-playground,0.4.5-20170309133051,0.4.5-20170309140844,129,1,181,4,185,13,FALSE
composer-playground,0.7.2-20170505194144,0.7.2-20170506073514,402,1,83,2,85,4,FALSE
composer-playground,0.4.5-20170306153357,0.4.5-20170306165425,82,9,1135,613,1748,99,FALSE
composer-playground,0.5.0-20170310165801,0.5.0-20170311090653,142,2,155,124,279,30,FALSE
composer-playground,0.7.3-20170518131232,0.7.3-20170518135130,457,1,1079,110,1189,5,FALSE
composer-playground,0.4.5-20170309201406,0.4.5-20170309212740,136,2,283,37,320,26,FALSE
composer-playground,0.5.6-20170320165206,0.5.6-20170320175009,229,1,202,11,213,2,FALSE
composer-playground,0.4.5-20170306171700,0.4.5-20170306190519,84,3,790,343,1133,55,FALSE
composer-playground,0.7.1-20170505101424,0.7.1-20170505135229,398,2,21,8,29,7,FALSE
composer-playground,0.7.3-20170516211022,0.7.3-20170517094659,447,1,0,8,8,2,FALSE
composer-playground,0.7.4-20170526142135,0.7.4-20170526142254,483,1,35,37,72,3,FALSE
composer-playground,0.5.6-20170401084624,0.5.6-20170401095849,274,1,27,1,28,2,FALSE
composer-playground,0.7.3-20170517125550,0.7.3-20170517144754,451,1,288,268,556,12,FALSE
composer-playground,0.5.6-20170322133654,0.5.6-20170322144011,239,1,268,21,289,9,TRUE
composer-playground,0.5.6-20170402192220,0.5.6-20170403084448,276,1,6193,1611,7804,64,TRUE
composer-playground,0.5.11-20170414131345,0.5.11-20170414140455,324,1,1120,117,1237,11,TRUE
composer-playground,0.7.3-20170525092654,0.7.3,478,1,35,37,72,3,TRUE
composer-playground,0.5.6-20170321165404,0.5.6-20170322091842,236,1,19,447,466,6,TRUE
composer-playground,0.7.2-20170506190618,0.7.2-20170507111349,405,1,445,6,451,11,TRUE
composer-playground,0.5.6-20170324122620,0.5.6-20170325121708,249,2,539,102,641,28,TRUE
composer-playground,0.7.3-20170520185533,0.7.3-20170523201332,464,1,4,4,8,4,TRUE
composer-playground,0.5.11-20170413081721,0.5.11-20170414131345,323,1,494,35,529,9,TRUE
composer-playground,0.7.1-20170504100253,0.7.1-20170504110951,390,1,466,162,628,19,TRUE
composer-playground,0.5.6-20170328172301,0.5.6-20170329065851,263,1,293,1,294,7,TRUE
composer-playground,0.7.4-20170526142254,0.7.4-20170527112128,484,1,504,9,513,8,TRUE
composer-playground,0.7.4-20170531224226,0.7.4-20170601142718,511,1,35,37,72,3,TRUE
composer-playground,0.7.3-20170512193834,0.7.3-20170513063455,440,2,30,4,34,5,TRUE
composer-playground,0.5.2-20170312210923,0.5.2-20170313083042,151,6,2648,2230,4878,118,TRUE
composer-playground,0.7.4-20170528142626,0.7.4-20170529161140,489,1,35,37,72,3,TRUE
composer-playground,0.5.11-20170412161822,0.5.11-20170413081721,322,1,11,10,21,3,TRUE
composer-playground,0.5.7-20170405225116,0.5.7-20170406092009,290,1,6,9,15,4,TRUE
composer-playground,0.5.6-20170319165038,0.5.6-20170320091921,224,1,46,5,51,1,TRUE
composer-playground,0.5.6-20170318165009,0.5.6-20170319165038,223,1,35,37,72,3,TRUE
composer-playground,0.7.2-20170508201056,0.7.2-20170509102910,413,1,11257,11252,22509,94,TRUE
composer-playground,0.5.6-20170331161339,0.5.6-20170401084624,273,1,1,1,2,1,TRUE
composer-playground,0.7.0,0.7.1-20170501205612,373,3,5300,531,5831,82,TRUE
composer-playground,0.5.0,0.5.1,146,11,629,472,1101,130,TRUE
composer-playground,0.7.3-20170518201536,0.7.3-20170519124107,460,1,5,1,6,1,TRUE
composer-playground,0.7.3-20170515142750,0.7.3-20170516211022,446,1,488,40,528,11,TRUE
composer-playground,0.4.5-20170307231805,0.4.5-20170308102441,98,4,3076,1128,4204,72,TRUE
composer-playground,0.5.2-20170314224640,0.5.2-20170315092953,181,9,5935,1549,7484,223,TRUE
composer-playground,0.7.3-20170514112333,0.7.3-20170515083534,443,1,10,10,20,2,TRUE
composer-playground,0.5.7-20170404205452,0.5.7-20170405074925,284,1,102,30,132,5,TRUE
composer-playground,0.5.6-20170328000248,0.5.6-20170328110516,259,1,285,35,320,2,TRUE
composer-playground,0.7.3-20170513161412,0.7.3-20170514112333,442,1,376,2,378,4,TRUE
composer-playground,0.7.2-20170507130651,0.7.2-20170508093534,407,1,220,135,355,11,TRUE
composer-playground,0.7.4-20170527212230,0.7.4-20170528142626,488,1,35,37,72,3,TRUE
composer-playground,0.5.6-20170320175009,0.5.6-20170321093733,230,1,246,122,368,12,TRUE
composer-playground,0.5.13-20170425174559,0.5.13-20170426092503,352,1,50,5,55,6,TRUE
composer-playground,0.7.1-20170503235534,0.7.1-20170504100253,389,1,1036,767,1803,32,TRUE
composer-playground,0.5.10,0.5.11-20170411102332,313,1,96,96,192,25,TRUE
composer-playground,0.7.2-20170511000120,0.7.2-20170511073210,427,1,155,54,209,9,TRUE
composer-playground,0.7.0-20170428204746,0.7.0-20170429134507,369,1,4,35,39,5,TRUE
composer-playground,0.5.6-20170401095849,0.5.6-20170402192220,275,1,13,0,13,2,TRUE
composer-playground,0.4.5-20170309212740,0.4.5-20170310112516,137,2,190,198,388,50,TRUE
composer-playground,0.7.0-20170428000725,0.7.0-20170428090650,362,1,137,142,279,27,TRUE
composer-playground,0.7.2-20170509222126,0.7.2-20170510080340,418,1,7,7,14,3,TRUE
composer-playground,0.7.2-20170505194144,0.7.2-20170506073514,402,1,83,2,85,4,TRUE
composer-playground,0.5.6-20170325121708,0.5.6-20170326213853,250,1,1,1,2,1,TRUE
composer-playground,0.5.6-20170326213853,0.5.6-20170327062813,251,1,0,1,1,1,TRUE
composer-playground,0.5.4-20170317010639,0.5.4-20170317095054,213,3,1562,1129,2691,150,TRUE
composer-playground,0.7.0-20170430150534,0.7.0-20170501193650,371,1,1,1,2,1,TRUE
composer-playground,0.5.13-20170420210947,0.5.13-20170421093118,340,1,1,1,2,1,TRUE
composer-playground,0.5.2-20170315224329,0.5.2-20170316085350,193,2,4,16,20,6,TRUE
composer-playground,0.5.11-20170414172920,0.5.11-20170417112232,326,1,923,225,1148,12,TRUE
composer-playground,0.7.1-20170502172623,0.7.1-20170503091344,381,1,5,5,10,2,TRUE
composer-playground,0.5.8-20170406224305,0.5.8-20170407092318,299,1,32,14247,14279,4,TRUE
composer-playground,0.5.13-20170426161821,0.5.13-20170427111149,355,1,35,37,72,3,TRUE
composer-playground,0.7.4-20170530143521,0.7.4-20170531082238,498,4,151,26,177,26,TRUE
composer-playground,0.5.7-20170403223455,0.5.7-20170404193825,282,1,29,1,30,1,TRUE
composer-playground,0.5.6-20170323175120,0.5.6-20170324122620,248,1,326,46,372,15,TRUE
composer-playground,0.7.3-20170524235951,0.7.3-20170525082746,476,1,3,3,6,1,TRUE
composer-playground,0.5.6-20170330150253,0.5.6-20170331093508,271,1,4,4,8,1,TRUE
composer-playground,0.5.2-20170312003519,0.5.2-20170312170113,148,2,51595,227115,278710,2201,TRUE
composer-playground,0.7.4-20170530052600,0.7.4-20170530074729,492,1,40,17,57,2,TRUE
composer-playground,0.7.0-20170429134507,0.7.0-20170430150534,370,1,5197,428,5625,56,TRUE
composer-playground,0.7.4-20170526042055,0.7.4-20170526142135,482,1,11,0,11,2,TRUE
composer-playground,0.5.6-20170317171321,0.5.6-20170318165009,222,1,35,37,72,3,TRUE
composer-playground,0.5.6-20170322165404,0.5.6-20170323082204,242,1,712,11,723,27,TRUE
composer-playground,0.7.1-20170504214639,0.7.1-20170505075003,395,2,37,37,74,11,TRUE
composer-playground,0.5.6-20170329172715,0.5.6-20170330070544,266,1,292,299,591,16,TRUE
composer-playground,0.5.2-20170313181004,0.5.2-20170314091451,166,2,440,260,700,29,TRUE
composer-playground,0.7.3-20170517185539,0.7.3-20170518103321,454,1,93,80,173,4,TRUE
composer-playground,0.5.11-20170411171848,0.5.11-20170412105027,317,1,75,31,106,1,TRUE
composer-playground,0.7.1-20170501205612,0.7.1-20170502072833,374,1,36,36,72,3,TRUE
composer-playground,0.7.3-20170523204533,0.7.3-20170524092303,466,1,117,16,133,7,TRUE
composer-playground,0.5.0-20170310165801,0.5.0-20170311090653,142,2,155,124,279,30,TRUE
composer-playground,0.7.3-20170516211022,0.7.3-20170517094659,447,1,0,8,8,2,TRUE
composer-playground,0.7.2-20170511184348,0.7.2-20170512065403,434,1,35,37,72,3,TRUE
composer-playground,0.4.5-20170305165559,0.4.5-20170306081940,78,4,8,8,16,2,FALSE
composer-playground,0.4.5-20170301170106,0.4.5-20170302031641,61,1,269,36,305,8,FALSE
composer-playground,0.4.5-20170306125832,0.4.5-20170306153357,81,7,752,574,1326,66,FALSE
composer-playground,0.5.2-20170316085350,0.5.2-20170316100248,194,6,861,347,1208,80,TRUE
composer-playground,0.4.5-20170306113142,0.4.5-20170306125832,80,2,165,36,201,7,TRUE
composer-playground,0.5.2-20170314100110,0.5.2-20170314104849,168,6,569,337,906,36,TRUE
composer-playground,0.5.13-20170422110932,0.5.13-20170424101321,345,1,41,24,65,3,TRUE
composer-playground,0.5.13-20170426100536,0.5.13-20170426161821,354,1,1,1,2,1,TRUE
composer-playground,0.5.13-20170422071634,0.5.13-20170422110932,344,1,648,144,792,20,TRUE
composer-playground,0.4.5-20170224153926,0.4.5-20170226224342,28,17,12269,4322,16591,479,TRUE
composer-playground,0.5.2,0.5.3-20170316223823,209,2,174,174,348,50,TRUE
composer-playground,0.4.5-20170228171523,0.4.5-20170301073428,54,6,8903,2710,11613,703,TRUE
composer-playground,0.4.4-20170223164152,0.4.4-20170224133853,25,5,1715,447,2162,390,TRUE
composer-playground,0.4.5-20170306204926,0.4.5-20170307102840,86,15,2433,1239226,1241659,3219,TRUE
composer-playground,0.4.4-20170220163845,0.4.4-20170221140404,3,16,43055,203931,246986,2412,TRUE
composer-playground,0.4.5-20170226235234,0.4.5-20170227091408,30,3,6300,1077,7377,211,TRUE
composer-playground,0.4.5-20170302225038,0.4.5-20170303100755,66,3,62,16,78,2,TRUE
composer-playground,0.4.5-20170302031641,0.4.5-20170302165055,62,3,393,84,477,12,TRUE
composer-playground,0.4.5,0.5.0-20170310095413,139,238,590753,2249232,2839985,9949,TRUE
composer-playground,0.4.4-20170219230928,0.4.4-20170220133531,1,3,26,12,38,4,TRUE
composer-playground,0.4.5-20170228053246,0.4.5-20170228075050,45,2,19,10,29,11,TRUE
composer-playground,0.4.4-20170221173204,0.4.4-20170222142641,9,15,88720,309,89029,452,TRUE
composer-playground,0.4.4-20170223011633,0.4.4-20170223080308,18,2,37,13,50,4,TRUE
composer-playground,0.5.4,0.5.5-20170317165420,219,2,117,360,477,35,TRUE
composer-playground,0.5.2-20170316120427,0.5.2-20170316123938,197,7,6723,3435,10158,268,TRUE
composer-playground,0.5.7-20170405122348,0.5.7-20170405154329,286,1,352,2,354,11,TRUE
composer-playground,0.5.6-20170329065851,0.5.6-20170329161359,264,1,359,34,393,16,TRUE
composer-playground,0.5.7-20170405195758,0.5.7-20170405225116,289,1,658,68,726,14,TRUE
composer-playground,0.4.5-20170308134235,0.4.5-20170308140018,103,3,189,122,311,19,TRUE
composer-playground,0.5.8-20170407140006,0.5.8-20170407163302,301,1,5,2,7,3,TRUE
composer-playground,0.4.5-20170227182015,0.4.5-20170227193120,38,3,848,818,1666,42,TRUE
composer-playground,0.5.6-20170321102551,0.5.6-20170321114011,232,1,2,1,3,1,TRUE
composer-playground,0.5.7-20170403153420,0.5.7-20170403223455,281,1,3,0,3,3,TRUE
composer-playground,0.7.2-20170509150231,0.7.2-20170509215115,416,1,8,8,16,1,TRUE
composer-playground,0.4.4-20170221152406,0.4.4-20170221160317,6,2,225,204,429,6,TRUE
composer-playground,0.7.2-20170510103407,0.7.2-20170510135245,421,1,605,379,984,22,TRUE
composer-playground,0.5.7-20170406120956,0.5.7-20170406193752,293,1,1,0,1,1,TRUE
composer-playground,0.5.8-20170407163302,0.5.8-20170408203136,302,1,2,2,4,1,TRUE
composer-playground,0.7.3-20170524154239,0.7.3-20170524214122,473,1,373,3,376,7,TRUE
composer-playground,0.5.6-20170320102223,0.5.6-20170320125116,226,1,73,1,74,2,TRUE
composer-playground,0.7.1,0.7.2-20170505194144,401,1,88,88,176,24,TRUE
composer-playground,0.7.1-20170502151544,0.7.1-20170502172623,380,1,13,13,26,9,TRUE
composer-playground,0.5.7-20170406105358,0.5.7-20170406120956,292,1,1669,516,2185,56,TRUE
composer-playground,0.5.11-20170420063536,0.5.11-20170420145917,333,1,185,8,193,30,TRUE
composer-playground,0.7.2-20170506084056,0.7.2-20170506190618,404,1,87,10,97,4,TRUE
oneyun-sipclient-desktop-js-sdk,0.1.0,0.1.3,1,13,165,106,271,18,FALSE
oneyun-sipclient-desktop-js-sdk,0.1.3,0.1.4,2,4,177,79,256,18,FALSE
oneyun-sipclient-desktop-js-sdk,0.1.4,0.1.5,3,3,4,4,8,4,FALSE
oneyun-sipclient-desktop-js-sdk,0.1.3,0.1.4,2,4,177,79,256,18,TRUE
boilerplate-server,0.2.7,0.3.0,10,1,1,1,2,1,FALSE
boilerplate-server,0.2.6,0.2.7,9,1,1,1,2,1,FALSE
boilerplate-server,0.2.5,0.2.6,8,1,1,1,2,1,FALSE
boilerplate-server,0.2.4,0.2.5,7,1,1,1,2,1,FALSE
boilerplate-server,0.2.3,0.2.4,6,1,1,1,2,1,FALSE
boilerplate-server,0.2.2,0.2.3,5,1,1,1,2,1,FALSE
boilerplate-server,0.2.1,0.2.2,4,1,1,1,2,1,FALSE
boilerplate-server,0.2.0,0.2.1,3,1,1,1,2,1,FALSE
boilerplate-server,0.1.0,0.1.1,1,1,1,1,2,1,FALSE
boilerplate-server,0.6.0,0.6.1,21,1,1,1,2,1,FALSE
boilerplate-server,0.1.1,0.2.0,2,1,1,1,2,1,FALSE
boilerplate-server,0.10.1,0.11.0,36,3,567,391,958,19,FALSE
boilerplate-server,0.10.0,0.10.1,35,5,159,199,358,19,FALSE
boilerplate-server,0.11.8,0.12.0,45,3,513,529,1042,45,FALSE
boilerplate-server,0.11.4,0.11.5,41,2,2,1,3,2,FALSE
boilerplate-server,0.11.5,0.11.6,42,2,13,1,14,3,FALSE
boilerplate-server,0.6.1,0.7.0,22,1,1,1,2,1,FALSE
boilerplate-server,0.11.7,0.11.8,44,2,5,2,7,2,FALSE
boilerplate-server,0.11.0,0.11.1,37,2,1,12,13,2,FALSE
boilerplate-server,0.11.1,0.11.2,38,2,111,112,223,7,FALSE
boilerplate-server,0.7.0,0.8.0,23,1,1,1,2,1,FALSE
boilerplate-server,0.11.3,0.11.4,40,2,1,9,10,3,FALSE
boilerplate-server,0.12.3,0.12.4,49,2,3,11,14,2,FALSE
boilerplate-server,0.12.2,0.12.3,48,2,2,2,4,2,FALSE
boilerplate-server,0.12.1,0.12.2,47,2,10,10,20,6,FALSE
boilerplate-server,0.12.0,0.12.1,46,2,2,2,4,2,FALSE
boilerplate-server,0.5.4,0.5.5,18,1,1,1,2,1,FALSE
boilerplate-server,0.5.5,0.5.6,19,1,1,1,2,1,FALSE
boilerplate-server,0.5.6,0.6.0,20,1,1,1,2,1,FALSE
boilerplate-server,0.5.0,0.5.1,14,1,1,1,2,1,FALSE
boilerplate-server,0.5.1,0.5.2,15,1,1,1,2,1,FALSE
boilerplate-server,0.5.2,0.5.3,16,1,1,1,2,1,FALSE
boilerplate-server,0.5.3,0.5.4,17,1,1,1,2,1,FALSE
boilerplate-server,0.9.0,0.9.1,27,1,1,1,2,1,FALSE
boilerplate-server,0.9.1,0.9.3,28,1,1,1,2,1,FALSE
boilerplate-server,0.9.3,0.9.4,29,1,1,1,2,1,FALSE
boilerplate-server,0.9.4,0.9.5,30,1,1,1,2,1,FALSE
boilerplate-server,0.9.5,0.9.6,31,3,41,43,84,33,FALSE
boilerplate-server,0.9.6,0.9.7,32,9,23,6986,7009,98,FALSE
boilerplate-server,0.9.7,0.9.9,33,7,13,9,22,9,FALSE
boilerplate-server,0.9.9,0.10.0,34,2,28,50,78,6,FALSE
boilerplate-server,0.8.1,0.8.2,25,1,1,1,2,1,FALSE
boilerplate-server,0.8.0,0.8.1,24,1,1,1,2,1,FALSE
boilerplate-server,0.8.2,0.9.0,26,1,1,1,2,1,FALSE
boilerplate-server,0.4.1,0.5.0,13,1,1,1,2,1,FALSE
boilerplate-server,0.4.0,0.4.1,12,1,1,1,2,1,FALSE
boilerplate-server,0.11.2,0.11.3,39,2,26,1,27,2,FALSE
boilerplate-server,0.11.6,0.11.7,43,2,2,9,11,3,FALSE
boilerplate-server,0.3.0,0.4.0,11,1,1,1,2,1,FALSE
boilerplate-server,0.12.1,0.12.2,47,2,10,10,20,6,TRUE
sl-api,1.0.0,1.0.1,2,2,3,7,10,2,FALSE
sl-api,1.0.1,1.0.2,3,2,9,5,14,2,FALSE
sl-api,1.0.2,1.0.3,4,5,11,9,20,5,FALSE
sl-api,0.0.1-0,1.0.0,1,19,5320,135,5455,34,FALSE
sl-api,1.0.2,1.0.3,4,5,11,9,20,5,TRUE
leitstand-github,0.1.0,0.1.1,1,8,40,71,111,10,FALSE
leitstand-github,0.1.1,0.1.2,2,5,17,5,22,5,FALSE
leitstand-github,0.1.2,0.1.3,3,2,2,2,4,2,FALSE
leitstand-github,0.1.3,0.1.4,4,3,8,89,97,5,FALSE
leitstand-github,0.1.2,0.1.3,3,2,2,2,4,2,TRUE
doctrine,1.4.0,1.5.0,28,3,114,3,117,5,FALSE
doctrine,1.1.0,1.2.0,22,10,190,752,942,16,FALSE
doctrine,1.0.0,1.1.0,21,6,333,301,634,19,FALSE
doctrine,0.6.3,0.6.4,16,3,5,13,18,4,FALSE
doctrine,0.7.2,1.0.0,20,3,44,2,46,6,FALSE
doctrine,1.5.0,2.0.0,29,4,195,50,245,6,FALSE
doctrine,0.7.0,0.7.1,18,12,646,49,695,24,FALSE
doctrine,0.6.4,0.7.0,17,17,392,182,574,31,FALSE
doctrine,1.3.0,1.4.0,27,3,258,5,263,4,FALSE
doctrine,1.2.2,1.2.3,25,4,16,13,29,6,FALSE
doctrine,1.2.3,1.3.0,26,3,97,3,100,5,FALSE
doctrine,1.2.0,1.2.1,23,5,53,1,54,7,FALSE
doctrine,1.2.1,1.2.2,24,10,354,384,738,39,FALSE
doctrine,0.7.1,0.7.2,19,3,23,12,35,5,FALSE
doctrine,0.6.2,0.6.3,15,22,1623,1327,2950,41,FALSE
doctrine,0.2.0,0.3.0,7,10,461,99,560,14,FALSE
doctrine,0.1.0,0.2.0,6,14,396,132,528,24,FALSE
doctrine,0.0.5,0.1.0,5,6,80,6,86,12,FALSE
doctrine,0.0.4,0.0.5,4,3,85,13,98,5,FALSE
doctrine,0.0.1,0.0.2,1,7,107,65,172,12,FALSE
doctrine,0.0.3,0.0.4,3,22,3147,559,3706,44,FALSE
doctrine,0.0.2,0.0.3,2,6,130,147,277,13,FALSE
doctrine,0.6.0,0.6.1,13,1,1,1,2,1,FALSE
doctrine,0.4.0,0.5.0,9,60,2169,146,2315,110,FALSE
doctrine,0.5.0,0.5.1,10,6,119,25,144,11,FALSE
doctrine,0.5.1,0.5.2,11,17,1116,154,1270,31,FALSE
doctrine,0.5.2,0.6.0,12,11,156,52,208,20,FALSE
doctrine,0.3.0,0.4.0,8,36,841,247,1088,55,FALSE
doctrine,0.0.5,0.1.0,5,6,80,6,86,12,TRUE
doctrine,0.6.1,0.6.2,14,18,677,307,984,31,TRUE
doctrine,0.7.1,0.7.2,19,3,23,12,35,5,TRUE
oauth2-oidc,0.2.7,0.2.8,40,2,2,2,4,2,FALSE
oauth2-oidc,0.1.9,0.1.10,12,4,181,27,208,9,FALSE
oauth2-oidc,0.2.5,0.2.6,38,2,16,1,17,3,FALSE
oauth2-oidc,0.2.4,0.2.5,37,2,8,1,9,2,FALSE
oauth2-oidc,0.2.3,0.2.4,36,2,27,12,39,3,FALSE
oauth2-oidc,0.2.2,0.2.3,35,2,2,12,14,3,FALSE
oauth2-oidc,0.2.1,0.2.2,34,2,21,27,48,3,FALSE
oauth2-oidc,0.2.0,0.2.1,33,2,2,2,4,2,FALSE
oauth2-oidc,0.1.0,0.1.1,3,3,26,12,38,4,FALSE
oauth2-oidc,0.1.1,0.1.2,4,2,5,2,7,2,FALSE
oauth2-oidc,0.1.2,0.1.3,5,2,6,2,8,2,FALSE
oauth2-oidc,0.1.3,0.1.4,6,5,14,12,26,6,FALSE
oauth2-oidc,0.1.4,0.1.5,7,2,8,1,9,2,FALSE
oauth2-oidc,0.1.5,0.1.6,8,2,95,2,97,4,FALSE
oauth2-oidc,0.1.6,0.1.7,9,8,161,33,194,10,FALSE
oauth2-oidc,0.1.7,0.1.8,10,2,6,2,8,2,FALSE
oauth2-oidc,0.1.29,0.1.30,31,2,3,4,7,2,FALSE
oauth2-oidc,0.1.28,0.1.29,30,2,2,2,4,2,FALSE
oauth2-oidc,0.0.1,0.0.2,1,2,10,2,12,2,FALSE
oauth2-oidc,0.0.2,0.1.0,2,11,106,14,120,14,FALSE
oauth2-oidc,0.1.23,0.1.24,25,2,4,2,6,2,FALSE
oauth2-oidc,0.1.21,0.1.23,24,4,54,14,68,8,FALSE
oauth2-oidc,0.1.20,0.1.21,23,2,6,2,8,3,FALSE
oauth2-oidc,0.1.27,0.1.28,29,2,43,2,45,4,FALSE
oauth2-oidc,0.1.26,0.1.27,28,2,5,2,7,3,FALSE
oauth2-oidc,0.1.25,0.1.26,27,4,5,5,10,4,FALSE
oauth2-oidc,0.1.24,0.1.25,26,2,7,2,9,2,FALSE
oauth2-oidc,0.1.15,0.1.16,18,2,3,2,5,2,FALSE
oauth2-oidc,0.2.8,0.2.9,41,2,2,2,4,2,FALSE
oauth2-oidc,0.1.12,0.1.13,15,2,8,4,12,3,FALSE
oauth2-oidc,0.1.13,0.1.14,16,2,54,6,60,3,FALSE
oauth2-oidc,0.1.10,0.1.11,13,2,15,6,21,3,FALSE
oauth2-oidc,0.1.11,0.1.12,14,3,7,7,14,4,FALSE
oauth2-oidc,0.1.16,0.1.17,19,2,46,32,78,3,FALSE
oauth2-oidc,0.1.17,0.1.18,20,2,17,15,32,3,FALSE
oauth2-oidc,0.1.14,0.1.15,17,3,124,13,137,5,FALSE
oauth2-oidc,0.2.6,0.2.7,39,2,6,4,10,2,FALSE
oauth2-oidc,0.1.18,0.1.19,21,2,34,6,40,3,FALSE
oauth2-oidc,0.1.19,0.1.20,22,2,38,3,41,3,FALSE
oauth2-oidc,0.1.30,0.2.0,32,3,437,453,890,21,FALSE
oauth2-oidc,0.1.8,0.1.9,11,2,3,3,6,2,FALSE
oauth2-oidc,0.1.10,0.1.11,13,2,15,6,21,3,TRUE
oauth2-oidc,0.2.7,0.2.8,40,2,2,2,4,2,TRUE
oauth2-oidc,0.1.14,0.1.15,17,3,124,13,137,5,TRUE
oauth2-oidc,0.1.4,0.1.5,7,2,8,1,9,2,TRUE
oauth2-oidc,0.1.30,0.2.0,32,3,437,453,890,21,TRUE
oauth2-oidc,0.1.5,0.1.6,8,2,95,2,97,4,TRUE
oauth2-oidc,0.2.6,0.2.7,39,2,6,4,10,2,TRUE
react-sparklines,1.0.0,1.0.1,12,2,37,3,40,3,FALSE
react-sparklines,1.0.1,1.0.2,13,1,10,1,11,1,FALSE
react-sparklines,0.8.1,0.8.3,10,2,111,96,207,13,FALSE
react-sparklines,0.8.0,0.8.1,9,1,1670,1028,2698,4,FALSE
react-sparklines,0.8.3,1.0.0,11,9,1135,403,1538,22,FALSE
react-sparklines,0.7.1,0.8.0,8,5,237,157,394,25,FALSE
react-sparklines,0.4.1,0.5.0,4,3,128,45,173,16,FALSE
react-sparklines,0.2.0,0.4.0,2,2,159,95,254,9,FALSE
react-sparklines,0.1.0,0.2.0,1,1,41,9,50,3,FALSE
react-sparklines,0.4.0,0.4.1,3,1,41,32,73,6,FALSE
react-sparklines,0.5.0,0.5.1,5,1,2,2,4,2,FALSE
react-sparklines,0.5.1,0.5.2,6,1,9,8,17,3,FALSE
react-sparklines,0.5.2,0.7.1,7,7,398,234,632,34,FALSE
react-sparklines,1.4.0,1.4.1,22,3,3,1,4,3,FALSE
react-sparklines,1.4.1,1.4.2,23,2,0,2,2,2,FALSE
react-sparklines,1.4.2,1.5.0,24,21,1717,84,1801,39,FALSE
react-sparklines,1.5.1,1.5.2,26,19,350,67,417,35,FALSE
react-sparklines,1.5.0,1.5.1,25,2,848,888,1736,12,FALSE
react-sparklines,1.5.2,1.6.0,27,7,1288,428,1716,54,FALSE
react-sparklines,1.3.0,1.4.0,21,4,26,9,35,5,FALSE
react-sparklines,1.2.2,1.3.0,20,2,9,2,11,4,FALSE
react-sparklines,1.1.1,1.1.2,17,2,8,8,16,2,FALSE
react-sparklines,1.1.0,1.1.1,16,1,30,29,59,3,FALSE
react-sparklines,1.1.2,1.2.0,18,8,41,23,64,9,FALSE
react-sparklines,1.0.2,1.0.3,14,10,68989,130275,199264,44,FALSE
react-sparklines,1.0.3,1.1.0,15,6,91,37,128,16,FALSE
react-sparklines,1.2.0,1.2.2,19,13,523,2304,2827,40,FALSE
react-sparklines,0.5.2,0.7.1,7,7,398,234,632,34,TRUE
react-sparklines,1.4.0,1.4.1,22,3,3,1,4,3,TRUE
react-sparklines,0.8.3,1.0.0,11,9,1135,403,1538,22,TRUE
logiled,0.0.1,0.0.2,1,7,376,306,682,18,FALSE
logiled,0.0.3,1.0.0,3,7,643,295,938,13,FALSE
logiled,0.0.2,0.0.3,2,2,9,1,10,2,FALSE
logiled,0.0.1,0.0.2,1,7,376,306,682,18,TRUE
logiled,0.0.3,1.0.0,3,7,643,295,938,13,TRUE
babel-plugin-partial-application,1.1.0,1.2.0,7,13,123738,26015,149753,53,FALSE
babel-plugin-partial-application,1.0.0,1.1.0,6,5,128,6,134,10,FALSE
babel-plugin-partial-application,1.0.0-alpha.1,1.0.0-alpha.2,1,4,28,7,35,5,FALSE
babel-plugin-partial-application,1.0.0-alpha.3,1.0.0-alpha.4,3,16,272,48,320,28,FALSE
babel-plugin-partial-application,1.0.0-alpha.2,1.0.0-alpha.3,2,2,12,24,36,5,FALSE
babel-plugin-partial-application,1.0.0-alpha.5,1.0.0,5,8,137,82,219,9,FALSE
babel-plugin-partial-application,1.0.0-alpha.4,1.0.0-alpha.5,4,8,125,33,158,15,FALSE
babel-plugin-partial-application,1.3.0,1.4.0,9,7,54,19,73,21,FALSE
babel-plugin-partial-application,1.2.0,1.3.0,8,11,381,395,776,14,FALSE
babel-plugin-partial-application,1.0.0-alpha.4,1.0.0-alpha.5,4,8,125,33,158,15,TRUE
babel-plugin-partial-application,1.0.0-alpha.5,1.0.0,5,8,137,82,219,9,TRUE
tatari,1.0.0,1.0.1,1,1,77,12,89,7,FALSE
tatari,1.0.1,1.0.2,2,1,77,12,89,7,FALSE
tatari,1.0.2,1.0.3,3,1,77,12,89,7,FALSE
tatari,1.0.3,1.0.4,4,1,77,12,89,7,FALSE
tatari,1.0.4,1.1.0,5,1,77,12,89,7,FALSE
tatari,1.1.0,1.1.1,6,1,77,12,89,7,FALSE
tatari,1.1.3,1.1.4,9,1,77,12,89,7,FALSE
tatari,1.1.2,1.1.3,8,1,77,12,89,7,FALSE
tatari,1.1.6,1.1.7,12,1,77,12,89,7,FALSE
tatari,1.1.1,1.1.2,7,1,77,12,89,7,FALSE
tatari,1.1.5,1.1.6,11,1,77,12,89,7,FALSE
tatari,1.1.4,1.1.5,10,1,77,12,89,7,FALSE
tatari,2.0.5,2.1.0,19,14,27543,20111,47654,84,FALSE
tatari,2.2.5,2.2.6,38,8,2555,3074,5629,77,FALSE
tatari,2.2.4,2.2.5,37,5,245,103,348,48,FALSE
tatari,2.1.8,2.1.9,28,4,37,2655,2692,13,FALSE
tatari,2.0.4,2.0.5,18,1,12,12,24,11,FALSE
tatari,2.2.1,2.2.2,34,2,13,20,33,6,FALSE
tatari,2.2.0,2.2.1,33,2,7,6,13,4,FALSE
tatari,2.2.3,2.2.4,36,2,68,22,90,12,FALSE
tatari,2.2.2,2.2.3,35,2,13,12,25,3,FALSE
tatari,2.1.2,2.1.3,22,2,11,6,17,7,FALSE
tatari,2.0.3,2.0.4,17,1,12,12,24,11,FALSE
tatari,2.1.0,2.1.1,20,1,13,8,21,4,FALSE
tatari,2.1.1,2.1.2,21,3,46,21,67,12,FALSE
tatari,2.1.6,2.1.7,26,2,24,22,46,11,FALSE
tatari,2.1.7,2.1.8,27,1,5,5,10,4,FALSE
tatari,2.1.4,2.1.5,24,2,14,11,25,5,FALSE
tatari,2.0.2,2.0.3,16,1,12,12,24,11,FALSE
tatari,2.1.3,2.1.4,23,3,51,32,83,13,FALSE
tatari,1.1.7,2.0.0,13,58,106469,50946,157415,1006,FALSE
tatari,2.1.5,2.1.6,25,2,22,12,34,9,FALSE
tatari,2.0.1,2.0.2,15,17,8877,5662,14539,106,FALSE
tatari,2.3.0,2.3.1,40,1,9,6,15,4,FALSE
tatari,2.3.1,2.3.2,41,2,43,33,76,9,FALSE
tatari,2.0.0,2.0.1,14,2,3539,1053,4592,29,FALSE
tatari,2.2.6,2.3.0,39,3,4435,98,4533,24,FALSE
tatari,2.1.10,2.1.11,30,1,11,3,14,4,FALSE
tatari,2.1.11,2.1.12,31,1,77,12,89,7,FALSE
tatari,2.1.12,2.2.0,32,4,110,62,172,20,FALSE
tatari,2.1.9,2.1.10,29,1,25,16,41,5,FALSE
tatari,2.0.1,2.0.2,15,17,8877,5662,14539,106,TRUE
tatari,1.1.5,1.1.6,11,1,77,12,89,7,TRUE
tatari,2.0.5,2.1.0,19,14,27543,20111,47654,84,TRUE
tatari,2.2.4,2.2.5,37,5,245,103,348,48,TRUE
tatari,2.1.8,2.1.9,28,4,37,2655,2692,13,TRUE
tatari,2.2.1,2.2.2,34,2,13,20,33,6,TRUE
tatari,1.1.4,1.1.5,10,1,77,12,89,7,TRUE
parsec-mycos-antd,1.0.3,1.0.4,1,27,14797,12996,27793,837,FALSE
parsec-mycos-antd,1.0.3,1.0.4,1,27,14797,12996,27793,837,TRUE
victory-core,6.1.0,6.1.1,46,5,79,69,148,8,FALSE
victory-core,6.1.1,7.0.0,47,9,36,36,72,15,FALSE
victory-core,9.1.1,9.2.0,58,9,258,53,311,18,FALSE
victory-core,9.1.0,9.1.1,57,7,68,92,160,11,TRUE
victory-core,13.0.4,14.0.0,77,20,821,342,1163,46,FALSE
victory-core,13.0.2,13.0.3,75,17,309,190,499,23,FALSE
victory-core,13.0.3,13.0.4,76,37,706,410,1116,69,FALSE
victory-core,13.0.0,13.0.1,73,4,15,10,25,4,FALSE
victory-core,13.0.1,13.0.2,74,30,1040,369,1409,45,FALSE
victory-core,4.0.0,4.1.0,23,14,1374,728,2102,23,FALSE
victory-core,15.0.0,15.0.1,88,1,1,1,2,1,FALSE
victory-core,15.0.1,15.1.0,89,28,863,600,1463,144,FALSE
victory-core,11.0.0,11.0.1,68,6,6,3,9,10,FALSE
victory-core,11.0.1,12.0.0,69,17,4585,15014,19599,138,FALSE
victory-core,4.5.0,4.5.1,33,11,2303,1850,4153,34,FALSE
victory-core,4.5.1,4.6.0,34,32,1078,738,1816,50,FALSE
victory-core,5.0.2,5.1.0,39,4,610,592,1202,7,FALSE
victory-core,5.0.0,5.0.1,37,5,16,12,28,8,FALSE
victory-core,5.0.1,5.0.2,38,5,12,8,20,6,FALSE
victory-core,7.0.1,7.0.2,49,11,356,99,455,13,FALSE
victory-core,4.3.0,4.4.0,29,18,766,484,1250,36,FALSE
victory-core,3.0.0,3.2.0,21,13,3087,3179,6266,17,FALSE
victory-core,9.0.0,9.0.1,53,5,20,29,49,7,FALSE
victory-core,9.0.1,9.0.2,54,20,273,228,501,58,FALSE
victory-core,9.0.2,9.0.3,55,7,25,24,49,9,FALSE
victory-core,9.0.3,9.1.0,56,11,52,35154,35206,22,FALSE
victory-core,14.1.0,14.1.1,86,7,95,11,106,9,FALSE
victory-core,14.1.1,15.0.0,87,21,1335,1211,2546,165,FALSE
victory-core,4.1.0,4.1.1,24,6,126,529,655,7,FALSE
victory-core,4.1.1,4.2.0,25,5,2577,2544,5121,18,FALSE
victory-core,15.1.0,15.2.0,90,23,1195,562,1757,91,FALSE
victory-core,7.0.2,8.0.0,50,43,18301,10778,29079,163,TRUE
victory-core,10.0.1,10.0.2,65,5,54,13,67,8,FALSE
victory-core,10.0.0,10.0.1,64,3,17,17,34,3,FALSE
victory-core,10.0.3,11.0.0,67,16,838,222,1060,72,FALSE
victory-core,10.0.2,10.0.3,66,4,121,59,180,30,FALSE
victory-core,6.0.2,6.1.0,45,14,2441,468,2909,58,FALSE
victory-core,9.2.4,10.0.0,63,10,227,419,646,19,FALSE
victory-core,9.2.2,9.2.3,61,14,193,396,589,23,FALSE
victory-core,9.2.3,9.2.4,62,4,45,19,64,4,FALSE
victory-core,9.2.0,9.2.1,59,4,7,7,14,4,FALSE
victory-core,9.2.1,9.2.2,60,6,70,40,110,8,FALSE
victory-core,2.0.1,2.1.0,18,9,147,77,224,13,FALSE
victory-core,2.0.0,2.0.1,17,9,2479,4121,6600,46,FALSE
victory-core,14.0.1,14.0.2,79,6,57,13,70,7,FALSE
victory-core,14.0.0,14.0.1,78,5,35,35,70,9,FALSE
victory-core,14.0.3,14.0.4,81,7,146,65,211,12,FALSE
victory-core,14.0.2,14.0.3,80,15,489,189,678,31,FALSE
victory-core,14.0.5,14.0.6,83,12,253,86,339,23,FALSE
victory-core,14.0.4,14.0.5,82,15,383,198,581,46,FALSE
victory-core,14.0.7,14.1.0,85,12,127,129,256,17,FALSE
victory-core,14.0.6,14.0.7,84,19,494,234,728,32,FALSE
victory-core,5.1.2,6.0.0,42,36,10342,2941,13283,109,FALSE
victory-core,1.3.2,1.4.0,12,30,1635,814,2449,65,FALSE
victory-core,1.3.1,1.3.2,11,7,51,22,73,8,FALSE
victory-core,1.3.0,1.3.1,10,4,80,68,148,5,FALSE
victory-core,8.0.1,9.0.0,52,14,8360,9321,17681,62,FALSE
victory-core,8.0.0,8.0.1,51,5,36,29,65,6,FALSE
victory-core,12.0.2,13.0.0,72,46,1605,733,2338,71,FALSE
victory-core,12.0.1,12.0.2,71,4,15,9,24,6,FALSE
victory-core,12.0.0,12.0.1,70,5,52,11,63,10,FALSE
victory-core,1.1.1,1.2.0,6,15,8342,4735,13077,91,FALSE
victory-core,1.1.0,1.1.1,5,7,135,190,325,16,FALSE
victory-core,6.0.1,6.0.2,44,5,17,10,27,6,FALSE
victory-core,6.0.0,6.0.1,43,5,35,16,51,6,FALSE
victory-core,5.1.1,5.1.2,41,5,12,11,23,6,FALSE
victory-core,5.1.0,5.1.1,40,5,107,17,124,8,FALSE
victory-core,2.1.0,2.1.1,19,4,23,19,42,7,FALSE
victory-core,2.1.1,3.0.0,20,12,2326,501,2827,24,FALSE
victory-core,0.0.1,0.0.2,1,6,33,32,65,11,FALSE
victory-core,0.0.2,0.0.3,2,6,194,3532,3726,11,FALSE
victory-core,1.4.0,1.4.1,13,4,11,11,22,5,FALSE
victory-core,1.4.1,1.4.2,14,4,32,15,47,5,FALSE
victory-core,1.4.2,1.4.3,15,4,19,19,38,7,FALSE
victory-core,1.4.3,2.0.0,16,10,278,345,623,13,FALSE
victory-core,7.0.0,7.0.1,48,11,7048,824,7872,54,FALSE
victory-core,1.2.2,1.3.0,9,25,1319,402,1721,52,FALSE
victory-core,1.2.0,1.2.1,7,10,4241,4233,8474,13,FALSE
victory-core,1.2.1,1.2.2,8,6,8263,8261,16524,10,FALSE
victory-core,4.6.1,5.0.0,36,9,3589,2635,6224,25,FALSE
victory-core,4.6.0,4.6.1,35,8,4023,2725,6748,35,FALSE
victory-core,4.4.1,4.4.2,31,17,217,45,262,32,FALSE
victory-core,4.4.0,4.4.1,30,8,490,373,863,15,FALSE
victory-core,4.4.2,4.5.0,32,6,368,668,1036,17,TRUE
victory-core,4.2.2,4.3.0,28,19,4567,4666,9233,31,FALSE
victory-core,4.2.1,4.2.2,27,8,18,12,30,9,FALSE
victory-core,4.2.0,4.2.1,26,13,72,47,119,15,FALSE
victory-core,3.2.0,4.0.0,22,9,2979,3177,6156,16,FALSE
victory-core,1.0.0,1.1.0,4,7,92,9,101,12,FALSE
victory-core,9.1.0,9.1.1,57,7,68,92,160,11,FALSE
victory-core,0.0.3,1.0.0,3,13,301,190,491,23,FALSE
victory-core,14.0.3,14.0.4,81,7,146,65,211,12,TRUE
victory-core,7.0.2,8.0.0,50,43,18301,10778,29079,163,FALSE
victory-core,4.4.2,4.5.0,32,6,368,668,1036,17,FALSE
victory-core,4.2.2,4.3.0,28,19,4567,4666,9233,31,TRUE
victory-core,9.0.1,9.0.2,54,20,273,228,501,58,TRUE
victory-core,4.4.1,4.4.2,31,17,217,45,262,32,TRUE
victory-core,15.0.1,15.1.0,89,28,863,600,1463,144,TRUE
victory-core,14.0.6,14.0.7,84,19,494,234,728,32,TRUE
acceptedlanguagesui,0.0.5,0.0.7,5,19,252,101,353,32,FALSE
acceptedlanguagesui,0.0.4,0.0.5,4,6,12,7,19,9,FALSE
acceptedlanguagesui,0.0.7,0.0.8,6,3,9,9,18,5,FALSE
acceptedlanguagesui,0.0.1,0.0.2,1,3,185,58,243,9,FALSE
acceptedlanguagesui,0.0.3,0.0.4,3,3,7,7,14,4,FALSE
acceptedlanguagesui,0.0.2,0.0.3,2,2,115,40,155,9,FALSE
acceptedlanguagesui,0.0.5,0.0.7,5,19,252,101,353,32,TRUE
acceptedlanguagesui,0.0.7,0.0.8,6,3,9,9,18,5,TRUE
acceptedlanguagesui,0.0.2,0.0.3,2,2,115,40,155,9,TRUE
ember-cli-rollup,0.1.1,0.2.4,1,8,396,3409,3805,22,FALSE
ember-cli-rollup,0.2.4,0.2.5,2,1,4,2,6,3,FALSE
ember-cli-rollup,0.1.1,0.2.4,1,8,396,3409,3805,22,TRUE
ember-cli-rollup,0.2.4,0.2.5,2,1,4,2,6,3,TRUE
mjml-image-swapper,1.0.4,1.0.5,4,2,2,3,5,2,FALSE
mjml-image-swapper,1.0.5,1.0.6,5,2,17,29,46,4,FALSE
mjml-image-swapper,1.0.6,1.1.0,6,2,315,2,317,4,FALSE
mjml-image-swapper,1.0.1,1.0.2,1,2,331,2,333,4,FALSE
mjml-image-swapper,1.0.2,1.0.3,2,2,1,2,3,2,FALSE
mjml-image-swapper,1.0.3,1.0.4,3,2,3,3,6,3,FALSE
mjml-image-swapper,1.1.0,1.1.1,7,2,23,164,187,3,FALSE
mjml-image-swapper,1.1.1,1.2.0,8,2,192,16,208,5,FALSE
mjml-image-swapper,1.0.5,1.0.6,5,2,17,29,46,4,TRUE
ringcentral-widget,0.3.8,0.3.9,69,2,18,18,36,4,FALSE
ringcentral-widget,0.3.9,0.3.10,70,3,430,304,734,37,FALSE
ringcentral-widget,0.3.2,0.3.3,63,1,16,4,20,1,FALSE
ringcentral-widget,0.3.3,0.3.4,64,1,2,1,3,1,FALSE
ringcentral-widget,0.3.0,0.3.1,61,2,8,8,16,4,FALSE
ringcentral-widget,0.3.1,0.3.2,62,1,70,4,74,8,FALSE
ringcentral-widget,0.3.6,0.3.7,67,3,17133,15109,32242,167,FALSE
ringcentral-widget,0.3.7,0.3.8,68,2,22,18,40,8,FALSE
ringcentral-widget,0.3.4,0.3.5,65,1,52,17,69,13,FALSE
ringcentral-widget,0.3.5,0.3.6,66,1,48,19,67,8,FALSE
ringcentral-widget,0.3.18,0.3.19,79,1,1839,84,1923,56,FALSE
ringcentral-widget,0.3.19,0.3.20,80,3,82,34,116,12,FALSE
ringcentral-widget,0.3.14,0.3.15,75,2,2,0,2,2,FALSE
ringcentral-widget,0.3.15,0.3.16,76,3,159,171,330,9,FALSE
ringcentral-widget,0.3.16,0.3.17,77,1,13,11,24,10,FALSE
ringcentral-widget,0.3.17,0.3.18,78,1,96,21,117,9,FALSE
ringcentral-widget,0.3.10,0.3.11,71,2,101,79,180,7,FALSE
ringcentral-widget,0.3.11,0.3.12,72,2,32,8,40,8,FALSE
ringcentral-widget,0.3.12,0.3.13,73,2,8,4,12,4,FALSE
ringcentral-widget,0.3.13,0.3.14,74,3,82,30,112,17,FALSE
ringcentral-widget,0.2.44,0.2.45,49,2,14,14,28,4,FALSE
ringcentral-widget,0.2.45,0.2.46,50,1,23,8,31,5,FALSE
ringcentral-widget,0.2.46,0.2.47,51,1,38,16,54,11,FALSE
ringcentral-widget,0.2.47,0.2.48,52,5,146,76,222,34,FALSE
ringcentral-widget,0.2.40,0.2.41,45,6,771,177,948,33,FALSE
ringcentral-widget,0.2.41,0.2.42,46,2,8,4,12,2,FALSE
ringcentral-widget,0.2.42,0.2.43,47,3,10,7,17,5,FALSE
ringcentral-widget,0.2.43,0.2.44,48,2,14,8,22,2,FALSE
ringcentral-widget,0.2.48,0.2.49,53,2,40,11,51,3,FALSE
ringcentral-widget,0.2.49,0.2.50,54,5,217,100,317,46,FALSE
ringcentral-widget,0.2.26,0.2.27,31,3,291,57,348,21,FALSE
ringcentral-widget,0.2.27,0.2.28,32,2,103,21,124,19,FALSE
ringcentral-widget,0.2.24,0.2.25,29,4,2382,65,2447,103,FALSE
ringcentral-widget,0.2.25,0.2.26,30,1,23,7,30,1,FALSE
ringcentral-widget,0.2.22,0.2.23,27,3,15123,11,15134,7,FALSE
ringcentral-widget,0.2.23,0.2.24,28,5,44,42,86,13,FALSE
ringcentral-widget,0.2.20,0.2.21,25,2,224,107,331,14,FALSE
ringcentral-widget,0.2.21,0.2.22,26,3,828,33,861,106,FALSE
ringcentral-widget,0.2.28,0.2.29,33,2,175,48,223,16,FALSE
ringcentral-widget,0.2.29,0.2.30,34,2,19,11,30,8,FALSE
ringcentral-widget,0.2.53,0.2.54,58,1,617,81,698,29,FALSE
ringcentral-widget,0.2.52,0.2.53,57,2,2,2,4,2,FALSE
ringcentral-widget,0.2.51,0.2.52,56,2,18,116,134,6,FALSE
ringcentral-widget,0.2.50,0.2.51,55,1,50,5,55,3,FALSE
ringcentral-widget,0.2.55,0.3.0,60,3,1700,1080,2780,70,FALSE
ringcentral-widget,0.2.54,0.2.55,59,4,1165,627,1792,42,FALSE
ringcentral-widget,0.2.35,0.2.36,40,2,287,6,293,8,FALSE
ringcentral-widget,0.2.34,0.2.35,39,1,10,3,13,3,FALSE
ringcentral-widget,0.2.37,0.2.38,42,4,429,1260,1689,35,FALSE
ringcentral-widget,0.2.36,0.2.37,41,1,73,51,124,2,FALSE
ringcentral-widget,0.2.31,0.2.32,36,4,212,33,245,29,FALSE
ringcentral-widget,0.2.30,0.2.31,35,1,1,1,2,1,FALSE
ringcentral-widget,0.2.33,0.2.34,38,6,107,71,178,34,FALSE
ringcentral-widget,0.2.32,0.2.33,37,2,68,18,86,8,FALSE
ringcentral-widget,0.2.39,0.2.40,44,1,1,0,1,1,FALSE
ringcentral-widget,0.2.38,0.2.39,43,1,34,8,42,3,FALSE
ringcentral-widget,0.2.19,0.2.20,24,2,119,81,200,15,FALSE
ringcentral-widget,0.2.18,0.2.19,23,5,101,27,128,30,FALSE
ringcentral-widget,0.2.17,0.2.18,22,2,552,119,671,15,FALSE
ringcentral-widget,0.2.16,0.2.17,21,3,297,140,437,22,FALSE
ringcentral-widget,0.2.15,0.2.16,20,15,2055,306,2361,91,FALSE
ringcentral-widget,0.2.14,0.2.15-brand,17,103,24628,2853,27481,709,FALSE
ringcentral-widget,0.2.13,0.2.14,16,3,172,114,286,16,FALSE
ringcentral-widget,0.2.12,0.2.13,15,2,2,0,2,2,FALSE
ringcentral-widget,0.2.11,0.2.12,14,2,48,48,96,6,FALSE
ringcentral-widget,0.2.10,0.2.11,13,2,10,8,18,6,FALSE
ringcentral-widget,0.2.7,0.2.8,10,2,100,80,180,8,FALSE
ringcentral-widget,0.2.6,0.2.7,9,3,749,29,778,19,FALSE
ringcentral-widget,0.2.5,0.2.6,8,2,12,12,24,4,FALSE
ringcentral-widget,0.2.4,0.2.5,7,2,40,40,80,14,FALSE
ringcentral-widget,0.2.3,0.2.4,6,2,628,6238,6866,16,FALSE
ringcentral-widget,0.2.2,0.2.3,5,2,104,74,178,20,FALSE
ringcentral-widget,0.2.1,0.2.2,4,2,2,2,4,2,FALSE
ringcentral-widget,0.2.0,0.2.1,3,4,1906,14,1920,54,FALSE
ringcentral-widget,0.1.0,0.2.0,2,14,13061,543,13604,180,FALSE
ringcentral-widget,0.2.9,0.2.10,12,2,12,4,16,2,FALSE
ringcentral-widget,0.2.8,0.2.9,11,2,4,4,8,2,FALSE
ringcentral-widget,0.2.15-brand,0.2.15-brand-locale,18,66,24483,18046,42529,626,FALSE
ringcentral-widget,0.3.21,0.3.22,82,1,12,13,25,3,FALSE
ringcentral-widget,0.3.20,0.3.21,81,3,398,16,414,18,FALSE
ringcentral-widget,0.3.23,0.3.24,84,2,12,17,29,4,FALSE
ringcentral-widget,0.3.22,0.3.23,83,2,36,8,44,6,FALSE
ringcentral-widget,0.3.25,0.3.26,86,2,22,22,44,8,FALSE
ringcentral-widget,0.3.24,0.3.25,85,2,24,18,42,6,FALSE
ringcentral-widget,0.2.41,0.2.42,46,2,8,4,12,2,TRUE
ringcentral-widget,0.2.40,0.2.41,45,6,771,177,948,33,TRUE
ringcentral-widget,0.2.48,0.2.49,53,2,40,11,51,3,TRUE
ringcentral-widget,0.2.27,0.2.28,32,2,103,21,124,19,TRUE
ringcentral-widget,0.2.21,0.2.22,26,3,828,33,861,106,TRUE
ringcentral-widget,0.2.14,0.2.15-brand,17,103,24628,2853,27481,709,TRUE
ringcentral-widget,0.2.19,0.2.20,24,2,119,81,200,15,TRUE
ringcentral-widget,0.2.0,0.2.1,3,4,1906,14,1920,54,TRUE
ringcentral-widget,0.2.51,0.2.52,56,2,18,116,134,6,TRUE
ringcentral-widget,0.2.20,0.2.21,25,2,224,107,331,14,TRUE
ringcentral-widget,0.1.0,0.2.0,2,14,13061,543,13604,180,TRUE
ringcentral-widget,0.2.26,0.2.27,31,3,291,57,348,21,TRUE
ringcentral-widget,0.2.24,0.2.25,29,4,2382,65,2447,103,TRUE
ringcentral-widget,0.2.13,0.2.14,16,3,172,114,286,16,TRUE
ringcentral-widget,0.2.33,0.2.34,38,6,107,71,178,34,TRUE
ringcentral-widget,0.2.7,0.2.8,10,2,100,80,180,8,TRUE
ringcentral-widget,0.2.3,0.2.4,6,2,628,6238,6866,16,TRUE
ringcentral-widget,0.3.10,0.3.11,71,2,101,79,180,7,TRUE
ringcentral-widget,0.2.47,0.2.48,52,5,146,76,222,34,TRUE
ringcentral-widget,0.2.37,0.2.38,42,4,429,1260,1689,35,TRUE
ringcentral-widget,0.2.38,0.2.39,43,1,34,8,42,3,TRUE
ringcentral-widget,0.2.52,0.2.53,57,2,2,2,4,2,TRUE
ringcentral-widget,0.3.8,0.3.9,69,2,18,18,36,4,TRUE
ringcentral-widget,0.2.29,0.2.30,34,2,19,11,30,8,TRUE
ringcentral-widget,0.2.34,0.2.35,39,1,10,3,13,3,TRUE
ringcentral-widget,0.3.20,0.3.21,81,3,398,16,414,18,TRUE
apiai,4.0.1,4.0.2,23,3,6410,3,6413,113,TRUE
apiai,4.0.0,4.0.1,22,14,373,52,425,30,TRUE
apiai,4.0.1,4.0.2,23,3,6410,3,6413,113,FALSE
apiai,4.0.0,4.0.1,22,14,373,52,425,30,FALSE
di-ioc,1.8.0,1.8.2,11,9,15,27,42,9,FALSE
di-ioc,1.7.1,1.8.0,10,2,9,5,14,2,FALSE
di-ioc,1.7.0,1.7.1,9,2,10,10,20,2,FALSE
di-ioc,1.4.1,1.5.0,2,2,35,2,37,3,FALSE
di-ioc,1.5.1,1.5.2,4,3,13,2,15,3,FALSE
di-ioc,1.5.0,1.5.1,3,5,351,9,360,16,FALSE
di-ioc,1.5.3,1.6.0,6,3,27,2,29,4,FALSE
di-ioc,1.5.2,1.5.3,5,3,30,2,32,3,FALSE
di-ioc,1.6.0,1.6.1,7,3,4,4,8,4,FALSE
di-ioc,1.6.1,1.7.0,8,3,96,47,143,10,FALSE
di-ioc,1.4.0,1.4.1,1,3,380,12,392,17,FALSE
di-ioc,1.6.1,1.7.0,8,3,96,47,143,10,TRUE
ethconnector,0.0.15,0.0.16,15,1,2,2,4,1,FALSE
ethconnector,0.0.14,0.0.15,14,1,2,2,4,1,TRUE
ethconnector,0.0.17,0.0.18,17,1,2,2,4,1,FALSE
ethconnector,0.0.16,0.0.17,16,1,2,2,4,1,TRUE
ethconnector,0.0.11,0.0.12,11,1,6,3,9,2,FALSE
ethconnector,0.0.10,0.0.11,10,1,1,1,2,1,FALSE
ethconnector,0.0.13,0.0.14,13,1,5,4,9,2,TRUE
ethconnector,0.0.12,0.0.13,12,1,2,2,4,1,FALSE
ethconnector,0.0.19,0.0.20,19,1,8,4,12,2,FALSE
ethconnector,0.0.18,0.0.19,18,1,2,2,4,1,FALSE
ethconnector,0.0.5,0.0.6,5,1,2,2,4,1,TRUE
ethconnector,0.0.4,0.0.5,4,1,2,2,4,2,FALSE
ethconnector,0.0.7,0.0.8,7,1,9,4,13,2,FALSE
ethconnector,0.0.6,0.0.7,6,1,2,2,4,1,FALSE
ethconnector,0.0.3,0.0.4,3,1,2,2,4,1,FALSE
ethconnector,0.0.2,0.0.3,2,1,7,3,10,2,FALSE
ethconnector,0.0.9,0.0.10,9,1,3,2,5,2,FALSE
ethconnector,0.0.8,0.0.9,8,1,6,4,10,2,FALSE
ethconnector,0.0.20,0.0.21,20,1,1,1,2,1,FALSE
ethconnector,0.0.21,0.0.22,21,5,54,7,61,6,FALSE
ethconnector,0.0.22,0.0.23,22,1,2,1,3,2,FALSE
ethconnector,0.0.23,0.0.24,23,1,2,2,4,2,FALSE
ethconnector,0.0.24,0.0.25,24,2,64,21,85,3,FALSE
ethconnector,0.0.5,0.0.6,5,1,2,2,4,1,FALSE
ethconnector,0.0.14,0.0.15,14,1,2,2,4,1,FALSE
ethconnector,0.0.16,0.0.17,16,1,2,2,4,1,FALSE
ethconnector,0.0.13,0.0.14,13,1,5,4,9,2,FALSE
react-trello,1.11.3,1.11.4,17,2,15,12,27,4,FALSE
react-trello,1.11.2,1.11.3,16,6,454,420,874,19,FALSE
react-trello,1.14.0,1.15.0,24,1,865,712,1577,7,FALSE
react-trello,1.11.0,1.11.1,14,1,1,1,2,1,FALSE
react-trello,1.11.5,1.12.0,19,2,26476,3575,30051,21,FALSE
react-trello,1.15.1,1.16.0,26,1,111,538,649,9,FALSE
react-trello,1.15.0,1.15.1,25,4,5,5,10,4,FALSE
react-trello,1.16.0,1.17.0,27,5,202,68,270,12,FALSE
react-trello,1.11.4,1.11.5,18,1,256,242,498,4,FALSE
react-trello,1.11.1,1.11.2,15,3,1195,251,1446,4,FALSE
react-trello,1.10.0,1.11.0,13,3,111,81,192,12,FALSE
react-trello,1.8.1,1.9.0,11,4,254,23,277,17,FALSE
react-trello,1.13.1,1.14.0,23,1,116,60,176,7,FALSE
react-trello,1.13.0,1.13.1,22,2,7362,5460,12822,7,FALSE
react-trello,1.6.0,1.7.0,8,1,75,50,125,6,TRUE
react-trello,1.8.0,1.8.1,10,3,3,0,3,3,FALSE
react-trello,1.9.0,1.10.0,12,7,8350,5116,13466,57,FALSE
react-trello,1.12.0,1.12.1,20,1,17,7,24,1,FALSE
react-trello,1.12.1,1.13.0,21,1,91,90,181,9,FALSE
react-trello,1.7.0,1.8.0,9,1,97,88,185,14,FALSE
react-trello,1.1.0,1.2.0,2,6,481,32,513,28,FALSE
react-trello,1.0.0,1.1.0,1,1,12,1,13,1,FALSE
react-trello,1.15.1,1.16.0,26,1,111,538,649,9,TRUE
react-trello,1.6.0,1.7.0,8,1,75,50,125,6,FALSE
react-trello,1.4.0,1.4.1,5,4,104,99,203,16,FALSE
react-trello,1.4.1,1.5.0,6,1,32,44,76,1,FALSE
react-trello,1.5.0,1.6.0,7,3,11489,3342,14831,20,FALSE
react-trello,1.3.0,1.4.0,4,4,167,90,257,14,FALSE
react-trello,1.2.0,1.3.0,3,3,5174,331,5505,7,FALSE
react-trello,1.15.0,1.15.1,25,4,5,5,10,4,TRUE
react-trello,1.11.0,1.11.1,14,1,1,1,2,1,TRUE
react-trello,1.10.0,1.11.0,13,3,111,81,192,12,TRUE
react-trello,1.8.0,1.8.1,10,3,3,0,3,3,TRUE
react-trello,1.1.0,1.2.0,2,6,481,32,513,28,TRUE
react-trello,1.8.1,1.9.0,11,4,254,23,277,17,TRUE
react-trello,1.3.0,1.4.0,4,4,167,90,257,14,TRUE
react-trello,1.11.4,1.11.5,18,1,256,242,498,4,TRUE
react-trello,1.11.2,1.11.3,16,6,454,420,874,19,TRUE
pixiv.moe,1.1.1,1.1.2,18,1,7,7,14,4,FALSE
pixiv.moe,1.1.2,1.1.4,19,6,1918,255,2173,50,FALSE
pixiv.moe,1.1.5,1.1.6,21,3,54,103,157,14,FALSE
pixiv.moe,1.1.4,1.1.5,20,1,142,95,237,15,FALSE
pixiv.moe,1.1.7,1.1.8,23,2,26,34,60,6,FALSE
pixiv.moe,1.1.6,1.1.7,22,1,30,46,76,11,TRUE
pixiv.moe,1.1.9,1.1.10,25,3,139,26,165,12,FALSE
pixiv.moe,1.1.8,1.1.9,24,1,12,12,24,5,FALSE
pixiv.moe,0.2.0,0.3.0,3,7,303,382,685,35,FALSE
pixiv.moe,0.1.0,0.2.0,2,1,10,2,12,1,FALSE
pixiv.moe,0.3.0,0.4.0,4,18,726,422,1148,97,FALSE
pixiv.moe,0.6.0,0.7.0,7,6,511,3177,3688,68,FALSE
pixiv.moe,0.7.0,0.8.0,8,8,725,529,1254,71,FALSE
pixiv.moe,0.4.0,0.5.0,5,18,3632,575,4207,143,FALSE
pixiv.moe,0.5.0,0.6.0,6,10,1570,1124,2694,144,FALSE
pixiv.moe,0.8.8,1.1.1,17,1,1449,979,2428,37,FALSE
pixiv.moe,0.8.5,0.8.6,14,2,133,41,174,12,FALSE
pixiv.moe,0.8.4,0.8.5,13,2,258,230,488,26,FALSE
pixiv.moe,0.8.7,0.8.8,16,3,34,53,87,11,FALSE
pixiv.moe,0.8.6,0.8.7,15,4,6429,79,6508,20,FALSE
pixiv.moe,0.8.1,0.8.2,10,2,89,92,181,25,FALSE
pixiv.moe,0.8.0,0.8.1,9,2,222,32,254,20,FALSE
pixiv.moe,0.8.3,0.8.4,12,1,62,56,118,14,FALSE
pixiv.moe,0.8.2,0.8.3,11,1,275,165,440,22,FALSE
pixiv.moe,1.1.11,1.1.12,27,2,409,466,875,21,FALSE
pixiv.moe,1.1.10,1.1.11,26,4,71,101,172,18,FALSE
pixiv.moe,1.1.13,1.1.14,29,1,209,492,701,12,FALSE
pixiv.moe,1.1.12,1.1.13,28,3,2319,2151,4470,53,FALSE
pixiv.moe,1.1.14,1.2.1,30,18,1655,876,2531,143,FALSE
pixiv.moe,1.1.6,1.1.7,22,1,30,46,76,11,FALSE
pixiv.moe,1.1.11,1.1.12,27,2,409,466,875,21,TRUE
pixiv.moe,1.1.7,1.1.8,23,2,26,34,60,6,TRUE
pixiv.moe,1.1.13,1.1.14,29,1,209,492,701,12,TRUE
pixiv.moe,1.1.9,1.1.10,25,3,139,26,165,12,TRUE
pixiv.moe,0.8.1,0.8.2,10,2,89,92,181,25,TRUE
pixiv.moe,0.3.0,0.4.0,4,18,726,422,1148,97,TRUE
pixiv.moe,0.8.6,0.8.7,15,4,6429,79,6508,20,TRUE
pixiv.moe,1.1.12,1.1.13,28,3,2319,2151,4470,53,TRUE
pixiv.moe,1.1.14,1.2.1,30,18,1655,876,2531,143,TRUE
pixiv.moe,0.8.0,0.8.1,9,2,222,32,254,20,TRUE
pixiv.moe,0.8.7,0.8.8,16,3,34,53,87,11,TRUE
pixiv.moe,0.8.3,0.8.4,12,1,62,56,118,14,TRUE
pixiv.moe,0.8.4,0.8.5,13,2,258,230,488,26,TRUE
binary-mock-websocket,1.0.4,1.0.5,5,2,2,2,4,2,FALSE
binary-mock-websocket,1.0.5,1.0.6,6,2,7,5,12,4,FALSE
binary-mock-websocket,1.0.6,1.0.7,7,2,26,1,27,8,FALSE
binary-mock-websocket,1.0.7,1.0.8,8,2,15,4,19,3,FALSE
binary-mock-websocket,1.0.0,1.0.1,1,2,592,1,593,10,FALSE
binary-mock-websocket,1.0.1,1.0.2,2,2,2,2,4,2,FALSE
binary-mock-websocket,1.0.2,1.0.3,3,2,20,4,24,3,FALSE
binary-mock-websocket,1.0.3,1.0.4,4,2,48,48,96,2,FALSE
binary-mock-websocket,1.1.9,1.1.10,23,2,5,5,10,2,FALSE
binary-mock-websocket,1.1.8,1.1.9,22,2,3,3,6,2,FALSE
binary-mock-websocket,1.0.8,1.0.9,9,2,4,3,7,3,FALSE
binary-mock-websocket,1.0.9,1.0.10,10,2,2,3,5,2,FALSE
binary-mock-websocket,3.0.8,4.0.0,39,3,114,126,240,12,FALSE
binary-mock-websocket,1.1.2,1.1.4,17,3,4,4,8,3,FALSE
binary-mock-websocket,1.1.6,1.1.7,20,2,4,4,8,2,FALSE
binary-mock-websocket,2.1.2,2.1.3,31,2,3,3,6,3,FALSE
binary-mock-websocket,2.1.3,3.0.0,32,2,285,288,573,6,FALSE
binary-mock-websocket,2.1.0,2.1.1,29,2,5,5,10,4,FALSE
binary-mock-websocket,2.1.1,2.1.2,30,2,3,3,6,3,FALSE
binary-mock-websocket,3.0.3,3.0.5,36,3,120,115,235,6,FALSE
binary-mock-websocket,4.0.0,4.1.0,40,3,132,120,252,7,FALSE
binary-mock-websocket,4.1.0,4.1.1,41,1,1,1,2,1,FALSE
binary-mock-websocket,3.0.1,3.0.2,34,3,49,60,109,4,FALSE
binary-mock-websocket,3.0.0,3.0.1,33,2,3,3,6,3,FALSE
binary-mock-websocket,1.0.14,1.1.1,15,4,18,6,24,4,FALSE
binary-mock-websocket,1.0.12,1.0.13,13,4,25,18,43,6,FALSE
binary-mock-websocket,1.0.13,1.0.14,14,2,3,3,6,2,FALSE
binary-mock-websocket,1.0.10,1.0.11,11,3,34,12,46,4,FALSE
binary-mock-websocket,1.0.11,1.0.12,12,2,2,2,4,2,FALSE
binary-mock-websocket,1.1.5,1.1.6,19,2,8,8,16,2,FALSE
binary-mock-websocket,1.4.0,2.0.0,27,4,1703,794,2497,22,FALSE
binary-mock-websocket,1.1.1,1.1.2,16,2,5,5,10,2,FALSE
binary-mock-websocket,1.3.0,1.4.0,26,2,3,3,6,2,FALSE
binary-mock-websocket,3.0.5,3.0.6,37,2,25,18,43,3,FALSE
binary-mock-websocket,1.2.0,1.3.0,25,3,42,17,59,3,FALSE
binary-mock-websocket,1.1.4,1.1.5,18,2,3,3,6,2,FALSE
binary-mock-websocket,2.0.0,2.1.0,28,2,161,115,276,4,FALSE
binary-mock-websocket,3.0.2,3.0.3,35,2,9,5,14,3,FALSE
binary-mock-websocket,1.1.7,1.1.8,21,2,3,3,6,2,FALSE
binary-mock-websocket,1.1.10,1.2.0,24,2,4,4,8,2,FALSE
binary-mock-websocket,3.0.6,3.0.8,38,4,414,404,818,9,FALSE
binary-mock-websocket,1.4.0,2.0.0,27,4,1703,794,2497,22,TRUE
binary-mock-websocket,1.1.2,1.1.4,17,3,4,4,8,3,TRUE
binary-mock-websocket,1.1.4,1.1.5,18,2,3,3,6,2,TRUE
binary-mock-websocket,1.1.6,1.1.7,20,2,4,4,8,2,TRUE
binary-mock-websocket,4.1.0,4.1.1,41,1,1,1,2,1,TRUE
binary-mock-websocket,4.0.0,4.1.0,40,3,132,120,252,7,TRUE
sockbot,0.0.1,0.99.0,1,86,24165,141364,165529,318,FALSE
sockbot,3.1.1,4.0.0,29,20,1944,388,2332,43,FALSE
sockbot,3.1.0,3.1.1,28,11,1230,136,1366,24,FALSE
sockbot,6.1.2,6.2.0,56,16,274,88,362,49,FALSE
sockbot,3.0.0,3.1.0-RC1,25,18,552,372,924,44,FALSE
sockbot,6.1.1,6.1.2,55,2,38,30,68,4,FALSE
sockbot,3.0.0-ALPHA1,3.0.0-ALPHA2,22,20,5015,2291,7306,67,TRUE
sockbot,3.0.0-ALPHA2,3.0.0-BETA1,23,7,2503,3748,6251,60,FALSE
sockbot,3.1.0-RC2,3.1.0,27,9,3838,205,4043,44,FALSE
sockbot,3.1.0-RC1,3.1.0-RC2,26,10,3830,213,4043,43,FALSE
sockbot,6.0.0,6.1.0,53,14,536,124,660,33,FALSE
sockbot,4.13.0,4.14.0,48,13,409,71,480,40,FALSE
sockbot,4.0.0,4.1.0,30,17,923,343,1266,35,FALSE
sockbot,4.1.0,4.1.1,31,1,1,1,2,1,FALSE
sockbot,4.1.1,4.1.2,32,12,317,93,410,17,FALSE
sockbot,4.1.2,4.2.0,33,12,791,132,923,20,FALSE
sockbot,4.12.0,4.13.0,47,23,258,293,551,38,FALSE
sockbot,4.14.0,4.15.0,49,4,406,54,460,18,FALSE
sockbot,4.15.0,5.0.0,50,2,189,67,256,16,FALSE
sockbot,5.0.0,5.0.1,51,3,25,10,35,5,FALSE
sockbot,3.0.0-BETA1,3.0.0,24,18,9904,19192,29096,147,FALSE
sockbot,4.11.0,4.11.1,45,6,44,40,84,8,FALSE
sockbot,4.11.1,4.12.0,46,11,320,54,374,19,FALSE
sockbot,4.7.0,4.8.0,40,14,301,33,334,23,FALSE
sockbot,4.10.0,4.11.0,44,6,252,288,540,19,FALSE
sockbot,4.8.1,4.9.0,42,3,54,24,78,6,FALSE
sockbot,4.8.0,4.8.1,41,2,28,28,56,4,FALSE
sockbot,4.9.0,4.10.0,43,2,20,8,28,8,FALSE
sockbot,4.6.0,4.7.0,39,12,814,531,1345,17,FALSE
sockbot,4.5.0,4.6.0,38,14,1092,99,1191,35,FALSE
sockbot,5.0.1,6.0.0,52,17,858,358,1216,72,FALSE
sockbot,6.1.0,6.1.1,54,4,44,2,46,6,FALSE
sockbot,4.4.0,4.5.0,37,16,763,110,873,22,FALSE
sockbot,6.2.0,6.3.0,57,11,140,65,205,19,FALSE
sockbot,4.2.1,4.3.0,35,10,423,101,524,27,FALSE
sockbot,4.2.0,4.2.1,34,3,24,10,34,3,FALSE
sockbot,6.3.0,6.3.1,58,18,197,161,358,22,FALSE
sockbot,4.3.0,4.4.0,36,31,1376,824,2200,153,FALSE
sockbot,3.0.0-ALPHA1,3.0.0-ALPHA2,22,20,5015,2291,7306,67,FALSE
sockbot,2.11.7,2.11.8,16,1,1,1,2,1,FALSE
sockbot,2.0.0,2.9.1,3,3,31,2286,2317,35,FALSE
sockbot,4.14.0,4.15.0,49,4,406,54,460,18,TRUE
sockbot,2.11.4,2.11.7,15,14,151,89,240,31,FALSE
sockbot,2.11.2,2.11.3,13,5,16,14,30,11,FALSE
sockbot,2.11.3,2.11.4,14,16,4908,2817,7725,99,FALSE
sockbot,2.11.0,2.11.1,11,12,2201,437,2638,28,FALSE
sockbot,2.11.1,2.11.2,12,2,2722,708,3430,35,FALSE
sockbot,2.11.8,2.11.9,17,5,546,530,1076,48,FALSE
sockbot,2.11.9,2.11.10,18,9,946,16,962,20,FALSE
sockbot,3.0.0-BETA1,3.0.0,24,18,9904,19192,29096,147,TRUE
sockbot,2.13.5,3.0.0-ALPHA1,21,77,5411,16139,21550,224,FALSE
sockbot,2.9.3,2.9.4,5,26,1782,726,2508,113,FALSE
sockbot,4.11.1,4.12.0,46,11,320,54,374,19,TRUE
sockbot,2.13.0,2.13.5,20,6,640,28,668,23,FALSE
sockbot,2.9.1,2.9.3,4,27,16039,137006,153045,199,FALSE
sockbot,2.11.10,2.13.0,19,53,5133,631,5764,170,FALSE
sockbot,2.9.4,2.10.0,6,20,2759,1621,4380,35,FALSE
sockbot,2.10.3,2.11.0,10,18,1986,303,2289,31,FALSE
sockbot,2.10.2,2.10.3,9,50,1470,908,2378,109,TRUE
sockbot,2.10.0,2.10.1,7,21,326,139,465,36,FALSE
sockbot,6.2.0,6.3.0,57,11,140,65,205,19,TRUE
sockbot,2.10.1,2.10.2,8,8,2058,1121,3179,48,FALSE
sockbot,2.10.2,2.10.3,9,50,1470,908,2378,109,FALSE
sockbot,0.99.0,2.0.0,2,1,1,1,2,1,FALSE
sockbot,3.1.0-RC2,3.1.0,27,9,3838,205,4043,44,TRUE
sockbot,4.2.0,4.2.1,34,3,24,10,34,3,TRUE
sockbot,6.1.1,6.1.2,55,2,38,30,68,4,TRUE
sockbot,6.0.0,6.1.0,53,14,536,124,660,33,TRUE
sockbot,5.0.1,6.0.0,52,17,858,358,1216,72,TRUE
sockbot,3.0.0,3.1.0-RC1,25,18,552,372,924,44,TRUE
sockbot,4.12.0,4.13.0,47,23,258,293,551,38,TRUE
sockbot,5.0.0,5.0.1,51,3,25,10,35,5,TRUE
sockbot,4.11.0,4.11.1,45,6,44,40,84,8,TRUE
sockbot,4.1.2,4.2.0,33,12,791,132,923,20,TRUE
sockbot,2.11.8,2.11.9,17,5,546,530,1076,48,TRUE
sockbot,4.4.0,4.5.0,37,16,763,110,873,22,TRUE
vuex-firebase,0.1.91,0.2.0,20,1,12,1,13,3,FALSE
vuex-firebase,0.1.8,0.1.9,18,1,66,27,93,4,FALSE
vuex-firebase,0.1.9,0.1.91,19,1,9,7,16,3,FALSE
vuex-firebase,0.2.0,0.3.0,21,3,100,63,163,7,FALSE
vuex-firebase,0.1.0,0.1.1,10,1,27,3,30,2,FALSE
vuex-firebase,0.1.1,0.1.2,11,1,32,15,47,3,FALSE
vuex-firebase,0.1.2,0.1.3,12,1,8,10,18,1,FALSE
vuex-firebase,0.1.3,0.1.4,13,1,20,19,39,3,FALSE
vuex-firebase,0.1.4,0.1.5,14,2,10,16,26,3,FALSE
vuex-firebase,0.1.5,0.1.6,15,1,23,32,55,3,FALSE
vuex-firebase,0.1.6,0.1.7,16,1,30,31,61,3,FALSE
vuex-firebase,0.1.7,0.1.8,17,1,5,3,8,2,FALSE
vuex-firebase,0.0.5,0.0.6,5,1,27,16,43,3,FALSE
vuex-firebase,0.0.4,0.0.5,4,1,280,282,562,3,FALSE
vuex-firebase,0.0.7,0.0.8,7,1,147,6,153,3,FALSE
vuex-firebase,0.0.6,0.0.7,6,2,36,14,50,6,FALSE
vuex-firebase,0.0.1,0.0.2,1,1,647,0,647,6,FALSE
vuex-firebase,0.0.3,0.0.4,3,2,29,23,52,6,FALSE
vuex-firebase,0.0.2,0.0.3,2,2,13,11,24,4,FALSE
vuex-firebase,0.3.0,0.3.1,22,1,3,3,6,2,FALSE
vuex-firebase,0.3.1,0.3.2,23,1,280,282,562,3,FALSE
vuex-firebase,0.0.9,0.1.0,9,1,280,282,562,3,FALSE
vuex-firebase,0.0.8,0.0.9,8,1,43,123,166,4,FALSE
vuex-firebase,0.1.6,0.1.7,16,1,30,31,61,3,TRUE
vuex-firebase,0.1.7,0.1.8,17,1,5,3,8,2,TRUE
vuex-firebase,0.1.91,0.2.0,20,1,12,1,13,3,TRUE
justo-console,0.2.1,0.2.2,6,1,24,3,27,5,FALSE
justo-console,0.2.0,0.2.1,5,1,4,2,6,4,FALSE
justo-console,0.1.0,0.1.1,1,1,10,10,20,4,FALSE
justo-console,0.1.1,0.1.2,2,1,4,4,8,4,FALSE
justo-console,0.1.2,0.1.3,3,1,4,4,8,4,FALSE
justo-console,0.1.3,0.2.0,4,1,69,9,78,6,FALSE
justo-console,0.1.2,0.1.3,3,1,4,4,8,4,TRUE
espower-typescript-babel,0.1.0,0.1.1,2,3,17,4,21,3,FALSE
espower-typescript-babel,0.1.1,0.2.0,3,5,14,12,26,9,FALSE
espower-typescript-babel,0.0.2,0.1.0,1,2,16,12,28,4,FALSE
espower-typescript-babel,0.1.1,0.2.0,3,5,14,12,26,9,TRUE
preact-cycle,0.3.0,0.4.0,4,2,2,2,4,2,FALSE
preact-cycle,0.2.0,0.3.0,3,2,55,8,63,6,FALSE
preact-cycle,0.4.1,0.5.0,6,5,141,53,194,5,FALSE
preact-cycle,0.4.0,0.4.1,5,2,4,4,8,2,FALSE
preact-cycle,0.1.0,0.1.1,1,2,3,2,5,2,FALSE
preact-cycle,0.1.1,0.2.0,2,4,8,4,12,4,FALSE
preact-cycle,0.5.0,0.5.1,7,2,4,4,8,3,FALSE
preact-cycle,0.1.1,0.2.0,2,4,8,4,12,4,TRUE
preact-cycle,0.2.0,0.3.0,3,2,55,8,63,6,TRUE
preact-cycle,0.5.0,0.5.1,7,2,4,4,8,3,TRUE
ractive-select,0.6.9,0.6.10,25,5,3523,61,3584,6,FALSE
ractive-select,0.6.8,0.6.9,24,2,3,3,6,3,FALSE
ractive-select,0.6.3,0.6.4,19,4,79,64,143,6,FALSE
ractive-select,0.6.7,0.6.8,23,2,2,2,4,2,FALSE
ractive-select,0.6.1,0.6.3,18,4,6,3,9,4,TRUE
ractive-select,0.6.0,0.6.1,17,3,8,11,19,5,FALSE
ractive-select,0.7.2,0.7.3,30,3,30,20,50,4,FALSE
ractive-select,0.7.3,0.8.0,31,6,30,18,48,7,TRUE
ractive-select,0.6.5,0.6.6,21,5,1075,19,1094,6,FALSE
ractive-select,0.6.6,0.6.7,22,3,4,2,6,3,FALSE
ractive-select,0.6.4,0.6.5,20,2,17,8,25,3,FALSE
ractive-select,0.7.0,0.7.2,29,7,66,55,121,8,FALSE
ractive-select,0.8.0,0.8.1,32,3,1662,1179,2841,4,FALSE
ractive-select,0.6.12,0.7.0,28,15,192,66,258,16,FALSE
ractive-select,0.6.11,0.6.12,27,4,2590,2187,4777,5,FALSE
ractive-select,0.6.10,0.6.11,26,4,9,8,17,5,FALSE
ractive-select,0.5.0,0.6.0,16,3,128,40,168,7,FALSE
ractive-select,0.4.7,0.5.0,15,7,261,38,299,11,FALSE
ractive-select,0.2.1,0.3.0,3,2,98,22,120,4,FALSE
ractive-select,0.2.0,0.2.1,2,5,44,11,55,7,FALSE
ractive-select,0.1.0,0.2.0,1,4,8,8,16,5,FALSE
ractive-select,0.3.3,0.4.0,7,10,439,107,546,23,FALSE
ractive-select,0.6.1,0.6.3,18,4,6,3,9,4,FALSE
ractive-select,0.3.1,0.3.2,5,2,1,5,6,2,FALSE
ractive-select,0.7.3,0.8.0,31,6,30,18,48,7,FALSE
ractive-select,0.4.1,0.4.2,9,1,1,1,2,1,FALSE
ractive-select,0.4.0,0.4.1,8,3,164,3,167,3,FALSE
ractive-select,0.4.3,0.4.4,11,3,27,7,34,4,FALSE
ractive-select,0.4.2,0.4.3,10,6,11,11,22,8,FALSE
ractive-select,0.4.5,0.4.6,13,2,3,3,6,3,FALSE
ractive-select,0.4.4,0.4.5,12,1,10,8,18,1,FALSE
ractive-select,0.4.6,0.4.7,14,2,6,3,9,4,FALSE
ractive-select,0.3.2,0.3.3,6,7,12,7,19,7,FALSE
ractive-select,0.3.0,0.3.1,4,4,30,5,35,5,FALSE
postcss-at-rules-variables,0.0.4,0.0.5,5,3,125,174,299,8,FALSE
postcss-at-rules-variables,0.0.1,0.0.2,2,2,2,3,5,2,FALSE
postcss-at-rules-variables,0.0.0,0.0.1,1,1,1,1,2,1,FALSE
postcss-at-rules-variables,0.0.3,0.0.4,4,2,9,9,18,2,FALSE
postcss-at-rules-variables,0.0.2,0.0.3,3,2,2,2,4,2,FALSE
postcss-at-rules-variables,0.0.7,0.0.8,8,2,3,3,6,3,FALSE
postcss-at-rules-variables,0.0.6,0.0.7,7,2,12,4,16,4,FALSE
postcss-at-rules-variables,0.0.9,0.0.10,10,1,2,2,4,2,FALSE
postcss-at-rules-variables,0.0.8,0.0.9,9,2,3,2,5,2,FALSE
postcss-at-rules-variables,0.0.15,0.0.16,15,8,24,6,30,8,FALSE
postcss-at-rules-variables,0.0.14,0.0.15,14,4,82,73,155,5,FALSE
postcss-at-rules-variables,0.0.11,0.0.13,12,6,90,63,153,6,FALSE
postcss-at-rules-variables,0.0.10,0.0.11,11,2,15,15,30,3,FALSE
postcss-at-rules-variables,0.0.13,0.0.14,13,4,9,4,13,4,FALSE
postcss-at-rules-variables,0.0.15,0.0.16,15,8,24,6,30,8,TRUE
postcss-at-rules-variables,0.0.21,0.0.23,21,27,185,78,263,39,FALSE
postcss-at-rules-variables,0.0.17,0.0.18,17,15,147,123,270,23,FALSE
postcss-at-rules-variables,0.0.23,0.0.24,22,16,79,27,106,20,FALSE
postcss-at-rules-variables,0.0.16,0.0.17,16,12,67,26,93,16,FALSE
postcss-at-rules-variables,0.0.24,0.0.25,23,15,76,55,131,16,FALSE
postcss-at-rules-variables,0.0.19,0.0.20,19,12,134,81,215,19,FALSE
postcss-at-rules-variables,0.1.0,0.1.1,27,18,100,55,155,22,FALSE
postcss-at-rules-variables,0.0.18,0.0.19,18,14,206,180,386,23,FALSE
postcss-at-rules-variables,0.0.5,0.0.6,6,3,79,70,149,9,FALSE
postcss-at-rules-variables,0.0.20,0.0.21,20,6,72,40,112,11,FALSE
postcss-at-rules-variables,0.0.25,0.0.26,24,49,264,188,452,54,FALSE
postcss-at-rules-variables,0.0.26,0.0.27,25,40,618,357,975,43,FALSE
postcss-at-rules-variables,0.0.27,0.1.0,26,23,135,50,185,27,FALSE
postcss-at-rules-variables,0.0.19,0.0.20,19,12,134,81,215,19,TRUE
postcss-at-rules-variables,0.0.23,0.0.24,22,16,79,27,106,20,TRUE
postcss-at-rules-variables,0.0.24,0.0.25,23,15,76,55,131,16,TRUE
webpack-rtl-plugin,1.1.1,1.2.0,5,4,59,14,73,7,FALSE
webpack-rtl-plugin,1.1.0,1.1.1,4,4,5,5,10,4,FALSE
webpack-rtl-plugin,1.4.2,1.5.0,12,5,101,5,106,7,FALSE
webpack-rtl-plugin,1.0.0,1.0.1,1,5,359,100,459,25,FALSE
webpack-rtl-plugin,1.0.1,1.0.2,2,2,12,10,22,5,FALSE
webpack-rtl-plugin,1.0.2,1.1.0,3,2,94,5,99,6,FALSE
webpack-rtl-plugin,1.4.1,1.4.2,11,6,93,75,168,6,FALSE
webpack-rtl-plugin,1.5.0,1.6.0,13,5,133,9,142,13,FALSE
webpack-rtl-plugin,1.3.2,1.4.0,9,2,73,10,83,6,FALSE
webpack-rtl-plugin,1.3.0,1.3.1,7,2,9,98,107,9,FALSE
webpack-rtl-plugin,1.2.0,1.3.0,6,2,144,1,145,10,FALSE
webpack-rtl-plugin,1.4.0,1.4.1,10,2,10,7,17,4,FALSE
webpack-rtl-plugin,1.3.1,1.3.2,8,2,2,2,4,2,FALSE
webpack-rtl-plugin,1.4.2,1.5.0,12,5,101,5,106,7,TRUE
react-search,1.0.5,1.0.6,12,6,28,28,56,10,FALSE
react-search,1.0.6,1.0.7,13,7,27,31,58,7,FALSE
react-search,1.0.7,1.0.8,14,3,265,46,311,10,FALSE
react-search,2.0.3,2.0.4,21,3,438,438,876,5,FALSE
react-search,2.0.2,2.0.3,20,2,43,46,89,5,FALSE
react-search,2.0.1,2.0.2,19,2,186,86,272,9,FALSE
react-search,2.0.0,2.0.1,18,3,233,49,282,7,FALSE
react-search,1.0.8,1.0.9,15,2,1,7,8,2,FALSE
react-search,1.0.9,1.0.10,16,3,16040,15357,31397,18,FALSE
react-search,2.0.4,2.0.5,22,4,4955,4787,9742,8,FALSE
react-search,1.0.10,2.0.0,17,6,12161,10048,22209,43,FALSE
react-search,0.0.5,0.0.6,4,4,5761,4112,9873,9,FALSE
react-search,0.0.4,0.0.5,3,1,1,1,2,1,FALSE
react-search,0.0.7,0.0.10,6,3,3,3,6,3,FALSE
react-search,0.0.6,0.0.7,5,1,1,1,2,1,FALSE
react-search,0.0.1,0.0.3,1,2,5,5,10,2,FALSE
react-search,0.0.3,0.0.4,2,1,176,171,347,6,FALSE
react-search,1.0.7,1.0.8,14,3,265,46,311,10,TRUE
react-search,1.0.0,1.0.2,9,14,695,667,1362,22,FALSE
react-search,1.0.2,1.0.3,10,2,16582,17244,33826,13,FALSE
react-search,1.0.3,1.0.5,11,43,1725,1527,3252,98,FALSE
react-search,0.0.10,0.0.12,7,3,41548,26259,67807,58,FALSE
react-search,0.0.12,1.0.0,8,2,29,20608,20637,8,FALSE
react-search,1.0.5,1.0.6,12,6,28,28,56,10,TRUE
react-search,1.0.2,1.0.3,10,2,16582,17244,33826,13,TRUE
react-search,1.0.3,1.0.5,11,43,1725,1527,3252,98,TRUE
react-search,0.0.1,0.0.3,1,2,5,5,10,2,TRUE
react-search,1.0.6,1.0.7,13,7,27,31,58,7,TRUE
nodefunc-generatorify,0.2.2,0.3.0,8,2,12,8,20,3,FALSE
nodefunc-generatorify,0.2.1,0.2.2,7,2,20,681,701,3,FALSE
nodefunc-generatorify,0.2.0,0.2.1,6,1,55,13,68,3,FALSE
nodefunc-generatorify,0.1.5,0.1.6,4,2,71,38,109,5,TRUE
nodefunc-generatorify,0.1.6,0.2.0,5,1,13,7,20,2,FALSE
nodefunc-generatorify,0.1.5,0.1.6,4,2,71,38,109,5,FALSE
teasim-player,1.0.0,1.0.1,9,8,546,45,591,21,FALSE
teasim-player,1.0.1,1.0.2,10,1,5311,5595,10906,257,FALSE
teasim-player,1.0.2,1.0.3,11,2,807,695,1502,79,TRUE
teasim-player,0.8.4,1.0.0,8,1,18625,0,18625,326,FALSE
teasim-player,0.8.1,0.8.3,6,1,72,83,155,9,FALSE
teasim-player,0.8.0,0.8.1,5,1,31,0,31,2,FALSE
teasim-player,0.8.3,0.8.4,7,1,72,83,155,9,FALSE
teasim-player,0.7.0,0.7.2,3,1,72,83,155,9,FALSE
teasim-player,0.7.2,0.8.0,4,1,72,83,155,9,FALSE
teasim-player,0.6.16,0.7.0,2,1,72,83,155,9,FALSE
teasim-player,1.1.1,1.1.2,14,1,72,83,155,9,FALSE
teasim-player,1.1.2,1.1.4,15,1,72,83,155,9,FALSE
teasim-player,1.0.3,1.0.9,12,1,72,83,155,9,FALSE
teasim-player,1.0.9,1.1.1,13,1,72,83,155,9,FALSE
teasim-player,1.1.5,2.0.0-alpha.0,17,8,55116,12112,67228,433,FALSE
teasim-player,3.0.0-1,3.0.1-alpha.1,22,1,72,83,155,9,FALSE
teasim-player,3.0.0-0,3.0.0-1,21,1,72,83,155,9,FALSE
teasim-player,1.1.4,1.1.5,16,1,72,83,155,9,FALSE
teasim-player,0.0.1,0.6.16,1,1,72,83,155,9,FALSE
teasim-player,2.1.0-0,3.0.0-0,20,1,72,83,155,9,FALSE
teasim-player,2.0.0,2.1.0-0,19,2,532,1,533,9,FALSE
teasim-player,1.0.2,1.0.3,11,2,807,695,1502,79,FALSE
teasim-player,1.1.4,1.1.5,16,1,72,83,155,9,TRUE
teasim-player,3.0.0-1,3.0.1-alpha.1,22,1,72,83,155,9,TRUE
teasim-player,0.7.0,0.7.2,3,1,72,83,155,9,TRUE
teasim-player,3.0.0-0,3.0.0-1,21,1,72,83,155,9,TRUE
teasim-player,0.7.2,0.8.0,4,1,72,83,155,9,TRUE
teasim-player,0.8.0,0.8.1,5,1,31,0,31,2,TRUE
teasim-player,0.0.1,0.6.16,1,1,72,83,155,9,TRUE
teasim-player,1.0.1,1.0.2,10,1,5311,5595,10906,257,TRUE
teasim-player,1.0.0,1.0.1,9,8,546,45,591,21,TRUE
teasim-player,0.8.4,1.0.0,8,1,18625,0,18625,326,TRUE
watson-ui-components,0.5.4,0.6.0,3,5,5076,170,5246,185,FALSE
watson-ui-components,0.5.2,0.5.3,1,4,8,1971,1979,8,FALSE
watson-ui-components,0.5.3,0.5.4,2,3,3,1,4,3,FALSE
watson-ui-components,0.5.3,0.5.4,2,3,3,1,4,3,TRUE
cluster-key-slot,1.0.5,1.0.6,7,1,52,5,57,3,FALSE
cluster-key-slot,1.0.6,1.0.8,8,6,19,11,30,6,FALSE
cluster-key-slot,1.0.4,1.0.5,6,5,8,6,14,5,FALSE
cluster-key-slot,1.0.0,1.0.1,1,9,165,155,320,21,FALSE
cluster-key-slot,1.0.1,1.0.2-p,2,2,16,18,34,4,FALSE
cluster-key-slot,1.0.2,1.0.3,4,2,37,8,45,3,FALSE
cluster-key-slot,1.0.3,1.0.4,5,1,7,1,8,1,FALSE
cluster-key-slot,1.0.2-p,1.0.2,3,1,1,0,1,1,FALSE
cluster-key-slot,1.0.0,1.0.1,1,9,165,155,320,21,TRUE
react-web-meteor,0.0.1,0.1.0,1,1,2,2,4,2,FALSE
react-web-meteor,0.2.2,0.2.3,5,4,509,415,924,5,FALSE
react-web-meteor,0.2.1,0.2.2,4,1,3,1,4,2,FALSE
react-web-meteor,0.2.0,0.2.1,3,6,1135,39,1174,12,FALSE
react-web-meteor,0.1.0,0.2.0,2,1,2,2,4,2,FALSE
react-web-meteor,0.2.1,0.2.2,4,1,3,1,4,2,TRUE
nexus-uplink-simple-server,0.7.5,0.8.0,24,2,120,79,199,3,FALSE
nexus-uplink-simple-server,0.11.0,0.11.1,33,2,3,3,6,2,FALSE
nexus-uplink-simple-server,0.11.1,0.11.2,34,2,68,515,583,9,FALSE
nexus-uplink-simple-server,0.2.3,0.3.0,6,1,43,45,88,7,FALSE
nexus-uplink-simple-server,0.7.0,0.7.1,19,2,2,2,4,2,FALSE
nexus-uplink-simple-server,0.2.1,0.2.2,4,2,6,4,10,3,FALSE
nexus-uplink-simple-server,0.2.0,0.2.1,3,1,2,1,3,1,FALSE
nexus-uplink-simple-server,0.1.0,0.1.1,1,1,141,62,203,11,FALSE
nexus-uplink-simple-server,0.1.1,0.2.0,2,2,157,148,305,8,FALSE
nexus-uplink-simple-server,0.6.4,0.7.0,18,2,90,73,163,7,FALSE
nexus-uplink-simple-server,0.10.1,0.10.2,31,2,4,6,10,3,FALSE
nexus-uplink-simple-server,0.10.0,0.10.1,30,2,4,2,6,3,FALSE
nexus-uplink-simple-server,0.10.2,0.11.0,32,2,6,3,9,3,FALSE
nexus-uplink-simple-server,0.6.3,0.6.4,17,2,28,27,55,5,FALSE
nexus-uplink-simple-server,0.3.3,0.3.4,10,1,2,2,4,2,FALSE
nexus-uplink-simple-server,0.7.4,0.7.5,23,2,4,2,6,3,FALSE
nexus-uplink-simple-server,0.6.0,0.6.1,14,2,2,2,4,2,FALSE
nexus-uplink-simple-server,0.7.2,0.7.3,21,2,4,14,18,3,FALSE
nexus-uplink-simple-server,0.7.3,0.7.4,22,2,4,4,8,3,FALSE
nexus-uplink-simple-server,0.7.1,0.7.2,20,2,77,74,151,3,FALSE
nexus-uplink-simple-server,0.4.0,0.5.0,12,2,34,24,58,3,FALSE
nexus-uplink-simple-server,0.3.4,0.4.0,11,5,42,20,62,6,FALSE
nexus-uplink-simple-server,0.5.0,0.6.0,13,2,20,22,42,9,FALSE
nexus-uplink-simple-server,0.9.0,0.9.1,26,2,4,4,8,3,FALSE
nexus-uplink-simple-server,0.9.1,0.9.2,27,2,11,8,19,3,FALSE
nexus-uplink-simple-server,0.9.2,0.9.3,28,2,4,4,8,3,FALSE
nexus-uplink-simple-server,0.9.3,0.10.0,29,2,5,4,9,3,FALSE
nexus-uplink-simple-server,0.8.0,0.9.0,25,2,4,4,8,3,FALSE
nexus-uplink-simple-server,0.6.1,0.6.2,15,2,2,2,4,2,FALSE
nexus-uplink-simple-server,0.3.1,0.3.2,8,1,4,6,10,3,FALSE
nexus-uplink-simple-server,0.3.2,0.3.3,9,1,21,11,32,3,FALSE
nexus-uplink-simple-server,0.6.2,0.6.3,16,2,3,4,7,3,FALSE
nexus-uplink-simple-server,0.3.0,0.3.1,7,1,4,5,9,3,FALSE
nexus-uplink-simple-server,0.2.2,0.2.3,5,1,2,2,4,1,FALSE
nexus-uplink-simple-server,1.0.0,1.1.0,83,2,46,49,95,7,FALSE
nexus-uplink-simple-server,0.12.19,0.12.20,59,2,6,6,12,2,FALSE
nexus-uplink-simple-server,0.12.18,0.12.19,58,2,37,19,56,3,FALSE
nexus-uplink-simple-server,0.12.11,0.12.12,51,2,5,5,10,2,FALSE
nexus-uplink-simple-server,0.12.17,0.12.18,57,2,5,5,10,3,FALSE
nexus-uplink-simple-server,0.12.16,0.12.17,56,2,7,6,13,3,FALSE
nexus-uplink-simple-server,0.12.15,0.12.16,55,2,40,26,66,5,FALSE
nexus-uplink-simple-server,0.12.14,0.12.15,54,2,13,11,24,5,FALSE
nexus-uplink-simple-server,0.14.11,0.14.12,76,2,29,1,30,5,FALSE
nexus-uplink-simple-server,0.14.10,0.14.11,75,2,35,19,54,3,FALSE
nexus-uplink-simple-server,0.14.13,0.14.14,78,2,7,3,10,5,FALSE
nexus-uplink-simple-server,0.14.12,0.14.13,77,2,3,3,6,3,FALSE
nexus-uplink-simple-server,0.14.15,0.14.16,80,2,3,3,6,3,FALSE
nexus-uplink-simple-server,0.14.14,0.14.15,79,2,9,5,14,3,FALSE
nexus-uplink-simple-server,0.14.17,1.0.0,82,4,68,9,77,4,FALSE
nexus-uplink-simple-server,0.14.16,0.14.17,81,2,3,15,18,7,FALSE
nexus-uplink-simple-server,1.4.0,1.5.0,93,5,52,38,90,11,FALSE
nexus-uplink-simple-server,0.14.8,0.14.9,73,2,84,65,149,5,FALSE
nexus-uplink-simple-server,0.12.20,0.13.0,60,2,431,242,673,11,FALSE
nexus-uplink-simple-server,0.11.4,0.11.5,37,2,4,4,8,2,FALSE
nexus-uplink-simple-server,0.12.12,0.12.13,52,2,4,4,8,2,FALSE
nexus-uplink-simple-server,0.12.10,0.12.11,50,2,10,18,28,3,FALSE
nexus-uplink-simple-server,0.11.6,0.12.0,39,2,23,17,40,9,FALSE
nexus-uplink-simple-server,0.11.2,0.11.3,35,2,474,5,479,4,FALSE
nexus-uplink-simple-server,0.11.3,0.11.4,36,2,16,15,31,8,FALSE
nexus-uplink-simple-server,0.12.13,0.12.14,53,2,39,22,61,5,FALSE
nexus-uplink-simple-server,0.13.2,0.13.3,63,2,281,233,514,6,FALSE
nexus-uplink-simple-server,0.13.3,0.14.0,64,4,1457,1516,2973,12,FALSE
nexus-uplink-simple-server,0.13.0,0.13.1,61,2,3,3,6,3,FALSE
nexus-uplink-simple-server,0.13.1,0.13.2,62,2,3,3,6,3,FALSE
nexus-uplink-simple-server,0.14.5,0.14.6,70,2,3,3,6,3,FALSE
nexus-uplink-simple-server,0.14.4,0.14.5,69,2,3,3,6,3,FALSE
nexus-uplink-simple-server,0.14.7,0.14.8,72,2,12,6,18,5,FALSE
nexus-uplink-simple-server,0.14.6,0.14.7,71,2,5,5,10,3,FALSE
nexus-uplink-simple-server,0.14.1,0.14.2,66,4,4,4,8,4,FALSE
nexus-uplink-simple-server,0.14.0,0.14.1,65,2,139,139,278,4,FALSE
nexus-uplink-simple-server,0.14.3,0.14.4,68,2,5,5,10,3,FALSE
nexus-uplink-simple-server,0.14.2,0.14.3,67,1,1,1,2,1,FALSE
nexus-uplink-simple-server,0.14.9,0.14.10,74,2,3,3,6,3,FALSE
nexus-uplink-simple-server,1.3.1,1.4.0,92,2,82,110,192,7,FALSE
nexus-uplink-simple-server,1.3.0,1.3.1,91,2,3,3,6,3,FALSE
nexus-uplink-simple-server,1.1.0,1.2.0,84,2,2,2,4,2,FALSE
nexus-uplink-simple-server,0.12.3,0.12.4,43,2,13,3,16,5,FALSE
nexus-uplink-simple-server,0.12.2,0.12.3,42,2,88,52,140,3,FALSE
nexus-uplink-simple-server,0.12.1,0.12.2,41,2,3,3,6,2,FALSE
nexus-uplink-simple-server,0.12.0,0.12.1,40,2,2,2,4,2,FALSE
nexus-uplink-simple-server,0.12.7,0.12.8,47,2,21,14,35,5,FALSE
nexus-uplink-simple-server,0.12.6,0.12.7,46,2,554,667,1221,5,FALSE
nexus-uplink-simple-server,0.12.5,0.12.6,45,2,3,3,6,3,FALSE
nexus-uplink-simple-server,0.12.4,0.12.5,44,2,4,13,17,5,FALSE
nexus-uplink-simple-server,0.12.9,0.12.10,49,2,8,7,15,4,FALSE
nexus-uplink-simple-server,0.12.8,0.12.9,48,2,8,3,11,3,FALSE
nexus-uplink-simple-server,0.11.5,0.11.6,38,2,51,58,109,7,TRUE
nexus-uplink-simple-server,1.2.4,1.2.5,89,2,35,27,62,3,FALSE
nexus-uplink-simple-server,1.2.5,1.3.0,90,2,112,1,113,5,FALSE
nexus-uplink-simple-server,1.2.2,1.2.3,87,2,5,3,8,3,FALSE
nexus-uplink-simple-server,1.2.3,1.2.4,88,2,9,1,10,3,FALSE
nexus-uplink-simple-server,1.2.0,1.2.1,85,2,2,2,4,2,FALSE
nexus-uplink-simple-server,1.2.1,1.2.2,86,2,19,16,35,4,FALSE
nexus-uplink-simple-server,0.6.0,0.6.1,14,2,2,2,4,2,TRUE
nexus-uplink-simple-server,0.11.5,0.11.6,38,2,51,58,109,7,FALSE
nexus-uplink-simple-server,0.12.19,0.12.20,59,2,6,6,12,2,TRUE
nexus-uplink-simple-server,0.6.2,0.6.3,16,2,3,4,7,3,TRUE
nexus-uplink-simple-server,0.11.6,0.12.0,39,2,23,17,40,9,TRUE
nexus-uplink-simple-server,0.11.0,0.11.1,33,2,3,3,6,2,TRUE
nexus-uplink-simple-server,0.11.1,0.11.2,34,2,68,515,583,9,TRUE
nexus-uplink-simple-server,0.4.0,0.5.0,12,2,34,24,58,3,TRUE
nexus-uplink-simple-server,0.2.2,0.2.3,5,1,2,2,4,1,TRUE
nexus-uplink-simple-server,0.1.0,0.1.1,1,1,141,62,203,11,TRUE
nexus-uplink-simple-server,0.7.1,0.7.2,20,2,77,74,151,3,TRUE
nexus-uplink-simple-server,0.12.7,0.12.8,47,2,21,14,35,5,TRUE
nexus-uplink-simple-server,0.12.6,0.12.7,46,2,554,667,1221,5,TRUE
nexus-uplink-simple-server,0.12.1,0.12.2,41,2,3,3,6,2,TRUE
rest-on-couch,3.1.3,3.2.0,16,3,79,50,129,10,FALSE
rest-on-couch,1.1.0,1.2.0,3,11,3612,135,3747,36,FALSE
rest-on-couch,3.1.1,3.1.2,14,8,137,129,266,27,FALSE
rest-on-couch,3.1.0,3.1.1,13,2,19,2,21,3,FALSE
rest-on-couch,1.0.0,1.1.0,2,8,118,16,134,13,FALSE
rest-on-couch,2.0.2,2.1.0,7,3,38,11,49,4,FALSE
rest-on-couch,2.0.1,2.0.2,6,3,9,3,12,4,FALSE
rest-on-couch,2.0.0,2.0.1,5,2,7,2,9,3,FALSE
rest-on-couch,2.1.2,3.0.0,10,19,638,397,1035,57,FALSE
rest-on-couch,2.1.0,2.1.1,8,2,12,2,14,3,FALSE
rest-on-couch,2.1.1,2.1.2,9,2,19,10,29,3,FALSE
rest-on-couch,4.0.1,4.0.2,23,6,2397,1789,4186,57,FALSE
rest-on-couch,4.0.0,4.0.1,22,4,359,340,699,11,FALSE
rest-on-couch,4.0.2,4.1.0,24,8,1389,282,1671,49,FALSE
rest-on-couch,4.1.0,4.2.0,25,32,1737,930,2667,106,FALSE
rest-on-couch,3.0.0,3.0.1,11,6,55,35,90,14,FALSE
rest-on-couch,3.0.1,3.1.0,12,8,362,214,576,35,FALSE
rest-on-couch,3.1.2,3.1.3,15,3,70,49,119,6,FALSE
rest-on-couch,1.2.0,2.0.0,4,104,25655,4956,30611,377,FALSE
rest-on-couch,3.4.0,3.4.1,19,7,58,24,82,9,FALSE
rest-on-couch,3.4.1,3.5.0,20,5,75,99,174,9,FALSE
rest-on-couch,3.5.0,4.0.0,21,34,2107,89421,91528,117,FALSE
rest-on-couch,3.3.0,3.4.0,18,7,477,424,901,9,FALSE
rest-on-couch,4.2.0,4.2.1,26,3,514,526,1040,12,FALSE
rest-on-couch,3.2.0,3.3.0,17,3,264,152,416,8,FALSE
rest-on-couch,0.2.0,1.0.0,1,396,7999,3963,11962,1010,FALSE
rest-on-couch,4.0.1,4.0.2,23,6,2397,1789,4186,57,TRUE
rest-on-couch,3.1.1,3.1.2,14,8,137,129,266,27,TRUE
rest-on-couch,3.4.0,3.4.1,19,7,58,24,82,9,TRUE
rest-on-couch,3.2.0,3.3.0,17,3,264,152,416,8,TRUE
rest-on-couch,3.5.0,4.0.0,21,34,2107,89421,91528,117,TRUE
rest-on-couch,0.2.0,1.0.0,1,396,7999,3963,11962,1010,TRUE
rest-on-couch,3.4.1,3.5.0,20,5,75,99,174,9,TRUE
rest-on-couch,4.1.0,4.2.0,25,32,1737,930,2667,106,TRUE
rest-on-couch,2.1.2,3.0.0,10,19,638,397,1035,57,TRUE
rest-on-couch,3.0.1,3.1.0,12,8,362,214,576,35,TRUE
rest-on-couch,4.2.0,4.2.1,26,3,514,526,1040,12,TRUE
redux-form,3.1.3,3.1.4,90,5,3020,325,3345,45,FALSE
redux-form,3.1.2,3.1.3,89,2,28,5,33,4,FALSE
redux-form,3.1.1,3.1.2,88,5,213,42,255,13,FALSE
redux-form,3.1.0,3.1.1,87,6,2231,558,2789,37,FALSE
redux-form,3.1.7,4.0.0,94,3,369,118,487,17,FALSE
redux-form,3.1.6,3.1.7,93,13,703,81,784,30,FALSE
redux-form,3.1.5,3.1.6,92,5,185,28,213,7,FALSE
redux-form,3.1.4,3.1.5,91,4,426,36,462,9,FALSE
redux-form,4.0.1,4.0.2,96,1,631,128,759,5,FALSE
redux-form,4.0.0,4.0.1,95,9,589,100,689,18,FALSE
redux-form,4.0.3,4.0.4,98,15,781,220,1001,29,FALSE
redux-form,4.0.2,4.0.3,97,3,17,9,26,3,FALSE
redux-form,4.0.5,4.0.6,100,4,78,32,110,10,FALSE
redux-form,4.0.4,4.0.5,99,4,31,6,37,5,FALSE
redux-form,4.0.7,4.1.0,102,4,282,21,303,10,FALSE
redux-form,4.0.6,4.0.7,101,3,539,225,764,12,FALSE
redux-form,6.1.1,6.2.0,169,13,2245,754,2999,113,FALSE
redux-form,3.0.10,3.0.11,84,5,77,74,151,11,FALSE
redux-form,3.0.11,3.0.12,85,9,477,94,571,21,FALSE
redux-form,3.0.12,3.1.0,86,6,516,24,540,18,FALSE
redux-form,3.0.0-beta-4,3.0.0,73,11,265,140,405,27,FALSE
redux-form,3.0.0-beta-1,3.0.0-beta-2,70,5,14,8,22,7,FALSE
redux-form,3.0.0-beta-3,3.0.0-beta-4,72,7,176,49,225,17,FALSE
redux-form,3.0.0-beta-2,3.0.0-beta-3,71,3,89,20,109,6,FALSE
redux-form,5.2.2,5.2.3,132,17,1494,172,1666,72,FALSE
redux-form,5.2.3,5.2.4,133,256,38848,30268,69116,2186,FALSE
redux-form,5.2.0,5.2.1,130,3,294,28,322,33,FALSE
redux-form,5.2.1,5.2.2,131,3,45,10,55,5,FALSE
redux-form,5.2.4,5.2.5,134,32,2488,1091,3579,173,FALSE
redux-form,5.2.5,5.3.0,135,111,8142,2745,10887,423,FALSE
redux-form,5.0.0,5.0.1,123,2,24,23,47,8,FALSE
redux-form,5.0.1,5.1.0,124,13,229,97,326,22,FALSE
redux-form,6.5.0,6.6.0,179,36,5456,197,5653,112,FALSE
redux-form,6.1.0,6.1.1,168,10,4184,107,4291,56,FALSE
redux-form,6.0.0-alpha.8,6.0.0-alpha.9,150,22,615,147,762,88,FALSE
redux-form,6.0.0-alpha.9,6.0.0-alpha.10,151,2,10,9,19,10,FALSE
redux-form,6.0.0-alpha.2,6.0.0-alpha.3,144,1,662,659,1321,14,FALSE
redux-form,6.0.0-alpha.3,6.0.0-alpha.4,145,1,662,659,1321,14,FALSE
redux-form,6.0.0-alpha.1,6.0.0-alpha.2,143,1,662,659,1321,14,FALSE
redux-form,6.0.0-alpha.6,6.0.0-alpha.7,148,51,9255,2362,11617,450,FALSE
redux-form,6.0.0-alpha.7,6.0.0-alpha.8,149,38,2227,3538,5765,208,FALSE
redux-form,6.0.0-alpha.4,6.0.0-alpha.5,146,29,15814,12416,28230,319,FALSE
redux-form,6.0.0-alpha.5,6.0.0-alpha.6,147,10,1864,2700,4564,148,FALSE
redux-form,3.0.6,3.0.7,80,5,65,14,79,7,FALSE
redux-form,3.0.7,3.0.8,81,5,290,146,436,17,FALSE
redux-form,3.0.4,3.0.5,78,1,289,33,322,6,FALSE
redux-form,3.0.5,3.0.6,79,4,4,14,18,7,FALSE
redux-form,3.0.2,3.0.3,76,1,5,5,10,2,FALSE
redux-form,3.0.3,3.0.4,77,1,2,2,4,2,FALSE
redux-form,3.0.0,3.0.1,74,5,12,13,25,9,FALSE
redux-form,3.0.1,3.0.2,75,2,16,4,20,3,FALSE
redux-form,3.0.8,3.0.9,82,1,2,2,4,1,FALSE
redux-form,3.0.9,3.0.10,83,5,98,89,187,11,FALSE
redux-form,4.1.4,4.1.5,107,2,37,1,38,3,FALSE
redux-form,4.1.5,4.1.6,108,6,371,203,574,10,FALSE
redux-form,4.1.6,4.1.7,109,6,466,266,732,20,FALSE
redux-form,4.1.7,4.1.8,110,1,6,2,8,2,FALSE
redux-form,4.1.0,4.1.1,103,10,486,73,559,18,FALSE
redux-form,4.1.1,4.1.2,104,11,938,176,1114,40,FALSE
redux-form,4.1.2,4.1.3,105,6,152,12,164,8,FALSE
redux-form,4.1.3,4.1.4,106,11,207,11,218,16,FALSE
redux-form,4.1.8,4.1.9,111,4,127,7,134,6,FALSE
redux-form,4.1.9,4.1.10,112,5,23,19,42,7,FALSE
redux-form,6.0.0-alpha.14,6.0.0-alpha.15,156,48,5092,2116,7208,276,FALSE
redux-form,6.0.0-alpha.15,6.0.0-rc.1,157,85,4244,874,5118,271,FALSE
redux-form,6.0.0-alpha.10,6.0.0-alpha.11,152,28,1404,330,1734,173,FALSE
redux-form,6.0.0-alpha.11,6.0.0-alpha.12,153,6,92,68,160,44,FALSE
redux-form,6.0.0-alpha.12,6.0.0-alpha.13,154,3,206,162,368,49,FALSE
redux-form,6.0.0-alpha.13,6.0.0-alpha.14,155,171,29847,24924,54771,1472,FALSE
redux-form,6.2.1,6.3.0,171,9,45930,44933,90863,165,FALSE
redux-form,6.2.0,6.2.1,170,41,1194,506,1700,85,FALSE
redux-form,6.0.0-rc.4,6.0.0-rc.5,161,31,2909,281,3190,91,FALSE
redux-form,6.0.0-rc.5,6.0.1,162,27,27162,14972,42134,525,FALSE
redux-form,6.0.0-rc.2,6.0.0-rc.3,159,11,782,391,1173,77,FALSE
redux-form,6.0.0-rc.3,6.0.0-rc.4,160,37,24520,15017,39537,536,FALSE
redux-form,6.0.0-rc.1,6.0.0-rc.2,158,18,539,493,1032,68,FALSE
redux-form,6.3.0,6.3.1,172,12,556,200,756,71,FALSE
redux-form,6.3.1,6.3.2,173,1,0,3850,3850,1,FALSE
redux-form,6.3.2,6.4.0,174,16,1297,517,1814,122,FALSE
redux-form,6.0.3,6.0.4,165,1,71,70,141,49,FALSE
redux-form,6.0.2,6.0.3,164,18,1943,349,2292,114,FALSE
redux-form,6.0.1,6.0.2,163,17,184,80,264,45,FALSE
redux-form,6.0.5,6.1.0,167,21,2411,283,2694,191,FALSE
redux-form,6.0.4,6.0.5,166,4,127,133,260,74,FALSE
redux-form,6.4.3,6.5.0,178,30,2936,664,3600,170,FALSE
redux-form,5.1.0,5.1.1,125,3,15358,12243,27601,228,FALSE
redux-form,6.4.1,6.4.2,176,5,232,230,462,61,FALSE
redux-form,6.4.0,6.4.1,175,3,75,68,143,46,FALSE
redux-form,4.1.16,4.2.0,119,1,119,13,132,4,FALSE
redux-form,4.1.14,4.1.15,117,3,15,5,20,5,FALSE
redux-form,4.1.15,4.1.16,118,5,472,178,650,13,FALSE
redux-form,4.1.12,4.1.13,115,3,13,5,18,5,FALSE
redux-form,4.1.13,4.1.14,116,5,129,35,164,7,FALSE
redux-form,4.1.10,4.1.11,113,9,480,243,723,15,FALSE
redux-form,4.1.11,4.1.12,114,4,682,66,748,8,FALSE
redux-form,5.3.5,5.3.6,141,1,662,659,1321,14,FALSE
redux-form,5.3.4,5.3.5,140,95,9608,6318,15926,589,FALSE
redux-form,5.3.3,5.3.4,139,194,88166,66681,154847,1682,FALSE
redux-form,5.3.2,5.3.3,138,66,26737,15682,42419,664,FALSE
redux-form,5.3.1,5.3.2,137,68,4331,1233,5564,320,FALSE
redux-form,5.3.0,5.3.1,136,3,17,25,42,5,FALSE
redux-form,5.1.4,5.2.0,129,12,586,77,663,62,FALSE
redux-form,5.1.1,5.1.2,126,17,511,2625,3136,125,FALSE
redux-form,6.4.2,6.4.3,177,15,785,170,955,79,FALSE
redux-form,5.1.3,5.1.4,128,10,1521,189,1710,94,FALSE
redux-form,5.1.2,5.1.3,127,1,77,22,99,8,FALSE
redux-form,4.2.2,5.0.0,122,13,414,281,695,27,FALSE
redux-form,4.2.1,4.2.2,121,1,662,659,1321,14,FALSE
redux-form,4.2.0,4.2.1,120,27,1933,755,2688,90,FALSE
redux-form,6.6.1,6.6.2,181,7,690,475,1165,62,FALSE
redux-form,6.6.0,6.6.1,180,10,622,4734,5356,172,FALSE
redux-form,6.6.3,6.7.0,183,34,28663,21041,49704,767,FALSE
redux-form,6.6.2,6.6.3,182,10,709,237,946,40,FALSE
redux-form,6.0.0-alpha.13,6.0.0-alpha.14,155,171,29847,24924,54771,1472,TRUE
redux-form,6.4.0,6.4.1,175,3,75,68,143,46,TRUE
redux-form,1.1.0,1.2.0,27,5,7,4,11,5,FALSE
redux-form,1.0.0,1.0.1,25,1,2,2,4,2,FALSE
redux-form,1.0.1,1.1.0,26,3,19,15,34,4,FALSE
redux-form,2.0.1,2.1.0,52,2,13,4,17,4,FALSE
redux-form,2.0.0,2.0.1,51,11,472,410,882,26,FALSE
redux-form,1.3.4,1.4.0,34,6,556,120,676,27,FALSE
redux-form,2.2.5,2.2.6,58,1,14,8,22,3,FALSE
redux-form,2.2.4,2.2.5,57,1,18,13,31,2,FALSE
redux-form,2.2.6,2.2.7,59,3,7,1,8,3,FALSE
redux-form,2.2.1,2.2.3,55,4,71,56,127,6,FALSE
redux-form,2.2.0,2.2.1,54,1,662,659,1321,14,FALSE
redux-form,2.2.3,2.2.4,56,4,13,7,20,4,FALSE
redux-form,2.1.0,2.2.0,53,1,118,96,214,2,FALSE
redux-form,0.0.4,0.0.5,4,1,2,1,3,2,FALSE
redux-form,0.0.3,0.0.4,3,8,40,20,60,8,FALSE
redux-form,0.0.2,0.0.3,2,4,491,33,524,27,FALSE
redux-form,0.6.1,1.0.0,24,15,946,282,1228,54,FALSE
redux-form,0.6.0,0.6.1,23,3,365,223,588,7,FALSE
redux-form,1.6.2,1.6.3,43,1,662,659,1321,14,FALSE
redux-form,1.6.3,1.6.4,44,2,36,4,40,5,FALSE
redux-form,1.6.0,1.6.1,41,5,11,11,22,5,FALSE
redux-form,1.6.1,1.6.2,42,7,18,12,30,7,FALSE
redux-form,1.6.6,1.6.7,47,3,37,10,47,7,TRUE
redux-form,1.6.7,1.6.8,48,3,131,21,152,5,FALSE
redux-form,1.6.4,1.6.5,45,1,3,3,6,2,FALSE
redux-form,1.6.5,1.6.6,46,1,3,3,6,1,FALSE
redux-form,0.4.1,0.5.0,21,3,172,41,213,4,FALSE
redux-form,0.4.0,0.4.1,20,2,138,68,206,5,FALSE
redux-form,1.6.8,1.7.0,49,2,20,9,29,4,FALSE
redux-form,0.5.0,0.6.0,22,3,32,12,44,6,FALSE
redux-form,1.7.0,2.0.0,50,23,190,185,375,27,FALSE
redux-form,1.4.0,1.4.1,35,1,4,1,5,1,FALSE
redux-form,1.4.1,1.5.0,36,10,122,31,153,17,FALSE
redux-form,1.5.3,1.6.0,40,5,165,15,180,9,FALSE
redux-form,1.5.2,1.5.3,39,1,21,3,24,3,FALSE
redux-form,1.3.3,1.3.4,33,1,662,659,1321,14,FALSE
redux-form,1.3.2,1.3.3,32,2,13,4,17,4,FALSE
redux-form,1.3.1,1.3.2,31,1,662,659,1321,14,FALSE
redux-form,1.3.0,1.3.1,30,2,51,11,62,7,FALSE
redux-form,1.2.0,1.2.1,28,4,65,47,112,7,FALSE
redux-form,1.2.1,1.3.0,29,10,98,17,115,15,FALSE
redux-form,6.0.0-alpha.15,6.0.0-rc.1,157,85,4244,874,5118,271,TRUE
redux-form,6.0.0-alpha.5,6.0.0-alpha.6,147,10,1864,2700,4564,148,TRUE
redux-form,1.6.6,1.6.7,47,3,37,10,47,7,FALSE
redux-form,4.2.2,5.0.0,122,13,414,281,695,27,TRUE
redux-form,6.0.0-rc.5,6.0.1,162,27,27162,14972,42134,525,TRUE
redux-form,5.3.2,5.3.3,138,66,26737,15682,42419,664,TRUE
redux-form,0.3.0,0.4.0,19,4,6,5,11,4,FALSE
redux-form,3.0.0-beta-4,3.0.0,73,11,265,140,405,27,TRUE
redux-form,6.5.0,6.6.0,179,36,5456,197,5653,112,TRUE
redux-form,2.2.7,2.2.8,60,3,17,9,26,3,FALSE
redux-form,2.2.8,2.3.0,61,12,205,49,254,33,FALSE
redux-form,0.6.1,1.0.0,24,15,946,282,1228,54,TRUE
redux-form,0.4.0,0.4.1,20,2,138,68,206,5,TRUE
redux-form,1.5.1,1.5.2,38,1,3,3,6,1,FALSE
redux-form,1.5.0,1.5.1,37,2,3,3,6,2,FALSE
redux-form,1.5.3,1.6.0,40,5,165,15,180,9,TRUE
redux-form,2.4.3,2.4.4,67,1,1,2,3,2,FALSE
redux-form,2.4.2,2.4.3,66,4,514,53,567,22,FALSE
redux-form,2.4.1,2.4.2,65,16,2548,396,2944,65,FALSE
redux-form,2.4.0,2.4.1,64,3,358,385,743,25,FALSE
redux-form,2.4.5,3.0.0-beta-1,69,9,3338,2627,5965,81,FALSE
redux-form,2.4.4,2.4.5,68,4,27,6,33,6,FALSE
redux-form,0.2.5,0.3.0,18,2,386,347,733,12,FALSE
redux-form,0.2.4,0.2.5,17,4,415,226,641,12,FALSE
redux-form,0.2.3,0.2.4,16,1,662,659,1321,14,FALSE
redux-form,0.2.2,0.2.3,15,1,7,4,11,2,FALSE
redux-form,0.2.1,0.2.2,14,1,5,1,6,2,FALSE
redux-form,0.2.0,0.2.1,13,6,231,79,310,11,FALSE
redux-form,0.1.0,0.1.1,9,1,12,6,18,2,FALSE
redux-form,0.1.1,0.1.2,10,1,15,6,21,2,FALSE
redux-form,0.1.2,0.1.3,11,1,2,2,4,2,FALSE
redux-form,0.1.3,0.2.0,12,1,13,3,16,1,FALSE
redux-form,0.0.5,0.0.7,5,6,334,103,437,14,FALSE
redux-form,0.0.7,0.0.8,6,6,150,49,199,11,FALSE
redux-form,0.0.1,0.0.2,1,1,662,659,1321,14,FALSE
redux-form,0.0.9,0.1.0,8,17,79,51,130,22,TRUE
redux-form,0.0.8,0.0.9,7,2,51,4,55,5,FALSE
redux-form,2.3.0,2.3.1,62,1,662,659,1321,14,FALSE
redux-form,2.3.1,2.4.0,63,2,4,3,7,3,FALSE
redux-form,4.2.0,4.2.1,120,27,1933,755,2688,90,TRUE
redux-form,6.6.2,6.6.3,182,10,709,237,946,40,TRUE
redux-form,6.0.0-alpha.8,6.0.0-alpha.9,150,22,615,147,762,88,TRUE
redux-form,1.6.5,1.6.6,46,1,3,3,6,1,TRUE
redux-form,1.4.1,1.5.0,36,10,122,31,153,17,TRUE
redux-form,6.2.1,6.3.0,171,9,45930,44933,90863,165,TRUE
redux-form,6.0.0-rc.4,6.0.0-rc.5,161,31,2909,281,3190,91,TRUE
redux-form,0.0.9,0.1.0,8,17,79,51,130,22,FALSE
redux-form,5.2.5,5.3.0,135,111,8142,2745,10887,423,TRUE
redux-form,5.0.1,5.1.0,124,13,229,97,326,22,TRUE
redux-form,2.0.1,2.1.0,52,2,13,4,17,4,TRUE
redux-form,2.2.0,2.2.1,54,1,662,659,1321,14,TRUE
redux-form,1.5.2,1.5.3,39,1,21,3,24,3,TRUE
redux-form,3.1.3,3.1.4,90,5,3020,325,3345,45,TRUE
redux-form,3.1.0,3.1.1,87,6,2231,558,2789,37,TRUE
redux-form,6.0.2,6.0.3,164,18,1943,349,2292,114,TRUE
redux-form,0.4.1,0.5.0,21,3,172,41,213,4,TRUE
redux-form,1.5.0,1.5.1,37,2,3,3,6,2,TRUE
redux-form,1.1.0,1.2.0,27,5,7,4,11,5,TRUE
redux-form,0.0.7,0.0.8,6,6,150,49,199,11,TRUE
redux-form,0.0.3,0.0.4,3,8,40,20,60,8,TRUE
redux-form,0.3.0,0.4.0,19,4,6,5,11,4,TRUE
redux-form,3.0.2,3.0.3,76,1,5,5,10,2,TRUE
redux-form,4.1.0,4.1.1,103,10,486,73,559,18,TRUE
redux-form,3.1.6,3.1.7,93,13,703,81,784,30,TRUE
redux-form,3.0.12,3.1.0,86,6,516,24,540,18,TRUE
redux-form,3.0.4,3.0.5,78,1,289,33,322,6,TRUE
redux-form,2.4.1,2.4.2,65,16,2548,396,2944,65,TRUE
redux-form,0.2.3,0.2.4,16,1,662,659,1321,14,TRUE
redux-form,3.0.0-beta-3,3.0.0-beta-4,72,7,176,49,225,17,TRUE
redux-form,3.0.0-beta-2,3.0.0-beta-3,71,3,89,20,109,6,TRUE
redux-form,5.0.0,5.0.1,123,2,24,23,47,8,TRUE
redux-form,6.3.1,6.3.2,173,1,0,3850,3850,1,TRUE
redux-form,4.2.1,4.2.2,121,1,662,659,1321,14,TRUE
redux-form,3.0.5,3.0.6,79,4,4,14,18,7,TRUE
redux-form,4.0.5,4.0.6,100,4,78,32,110,10,TRUE
redux-form,3.0.10,3.0.11,84,5,77,74,151,11,TRUE
redux-form,6.0.0-alpha.4,6.0.0-alpha.5,146,29,15814,12416,28230,319,TRUE
redux-form,5.1.4,5.2.0,129,12,586,77,663,62,TRUE
redux-form,5.1.1,5.1.2,126,17,511,2625,3136,125,TRUE
redux-form,6.6.1,6.6.2,181,7,690,475,1165,62,TRUE
redux-form,6.0.0-alpha.11,6.0.0-alpha.12,153,6,92,68,160,44,TRUE
redux-form,0.5.0,0.6.0,22,3,32,12,44,6,TRUE
redux-form,6.1.0,6.1.1,168,10,4184,107,4291,56,TRUE
redux-form,6.0.0-alpha.10,6.0.0-alpha.11,152,28,1404,330,1734,173,TRUE
redux-form,6.0.0-rc.2,6.0.0-rc.3,159,11,782,391,1173,77,TRUE
redux-form,4.1.5,4.1.6,108,6,371,203,574,10,TRUE
react-announce-size,0.0.5,0.0.6,5,2,5,3,8,3,FALSE
react-announce-size,0.0.4,0.0.5,4,2,2,3,5,2,FALSE
react-announce-size,0.0.7,0.0.8,7,2,2,6,8,3,FALSE
react-announce-size,0.0.6,0.0.7,6,6,39,29,68,8,FALSE
react-announce-size,0.0.1,0.0.2,1,3,44,13,57,4,FALSE
react-announce-size,0.0.3,0.0.4,3,2,5,4,9,3,FALSE
react-announce-size,0.0.2,0.0.3,2,4,66,3,69,4,FALSE
react-announce-size,0.0.9,0.0.11,10,11,30,45,75,14,FALSE
react-announce-size,0.0.8,0.0.9-0,8,3,69,58,127,5,FALSE
react-announce-size,0.0.11,0.2.0,11,13,145,64,209,23,TRUE
react-announce-size,0.0.9-0,0.0.9,9,1,22,2,24,1,FALSE
react-announce-size,0.2.0,0.2.1,12,1,2,1,3,1,FALSE
react-announce-size,0.3.0,0.3.1,14,3,4,4,8,3,FALSE
react-announce-size,0.0.11,0.2.0,11,13,145,64,209,23,FALSE
react-announce-size,0.2.1,0.3.0,13,3,15,10,25,4,FALSE
react-announce-size,1.0.0,1.0.1,20,3,36,11,47,5,FALSE
react-announce-size,1.0.1,1.1.0,21,4,77,15,92,7,FALSE
react-announce-size,0.3.1,0.4.0,15,6,211,27,238,12,FALSE
react-announce-size,0.4.1,0.4.2,17,2,42,14,56,3,FALSE
react-announce-size,0.4.0,0.4.1,16,4,17,7,24,4,FALSE
react-announce-size,0.4.3,1.0.0,19,10,155,386,541,21,FALSE
react-announce-size,0.4.2,0.4.3,18,3,69,23,92,3,FALSE
node-rev,1.0.4,1.1.0,5,3,202,126,328,6,FALSE
node-rev,1.1.0,1.1.1,6,2,2,3,5,3,FALSE
node-rev,1.1.1,1.1.2,7,2,15,1,16,2,FALSE
node-rev,1.1.2,1.1.3,8,3,19,3,22,3,FALSE
node-rev,1.0.0,1.0.1,1,9,1761,7,1768,24,FALSE
node-rev,1.0.1,1.0.2,2,1,0,0,0,0,FALSE
node-rev,1.0.2,1.0.3,3,4,4,4,8,4,FALSE
node-rev,1.0.3,1.0.4,4,2,2,2,4,2,FALSE
node-rev,1.1.3,1.2.0,9,2,3,3,6,2,FALSE
node-rev,1.2.0,1.3.0,10,11,158,1367,1525,14,FALSE
node-rev,1.1.3,1.2.0,9,2,3,3,6,2,TRUE
node-rev,1.0.4,1.1.0,5,3,202,126,328,6,TRUE
node-rev,1.0.2,1.0.3,3,4,4,4,8,4,TRUE
vue-build,0.9.0,0.9.1,17,5,55,53,108,14,FALSE
vue-build,0.9.1,0.9.2,18,4,36,6,42,7,FALSE
vue-build,0.10.0,0.11.0,20,13,1438,1480,2918,37,FALSE
vue-build,0.11.4,0.12.0,25,3,72,6,78,8,FALSE
vue-build,0.11.0,0.11.1,21,3,16,8,24,8,FALSE
vue-build,0.11.1,0.11.2,22,3,12,2,14,4,FALSE
vue-build,0.11.2,0.11.3,23,3,41,8,49,11,FALSE
vue-build,0.11.3,0.11.4,24,2,16,16,32,6,FALSE
vue-build,0.17.0,0.18.0,31,4,24,42,66,8,FALSE
vue-build,0.12.0,0.13.0,26,5,35,2,37,6,FALSE
vue-build,0.20.0,0.21.0,35,3,678,726,1404,5,FALSE
vue-build,0.23.0,0.24.0,38,5,8,4,12,6,FALSE
vue-build,0.13.0,0.14.0,27,4,140,98,238,13,FALSE
vue-build,0.15.0,0.15.1,29,3,6,12,18,4,FALSE
vue-build,0.15.1,0.17.0,30,9,384,276,660,20,FALSE
vue-build,0.9.2,0.10.0,19,6,207,125,332,17,FALSE
vue-build,0.19.0,0.20.0,34,5,14,16,30,5,FALSE
vue-build,0.14.0,0.15.0,28,9,214,24,238,16,FALSE
vue-build,0.22.0,0.23.0,37,3,9,4,13,5,FALSE
vue-build,0.24.0,0.25.0,39,2,10,10,20,2,FALSE
vue-build,0.21.0,0.22.0,36,6,64,14,78,11,FALSE
vue-build,0.8.1,0.9.0,16,13,66,66,132,17,FALSE
vue-build,0.25.0,0.26.0,40,2,4,4,8,2,FALSE
vue-build,0.8.0,0.8.1,15,3,324,54,378,4,FALSE
vue-build,0.29.1,0.29.2,47,7,1024,244,1268,77,FALSE
vue-build,0.29.0,0.29.1,46,6,13638,14,13652,35,FALSE
vue-build,0.29.3,0.29.4,49,2,2648,2862,5510,4,FALSE
vue-build,0.29.2,0.29.3,48,3,8,12,20,6,FALSE
vue-build,0.29.4,0.30.0,50,7,108,116,224,17,FALSE
vue-build,0.18.1,0.19.0,33,5,113,113,226,11,FALSE
vue-build,0.18.0,0.18.1,32,8,767,611,1378,20,FALSE
vue-build,0.26.0,0.27.0,41,3,6,2,8,6,FALSE
vue-build,0.28.0,0.28.1,44,3,20,2,22,4,FALSE
vue-build,0.28.1,0.29.0,45,3,6,4,10,5,FALSE
vue-build,0.27.1,0.28.0,43,2,38,30,68,6,FALSE
vue-build,0.27.0,0.27.1,42,2,4,4,8,2,FALSE
vue-build,0.30.1,0.30.2,52,4,4,4,8,4,TRUE
vue-build,0.30.0,0.30.1,51,3,12,4,16,4,FALSE
vue-build,0.37.0,0.37.1,65,3,8,4,12,4,FALSE
vue-build,0.37.1,0.38.0,66,11,1328,502,1830,94,FALSE
vue-build,0.35.0,0.35.1,62,8,24,50,74,17,FALSE
vue-build,0.35.1,0.36.0,63,3,16,30,46,12,FALSE
vue-build,0.3.2,0.3.3,5,2,4,4,8,4,FALSE
vue-build,0.3.3,0.3.4,6,2,38,48,86,6,FALSE
vue-build,0.3.0,0.3.2,4,4,14,14,28,14,FALSE
vue-build,0.3.6,0.4.0,9,5,68,16,84,18,FALSE
vue-build,0.3.4,0.3.5,7,3,4,4,8,3,FALSE
vue-build,0.3.5,0.3.6,8,2,6,2,8,2,FALSE
vue-build,0.27.1,0.28.0,43,2,38,30,68,6,TRUE
vue-build,0.27.0,0.27.1,42,2,4,4,8,2,TRUE
vue-build,0.49.1,0.50.0,88,4,47,8,55,5,FALSE
vue-build,0.49.0,0.49.1,87,3,4,12,16,4,FALSE
vue-build,0.42.0,0.43.0,74,9,143,119,262,13,FALSE
vue-build,0.36.0,0.37.0,64,6,74,107,181,17,FALSE
vue-build,0.40.0,0.40.1,71,6,10,12,22,9,FALSE
vue-build,0.40.1,0.41.0,72,11,7917,7301,15218,22,FALSE
vue-build,0.34.0,0.35.0,61,3,108,68,176,22,FALSE
vue-build,0.46.0,0.46.1,81,2,6,6,12,4,FALSE
vue-build,0.46.1,0.47.0,82,2,28,28,56,2,FALSE
vue-build,0.44.0,0.45.0,78,4,1459,1191,2650,7,FALSE
vue-build,0.30.3,0.31.0,54,9,289,67,356,28,FALSE
vue-build,0.30.2,0.30.3,53,2,6,10,16,4,FALSE
vue-build,0.30.1,0.30.2,52,4,4,4,8,4,FALSE
vue-build,0.39.1,0.40.0,70,9,1406,349,1755,96,FALSE
vue-build,0.31.2,0.31.3,57,22,947,487,1434,79,FALSE
vue-build,0.31.3,0.32.0,58,19,172,81,253,60,FALSE
vue-build,0.31.0,0.31.1,55,3,24,302,326,6,FALSE
vue-build,0.31.1,0.31.2,56,6,762,410,1172,30,FALSE
vue-build,0.39.0,0.39.1,69,4,327,127,454,30,FALSE
vue-build,0.43.1,0.43.2,76,3,4,4,8,4,FALSE
vue-build,0.43.0,0.43.1,75,5,12,4,16,6,FALSE
vue-build,0.43.2,0.44.0,77,6,166,40,206,22,FALSE
vue-build,0.6.1,0.7.0,13,2,30,12,42,4,FALSE
vue-build,0.6.0,0.6.1,12,2,10,8,18,2,FALSE
vue-build,0.4.0,0.5.0,10,19,964,682,1646,41,FALSE
vue-build,0.41.0,0.42.0,73,8,308,236,544,28,FALSE
vue-build,0.47.0,0.48.0,83,4,1102,1080,2182,5,FALSE
vue-build,0.45.1,0.46.0,80,5,230,56,286,7,FALSE
vue-build,0.45.0,0.45.1,79,3,10,4,14,4,FALSE
vue-build,0.33.0,0.34.0,60,8,145,108,253,22,FALSE
vue-build,0.32.0,0.33.0,59,25,1418,16571,17989,140,FALSE
vue-build,0.2.1,0.3.0,3,3,166,42,208,15,FALSE
vue-build,0.2.0,0.2.1,2,2,8,22,30,4,FALSE
vue-build,0.1.0,0.2.0,1,2,58,42,100,10,FALSE
vue-build,0.38.1,0.39.0,68,5,132,84,216,9,FALSE
vue-build,0.38.0,0.38.1,67,3,130,32,162,6,FALSE
vue-build,0.7.0,0.8.0,14,2,28,36,64,6,FALSE
vue-build,0.5.0,0.6.0,11,6,105,33,138,14,FALSE
vue-build,0.48.2,0.49.0,86,3,288,236,524,5,FALSE
vue-build,0.48.0,0.48.1,84,3,4,10,14,4,FALSE
vue-build,0.48.1,0.48.2,85,3,4,4,8,4,FALSE
vue-build,0.17.0,0.18.0,31,4,24,42,66,8,TRUE
vue-build,0.34.0,0.35.0,61,3,108,68,176,22,TRUE
vue-build,0.32.0,0.33.0,59,25,1418,16571,17989,140,TRUE
vue-build,0.39.0,0.39.1,69,4,327,127,454,30,TRUE
vue-build,0.42.0,0.43.0,74,9,143,119,262,13,TRUE
vue-build,0.29.4,0.30.0,50,7,108,116,224,17,TRUE
vue-build,0.19.0,0.20.0,34,5,14,16,30,5,TRUE
vue-build,0.47.0,0.48.0,83,4,1102,1080,2182,5,TRUE
vue-build,0.38.1,0.39.0,68,5,132,84,216,9,TRUE
vue-build,0.37.1,0.38.0,66,11,1328,502,1830,94,TRUE
vue-build,0.33.0,0.34.0,60,8,145,108,253,22,TRUE
vue-build,0.40.0,0.40.1,71,6,10,12,22,9,TRUE
vue-build,0.40.1,0.41.0,72,11,7917,7301,15218,22,TRUE
vue-build,0.6.1,0.7.0,13,2,30,12,42,4,TRUE
vue-build,0.9.2,0.10.0,19,6,207,125,332,17,TRUE
vue-build,0.22.0,0.23.0,37,3,9,4,13,5,TRUE
vue-build,0.41.0,0.42.0,73,8,308,236,544,28,TRUE
vue-build,0.8.0,0.8.1,15,3,324,54,378,4,TRUE
vue-build,0.36.0,0.37.0,64,6,74,107,181,17,TRUE
vue-build,0.39.1,0.40.0,70,9,1406,349,1755,96,TRUE
vue-build,0.29.1,0.29.2,47,7,1024,244,1268,77,TRUE
vue-build,0.2.1,0.3.0,3,3,166,42,208,15,TRUE
vue-build,0.3.0,0.3.2,4,4,14,14,28,14,TRUE
vue-build,0.2.0,0.2.1,2,2,8,22,30,4,TRUE
vue-build,0.18.1,0.19.0,33,5,113,113,226,11,TRUE
vue-build,0.24.0,0.25.0,39,2,10,10,20,2,TRUE
vue-build,0.46.1,0.47.0,82,2,28,28,56,2,TRUE
vue-build,0.5.0,0.6.0,11,6,105,33,138,14,TRUE
vue-build,0.49.1,0.50.0,88,4,47,8,55,5,TRUE
vue-build,0.15.1,0.17.0,30,9,384,276,660,20,TRUE
vue-build,0.31.3,0.32.0,58,19,172,81,253,60,TRUE
vue-build,0.43.0,0.43.1,75,5,12,4,16,6,TRUE
vue-build,0.3.2,0.3.3,5,2,4,4,8,4,TRUE
vue-build,0.46.0,0.46.1,81,2,6,6,12,4,TRUE
vue-build,0.45.1,0.46.0,80,5,230,56,286,7,TRUE
vue-build,0.44.0,0.45.0,78,4,1459,1191,2650,7,TRUE
vue-build,0.48.2,0.49.0,86,3,288,236,524,5,TRUE
vue-build,0.28.1,0.29.0,45,3,6,4,10,5,TRUE
vue-build,0.8.1,0.9.0,16,13,66,66,132,17,TRUE
vue-build,0.26.0,0.27.0,41,3,6,2,8,6,TRUE
vue-build,0.20.0,0.21.0,35,3,678,726,1404,5,TRUE
vue-build,0.1.0,0.2.0,1,2,58,42,100,10,TRUE
baobab-meteor-utils,0.2.0,0.3.0,6,1,132,19,151,7,FALSE
baobab-meteor-utils,0.1.0,0.1.1,1,1,132,19,151,7,FALSE
baobab-meteor-utils,0.1.1,0.1.2,2,4,15,5,20,7,FALSE
baobab-meteor-utils,0.1.2,0.1.3,3,1,2,2,4,2,FALSE
baobab-meteor-utils,0.1.3,0.1.4,4,1,3,8,11,2,FALSE
baobab-meteor-utils,0.1.4,0.2.0,5,2,22,19,41,6,FALSE
baobab-meteor-utils,0.1.3,0.1.4,4,1,3,8,11,2,TRUE
reboundjs,0.3.2,0.3.3,100,1,110,11,121,6,FALSE
reboundjs,0.3.3,0.3.4,101,1,136,6,142,5,FALSE
reboundjs,0.3.0,0.3.1,98,1,47,23,70,3,FALSE
reboundjs,0.3.1,0.3.2,99,4,28,15,43,6,FALSE
reboundjs,0.2.3,0.3.0,97,1,1,1,2,1,FALSE
reboundjs,0.2.2,0.2.3,96,1,67,20,87,8,FALSE
reboundjs,0.2.1,0.2.2,95,4,435,474,909,36,FALSE
reboundjs,0.2.0,0.2.1,94,1,11,11,22,4,FALSE
reboundjs,0.1.0,0.1.1,88,2,19,14,33,4,FALSE
reboundjs,0.1.1,0.1.2,89,1,2,2,4,2,FALSE
reboundjs,0.1.2,0.1.3,90,1,89,49,138,7,FALSE
reboundjs,0.1.3,0.1.4,91,1,3,3,6,2,FALSE
reboundjs,0.1.4,0.1.5,92,1,31,15,46,4,FALSE
reboundjs,0.0.5,0.0.6,4,1,136,6,142,5,FALSE
reboundjs,0.0.4,0.0.5,3,1,4,4,8,2,FALSE
reboundjs,0.0.13,0.0.14,10,4,355,127,482,29,FALSE
reboundjs,0.0.3,0.0.4,2,1,2,2,4,2,FALSE
reboundjs,0.0.14,0.0.15,11,2,149,101,250,9,FALSE
reboundjs,0.0.9,0.0.10,7,1,1,1,2,1,FALSE
reboundjs,0.0.17,0.0.18,14,9,632,231,863,24,FALSE
reboundjs,0.0.20,0.0.21,17,1,2,2,4,2,FALSE
reboundjs,0.0.21,0.0.22,18,1,39,33,72,9,FALSE
reboundjs,0.0.22,0.0.23,19,1,2,2,4,2,FALSE
reboundjs,0.0.23,0.0.24,20,9,1104,96,1200,25,FALSE
reboundjs,0.0.24,0.0.25,21,1,12,3,15,3,FALSE
reboundjs,0.0.10,0.0.12,8,13,2833,57527,60360,99,FALSE
reboundjs,0.0.12,0.0.13,9,1,136,6,142,5,FALSE
reboundjs,0.0.16,0.0.17,13,2,21,12,33,7,FALSE
reboundjs,0.0.19,0.0.20,16,2,11,34,45,10,FALSE
reboundjs,0.0.18,0.0.19,15,1,24,123,147,9,FALSE
reboundjs,0.0.15,0.0.16,12,8,1910,963,2873,71,FALSE
reboundjs,0.0.25,0.0.26,22,1,13,8,21,2,FALSE
reboundjs,0.0.72,0.0.74,68,1,331,290,621,4,FALSE
reboundjs,0.0.71,0.0.72,67,4,265,226,491,9,FALSE
reboundjs,0.0.70,0.0.71,66,1,6,2,8,2,FALSE
reboundjs,0.0.77,0.0.78,72,1,30,12,42,5,FALSE
reboundjs,0.0.76,0.0.77,71,3,550,199,749,21,FALSE
reboundjs,0.0.75,0.0.76,70,2,68,54,122,3,FALSE
reboundjs,0.0.74,0.0.75,69,2,17,5,22,4,FALSE
reboundjs,0.0.94,0.0.97,86,6,140,73,213,16,FALSE
reboundjs,0.0.79,0.0.80,74,1,2,2,4,1,FALSE
reboundjs,0.0.78,0.0.79,73,14,6226,5984,12210,115,FALSE
reboundjs,0.0.90,0.0.94,85,28,2283,1163,3446,167,FALSE
reboundjs,0.0.59,0.0.60,55,1,17,10,27,4,FALSE
reboundjs,0.0.58,0.0.59,54,1,15,15,30,2,FALSE
reboundjs,0.0.51,0.0.52,47,2,25,15,40,7,FALSE
reboundjs,0.0.50,0.0.51,46,5,10,9,19,5,FALSE
reboundjs,0.0.53,0.0.54,49,2,1,2,3,2,FALSE
reboundjs,0.0.52,0.0.53,48,1,1,2,3,2,FALSE
reboundjs,0.0.55,0.0.56,51,1,18,6,24,4,FALSE
reboundjs,0.0.54,0.0.55,50,1,3,3,6,2,FALSE
reboundjs,0.0.57,0.0.58,53,1,149,88,237,10,FALSE
reboundjs,0.0.56,0.0.57,52,1,15,4,19,3,FALSE
reboundjs,0.0.68,0.0.69,64,1,11,3,14,3,FALSE
reboundjs,0.0.62,0.0.63,58,1,8,8,16,1,FALSE
reboundjs,0.1.5,0.2.0,93,18,7123,8737,15860,294,FALSE
reboundjs,0.0.97,0.1.0,87,18,2099,1346,3445,148,FALSE
reboundjs,0.0.64,0.0.65,60,1,222,29,251,14,FALSE
reboundjs,0.0.65,0.0.66,61,5,350,154,504,25,FALSE
reboundjs,0.0.66,0.0.67,62,3,8,17,25,5,FALSE
reboundjs,0.0.67,0.0.68,63,1,105,52,157,12,FALSE
reboundjs,0.0.60,0.0.61,56,1,35,2,37,5,FALSE
reboundjs,0.0.61,0.0.62,57,2,1179,809,1988,15,FALSE
reboundjs,0.0.88,0.0.89,83,2,2,2,4,2,FALSE
reboundjs,0.0.89,0.0.90,84,1,7,2,9,3,FALSE
reboundjs,0.0.86,0.0.87,81,2,9,3,12,4,FALSE
reboundjs,0.0.87,0.0.88,82,1,28,1,29,2,FALSE
reboundjs,0.0.84,0.0.85,79,2,2,2,4,2,FALSE
reboundjs,0.0.85,0.0.86,80,1,58,10,68,6,FALSE
reboundjs,0.0.82,0.0.83,77,11,157,231,388,35,FALSE
reboundjs,0.0.69,0.0.70,65,1,1,1,2,1,FALSE
reboundjs,0.0.80,0.0.81,75,2,20,30,50,3,FALSE
reboundjs,0.0.83,0.0.84,78,1,8,9,17,2,FALSE
reboundjs,0.0.48,0.0.49,44,1,3,24,27,2,FALSE
reboundjs,0.0.49,0.0.50,45,3,83,11,94,4,FALSE
reboundjs,0.0.81,0.0.82,76,1,9,9,18,3,FALSE
reboundjs,0.0.47,0.0.48,43,26,2100,1911,4011,178,FALSE
reboundjs,0.0.63,0.0.64,59,4,124,115,239,14,FALSE
reboundjs,0.2.3,0.3.0,97,1,1,1,2,1,TRUE
reboundjs,0.0.29,0.0.30,25,1,136,6,142,5,FALSE
reboundjs,0.0.34,0.0.35,30,8,46579,47633,94212,100,FALSE
reboundjs,0.0.30,0.0.31,26,2,4,4,8,4,FALSE
reboundjs,0.0.33,0.0.34,29,7,208,103,311,31,FALSE
reboundjs,0.0.32,0.0.33,28,3,7463,14728,22191,64,FALSE
reboundjs,0.0.36,0.0.37,32,11,330,459,789,21,FALSE
reboundjs,0.0.28,0.0.29,24,4,19,23,42,6,FALSE
reboundjs,0.0.37,0.0.38,33,7,1381,1213,2594,59,FALSE
reboundjs,0.0.31,0.0.32,27,3,21,51,72,12,FALSE
reboundjs,0.0.39,0.0.40,35,1,136,6,142,5,FALSE
reboundjs,0.0.38,0.0.39,34,2,47,78,125,14,FALSE
reboundjs,0.0.42,0.0.43,38,3,2404,35276,37680,59,FALSE
reboundjs,0.0.43,0.0.44,39,1,63,45,108,12,FALSE
reboundjs,0.0.40,0.0.41,36,6,4828,23738,28566,100,FALSE
reboundjs,0.0.41,0.0.42,37,1,18912,52,18964,10,FALSE
reboundjs,0.0.35,0.0.36,31,1,83,2,85,4,FALSE
reboundjs,0.0.44,0.0.45,40,10,16262,13556,29818,166,FALSE
reboundjs,0.0.45,0.0.46,41,9,1123,730,1853,84,FALSE
reboundjs,0.3.3,0.3.4,101,1,136,6,142,5,TRUE
reboundjs,0.0.46,0.0.47,42,24,31095,76755,107850,522,FALSE
reboundjs,0.0.77,0.0.78,72,1,30,12,42,5,TRUE
reboundjs,0.0.75,0.0.76,70,2,68,54,122,3,TRUE
reboundjs,0.0.94,0.0.97,86,6,140,73,213,16,TRUE
reboundjs,0.0.52,0.0.53,48,1,1,2,3,2,TRUE
reboundjs,0.0.65,0.0.66,61,5,350,154,504,25,TRUE
reboundjs,0.0.74,0.0.75,69,2,17,5,22,4,TRUE
reboundjs,0.0.51,0.0.52,47,2,25,15,40,7,TRUE
reboundjs,0.3.1,0.3.2,99,4,28,15,43,6,TRUE
reboundjs,0.0.87,0.0.88,82,1,28,1,29,2,TRUE
react-querybuilder,1.0.4,1.0.5,5,2,3,1,4,2,FALSE
react-querybuilder,1.0.5,1.0.6,6,3,4,2,6,3,FALSE
react-querybuilder,1.0.6,1.0.7,7,2,6,2,8,2,FALSE
react-querybuilder,1.0.7,1.0.8,8,2,10,9,19,2,FALSE
react-querybuilder,1.0.0,1.0.1,1,4,84,25,109,4,FALSE
react-querybuilder,1.0.1,1.0.2,2,1,947,4,951,5,FALSE
react-querybuilder,1.0.2,1.0.3,3,2,70,49,119,8,FALSE
react-querybuilder,1.0.3,1.0.4,4,5,21753,153,21906,18,FALSE
react-querybuilder,1.1.0,1.2.0,12,5,68444,66365,134809,18,FALSE
react-querybuilder,1.0.8,1.0.9,9,4,193,7,200,11,FALSE
react-querybuilder,1.0.9,1.0.10,10,9,446,276,722,35,FALSE
react-querybuilder,1.3.0,1.3.4,14,17,14296,8306,22602,44,FALSE
react-querybuilder,1.3.6,1.3.7,17,3,3501,2030,5531,13,FALSE
react-querybuilder,1.3.5,1.3.6,16,14,669,6713,7382,47,FALSE
react-querybuilder,1.3.4,1.3.5,15,7,14400,13318,27718,16,FALSE
react-querybuilder,1.2.0,1.3.0,13,43,12306,3288,15594,157,FALSE
react-querybuilder,1.0.10,1.1.0,11,3,99,39,138,9,FALSE
react-querybuilder,1.0.9,1.0.10,10,9,446,276,722,35,TRUE
react-querybuilder,1.0.10,1.1.0,11,3,99,39,138,9,TRUE
react-querybuilder,1.3.0,1.3.4,14,17,14296,8306,22602,44,TRUE
react-querybuilder,1.3.5,1.3.6,16,14,669,6713,7382,47,TRUE
test-bed,0.3.1,0.4.0,1,20,974,200,1174,53,FALSE
test-bed,0.6.0,0.7.0,5,3,17,4,21,4,FALSE
test-bed,0.7.0,0.77.77,6,26,6227,728,6955,47,FALSE
test-bed,0.4.0,0.5.2,2,7,47,9,56,12,FALSE
test-bed,0.5.2,0.5.3,3,2,2,1,3,2,FALSE
test-bed,0.5.3,0.6.0,4,4,44,7,51,7,FALSE
test-bed,0.3.1,0.4.0,1,20,974,200,1174,53,TRUE
run-if-changed,0.0.4,0.0.6,4,2,32,27,59,7,FALSE
run-if-changed,0.0.1,0.0.2,1,2,736,490,1226,33,FALSE
run-if-changed,0.0.3,0.0.4,3,9,832,119,951,37,FALSE
run-if-changed,0.0.2,0.0.3,2,3,38,60,98,12,FALSE
run-if-changed,0.0.4,0.0.6,4,2,32,27,59,7,TRUE
run-if-changed,0.0.3,0.0.4,3,9,832,119,951,37,TRUE
run-if-changed,0.0.2,0.0.3,2,3,38,60,98,12,TRUE
generator-react-ui,0.0.20,0.0.21,20,1,7,1,8,2,FALSE
generator-react-ui,0.0.21,0.0.22,21,1,2,2,4,2,FALSE
generator-react-ui,0.0.22,0.0.23,22,1,3,3,6,3,FALSE
generator-react-ui,0.0.15,0.0.16,15,1,3,2,5,1,FALSE
generator-react-ui,0.0.14,0.0.15,14,4,41,2,43,4,FALSE
generator-react-ui,0.0.17,0.0.18,17,2,6,4,10,2,FALSE
generator-react-ui,0.0.16,0.0.17,16,1,2,1,3,2,FALSE
generator-react-ui,0.0.19,0.0.20,19,2,2,2,4,2,FALSE
generator-react-ui,0.0.18,0.0.19,18,6,100,55,155,24,FALSE
generator-react-ui,0.0.14,0.0.15,14,4,41,2,43,4,TRUE
generator-react-ui,0.0.17,0.0.18,17,2,6,4,10,2,TRUE
generator-react-ui,0.0.16,0.0.17,16,1,2,1,3,2,TRUE
generator-react-ui,0.0.11,0.0.12,11,1,17,13,30,3,FALSE
generator-react-ui,0.0.10,0.0.11,10,1,3,3,6,3,FALSE
generator-react-ui,0.0.13,0.0.14,13,1,3,3,6,3,FALSE
generator-react-ui,0.0.12,0.0.13,12,1,1,2,3,2,FALSE
generator-react-ui,0.0.5,0.0.6,5,2,1,3,4,2,FALSE
generator-react-ui,0.0.4,0.0.5,4,2,10,7,17,2,FALSE
generator-react-ui,0.0.7,0.0.8,7,1,3,3,6,3,FALSE
generator-react-ui,0.0.6,0.0.7,6,2,44,7,51,4,FALSE
generator-react-ui,0.0.1,0.0.2,1,2,10,7,17,3,FALSE
generator-react-ui,0.0.3,0.0.4,3,5,37,2,39,5,FALSE
generator-react-ui,0.0.2,0.0.3,2,2,4,2,6,3,FALSE
generator-react-ui,0.0.9,0.0.10,9,1,3,3,6,3,FALSE
generator-react-ui,0.0.8,0.0.9,8,2,5,1,6,2,FALSE
simple-react-firebase,0.0.5,0.0.6,5,3,330,8,338,12,FALSE
simple-react-firebase,0.0.4,0.0.5,4,1,9,8,17,1,TRUE
simple-react-firebase,0.0.7,0.0.8,7,1,66,2,68,3,FALSE
simple-react-firebase,0.0.6,0.0.7,6,1,20,31,51,3,FALSE
simple-react-firebase,0.0.9,0.1.0,9,1,37,19,56,3,FALSE
simple-react-firebase,0.0.8,0.0.9,8,1,2,2,4,2,FALSE
simple-react-firebase,0.1.0,0.1.1,10,1,66,2,68,3,FALSE
simple-react-firebase,0.1.1,0.1.2,11,1,8,6,14,3,FALSE
simple-react-firebase,0.1.2,0.1.3,12,1,9,2,11,2,FALSE
simple-react-firebase,0.0.4,0.0.5,4,1,9,8,17,1,FALSE
simple-react-firebase,0.0.7,0.0.8,7,1,66,2,68,3,TRUE
simple-react-firebase,0.0.1,0.0.2,1,1,66,2,68,3,FALSE
simple-react-firebase,0.0.3,0.0.4,3,1,136,1,137,2,FALSE
simple-react-firebase,0.0.2,0.0.3,2,1,201,0,201,6,FALSE
redux-awesome-modal,1.0.0,1.0.1,1,6,242,63,305,6,FALSE
redux-awesome-modal,1.0.1,1.0.2,2,2,4,2,6,2,TRUE
redux-awesome-modal,1.0.2,1.0.3,3,2,12,2,14,2,FALSE
redux-awesome-modal,1.0.3,1.0.4,4,2,9,5,14,2,FALSE
redux-awesome-modal,1.0.1,1.0.2,2,2,4,2,6,2,FALSE
redux-awesome-modal,1.0.3,1.0.4,4,2,9,5,14,2,TRUE
paye,1.1.0,1.2.0,4,3,223,207,430,4,FALSE
paye,1.0.0,1.0.1,1,2,44,50,94,5,FALSE
paye,1.0.1,1.0.2,2,2,123,20,143,5,FALSE
paye,1.0.2,1.1.0,3,2,143,6,149,4,FALSE
paye,1.3.1,2.0.0,8,2,312,18,330,5,FALSE
paye,1.3.0,1.3.1,7,2,3,3,6,2,FALSE
paye,1.2.0,1.2.1,5,2,173,80,253,4,FALSE
paye,1.2.1,1.3.0,6,2,20,14,34,3,FALSE
paye,1.1.0,1.2.0,4,3,223,207,430,4,TRUE
article-json-to-fbia,1.1.1,1.2.0,3,4,14,11,25,7,FALSE
article-json-to-fbia,1.1.0,1.1.1,2,3,13,10,23,6,FALSE
article-json-to-fbia,1.0.0,1.1.0,1,4,116,6,122,9,FALSE
article-json-to-fbia,1.3.0,1.3.1,5,2,10,10,20,3,FALSE
article-json-to-fbia,1.2.0,1.3.0,4,5,100,12,112,11,FALSE
article-json-to-fbia,1.2.0,1.3.0,4,5,100,12,112,11,TRUE
larvitbase,1.1.1,1.1.2,50,1,10,2,12,2,FALSE
larvitbase,1.1.0,1.1.1,49,1,31,12,43,3,FALSE
larvitbase,1.1.3,1.1.4,52,1,4,2,6,2,FALSE
larvitbase,1.1.2,1.1.3,51,2,4,4,8,3,FALSE
larvitbase,1.1.5,1.1.6,54,2,31,3,34,5,FALSE
larvitbase,1.1.4,1.1.5,53,3,38,10,48,8,FALSE
larvitbase,1.1.7,1.1.8,56,5,216,191,407,14,FALSE
larvitbase,1.1.6,1.1.7,55,4,9,21,30,4,TRUE
larvitbase,1.1.9,1.1.10,58,1,2,7,9,2,FALSE
larvitbase,1.1.8,1.1.9,57,1,2,2,4,1,FALSE
larvitbase,1.1.11,1.1.12,60,1,18,13,31,2,FALSE
larvitbase,1.1.10,1.1.11,59,1,8,8,16,2,FALSE
larvitbase,1.0.1,1.0.2,46,2,18,4,22,2,FALSE
larvitbase,1.0.2,1.0.3,47,1,42,25,67,3,FALSE
larvitbase,1.0.3,1.1.0,48,1,104,75,179,3,FALSE
larvitbase,0.1.8,0.1.9,37,1,2,2,4,2,FALSE
larvitbase,0.1.9,0.1.10,38,1,10,10,20,1,FALSE
larvitbase,1.0.0,1.0.1,45,2,2,2,4,2,FALSE
larvitbase,0.1.5,0.1.6,34,1,4,1,5,2,FALSE
larvitbase,0.1.6,0.1.7,35,1,46,17,63,2,FALSE
larvitbase,0.1.7,0.1.8,36,1,3,2,5,2,FALSE
larvitbase,1.1.6,1.1.7,55,4,9,21,30,4,FALSE
larvitbase,1.1.4,1.1.5,53,3,38,10,48,8,TRUE
larvitbase,0.1.12,0.1.13,41,1,59,47,106,1,FALSE
larvitbase,0.1.13,0.1.14,42,1,4,4,8,1,FALSE
larvitbase,0.1.10,0.1.11,39,1,125,120,245,2,FALSE
larvitbase,0.1.11,0.1.12,40,1,12,12,24,1,TRUE
larvitbase,0.1.14,0.1.15,43,1,3,3,6,1,FALSE
larvitbase,0.1.15,1.0.0,44,9,202,107,309,12,FALSE
larvitbase,0.0.3-beta,0.0.4-beta,3,1,9,11,20,2,FALSE
larvitbase,0.0.7-beta,0.0.8-beta,7,2,33,55,88,4,FALSE
larvitbase,0.0.15-beta,0.0.16-beta,15,1,15,6,21,2,FALSE
larvitbase,0.0.12-beta,0.0.13-beta,12,1,2,2,4,2,FALSE
larvitbase,0.0.16-beta,0.0.17-beta,16,1,22,10,32,3,FALSE
larvitbase,0.1.0,0.1.1,29,1,19,16,35,2,FALSE
larvitbase,0.1.1,0.1.2,30,1,54,48,102,2,FALSE
larvitbase,0.0.9-beta,0.0.10-beta,9,1,155,114,269,3,FALSE
larvitbase,0.1.3,0.1.4,32,1,14,39,53,3,FALSE
larvitbase,0.0.19,0.0.20,19,1,15,2,17,2,FALSE
larvitbase,0.0.18,0.0.19,18,1,2,2,4,2,FALSE
larvitbase,0.1.2,0.1.3,31,1,2,2,4,2,FALSE
larvitbase,0.0.13-beta,0.0.14-beta,13,1,3,2,5,1,FALSE
larvitbase,0.1.4,0.1.5,33,2,31,3,34,4,FALSE
larvitbase,0.0.10-beta,0.0.11-beta,10,1,11,7,18,2,FALSE
larvitbase,0.0.14-beta,0.0.15-beta,14,1,30,27,57,2,FALSE
larvitbase,0.0.28,0.1.0,28,4,91,116,207,9,FALSE
larvitbase,0.0.17-beta,0.0.18,17,1,92,21,113,3,FALSE
larvitbase,0.0.8-beta,0.0.9-beta,8,1,29,5,34,2,FALSE
larvitbase,0.0.20,0.0.21,20,1,3,4,7,2,FALSE
larvitbase,0.0.21,0.0.22,21,1,6,2,8,2,FALSE
larvitbase,0.0.22,0.0.23,22,1,26,28,54,2,FALSE
larvitbase,0.0.23,0.0.24,23,1,36,7,43,4,FALSE
larvitbase,0.0.24,0.0.25,24,2,1,1,2,2,FALSE
larvitbase,0.0.25,0.0.26,25,1,30,1,31,3,FALSE
larvitbase,0.0.26,0.0.27,26,1,3,2,5,1,FALSE
larvitbase,0.0.27,0.0.28,27,1,126,5,131,2,FALSE
larvitbase,0.0.4-beta,0.0.5-beta,4,8,52,14,66,9,FALSE
larvitbase,0.0.6-beta,0.0.7-beta,6,1,41,6,47,2,FALSE
larvitbase,0.1.11,0.1.12,40,1,12,12,24,1,FALSE
larvitbase,0.0.5-beta,0.0.6-beta,5,1,1,2,3,1,FALSE
larvitbase,0.0.11-beta,0.0.12-beta,11,1,6,2,8,2,FALSE
larvitbase,0.0.2-beta,0.0.3-beta,2,1,117,40,157,4,FALSE
larvitbase,1.1.10,1.1.11,59,1,8,8,16,2,TRUE
larvitbase,0.0.1-beta,0.0.2-beta,1,1,1,1,2,1,FALSE
larvitbase,1.1.2,1.1.3,51,2,4,4,8,3,TRUE
larvitbase,0.1.8,0.1.9,37,1,2,2,4,2,TRUE
larvitbase,0.1.14,0.1.15,43,1,3,3,6,1,TRUE
larvitbase,0.0.21,0.0.22,21,1,6,2,8,2,TRUE
larvitbase,0.1.12,0.1.13,41,1,59,47,106,1,TRUE
organism-react-ajax,0.0.73,0.0.74,71,1,61,51,112,8,FALSE
organism-react-ajax,0.0.72,0.0.73,70,1,61,51,112,8,FALSE
organism-react-ajax,0.0.75,0.0.76,73,8,1144,64533,65677,67,FALSE
organism-react-ajax,0.0.74,0.0.75,72,13,7925,3707,11632,74,FALSE
organism-react-ajax,0.0.4,0.0.6,5,10,9911,9586,19497,47,FALSE
organism-react-ajax,0.0.6,0.0.8,6,1,61,51,112,8,FALSE
organism-react-ajax,0.0.1,0.0.2,2,1,61,51,112,8,FALSE
organism-react-ajax,0.0.0,0.0.1,1,1,61,51,112,8,FALSE
organism-react-ajax,0.0.3,0.0.4,4,1,36,14,50,4,FALSE
organism-react-ajax,0.0.2,0.0.3,3,1,61,51,112,8,FALSE
organism-react-ajax,0.0.9,0.0.10,8,1,3,20,23,2,FALSE
organism-react-ajax,0.0.8,0.0.9,7,1,21,9,30,3,FALSE
organism-react-ajax,0.0.11,0.0.12,10,1,2,1,3,2,FALSE
organism-react-ajax,0.0.10,0.0.11,9,2,2324,19,2343,7,FALSE
organism-react-ajax,0.0.71,0.0.72,69,3,225,124,349,14,FALSE
organism-react-ajax,0.0.70,0.0.71,68,2,24,18,42,6,FALSE
organism-react-ajax,0.0.13,0.0.14,12,82,194080,55712,249792,449,FALSE
organism-react-ajax,0.0.12,0.0.13,11,3,9001,3591,12592,16,FALSE
organism-react-ajax,0.0.15,0.0.16,14,5,179,135,314,15,FALSE
organism-react-ajax,0.0.14,0.0.15,13,2,36,158,194,11,FALSE
organism-react-ajax,0.0.17,0.0.18,16,4,19344,15175,34519,17,FALSE
organism-react-ajax,0.0.16,0.0.17,15,3,2409,2,2411,9,FALSE
organism-react-ajax,0.0.39,0.0.40,37,1,27,9,36,3,FALSE
organism-react-ajax,0.0.38,0.0.39,36,1,61,51,112,8,FALSE
organism-react-ajax,0.0.37,0.0.38,35,1,19,21,40,2,FALSE
organism-react-ajax,0.0.36,0.0.37,34,1,61,51,112,8,FALSE
organism-react-ajax,0.0.35,0.0.36,33,1,3,3,6,2,FALSE
organism-react-ajax,0.0.52,0.0.53,50,1,61,51,112,8,FALSE
organism-react-ajax,0.0.19,0.0.20,18,3,15344,14941,30285,13,FALSE
organism-react-ajax,0.0.54,0.0.55,52,1,61,51,112,8,FALSE
organism-react-ajax,0.0.31,0.0.32,30,1,61,51,112,8,FALSE
organism-react-ajax,0.0.30,0.0.31,29,2,55,42,97,6,FALSE
organism-react-ajax,0.0.33,0.0.35,32,2,249,203,452,9,FALSE
organism-react-ajax,0.0.32,0.0.33,31,1,102,12,114,5,FALSE
organism-react-ajax,0.0.53,0.0.54,51,1,21,14,35,5,FALSE
organism-react-ajax,0.0.57,0.0.58,55,12,5052,3070,8122,43,FALSE
organism-react-ajax,0.0.56,0.0.57,54,10,5044,2334,7378,53,FALSE
organism-react-ajax,0.0.64,0.0.65,62,3,1941,58,1999,12,FALSE
organism-react-ajax,0.0.65,0.0.66,63,2,120,124,244,5,FALSE
organism-react-ajax,0.0.66,0.0.67,64,23,46232,25354,71586,204,FALSE
organism-react-ajax,0.0.67,0.0.68,65,15,5056,4425,9481,68,FALSE
organism-react-ajax,0.0.60,0.0.61,58,2,39,45,84,6,FALSE
organism-react-ajax,0.0.61,0.0.62,59,2,1999,159,2158,9,FALSE
organism-react-ajax,0.0.62,0.0.63,60,1,23,18,41,3,FALSE
organism-react-ajax,0.0.63,0.0.64,61,1,59,32,91,4,FALSE
organism-react-ajax,0.0.68,0.0.69,66,2,118,111,229,6,FALSE
organism-react-ajax,0.0.69,0.0.70,67,2,46,32,78,5,FALSE
organism-react-ajax,0.0.20,0.0.21,19,1,8,4,12,2,FALSE
organism-react-ajax,0.0.21,0.0.22,20,1,15,12,27,4,FALSE
organism-react-ajax,0.0.22,0.0.23,21,6,18332,14704,33036,73,FALSE
organism-react-ajax,0.0.23,0.0.24,22,1,61,51,112,8,FALSE
organism-react-ajax,0.0.24,0.0.25,23,1,31,27,58,4,FALSE
organism-react-ajax,0.0.25,0.0.26,24,1,61,51,112,8,FALSE
organism-react-ajax,0.0.26,0.0.27,25,1,22,18,40,16,FALSE
organism-react-ajax,0.0.27,0.0.28,26,2,211,307,518,9,FALSE
organism-react-ajax,0.0.28,0.0.29,27,1,91,65,156,3,FALSE
organism-react-ajax,0.0.43,0.0.44,41,4,10133,2321,12454,20,FALSE
organism-react-ajax,0.0.40,0.0.41,38,1,61,51,112,8,FALSE
organism-react-ajax,0.0.41,0.0.42,39,1,61,51,112,8,FALSE
organism-react-ajax,0.0.46,0.0.47,44,2,25,33,58,5,FALSE
organism-react-ajax,0.0.47,0.0.48,45,1,61,51,112,8,FALSE
organism-react-ajax,0.0.29,0.0.30,28,1,6,10,16,2,FALSE
organism-react-ajax,0.0.45,0.0.46,43,1,5213,476,5689,20,FALSE
organism-react-ajax,0.0.59,0.0.60,57,4,177,102,279,14,FALSE
organism-react-ajax,0.0.42,0.0.43,40,2,2206,10,2216,12,FALSE
organism-react-ajax,0.0.58,0.0.59,56,1,61,51,112,8,FALSE
organism-react-ajax,0.0.48,0.0.49,46,2,22,14,36,6,FALSE
organism-react-ajax,0.0.55,0.0.56,53,1,14,9,23,3,FALSE
organism-react-ajax,0.0.18,0.0.19,17,17,41321,45312,86633,101,FALSE
organism-react-ajax,0.0.49,0.0.50,47,1,61,51,112,8,FALSE
organism-react-ajax,0.0.51,0.0.52,49,7,4701,46,4747,29,FALSE
organism-react-ajax,0.0.50,0.0.51,48,3,209,175,384,8,FALSE
organism-react-ajax,0.0.44,0.0.45,42,1,191,194,385,3,FALSE
organism-react-ajax,0.0.66,0.0.67,64,23,46232,25354,71586,204,TRUE
organism-react-ajax,0.0.3,0.0.4,4,1,36,14,50,4,TRUE
organism-react-ajax,0.0.29,0.0.30,28,1,6,10,16,2,TRUE
twitter-server,1.1.1,1.1.2,4,3,19,16,35,3,FALSE
twitter-server,1.1.0,1.1.1,3,3,17225,31,17256,12,FALSE
twitter-server,1.2.12,1.2.13,18,1,1,1,2,1,FALSE
twitter-server,1.1.2,1.2.0,5,4,108,75,183,9,FALSE
twitter-server,1.0.0,1.0.1,1,4,25,3,28,4,FALSE
twitter-server,1.0.1,1.1.0,2,5,54,17,71,8,FALSE
twitter-server,1.2.11,1.2.12,17,2,25,3,28,3,FALSE
twitter-server,1.2.13,1.3.0,19,12,346,128,474,23,FALSE
twitter-server,1.2.6,1.2.7,12,2,13,4,17,2,FALSE
twitter-server,1.2.7,1.2.8,13,2,18,2,20,3,FALSE
twitter-server,1.2.4,1.2.5,10,3,20,7,27,6,FALSE
twitter-server,1.2.5,1.2.6,11,7,31,22,53,8,FALSE
twitter-server,1.2.2,1.2.3,8,2,38,22,60,3,FALSE
twitter-server,1.2.3,1.2.4,9,10,31,28,59,15,FALSE
twitter-server,1.2.0,1.2.1,6,4,46,6,52,5,FALSE
twitter-server,1.2.1,1.2.2,7,2,24,10,34,2,FALSE
twitter-server,1.2.10,1.2.11,16,2,2,2,4,2,FALSE
twitter-server,1.3.0,1.4.0,20,4,4,10,14,5,FALSE
twitter-server,1.2.8,1.2.9,14,4,4,20,24,4,FALSE
twitter-server,1.2.9,1.2.10,15,2,17,1,18,2,FALSE
twitter-server,1.2.10,1.2.11,16,2,2,2,4,2,TRUE
twitter-server,1.2.9,1.2.10,15,2,17,1,18,2,TRUE
fetch-one,0.6.2,0.6.3,8,2,3,1,4,3,TRUE
fetch-one,0.6.1,0.6.2,7,3,5,5,10,3,FALSE
fetch-one,0.6.0,0.6.1,6,2,2,1,3,2,FALSE
fetch-one,0.2.0,0.3.0,2,4,53,18,71,9,FALSE
fetch-one,0.1.0,0.2.0,1,3,32,15,47,6,FALSE
fetch-one,0.4.0,0.5.0,4,3,3,3,6,3,FALSE
fetch-one,0.5.0,0.6.0,5,4,54,10,64,6,FALSE
fetch-one,0.3.0,0.4.0,3,1,11,3,14,1,FALSE
fetch-one,0.6.2,0.6.3,8,2,3,1,4,3,FALSE
bless-css-webpack-plugin,1.1.0,2.0.0,3,2,16387,16388,32775,5,FALSE
bless-css-webpack-plugin,1.0.0,1.0.1,1,1,16,7,23,4,FALSE
bless-css-webpack-plugin,1.0.1,1.1.0,2,12,45021,121,45142,29,FALSE
bless-css-webpack-plugin,1.0.1,1.1.0,2,12,45021,121,45142,29,TRUE
bless-css-webpack-plugin,1.0.0,1.0.1,1,1,16,7,23,4,TRUE
simple-ng-websocket,0.1.1,0.1.2,2,1,2,2,4,2,FALSE
simple-ng-websocket,0.1.0,0.1.1,1,3,204,24,228,9,FALSE
simple-ng-websocket,0.1.0,0.1.1,1,3,204,24,228,9,TRUE
record-desktop,0.2.3,0.3.0,8,7,82,28,110,20,FALSE
record-desktop,0.2.2,0.2.3,7,2,9,7,16,5,FALSE
record-desktop,0.2.1,0.2.2,6,3,7,1,8,3,FALSE
record-desktop,0.2.0,0.2.1,5,2,14,10,24,4,FALSE
record-desktop,0.1.0,0.1.1,3,7,65,17,82,14,FALSE
record-desktop,0.1.1,0.2.0,4,2,39,9,48,9,FALSE
record-desktop,0.3.0,0.4.0,9,9,174,63,237,19,FALSE
record-desktop,0.4.9,0.4.10,18,2,2,1,3,2,FALSE
record-desktop,0.4.8,0.4.9,17,1,1,1,2,1,FALSE
record-desktop,0.4.1,0.4.3,11,5,35,4,39,8,FALSE
record-desktop,0.4.0,0.4.1,10,2,7,3,10,4,FALSE
record-desktop,0.4.3,0.4.4,12,1,1,1,2,1,FALSE
record-desktop,0.4.5,0.4.6,14,2,3,2,5,2,FALSE
record-desktop,0.5.1,0.5.2,23,6,602,288,890,11,FALSE
record-desktop,0.4.7,0.4.8,16,2,14,2,16,3,FALSE
record-desktop,0.4.6,0.4.7,15,2,2,2,4,2,FALSE
record-desktop,0.4.11,0.4.12,20,2,3,3,6,2,FALSE
record-desktop,0.4.10,0.4.11,19,2,8,3,11,3,FALSE
record-desktop,0.4.12,0.5.0,21,7,156,168,324,16,FALSE
record-desktop,0.5.0,0.5.1,22,7,6517,46,6563,22,FALSE
record-desktop,0.4.4,0.4.5,13,2,3,5,8,3,FALSE
record-desktop,0.0.1,0.1.0,2,5,396,75,471,34,FALSE
record-desktop,0.0.0,0.0.1,1,2,8,3,11,3,FALSE
record-desktop,0.2.0,0.2.1,5,2,14,10,24,4,TRUE
cerebral-addons,0.4.10,0.5.0,24,1,1,1,2,1,TRUE
cerebral-addons,0.6.2,0.6.3,32,1,3,1,4,3,FALSE
cerebral-addons,0.6.1,0.6.2,31,6,241,287,528,15,FALSE
cerebral-addons,0.6.0,0.6.1,30,1,32,30,62,1,FALSE
cerebral-addons,0.5.4,0.6.0,29,11,2144,572,2716,71,FALSE
cerebral-addons,0.5.0,0.5.1,25,1,1,1,2,1,TRUE
cerebral-addons,0.5.1,0.5.2,26,1,1,1,2,1,FALSE
cerebral-addons,0.5.2,0.5.3,27,1,1,1,2,1,FALSE
cerebral-addons,0.5.3,0.5.4,28,1,1,1,2,1,FALSE
cerebral-addons,0.4.10,0.5.0,24,1,1,1,2,1,FALSE
cerebral-addons,0.4.9,0.4.10,23,1,1,1,2,1,FALSE
cerebral-addons,0.4.8,0.4.9,22,1,1,1,2,1,FALSE
cerebral-addons,0.1.0,0.1.1,1,1,1,1,2,1,FALSE
cerebral-addons,0.1.1,0.1.2,2,1,1,1,2,1,FALSE
cerebral-addons,0.1.2,0.1.3,3,1,1,1,2,1,FALSE
cerebral-addons,0.1.3,0.2.0,4,1,1,1,2,1,FALSE
cerebral-addons,0.5.0,0.5.1,25,1,1,1,2,1,FALSE
cerebral-addons,0.3.1,0.3.2,11,1,1,1,2,1,FALSE
cerebral-addons,0.2.4,0.3.0,9,1,1,1,2,1,FALSE
cerebral-addons,0.2.3,0.2.4,8,1,1,1,2,1,FALSE
cerebral-addons,0.2.2,0.2.3,7,1,1,1,2,1,FALSE
cerebral-addons,0.2.1,0.2.2,6,1,1,1,2,1,FALSE
cerebral-addons,0.3.3,0.4.0,13,1,1,1,2,1,FALSE
cerebral-addons,0.3.0,0.3.1,10,1,1,1,2,1,FALSE
cerebral-addons,0.6.0,0.6.1,30,1,32,30,62,1,TRUE
cerebral-addons,0.4.1,0.4.2,15,1,1,1,2,1,FALSE
cerebral-addons,0.4.0,0.4.1,14,1,1,1,2,1,FALSE
cerebral-addons,0.4.3,0.4.4,17,1,1,1,2,1,FALSE
cerebral-addons,0.4.2,0.4.3,16,1,1,1,2,1,FALSE
cerebral-addons,0.5.3,0.5.4,28,1,1,1,2,1,TRUE
cerebral-addons,0.4.5,0.4.6,19,1,1,1,2,1,FALSE
cerebral-addons,0.4.4,0.4.5,18,1,1,1,2,1,FALSE
cerebral-addons,0.3.2,0.3.3,12,1,1,1,2,1,FALSE
cerebral-addons,0.4.7,0.4.8,21,1,1,1,2,1,TRUE
cerebral-addons,0.6.2,0.6.3,32,1,3,1,4,3,TRUE
cerebral-addons,0.4.6,0.4.7,20,1,1,1,2,1,FALSE
cerebral-addons,0.2.0,0.2.1,5,1,1,1,2,1,FALSE
cerebral-addons,0.4.5,0.4.6,19,1,1,1,2,1,TRUE
cerebral-addons,0.4.7,0.4.8,21,1,1,1,2,1,FALSE
cerebral-addons,0.4.3,0.4.4,17,1,1,1,2,1,TRUE
cerebral-addons,0.4.4,0.4.5,18,1,1,1,2,1,TRUE
fortysixelks-node,0.3.0,0.3.1,8,2,22,2,24,2,FALSE
fortysixelks-node,0.2.3,0.3.0,7,2,11,10,21,4,FALSE
fortysixelks-node,0.2.2,0.2.3,6,2,7,7,14,2,FALSE
fortysixelks-node,0.2.1,0.2.2,5,2,3,4,7,3,FALSE
fortysixelks-node,0.2.0,0.2.1,4,3,24,5,29,4,FALSE
fortysixelks-node,0.1.2,0.1.3,1,2,2,2,4,2,FALSE
fortysixelks-node,0.1.3,0.1.4,2,14,99,25,124,15,FALSE
fortysixelks-node,0.1.4,0.2.0,3,2,170,41,211,6,FALSE
fortysixelks-node,0.2.3,0.3.0,7,2,11,10,21,4,TRUE
mole-redux,1.0.0,1.0.3,1,4,11,20,31,11,FALSE
mole-redux,1.0.3,1.0.4,2,6,110,110,220,18,FALSE
mole-redux,1.0.0,1.0.3,1,4,11,20,31,11,TRUE
schema-based-json-editor,3.8.1,3.9.0,24,2,185,441,626,35,FALSE
schema-based-json-editor,3.7.3,3.7.4,21,1,90,113,203,12,FALSE
schema-based-json-editor,3.7.4,3.8.0,22,8,973,947,1920,63,FALSE
schema-based-json-editor,3.7.1,3.7.2,19,1,11,3,14,3,FALSE
schema-based-json-editor,3.8.0,3.8.1,23,2,36,20,56,15,FALSE
schema-based-json-editor,3.7.2,3.7.3,20,9,101,167,268,30,FALSE
schema-based-json-editor,1.0.0,1.0.1,1,3,33,20,53,7,FALSE
schema-based-json-editor,1.0.1,1.1.0,2,9,2151,597,2748,158,FALSE
schema-based-json-editor,1.1.0,2.0.0,3,8,968,1048,2016,159,FALSE
schema-based-json-editor,3.1.0,3.2.0,7,5,1347,541,1888,172,FALSE
schema-based-json-editor,2.0.1,3.0.0,5,1,146,121,267,25,FALSE
schema-based-json-editor,2.0.0,2.0.1,4,3,180,27,207,23,FALSE
schema-based-json-editor,3.0.0,3.1.0,6,3,408,303,711,66,FALSE
schema-based-json-editor,3.6.1,3.6.2,16,2,12,12,24,6,FALSE
schema-based-json-editor,3.4.0,3.5.0,12,6,299,152,451,45,FALSE
schema-based-json-editor,3.5.1,3.6.0,14,1,72,15,87,7,FALSE
schema-based-json-editor,3.5.0,3.5.1,13,1,86,55,141,10,FALSE
schema-based-json-editor,3.6.0,3.6.1,15,1,90,113,203,12,FALSE
schema-based-json-editor,3.3.0,3.4.0,11,8,1493,4934,6427,216,FALSE
schema-based-json-editor,3.6.2,3.7.0,17,13,947,497,1444,80,FALSE
schema-based-json-editor,3.2.0,3.2.1,8,1,189,215,404,58,FALSE
schema-based-json-editor,3.2.1,3.2.2,9,1,23,23,46,24,FALSE
schema-based-json-editor,3.2.2,3.3.0,10,4,1784,1088,2872,172,FALSE
schema-based-json-editor,3.7.0,3.7.1,18,5,230,107,337,26,FALSE
schema-based-json-editor,2.0.0,2.0.1,4,3,180,27,207,23,TRUE
schema-based-json-editor,1.1.0,2.0.0,3,8,968,1048,2016,159,TRUE
schema-based-json-editor,3.1.0,3.2.0,7,5,1347,541,1888,172,TRUE
schema-based-json-editor,1.0.1,1.1.0,2,9,2151,597,2748,158,TRUE
schema-based-json-editor,2.0.1,3.0.0,5,1,146,121,267,25,TRUE
schema-based-json-editor,3.0.0,3.1.0,6,3,408,303,711,66,TRUE
schema-based-json-editor,3.4.0,3.5.0,12,6,299,152,451,45,TRUE
schema-based-json-editor,3.5.1,3.6.0,14,1,72,15,87,7,TRUE
schema-based-json-editor,3.5.0,3.5.1,13,1,86,55,141,10,TRUE
schema-based-json-editor,3.3.0,3.4.0,11,8,1493,4934,6427,216,TRUE
schema-based-json-editor,3.2.2,3.3.0,10,4,1784,1088,2872,172,TRUE
schema-based-json-editor,3.6.2,3.7.0,17,13,947,497,1444,80,TRUE
fuge-runner,0.9.0,0.10.0,29,8,46,39,85,8,FALSE
fuge-runner,0.10.0,1.0.0,30,32,4937,3274,8211,199,FALSE
fuge-runner,1.0.0,1.0.1,31,1,10,10,20,1,FALSE
fuge-runner,1.0.1,1.0.2,32,8,2864,1445,4309,63,FALSE
fuge-runner,0.8.4,0.9.0,28,15,3415,3137,6552,99,FALSE
fuge-runner,0.7.0,0.7.1,23,2,26,21,47,4,FALSE
fuge-runner,0.2.1,0.4.0,6,2,20,13,33,4,FALSE
fuge-runner,0.2.0,0.2.1,5,2,13,12,25,4,FALSE
fuge-runner,0.1.1,0.1.2,2,2,7,5,12,3,FALSE
fuge-runner,0.1.2,0.1.3,3,1,1,1,2,1,FALSE
fuge-runner,0.6.4,0.6.5,21,2,5,6,11,3,FALSE
fuge-runner,0.1.3,0.2.0,4,4,830,143,973,19,FALSE
fuge-runner,0.6.3,0.6.4,20,2,8,1,9,2,FALSE
fuge-runner,0.6.2,0.6.3,19,9,144,45,189,19,FALSE
fuge-runner,0.7.4,0.8.4,27,12,73,55,128,14,FALSE
fuge-runner,0.6.0,0.6.1,17,2,7,2,9,2,FALSE
fuge-runner,0.7.2,0.7.3,25,3,5,3,8,3,FALSE
fuge-runner,0.7.3,0.7.4,26,3,7,7,14,3,FALSE
fuge-runner,0.6.5,0.7.0,22,19,542,149,691,47,FALSE
fuge-runner,0.7.1,0.7.2,24,3,3,3,6,3,FALSE
fuge-runner,0.4.8,0.5.0,15,3,34,13,47,7,FALSE
fuge-runner,0.4.1,0.4.2,8,3,122,69,191,5,FALSE
fuge-runner,0.4.0,0.4.1,7,1,6,1,7,2,FALSE
fuge-runner,0.4.3,0.4.4,10,2,6,2,8,2,FALSE
fuge-runner,0.4.2,0.4.3,9,2,54,8,62,4,FALSE
fuge-runner,0.4.5,0.4.6,12,2,15,3,18,2,FALSE
fuge-runner,0.4.4,0.4.5,11,1,8,3,11,2,FALSE
fuge-runner,0.4.7,0.4.8,14,3,32,3,35,4,FALSE
fuge-runner,0.4.6,0.4.7,13,1,21,5,26,2,FALSE
fuge-runner,0.5.0,0.6.0,16,2,13,4,17,2,FALSE
fuge-runner,0.6.1,0.6.2,18,1,1,1,2,1,FALSE
fuge-runner,0.1.0,0.1.1,1,1,10,10,20,1,FALSE
fuge-runner,0.7.2,0.7.3,25,3,5,3,8,3,TRUE
fuge-runner,0.1.1,0.1.2,2,2,7,5,12,3,TRUE
vue-toastr,1.0.4,2.0.0,5,7,539,389,928,46,FALSE
vue-toastr,2.0.5,2.0.6,11,2,84,10,94,10,FALSE
vue-toastr,2.0.4,2.0.5,10,2,43,31,74,16,FALSE
vue-toastr,1.0.0,1.0.1,1,1,5,1,6,1,FALSE
vue-toastr,1.0.1,1.0.2,2,3,131,86,217,20,FALSE
vue-toastr,2.0.1,2.0.2,7,1,2,6,8,2,FALSE
vue-toastr,2.0.0,2.0.1,6,3,10,27,37,5,FALSE
vue-toastr,1.0.3,1.0.4,4,4,23,19,42,9,FALSE
vue-toastr,2.0.3,2.0.4,9,1,77,23,100,11,FALSE
vue-toastr,1.0.2,1.0.3,3,1,27,11,38,8,FALSE
vue-toastr,2.0.2,2.0.3,8,2,41,8,49,3,FALSE
vue-toastr,1.0.3,1.0.4,4,4,23,19,42,9,TRUE
vue-toastr,2.0.3,2.0.4,9,1,77,23,100,11,TRUE
vue-toastr,2.0.2,2.0.3,8,2,41,8,49,3,TRUE
vue-toastr,2.0.4,2.0.5,10,2,43,31,74,16,TRUE
lucabro-linked-list,1.0.0,1.0.1,1,1,1,1,2,1,FALSE
lucabro-linked-list,1.0.1,1.0.2,2,1,1,1,2,1,FALSE
lucabro-linked-list,1.0.2,1.0.3,3,1,1,1,2,1,FALSE
lucabro-linked-list,1.0.3,1.0.4,4,1,1,1,2,1,FALSE
lucabro-linked-list,1.0.5,1.0.6,6,1,1,1,2,1,FALSE
lucabro-linked-list,1.0.6,1.0.7,7,3,49,22,71,6,FALSE
lucabro-linked-list,1.0.7,1.0.8,8,1,1,1,2,1,FALSE
lucabro-linked-list,1.0.8,1.0.9,9,23,1349,849,2198,52,FALSE
lucabro-linked-list,1.0.9,1.0.10,10,2,99,5,104,3,FALSE
lucabro-linked-list,1.0.16,1.0.17,17,1,5,5,10,2,FALSE
lucabro-linked-list,1.0.17,1.0.18,18,2,3,3,6,2,FALSE
lucabro-linked-list,1.0.14,1.0.15,15,2,1063,555,1618,12,FALSE
lucabro-linked-list,1.0.15,1.0.16,16,1,5,5,10,1,FALSE
lucabro-linked-list,1.0.12,1.0.13,13,1,1,1,2,1,FALSE
lucabro-linked-list,1.0.13,1.0.14,14,2,204,28,232,3,FALSE
lucabro-linked-list,1.0.10,1.0.11,11,2,42,41,83,2,FALSE
lucabro-linked-list,1.0.11,1.0.12,12,1,1,1,2,1,FALSE
lucabro-linked-list,1.0.18,1.0.19,19,25,2484,2186,4670,56,FALSE
lucabro-linked-list,1.0.19,1.0.20,20,1,1,1,2,1,FALSE
lucabro-linked-list,1.0.27,1.0.28,27,1,1,1,2,1,FALSE
lucabro-linked-list,1.0.26,1.0.27,26,1,1,1,2,1,FALSE
lucabro-linked-list,1.0.25,1.0.26,25,1,1,1,2,1,FALSE
lucabro-linked-list,1.0.24,1.0.25,24,1,1,1,2,1,FALSE
lucabro-linked-list,1.0.22,1.0.24,23,1,1,1,2,1,FALSE
lucabro-linked-list,1.0.21,1.0.22,22,1,1,1,2,1,FALSE
lucabro-linked-list,1.0.20,1.0.21,21,1,1,1,2,1,FALSE
lucabro-linked-list,1.0.6,1.0.7,7,3,49,22,71,6,TRUE
lucabro-linked-list,1.0.8,1.0.9,9,23,1349,849,2198,52,TRUE
lucabro-linked-list,1.0.18,1.0.19,19,25,2484,2186,4670,56,TRUE
lucabro-linked-list,1.0.22,1.0.24,23,1,1,1,2,1,TRUE
lucabro-linked-list,1.0.4,1.0.5,5,1,1,1,2,1,FALSE
audio-player-es6,1.0.4,1.0.5,3,1,6,2,8,2,FALSE
audio-player-es6,1.0.5,1.0.6,4,1,44,7,51,3,FALSE
audio-player-es6,1.0.6,1.0.7,5,1,4,4,8,3,FALSE
audio-player-es6,1.0.7,1.0.8,6,1,6,2,8,3,FALSE
audio-player-es6,1.0.2,1.0.3,1,2,131,149,280,3,FALSE
audio-player-es6,1.0.3,1.0.4,2,1,181,177,358,4,FALSE
audio-player-es6,1.0.7,1.0.8,6,1,6,2,8,3,TRUE
prop-map,0.0.5,0.0.6,6,1,4,2,6,2,FALSE
prop-map,0.0.4,0.0.5,5,1,4,2,6,2,FALSE
prop-map,0.0.1,0.0.2,2,2,7,9,16,3,FALSE
prop-map,0.0.0,0.0.1,1,6,331,21,352,14,FALSE
prop-map,0.0.3,0.0.4,4,1,1,1,2,1,FALSE
prop-map,0.0.2,0.0.3,3,1,3,2,5,1,FALSE
prop-map,0.0.1,0.0.2,2,2,7,9,16,3,TRUE
prop-map,0.0.0,0.0.1,1,6,331,21,352,14,TRUE
gulp-tsc,1.1.1,1.1.2,26,7,57,19,76,12,FALSE
gulp-tsc,1.1.0,1.1.1,25,4,2460,122,2582,12,FALSE
gulp-tsc,1.1.3,1.1.4,28,2,2,2,4,2,FALSE
gulp-tsc,1.1.2,1.1.3,27,3,46,19,65,5,FALSE
gulp-tsc,1.0.0,1.1.0,24,8,55,32,87,14,FALSE
gulp-tsc,1.1.4,1.1.5,29,2,101,8,109,5,FALSE
gulp-tsc,1.2.4-alpha1,1.2.4-alpha2,34,1,9,2294,2303,7,FALSE
gulp-tsc,1.2.4-alpha2,1.2.4,35,1,3,3,6,1,FALSE
gulp-tsc,0.2.2,0.3.0,8,5,11,5,16,5,FALSE
gulp-tsc,0.2.1,0.2.2,7,4,250,14,264,11,FALSE
gulp-tsc,0.2.0,0.2.1,6,4,78,12,90,8,FALSE
gulp-tsc,0.1.0,0.2.0,5,3,85,3,88,7,FALSE
gulp-tsc,1.1.5,1.2.0,30,8,74,23,97,9,FALSE
gulp-tsc,0.10.1,1.0.0,23,1,22,1,23,2,FALSE
gulp-tsc,0.0.4,0.1.0,4,11,655,417,1072,43,FALSE
gulp-tsc,0.0.1,0.0.2,1,5,5,5,10,5,FALSE
gulp-tsc,0.0.3,0.0.4,3,6,71,40,111,15,FALSE
gulp-tsc,0.0.2,0.0.3,2,6,93,5,98,14,FALSE
gulp-tsc,0.3.0,0.4.0,9,5,86,16,102,8,FALSE
gulp-tsc,0.6.0,0.7.0,13,3,3,3,6,3,FALSE
gulp-tsc,0.7.0,0.8.0,14,6,424,56,480,16,FALSE
gulp-tsc,0.4.0,0.5.0,10,5,46,29,75,9,FALSE
gulp-tsc,0.5.0,0.5.1,11,3,149,25,174,7,FALSE
gulp-tsc,0.5.1,0.6.0,12,5,161,87,248,11,FALSE
gulp-tsc,0.9.0,0.9.1,16,2,13,13,26,2,FALSE
gulp-tsc,0.9.1,0.9.2,17,4,162,62,224,12,FALSE
gulp-tsc,0.9.2,0.9.3,18,23,169,126,295,25,FALSE
gulp-tsc,0.9.3,0.9.4,19,4,77,12,89,6,FALSE
gulp-tsc,0.9.4,0.9.5,20,6,33,17,50,7,FALSE
gulp-tsc,0.9.5,0.10.0,21,2,14,6,20,2,FALSE
gulp-tsc,0.10.0,0.10.1,22,4,15,11,26,6,FALSE
gulp-tsc,0.8.0,0.9.0,15,5,96,15,111,7,FALSE
gulp-tsc,1.2.6,1.3.0,38,7,180,66,246,17,FALSE
gulp-tsc,1.2.4,1.2.5,36,3,15,2,17,4,FALSE
gulp-tsc,1.3.0,1.3.1,39,2,11,6,17,2,FALSE
gulp-tsc,1.2.2,1.2.3,32,3,5,5,10,3,FALSE
gulp-tsc,1.2.3,1.2.4-alpha1,33,1,9,2294,2303,7,FALSE
gulp-tsc,1.2.0,1.2.2,31,4,45,24,69,6,FALSE
gulp-tsc,1.3.1,1.3.2,40,3,23,14,37,3,FALSE
gulp-tsc,1.2.5,1.2.6,37,2,8,16,24,3,FALSE
gulp-tsc,1.1.1,1.1.2,26,7,57,19,76,12,TRUE
gulp-tsc,1.1.0,1.1.1,25,4,2460,122,2582,12,TRUE
gulp-tsc,1.0.0,1.1.0,24,8,55,32,87,14,TRUE
gulp-tsc,1.1.4,1.1.5,29,2,101,8,109,5,TRUE
gulp-tsc,0.6.0,0.7.0,13,3,3,3,6,3,TRUE
gulp-tsc,0.9.2,0.9.3,18,23,169,126,295,25,TRUE
gulp-tsc,0.5.1,0.6.0,12,5,161,87,248,11,TRUE
gulp-tsc,0.10.0,0.10.1,22,4,15,11,26,6,TRUE
gulp-tsc,0.3.0,0.4.0,9,5,86,16,102,8,TRUE
react-flex-grid,0.0.4,0.0.5,3,4,6,6,12,5,FALSE
react-flex-grid,0.0.1,0.0.2,1,3,124,129,253,7,FALSE
react-flex-grid,0.0.2,0.0.4,2,3,2,6,8,3,FALSE
react-flex-grid,1.1.1,1.1.2,13,2,16,21,37,5,FALSE
react-flex-grid,1.1.0,1.1.1,12,3,214,2,216,8,FALSE
react-flex-grid,1.1.3,1.1.4,15,2,2,193,195,4,FALSE
react-flex-grid,1.1.2,1.1.3,14,2,13,11,24,3,FALSE
react-flex-grid,1.1.5,1.1.6,17,2,25,56,81,3,FALSE
react-flex-grid,1.1.4,1.1.5,16,2,23,13,36,3,FALSE
react-flex-grid,1.1.7,1.1.8,19,2,3,3,6,3,FALSE
react-flex-grid,1.1.6,1.1.7,18,2,10,2,12,4,FALSE
react-flex-grid,1.1.9,1.1.10,21,2,9,3,12,4,FALSE
react-flex-grid,1.1.8,1.1.9,20,2,20,20,40,5,FALSE
react-flex-grid,2.0.3,2.0.4,42,2,3,1,4,3,FALSE
react-flex-grid,2.0.2,2.0.3,41,2,27,21,48,4,FALSE
react-flex-grid,1.1.24,1.1.25,36,2,5,5,10,3,FALSE
react-flex-grid,1.1.25,1.1.26,37,2,4,3,7,4,FALSE
react-flex-grid,1.1.26,2.0.0,38,2,20,34,54,5,TRUE
react-flex-grid,1.1.20,1.1.21,32,2,36,4,40,4,FALSE
react-flex-grid,1.1.21,1.1.22,33,2,5,5,10,3,FALSE
react-flex-grid,1.1.22,1.1.23,34,2,10,14,24,3,FALSE
react-flex-grid,1.1.23,1.1.24,35,2,36,10,46,4,FALSE
react-flex-grid,2.0.0,2.0.1,39,2,49,31,80,3,FALSE
react-flex-grid,1.0.16,1.0.17,9,2,947,370,1317,15,FALSE
react-flex-grid,1.0.17,1.0.18,10,2,4,4,8,4,FALSE
react-flex-grid,1.0.15,1.0.16,8,2,38275,14,38289,4,FALSE
react-flex-grid,1.0.18,1.1.0,11,2,51,24,75,7,FALSE
react-flex-grid,2.0.1,2.0.2,40,2,81,54,135,3,FALSE
react-flex-grid,1.1.19,1.1.20,31,2,93,24,117,8,FALSE
react-flex-grid,1.1.18,1.1.19,30,2,9,7,16,2,FALSE
react-flex-grid,1.1.11,1.1.12,23,2,7,5,12,3,FALSE
react-flex-grid,1.1.10,1.1.11,22,2,19,10,29,3,FALSE
react-flex-grid,1.1.13,1.1.14,25,2,181,31,212,6,FALSE
react-flex-grid,1.1.12,1.1.13,24,2,4,4,8,3,FALSE
react-flex-grid,1.1.15,1.1.16,27,2,29,23,52,3,FALSE
react-flex-grid,1.1.14,1.1.15,26,2,171,27,198,7,FALSE
react-flex-grid,1.1.17,1.1.18,29,2,4,3,7,3,FALSE
react-flex-grid,1.1.16,1.1.17,28,2,273,11,284,8,FALSE
react-flex-grid,1.1.26,2.0.0,38,2,20,34,54,5,FALSE
react-flex-grid,1.1.15,1.1.16,27,2,29,23,52,3,TRUE
react-flex-grid,1.0.14,1.0.15,7,7,152,145,297,11,FALSE
react-flex-grid,1.0.13,1.0.14,6,2,4,4,8,4,FALSE
react-flex-grid,1.1.13,1.1.14,25,2,181,31,212,6,TRUE
react-flex-grid,1.1.16,1.1.17,28,2,273,11,284,8,TRUE
react-flex-grid,1.1.4,1.1.5,16,2,23,13,36,3,TRUE
react-flex-grid,1.1.8,1.1.9,20,2,20,20,40,5,TRUE
react-flex-grid,1.0.12,1.0.13,5,1,58,13,71,1,FALSE
react-flex-grid,0.0.5,1.0.12,4,4,16,63,79,4,FALSE
react-flex-grid,1.1.9,1.1.10,21,2,9,3,12,4,TRUE
node-purestorage,1.0.0,1.1.0,3,7,45,31,76,10,FALSE
node-purestorage,0.0.1,0.0.2,1,4,12,2,14,4,FALSE
node-purestorage,1.0.0,1.1.0,3,7,45,31,76,10,TRUE
node-purestorage,0.0.2,1.0.0,2,3,300,16,316,15,FALSE
react-formalize,0.3.0-alpha4,0.3.0,9,4,479,207,686,19,FALSE
react-formalize,0.3.1,0.4.0,11,2,46,5,51,3,FALSE
react-formalize,0.2.0,0.2.1,4,2,35,3,38,3,FALSE
react-formalize,0.4.0,0.5.0-rc,12,2,87,6,93,3,FALSE
react-formalize,2.0.0-beta.2,2.0.0-beta.3,17,1,2,1,3,2,FALSE
react-formalize,0.3.0,0.3.1,10,7,51,45,96,13,FALSE
react-formalize,0.3.0-alpha3,0.3.0-alpha4,8,2,21,16,37,2,FALSE
react-formalize,0.5.0-rc,0.5.0-rc2,13,2,25,13,38,2,FALSE
react-formalize,0.5.0-rc2,0.5.0-rc3,14,2,8,4,12,2,FALSE
react-formalize,0.5.0-rc3,2.0.0-beta.1,15,8,2603,2239,4842,91,FALSE
react-formalize,0.3.0-alpha2,0.3.0-alpha3,7,2,83,13,96,4,FALSE
react-formalize,0.2.1,0.3.0-alpha,5,2,83,23,106,11,FALSE
react-formalize,0.3.0-alpha,0.3.0-alpha2,6,2,122,58,180,9,FALSE
react-formalize,0.1.0,0.1.1,1,1,2,1,3,2,FALSE
react-formalize,0.1.1,0.1.2,2,28,651,229,880,60,FALSE
react-formalize,0.1.2,0.2.0,3,6,1175,127,1302,37,TRUE
react-formalize,2.0.0-beta.1,2.0.0-beta.2,16,3,16,12,28,3,FALSE
react-formalize,0.1.2,0.2.0,3,6,1175,127,1302,37,FALSE
react-formalize,0.3.0-alpha2,0.3.0-alpha3,7,2,83,13,96,4,TRUE
react-formalize,0.1.1,0.1.2,2,28,651,229,880,60,TRUE
react-formalize,0.3.0-alpha4,0.3.0,9,4,479,207,686,19,TRUE
react-formalize,0.3.0,0.3.1,10,7,51,45,96,13,TRUE
react-formalize,0.3.1,0.4.0,11,2,46,5,51,3,TRUE
gulp-responsive,1.0.4,1.0.5,6,4,11,5,16,5,FALSE
gulp-responsive,1.0.5,1.0.6,7,2,8,1,9,3,FALSE
gulp-responsive,1.0.6,1.0.7,8,4,78,23,101,15,FALSE
gulp-responsive,1.0.7,1.1.1,9,7,148,22,170,12,FALSE
gulp-responsive,1.0.0,1.0.1,2,7,109,15,124,12,FALSE
gulp-responsive,1.0.1,1.0.2,3,6,69,10,79,9,FALSE
gulp-responsive,1.0.2,1.0.3,4,3,175,97,272,7,FALSE
gulp-responsive,1.0.3,1.0.4,5,2,124,13,137,9,FALSE
gulp-responsive,2.2.0,2.3.0,15,3,8,8,16,5,FALSE
gulp-responsive,2.1.0,2.2.0,14,12,142,28,170,17,FALSE
gulp-responsive,0.0.1,1.0.0,1,7,237,16,253,13,FALSE
gulp-responsive,2.0.0,2.1.0,13,3,8,10,18,3,FALSE
gulp-responsive,1.1.1,1.2.0,10,5,115,19,134,12,FALSE
gulp-responsive,2.3.0,2.4.0,16,4,12,9,21,7,FALSE
gulp-responsive,1.2.0,1.2.1,11,5,75,68,143,12,FALSE
gulp-responsive,1.2.1,2.0.0,12,28,1358,469,1827,53,FALSE
gulp-responsive,2.4.0,2.5.0,17,10,17,11,28,11,FALSE
gulp-responsive,2.5.0,2.5.1,18,4,37,3,40,5,FALSE
gulp-responsive,2.5.1,2.6.0,19,3,37,13,50,6,FALSE
gulp-responsive,2.6.0,2.7.0,20,6,6,5,11,6,FALSE
gulp-responsive,2.7.0,2.7.1,21,5,87,5,92,7,FALSE
gulp-responsive,1.0.7,1.1.1,9,7,148,22,170,12,TRUE
gulp-responsive,1.0.6,1.0.7,8,4,78,23,101,15,TRUE
gulp-responsive,0.0.1,1.0.0,1,7,237,16,253,13,TRUE
backbone-virtualized-listview,0.6.0-0,0.6.0-1,18,2,321,90,411,21,FALSE
backbone-virtualized-listview,0.6.0-1,0.6.0,19,1,1,1,2,1,FALSE
backbone-virtualized-listview,0.3.0-0,0.3.0-1,6,19,581,307,888,29,FALSE
backbone-virtualized-listview,0.6.4-0,0.6.4,24,3,18,10,28,4,FALSE
backbone-virtualized-listview,0.3.0-3,0.3.0,9,1,3,3,6,2,FALSE
backbone-virtualized-listview,0.3.0-2,0.3.0-3,8,4,850,416,1266,9,FALSE
backbone-virtualized-listview,0.3.0-1,0.3.0-2,7,3,49,59,108,7,FALSE
backbone-virtualized-listview,0.2.0,0.3.0-0,5,8,636,498,1134,12,FALSE
backbone-virtualized-listview,0.2.0-4,0.2.0,4,6,85,35,120,10,FALSE
backbone-virtualized-listview,0.2.0-2,0.2.0-3,2,3,90,6,96,6,FALSE
backbone-virtualized-listview,0.2.0-3,0.2.0-4,3,2,4,4,8,2,FALSE
backbone-virtualized-listview,0.6.3,0.6.4-0,23,3,21,29,50,3,FALSE
backbone-virtualized-listview,0.6.2,0.6.3,22,6,12428,4,12432,5,FALSE
backbone-virtualized-listview,0.6.1,0.6.2,21,1,3,3,6,2,FALSE
backbone-virtualized-listview,0.6.0,0.6.1,20,3,8,4,12,3,FALSE
backbone-virtualized-listview,0.5.4,0.6.0-0,17,2,33,36,69,6,FALSE
backbone-virtualized-listview,0.4.0,0.5.0,11,2,76,78,154,4,FALSE
backbone-virtualized-listview,0.5.0,0.5.1,12,5,128,52,180,11,FALSE
backbone-virtualized-listview,0.5.1,0.5.2,13,2,22,5,27,2,FALSE
backbone-virtualized-listview,0.5.2,0.5.3,14,2,2,2,4,2,FALSE
backbone-virtualized-listview,0.5.3,0.5.4-1,15,5,20,13,33,5,FALSE
backbone-virtualized-listview,0.5.4-1,0.5.4,16,2,2,2,4,2,FALSE
backbone-virtualized-listview,0.3.0,0.4.0,10,4,255,104,359,11,FALSE
backbone-virtualized-listview,0.1.4,0.2.0-2,1,35,2989,1199,4188,132,FALSE
backbone-virtualized-listview,0.6.2,0.6.3,22,6,12428,4,12432,5,TRUE
backbone-virtualized-listview,0.6.0,0.6.1,20,3,8,4,12,3,TRUE
backbone-virtualized-listview,0.5.3,0.5.4-1,15,5,20,13,33,5,TRUE
backbone-virtualized-listview,0.3.0-0,0.3.0-1,6,19,581,307,888,29,TRUE
backbone-virtualized-listview,0.2.0,0.3.0-0,5,8,636,498,1134,12,TRUE
backbone-virtualized-listview,0.5.1,0.5.2,13,2,22,5,27,2,TRUE
backbone-virtualized-listview,0.3.0-2,0.3.0-3,8,4,850,416,1266,9,TRUE
react-mixout,0.5.0,0.5.1,10,1,8,8,16,8,FALSE
react-mixout,0.5.1,0.5.2,11,1,11,11,22,11,FALSE
react-mixout,0.5.2,0.5.4,12,2,209,208,417,27,FALSE
react-mixout,0.0.1,0.0.2,1,1,4,4,8,2,TRUE
react-mixout,0.0.2,0.1.0,2,1,18,18,36,10,TRUE
react-mixout,0.1.0,0.2.0,3,23,2056,1243,3299,89,TRUE
react-mixout,0.2.0,0.2.1,4,1,18,18,36,10,FALSE
react-mixout,0.4.0,0.4.1,8,3,926,617,1543,61,FALSE
react-mixout,0.5.2,0.5.4,12,2,209,208,417,27,TRUE
react-mixout,0.4.1,0.5.0,9,8,575,328,903,49,TRUE
react-mixout,0.0.1,0.0.2,1,1,4,4,8,2,FALSE
react-mixout,0.0.2,0.1.0,2,1,18,18,36,10,FALSE
react-mixout,0.3.0,0.3.1,6,7,1356,38,1394,42,FALSE
react-mixout,0.2.1,0.3.0,5,33,2454,162,2616,92,FALSE
react-mixout,0.1.0,0.2.0,3,23,2056,1243,3299,89,FALSE
cerebral-angular-immutable-store,0.3.2,0.3.3,8,1,2,1,3,2,FALSE
cerebral-angular-immutable-store,0.3.3,0.4.0,9,2,6,3,9,2,FALSE
cerebral-angular-immutable-store,0.3.0,0.3.1,6,3,6,32,38,4,FALSE
cerebral-angular-immutable-store,0.3.1,0.3.2,7,4,13,39,52,6,FALSE
cerebral-angular-immutable-store,0.2.0,0.3.0,5,4,5,59,64,5,FALSE
cerebral-angular-immutable-store,0.1.0,0.1.1,1,2,10,4,14,3,FALSE
cerebral-angular-immutable-store,0.1.1,0.1.2,2,1,3,3,6,2,FALSE
cerebral-angular-immutable-store,0.1.2,0.1.4,3,2,6,6,12,4,FALSE
cerebral-angular-immutable-store,0.1.4,0.2.0,4,7,497,99,596,20,FALSE
cerebral-angular-immutable-store,0.1.0,0.1.1,1,2,10,4,14,3,TRUE
cerebral-angular-immutable-store,0.3.1,0.3.2,7,4,13,39,52,6,TRUE
cerebral-angular-immutable-store,0.1.4,0.2.0,4,7,497,99,596,20,TRUE
buildreq,1.0.0,1.0.1,31,4,117,60,177,9,FALSE
buildreq,1.0.1,2.0.0,32,5,910,494,1404,37,FALSE
buildreq,2.0.0,2.1.0,33,3,48,62,110,10,FALSE
buildreq,0.4.42,0.4.43,22,1,46,15,61,6,FALSE
buildreq,0.4.43,0.4.44,23,1,24,31,55,5,FALSE
buildreq,0.4.41,0.4.42,21,1,83,42,125,6,FALSE
buildreq,0.3.0,0.4.0,12,1,182,43,225,8,FALSE
buildreq,0.4.1,0.4.2,14,1,52,33,85,4,FALSE
buildreq,0.4.0,0.4.1,13,1,27,5,32,6,FALSE
buildreq,0.4.3,0.4.4,16,5,42,25,67,13,FALSE
buildreq,0.4.2,0.4.3,15,2,28,3,31,3,FALSE
buildreq,0.4.44,0.9.0,24,1,103,72,175,7,FALSE
buildreq,0.9.0,0.9.1,25,4,1030,672,1702,13,FALSE
buildreq,0.9.1,0.9.2,26,1,75,27,102,5,FALSE
buildreq,0.9.2,0.9.3,27,5,86,11,97,18,FALSE
buildreq,0.9.3,0.9.4,28,3,78,52,130,11,FALSE
buildreq,0.9.4,0.9.5,29,16,2173,1079,3252,55,FALSE
buildreq,0.9.5,1.0.0,30,5,1321,980,2301,27,FALSE
buildreq,0.4.33,0.4.41,20,1,13,12,25,4,FALSE
buildreq,0.4.32,0.4.33,19,1,8,3,11,3,FALSE
buildreq,0.4.31,0.4.32,18,1,9,1,10,3,FALSE
buildreq,0.2.0,0.3.0,11,1,600,101,701,10,FALSE
buildreq,0.1.0,0.1.1,7,2,122,105,227,10,FALSE
buildreq,0.1.1,0.1.2,8,1,26,18,44,7,FALSE
buildreq,0.1.3,0.2.0,10,3,125,25,150,7,FALSE
buildreq,0.1.2,0.1.3,9,1,33,12,45,6,FALSE
buildreq,0.0.5,0.0.6,5,1,24,31,55,5,FALSE
buildreq,0.0.4,0.0.5,4,6,232,79,311,8,FALSE
buildreq,0.0.6,0.1.0,6,9,1996,1290,3286,26,FALSE
buildreq,0.0.1,0.0.2,1,1,24,31,55,5,FALSE
buildreq,0.0.3,0.0.4,3,3,477,279,756,9,FALSE
buildreq,0.0.2,0.0.3,2,6,291,205,496,7,FALSE
buildreq,1.0.1,2.0.0,32,5,910,494,1404,37,TRUE
buildreq,0.0.4,0.0.5,4,6,232,79,311,8,TRUE
buildreq,0.4.44,0.9.0,24,1,103,72,175,7,TRUE
buildreq,0.9.0,0.9.1,25,4,1030,672,1702,13,TRUE
buildreq,0.9.1,0.9.2,26,1,75,27,102,5,TRUE
buildreq,2.0.0,2.1.0,33,3,48,62,110,10,TRUE
buildreq,0.9.3,0.9.4,28,3,78,52,130,11,TRUE
mediaelement,3.1.3,3.2.0,20,55,16946,55247,72193,427,FALSE
mediaelement,3.1.2,3.1.3,19,61,7196,7662,14858,669,FALSE
mediaelement,3.1.1,3.1.2,18,43,4009,2795,6804,318,FALSE
mediaelement,3.1.0,3.1.1,17,2,62,39,101,24,FALSE
mediaelement,3.0.2,3.1.0,16,52,24962,22883,47845,179,FALSE
mediaelement,3.0.1,3.0.2,15,40,2679,5853,8532,136,FALSE
mediaelement,4.0.1,4.0.2,27,6,211,152,363,37,FALSE
mediaelement,4.0.0,4.0.1,26,3,442,401,843,20,FALSE
mediaelement,4.0.3,4.0.4,29,37,3810,2887,6697,212,FALSE
mediaelement,4.0.2,4.0.3,28,19,62220,27364,89584,437,FALSE
mediaelement,4.1.0,4.1.1,34,34,853,1004,1857,204,FALSE
mediaelement,4.1.1,4.1.2,35,66,11538,30615,42153,568,FALSE
mediaelement,4.0.7,4.1.0,33,28,2465,1634,4099,133,FALSE
mediaelement,4.0.6,4.0.7,32,14,196,105,301,64,FALSE
mediaelement,4.0.5,4.0.6,31,6,115,46,161,38,FALSE
mediaelement,4.0.4,4.0.5,30,3,21,17,38,18,FALSE
mediaelement,3.2.4,4.0.0,25,50,8458,6399,14857,436,FALSE
mediaelement,3.2.0,3.2.1,21,3,37,21,58,23,FALSE
mediaelement,3.2.1,3.2.2,22,9,1022,1026,2048,70,FALSE
mediaelement,3.2.2,3.2.3,23,2,30,14,44,16,FALSE
mediaelement,3.2.3,3.2.4,24,83,19106,36653,55759,743,FALSE
mediaelement,3.0.0,3.0.1,14,26,4883,4750,9633,135,TRUE
mediaelement,3.0.0,3.0.1,14,26,4883,4750,9633,135,FALSE
mediaelement,2.18.2,2.21.0,2,76,2965,2151,5116,145,FALSE
mediaelement,2.22.0,2.22.1,6,632,136855,81438,218293,2895,FALSE
mediaelement,2.22.1,2.23.0,7,1,9,9,18,9,FALSE
mediaelement,2.23.1,2.23.2,9,1,9,9,18,9,FALSE
mediaelement,2.23.0,2.23.1,8,1,9,9,18,9,FALSE
mediaelement,2.23.3,2.23.4,11,1,9,9,18,9,FALSE
mediaelement,2.23.2,2.23.3,10,1,9,9,18,9,FALSE
mediaelement,2.21.2,2.22.0,5,29,1668,1106,2774,53,FALSE
mediaelement,2.21.1,2.21.2,4,5,15,11,26,9,FALSE
mediaelement,2.21.0,2.21.1,3,6,90,36,126,14,FALSE
mediaelement,2.23.5,3.0.0,13,44,139569,98588,238157,926,FALSE
mediaelement,2.23.4,2.23.5,12,253,50410,27509,77919,1723,FALSE
mediaelement,2.17.0,2.18.2,1,133,6543,5537,12080,284,FALSE
mediaelement,3.1.3,3.2.0,20,55,16946,55247,72193,427,TRUE
mediaelement,4.0.1,4.0.2,27,6,211,152,363,37,TRUE
mediaelement,4.1.0,4.1.1,34,34,853,1004,1857,204,TRUE
mediaelement,3.2.1,3.2.2,22,9,1022,1026,2048,70,TRUE
mediaelement,3.1.2,3.1.3,19,61,7196,7662,14858,669,TRUE
wee-core,1.0.0-alpha.9,1.0.0-alpha.10,10,6,144,137,281,7,FALSE
wee-core,1.0.0-alpha.8,1.0.0-alpha.9,9,7,316,264,580,28,FALSE
wee-core,1.0.0-beta,1.0.0-beta.2,29,11,3977,954,4931,27,FALSE
wee-core,1.0.0,1.0.1,46,5,30,68,98,7,FALSE
wee-core,1.0.1,1.0.2,47,7,75,75,150,11,FALSE
wee-core,1.0.2,1.1.0,48,36,316,231,547,43,FALSE
wee-core,1.1.0,1.1.1,49,3,19,20,39,3,TRUE
wee-core,1.0.0-alpha.1,1.0.0-alpha.2,2,1,4,1,5,3,FALSE
wee-core,1.0.0-alpha.3,1.0.0-alpha.4,4,2,54,44,98,4,FALSE
wee-core,1.0.0-alpha.2,1.0.0-alpha.3,3,5,48,23,71,8,FALSE
wee-core,1.0.0-alpha.5,1.0.0-alpha.6,6,6,244,195,439,14,FALSE
wee-core,1.0.0-alpha.4,1.0.0-alpha.5,5,7,269,135,404,22,FALSE
wee-core,1.0.0-alpha.7,1.0.0-alpha.8,8,5,58,35,93,21,FALSE
wee-core,1.0.0-alpha.6,1.0.0-alpha.7,7,8,144,56,200,16,FALSE
wee-core,1.3.5,1.3.6,58,10,277,254,531,10,FALSE
wee-core,1.0.0-beta.8,1.0.0-beta.9,36,13,1594,1623,3217,52,FALSE
wee-core,1.0.0-beta.9,1.0.0-beta.10,37,2,8,9,17,5,FALSE
wee-core,1.0.0-beta.6,1.0.0-beta.7,34,13,185,131,316,29,FALSE
wee-core,1.0.0-beta.7,1.0.0-beta.8,35,8,90,55,145,12,FALSE
wee-core,1.0.0-beta.4,1.0.0-beta.5,32,11,492,417,909,36,FALSE
wee-core,1.0.0-beta.5,1.0.0-beta.6,33,6,147,70,217,9,FALSE
wee-core,1.0.0-beta.2,1.0.0-beta.3,30,8,52,42,94,10,FALSE
wee-core,1.0.0-beta.3,1.0.0-beta.4,31,4,12,8,20,4,FALSE
wee-core,1.0.0-beta.16,1.0.0-rc.1,43,12,156,91,247,25,FALSE
wee-core,1.4.2,1.5.0,63,14,110,67,177,15,FALSE
wee-core,1.0.0-alpha.24,1.0.0-alpha.25,25,7,50,49,99,7,FALSE
wee-core,1.0.0-alpha.25,1.0.0-alpha.26,26,17,398,177,575,26,FALSE
wee-core,1.0.0-alpha.26,1.0.0-alpha.27,27,4,107,100,207,5,FALSE
wee-core,1.0.0-alpha.27,1.0.0-beta,28,20,332,304,636,25,FALSE
wee-core,1.0.0-alpha.20,1.0.0-alpha.21,21,23,1371,819,2190,48,FALSE
wee-core,1.0.0-alpha.21,1.0.0-alpha.22,22,5,29,17,46,5,FALSE
wee-core,1.0.0-alpha.22,1.0.0-alpha.23,23,8,154,120,274,13,FALSE
wee-core,1.0.0-alpha.23,1.0.0-alpha.24,24,7,71,29,100,7,FALSE
wee-core,1.6.1,1.7.0,65,27,330,350,680,41,FALSE
wee-core,1.4.1,1.4.2,62,3,3,4,7,3,FALSE
wee-core,1.8.1,1.8.2,67,27,1811,82,1893,44,FALSE
wee-core,1.8.2,1.8.3,68,456,36878,30237,67115,851,FALSE
wee-core,1.7.0,1.8.1,66,55,6778,5774,12552,193,FALSE
wee-core,1.4.0,1.4.1,61,10,82,70,152,10,FALSE
wee-core,1.0.0-beta.15,1.0.0-beta.16,42,10,143,108,251,12,FALSE
wee-core,1.1.1,1.2.0,50,36,328,192,520,40,FALSE
wee-core,1.0.0-beta.10,1.0.0-beta.11,38,5,66,51,117,14,FALSE
wee-core,1.0.0-beta.11,1.0.0-beta.12,39,4,12,11,23,6,TRUE
wee-core,1.0.0-beta.12,1.0.0-beta.14,40,7,174,129,303,8,FALSE
wee-core,1.5.0,1.6.1,64,203,13989,6943,20932,357,FALSE
wee-core,1.3.3,1.3.4,56,5,71,94,165,17,FALSE
wee-core,1.3.2,1.3.3,55,10,475,551,1026,21,FALSE
wee-core,1.3.1,1.3.2,54,1,16,16,32,2,FALSE
wee-core,1.3.0,1.3.1,53,3,153,46,199,4,FALSE
wee-core,1.3.7,1.4.0,60,11,253,215,468,11,FALSE
wee-core,1.0.0-rc.2,1.0.0,45,12,103,112,215,18,FALSE
wee-core,1.2.0,1.2.1,51,4,8,11,19,4,FALSE
wee-core,1.3.4,1.3.5,57,5,19,14,33,5,FALSE
wee-core,1.0.0-beta.14,1.0.0-beta.15,41,24,2238,2107,4345,115,FALSE
wee-core,1.2.1,1.3.0,52,38,682,433,1115,67,FALSE
wee-core,1.0.0-alpha.11,1.0.0-alpha.12,12,9,678,595,1273,20,FALSE
wee-core,1.0.0-alpha.10,1.0.0-alpha.11,11,4,39,26,65,4,FALSE
wee-core,1.0.0-alpha.13,1.0.0-alpha.14,14,5,393,236,629,18,FALSE
wee-core,1.0.0-alpha.12,1.0.0-alpha.13,13,4,52,80,132,10,FALSE
wee-core,1.0.0-alpha.15,1.0.0-alpha.16,16,5,39,55,94,6,FALSE
wee-core,1.0.0-alpha.14,1.0.0-alpha.15,15,3,20,29,49,11,FALSE
wee-core,1.0.0-alpha.17,1.0.0-alpha.18,18,2,11,4,15,3,FALSE
wee-core,1.0.0-alpha.16,1.0.0-alpha.17,17,8,243,102,345,14,FALSE
wee-core,1.0.0-alpha.19,1.0.0-alpha.20,20,1,6,6,12,2,FALSE
wee-core,1.0.0-alpha.18,1.0.0-alpha.19,19,6,20,19,39,7,FALSE
wee-core,1.0.0-rc.1,1.0.0-rc.2,44,6,61,460,521,19,FALSE
wee-core,1.3.6,1.3.7,59,18,59,60,119,18,FALSE
wee-core,1.1.0,1.1.1,49,3,19,20,39,3,FALSE
wee-core,1.0.0-beta.11,1.0.0-beta.12,39,4,12,11,23,6,FALSE
wee-core,1.0.2,1.1.0,48,36,316,231,547,43,TRUE
wee-core,1.0.0-beta.8,1.0.0-beta.9,36,13,1594,1623,3217,52,TRUE
wee-core,1.3.6,1.3.7,59,18,59,60,119,18,TRUE
wee-core,1.0.0-alpha.15,1.0.0-alpha.16,16,5,39,55,94,6,TRUE
wee-core,1.0.0-beta.4,1.0.0-beta.5,32,11,492,417,909,36,TRUE
wee-core,1.0.0-alpha.25,1.0.0-alpha.26,26,17,398,177,575,26,TRUE
wee-core,1.4.0,1.4.1,61,10,82,70,152,10,TRUE
wee-core,1.0.0-alpha.18,1.0.0-alpha.19,19,6,20,19,39,7,TRUE
wee-core,1.0.0-alpha.5,1.0.0-alpha.6,6,6,244,195,439,14,TRUE
wee-core,1.3.5,1.3.6,58,10,277,254,531,10,TRUE
wee-core,1.0.0-alpha.26,1.0.0-alpha.27,27,4,107,100,207,5,TRUE
wee-core,1.0.0-alpha.27,1.0.0-beta,28,20,332,304,636,25,TRUE
wee-core,1.3.3,1.3.4,56,5,71,94,165,17,TRUE
wee-core,1.0.0-beta.14,1.0.0-beta.15,41,24,2238,2107,4345,115,TRUE
wee-core,1.0.0-beta.16,1.0.0-rc.1,43,12,156,91,247,25,TRUE
wee-core,1.3.4,1.3.5,57,5,19,14,33,5,TRUE
wee-core,2.0.0-alpha.4,2.0.0-alpha.6,74,4,377,207,584,7,FALSE
wee-core,2.0.0-alpha.2,2.0.0-alpha.3,72,4,53,29,82,6,FALSE
wee-core,2.0.0-alpha.3,2.0.0-alpha.4,73,10,63,53,116,15,FALSE
wee-core,2.0.0-alpha,2.0.0-alpha.1,70,9,77,69,146,12,FALSE
wee-core,2.0.0-alpha.1,2.0.0-alpha.2,71,1,9,9,18,2,FALSE
wee-core,1.0.0-alpha.20,1.0.0-alpha.21,21,23,1371,819,2190,48,TRUE
wee-core,2.0.0-alpha,2.0.0-alpha.1,70,9,77,69,146,12,TRUE
wee-core,2.0.0-alpha.4,2.0.0-alpha.6,74,4,377,207,584,7,TRUE
mkdirp-bluebird,1.0.0,1.0.1,1,4,7,3,10,4,FALSE
mkdirp-bluebird,1.0.1,1.2.0,2,14,205,93,298,34,FALSE
mkdirp-bluebird,1.2.0,1.2.1,3,6,35,87,122,10,FALSE
mkdirp-bluebird,1.2.1,1.3.0,4,6,68,65,133,13,FALSE
mkdirp-bluebird,1.0.0,1.0.1,1,4,7,3,10,4,TRUE
eliot,0.1.8,0.1.9,9,2,14,2,16,2,FALSE
eliot,0.1.9,0.1.10,10,1,3,1,4,2,FALSE
eliot,0.1.0,0.1.1,1,1,4,5,9,1,FALSE
eliot,0.1.1,0.1.2,2,2,2,3,5,2,FALSE
eliot,0.1.2,0.1.3,3,1,8,3,11,3,FALSE
eliot,0.1.3,0.1.4,4,1,8,3,11,2,FALSE
eliot,0.1.4,0.1.5,5,1,2,2,4,2,FALSE
eliot,0.1.5,0.1.6,6,1,3,3,6,2,FALSE
eliot,0.1.6,0.1.7,7,1,3,3,6,2,FALSE
eliot,0.1.7,0.1.8,8,1,6,8,14,3,FALSE
eliot,0.1.29,0.1.30,30,3,15,5,20,3,FALSE
eliot,0.1.28,0.1.29,29,10,31,41,72,21,FALSE
eliot,0.1.23,0.1.24,24,3,6,3,9,6,FALSE
eliot,0.1.22,0.1.23,23,3,3,3,6,3,FALSE
eliot,0.1.21,0.1.22,22,6,356,162,518,20,FALSE
eliot,0.1.20,0.1.21,21,1,13,2,15,2,FALSE
eliot,0.1.27,0.1.28,28,3,3,5,8,3,FALSE
eliot,0.1.26,0.1.27,27,3,12,3,15,5,FALSE
eliot,0.1.25,0.1.26,26,3,21,3,24,3,FALSE
eliot,0.1.24,0.1.25,25,3,14,10,24,4,FALSE
eliot,0.1.12,0.1.13,13,1,83,20,103,8,FALSE
eliot,0.1.13,0.1.14,14,1,11,15,26,4,FALSE
eliot,0.1.10,0.1.11,11,1,5,5,10,2,FALSE
eliot,0.1.11,0.1.12,12,1,3,3,6,2,FALSE
eliot,0.1.16,0.1.17,17,1,2,2,4,2,FALSE
eliot,0.1.17,0.1.18,18,1,4,2,6,2,FALSE
eliot,0.1.14,0.1.15,15,1,8,2,10,2,FALSE
eliot,0.1.15,0.1.16,16,1,4,2,6,2,FALSE
eliot,0.1.18,0.1.19,19,1,2,1,3,2,FALSE
eliot,0.1.19,0.1.20,20,1,2,2,4,2,FALSE
eliot,0.1.30,0.1.31,31,3,16,5,21,5,FALSE
eliot,0.1.31,0.1.32,32,7,29,18,47,10,FALSE
eliot,0.1.32,0.1.33,33,3,33,18,51,4,FALSE
eliot,0.1.20,0.1.21,21,1,13,2,15,2,TRUE
eliot,0.1.21,0.1.22,22,6,356,162,518,20,TRUE
bottr-cli,0.1.4,0.1.5,4,10,105,73,178,12,FALSE
bottr-cli,0.1.3,0.1.4,3,4,11,7,18,5,TRUE
bottr-cli,0.1.1,0.1.2,1,7,8,11,19,7,FALSE
bottr-cli,0.1.2,0.1.3,2,7,187,67,254,11,FALSE
bottr-cli,0.1.3,0.1.4,3,4,11,7,18,5,FALSE
